experiment_info	module	significant	p_value	term_size	query_size	intersection_size	precision	recall	term_id	source	term_name	effective_domain_size	source_order	parents	goslim_pir	perc_rank	cumelative_dist	monet_type	genes	rank	P	N	tp	fp	fn	tn	tot_pop_valid	mcc
e019_R1	1	TRUE	9.33528436815188e-5	12	13	3	0.23076923076923078	0.25	REAC:R-HSA-1663150	REAC	The activation of arylsulfatases	10790	2363		NA	0	0.3333333333333333	R1	-	1	12	10778	3	10	9	10768	10790	0.23931191613213965
e019_R1	2	TRUE	1.5691177583892905e-15	132	26	13	0.5	0.09848484848484848	KEGG:04142	KEGG	Lysosome	8161	274		GO:0008152	0	0.047619047619047616	R1	-	1	132	8029	13	13	119	8016	8161	0.21683148449748063
e019_R1	3	TRUE	3.4458638120663977e-7	9	20	4	0.2	0.4444444444444444	REAC:R-HSA-391908	REAC	Prostanoid ligand receptors	10790	1720		GO:0050789	0	0.16666666666666666	R1	-	1	9	10781	4	16	5	10765	10790	0.2972985451317327
e019_R1	4	TRUE	3.179122905075278e-13	35	21	8	0.38095238095238093	0.22857142857142856	REAC:R-HSA-1296065	REAC	Inwardly rectifying K+ channels	10790	1211		GO:0006936;GO:0006811	0	0.02040816326530612	R1	-	1	35	10755	8	13	27	10742	10790	0.2933331119213059
e019_R1	5	TRUE	4.102500520200147e-24	18	24	11	0.4583333333333333	0.6111111111111112	REAC:R-HSA-163210	REAC	Formation of ATP by chemiosmotic coupling	10790	898		GO:0006119;GO:0009117	0	0.02040816326530612	R1	-	1	18	10772	11	13	7	10759	10790	0.5283397621500766
e019_R1	6	TRUE	5.270802926965621e-25	43	19	13	0.6842105263157895	0.3023255813953488	KEGG:03022	KEGG	Basal transcription factors	8161	213		GO:0009059;GO:0006281;GO:0016070	0	0.017241379310344827	R1	-	1	43	8118	13	6	30	8112	8161	0.4530313689598902
e019_R1	7	TRUE	1.6998006314301527e-49	43	28	23	0.8214285714285714	0.5348837209302325	KEGG:03022	KEGG	Basal transcription factors	8161	213		GO:0006508;GO:0016070;GO:0050789;GO:0065003;GO:0036211;GO:0009059	0	0.01818181818181818	R1	-	1	43	8118	23	5	20	8113	8161	0.6614748772569595
e019_R1	8	TRUE	5.581079007415451e-4	449	11	6	0.5454545454545454	0.013363028953229399	REAC:R-HSA-9012999	REAC	RHO GTPase cycle	10790	1755		NA	0	0.3333333333333333	R1	-	1	449	10341	6	5	443	10336	10790	0.08059691678035674
e019_R1	9	TRUE	1.178889931268636e-19	23	17	9	0.5294117647058824	0.391304347826087	GO:0042744	GO:BP	hydrogen peroxide catabolic process	16324	10914		GO:0008152;GO:0015669	0	0.05263157894736842	R1	-	1	23	16301	9	8	14	16293	16324	0.45449508605563205
e019_R1	10	TRUE	9.37995722677978e-26	170	22	18	0.8181818181818182	0.10588235294117647	KEGG:04310	KEGG	Wnt signaling pathway	8161	293		GO:0032501;GO:0007154;GO:0050896;GO:0050789;GO:0032502	0	0.01098901098901099	R1	-	1	170	7991	18	4	152	7987	8161	0.29026437157621876
e019_R1	11	TRUE	4.083859608820558e-17	140	21	12	0.5714285714285714	0.08571428571428572	GO:0006836	GO:BP	neurotransmitter transport	16324	2562		GO:0007154;GO:0065008;GO:0006836;GO:0046903;GO:0016192	0	0.01818181818181818	R1	-	1	140	16184	12	9	128	16175	16324	0.21907353538175534
e019_R1	12	TRUE	2.9417350915754257e-46	24	26	18	0.6923076923076923	0.75	GO:0031145	GO:BP	anaphase-promoting complex-dependent catabolic process	16324	7447		GO:0007049;GO:0006508;GO:0009057;GO:0050789;GO:0036211	0	0.00980392156862745	R1	-	1	24	16300	18	8	6	16292	16324	0.7201493313891848
e019_R1	13	TRUE	1.1157332927870037e-17	35	23	10	0.43478260869565216	0.2857142857142857	REAC:R-HSA-114604	REAC	GPVI-mediated activation cascade	10790	967		GO:0044255;GO:0050789;GO:0006793	0	0.004273504273504274	R1	-	1	35	10755	10	13	25	10742	10790	0.35076696988376926
e019_R1	14	TRUE	5.661990639599903e-9	94	15	7	0.4666666666666667	0.07446808510638298	REAC:R-HSA-9013423	REAC	RAC3 GTPase cycle	10790	1746		GO:0050789	0	0.043478260869565216	R1	-	1	94	10696	7	8	87	10688	10790	0.18386815480995278
e019_R1	15	TRUE	4.036858593427404e-4	43	8	3	0.375	0.06976744186046512	KEGG:04975	KEGG	Fat digestion and absorption	8161	399		GO:0043062;GO:0045229	0	0.1111111111111111	R1	-	1	43	8118	3	5	40	8113	8161	0.1599767275812419
e019_R1	16	TRUE	1.1257575651936063e-35	22	23	15	0.6521739130434783	0.6818181818181818	REAC:R-HSA-392170	REAC	ADP signalling through P2Y purinoceptor 12	10790	10		GO:0050789	0	0.012345679012345678	R1	-	1	22	10768	15	8	7	10760	10790	0.6661356570320618
e019_R1	17	TRUE	1.412724315145702e-7	11	3	3	1	0.2727272727272727	REAC:R-HSA-2485179	REAC	Activation of the phototransduction cascade	10790	102		GO:0050877	0	0.125	R1	-	1	11	10779	3	0	8	10779	10790	0.5220392792307172
e019_R1	18	TRUE	0.0068955225432860675	3	20	2	0.1	0.6666666666666666	GO:0018343	GO:BP	protein farnesylation	16324	5664		GO:0036211	0	0.5	R1	-	1	3	16321	2	18	1	16303	16324	0.2579061014981554
e019_R1	19	TRUE	1.9174830663547153e-100	187	79	64	0.810126582278481	0.3422459893048128	REAC:R-HSA-72172	REAC	mRNA Splicing	10790	2565		GO:0065003;GO:0000375	0	0.02564102564102564	R1	-	1	187	10603	64	15	123	10588	10790	0.5217303411620039
e019_R1	20	TRUE	1.8431333337734773e-46	53	33	24	0.7272727272727273	0.4528301886792453	KEGG:03460	KEGG	Fanconi anemia pathway	8161	237		GO:0050789;GO:0006281;GO:0036211	0	0.011904761904761904	R1	-	1	53	8108	24	9	29	8099	8161	0.5717622446140483
e019_R1	21	TRUE	6.231635381788395e-15	383	18	13	0.7222222222222222	0.033942558746736295	GO:0006338	GO:BP	chromatin remodeling	16324	2173		GO:0065003	0	0.07142857142857142	R1	-	1	383	15941	13	5	370	15936	16324	0.15337687528448105
e019_R1	22	TRUE	1.2432443281043205e-6	210	17	7	0.4117647058823529	0.03333333333333333	GO:1903320	GO:BP	regulation of protein modification by small protein conjugation or removal	16324	24000		GO:0050789;GO:0036211	0	0.058823529411764705	R1	-	1	210	16114	7	10	203	16104	16324	0.11429229439166712
e019_R1	23	TRUE	6.8391433637091725e-25	140	31	19	0.6129032258064516	0.1357142857142857	KEGG:04120	KEGG	Ubiquitin mediated proteolysis	8161	265		GO:0050789;GO:0006508;GO:0036211;GO:0009057	0	0.01	R1	-	1	140	8021	19	12	121	8009	8161	0.2833111117007851
e019_R1	24	TRUE	7.416034229242465e-24	516	34	23	0.6764705882352942	0.044573643410852716	GO:0006281	GO:BP	DNA repair	16324	2140		GO:0007049;GO:0000280;GO:0006281	0	0.011363636363636364	R1	-	1	516	15808	23	11	493	15797	16324	0.16838681823970802
e019_R1	25	TRUE	1.4681286348189815e-21	175	29	16	0.5517241379310345	0.09142857142857143	GO:0070646	GO:BP	protein modification by small protein removal	16324	17165		GO:0050789;GO:0006508;GO:0036211	0	0.013333333333333334	R1	-	1	175	16149	16	13	159	16136	16324	0.2216189114852788
e019_R1	26	TRUE	1.8646226058065107e-5	4	25	3	0.12	0.75	GO:0006556	GO:BP	S-adenosylmethionine biosynthetic process	16324	2330		GO:0006790	0	0.125	R1	-	1	4	16320	3	22	1	16298	16324	0.2996536382359366
e019_R1	27	TRUE	6.862884571921239e-7	10	21	4	0.19047619047619047	0.4	REAC:R-HSA-198693	REAC	AKT phosphorylates targets in the nucleus	10790	12		NA	0	0.05263157894736842	R1	-	1	10	10780	4	17	6	10763	10790	0.2750783761217926
e019_R1	28	TRUE	5.037081291347384e-32	36	25	16	0.64	0.4444444444444444	KEGG:03030	KEGG	DNA replication	8161	214		GO:0009059;GO:0006260;GO:0006281	0	0.010526315789473684	R1	-	1	36	8125	16	9	20	8116	8161	0.5316443419642526
e019_R1	29	TRUE	2.0370138552679745e-20	34	15	10	0.6666666666666666	0.29411764705882354	REAC:R-HSA-174417	REAC	Telomere C-strand (Lagging Strand) Synthesis	10790	2351		GO:0050789;GO:0006260;GO:0065009;GO:0009059	0	0.012195121951219513	R1	-	1	34	10756	10	5	24	10751	10790	0.4417176145487904
e019_R1	30	TRUE	2.016027034069881e-35	33	38	18	0.47368421052631576	0.5454545454545454	REAC:R-HSA-68962	REAC	Activation of the pre-replicative complex	10790	103		GO:0007049;GO:0050789;GO:0006260;GO:0006281	0	0.011904761904761904	R1	-	1	33	10757	18	20	15	10737	10790	0.5066893943080664
e019_R1	32	TRUE	1.2308376699926318e-19	813	27	21	0.7777777777777778	0.025830258302583026	GO:0000278	GO:BP	mitotic cell cycle	16324	80		GO:0007049;GO:0050789;GO:0065009	0	0.008695652173913044	R1	-	1	813	15511	21	6	792	15505	16324	0.13620881597861187
e019_R1	33	TRUE	3.7548030022078594e-21	13	19	9	0.47368421052631576	0.6923076923076923	REAC:R-HSA-174430	REAC	Telomere C-strand synthesis initiation	10790	2352		GO:0051276;GO:0051641;GO:0050789;GO:0009059;GO:0006259	0	0.00980392156862745	R1	-	1	13	10777	9	10	4	10767	10790	0.57204801731398
e019_R1	34	TRUE	6.3953284387195254e-12	516	49	18	0.3673469387755102	0.03488372093023256	GO:0007169	GO:BP	transmembrane receptor protein tyrosine kinase signaling pathway	16324	2796		GO:0050789;GO:0050896;GO:0065009;GO:0002376	0	0.006802721088435374	R1	-	1	516	15808	18	31	498	15777	16324	0.10529313807710611
e019_R1	35	TRUE	1.0352633153793067e-17	51	31	11	0.3548387096774194	0.21568627450980393	GO:0001836	GO:BP	release of cytochrome c from mitochondria	16324	507		GO:0065008;GO:0050896;GO:0061024;GO:0050789;GO:0007005	0	0.008695652173913044	R1	-	1	51	16273	11	20	40	16253	16324	0.27490221985937086
e019_R1	36	TRUE	5.4312070338462876e-33	19	25	14	0.56	0.7368421052631579	REAC:R-HSA-77595	REAC	Processing of Intronless Pre-mRNAs	10790	1709		GO:0006396	0	0.017857142857142856	R1	-	1	19	10771	14	11	5	10760	10790	0.6416524819028077
e019_R1	37	TRUE	2.000969835088951e-16	67	22	11	0.5	0.16417910447761194	KEGG:00010	KEGG	Glycolysis / Gluconeogenesis	8161	2		GO:0006082;GO:0006091;GO:0009117;GO:0005975	0	0.04	R1	-	1	67	8094	11	11	56	8083	8161	0.283354479101971
e019_R1	38	TRUE	1.249630284560586e-9	12	17	5	0.29411764705882354	0.4166666666666667	REAC:R-HSA-4641265	REAC	Repression of WNT target genes	10790	1946		GO:0050789	0	0.02127659574468085	R1	-	1	12	10778	5	12	7	10766	10790	0.349215606801021
e019_R1	39	TRUE	1.000075251466293e-16	150	16	12	0.75	0.08	KEGG:03040	KEGG	Spliceosome	8161	215		GO:0000375	0	0.07142857142857142	R1	-	1	150	8011	12	4	138	8007	8161	0.2414094902002947
e019_R1	40	TRUE	2.2112196625678275e-7	30	17	5	0.29411764705882354	0.16666666666666666	REAC:R-HSA-3000157	REAC	Laminin interactions	10790	1241		NA	0	0.04	R1	-	1	30	10760	5	12	25	10748	10790	0.21978947712006083
e019_R1	41	TRUE	1.7980570446502356e-5	73	17	5	0.29411764705882354	0.0684931506849315	KEGG:04115	KEGG	p53 signaling pathway	8161	264		NA	0	0.2	R1	-	1	73	8088	5	12	68	8076	8161	0.13838048508136716
e019_R1	42	TRUE	6.3411538555649925e-6	170	13	6	0.46153846153846156	0.03529411764705882	KEGG:04310	KEGG	Wnt signaling pathway	8161	293		GO:0050789;GO:0065009	0	0.027777777777777776	R1	-	1	170	7991	6	7	164	7984	8161	0.12325800598477878
e019_R1	43	TRUE	2.4538240679759295e-20	33	24	11	0.4583333333333333	0.3333333333333333	REAC:R-HSA-1592389	REAC	Activation of Matrix Metalloproteinases	10790	82		GO:0065008;GO:0050896;GO:0045229;GO:0050789;GO:0043062;GO:0022411;GO:0008152	0	0.02	R1	-	1	33	10757	11	13	22	10744	10790	0.38928805238540337
e019_R1	44	TRUE	3.4469300686483267e-13	137	20	10	0.5	0.072992700729927	GO:0070507	GO:BP	regulation of microtubule cytoskeleton organization	16324	17092		GO:0050789;GO:0006996;GO:0022607	0	0.021739130434782608	R1	-	1	137	16187	10	10	127	16177	16324	0.1887424067432441
e019_R1	45	TRUE	6.414021322298967e-17	31	22	9	0.4090909090909091	0.2903225806451613	GO:0006506	GO:BP	GPI anchor biosynthetic process	16324	2284		GO:0044255;GO:0009059;GO:0006793;GO:0036211	0	0.02857142857142857	R1	-	1	31	16293	9	13	22	16280	16324	0.3435857940388129
e019_R1	48	TRUE	5.826848328901175e-10	8	24	5	0.20833333333333334	0.625	REAC:R-HSA-75158	REAC	TRAIL  signaling	10790	2335		GO:0050789;GO:0050896;GO:0065009	0	0.011904761904761904	R1	-	1	8	10782	5	19	3	10763	10790	0.36009379440379435
e019_R1	50	TRUE	8.393445295210992e-26	36	22	13	0.5909090909090909	0.3611111111111111	REAC:R-HSA-390522	REAC	Striated Muscle Contraction	10790	2225		GO:0006936;GO:0006996;GO:0032502;GO:0022607	0	0.017543859649122806	R1	-	1	36	10754	13	9	23	10745	10790	0.460564628556271
e019_R1	52	TRUE	3.6571094938529876e-14	174	20	11	0.55	0.06321839080459771	GO:0007051	GO:BP	spindle organization	16324	2709		GO:0007049;GO:0051276;GO:0007059;GO:0000280	0	0.02857142857142857	R1	-	1	174	16150	11	9	163	16141	16324	0.1839487862797564
e019_R1	53	TRUE	3.5184624558081133e-4	39	7	3	0.42857142857142855	0.07692307692307693	REAC:R-HSA-9031628	REAC	NGF-stimulated transcription	10790	1442		NA	0	0.2	R1	-	1	39	10751	3	4	36	10747	10790	0.18042174760786478
e019_R1	54	TRUE	4.476508733078966e-9	131	18	8	0.4444444444444444	0.061068702290076333	REAC:R-HSA-166520	REAC	Signaling by NTRKs	10790	2162		GO:0050789;GO:0050896	0	0.041666666666666664	R1	-	1	131	10659	8	10	123	10649	10790	0.16136319011795097
e019_R1	56	TRUE	1.6925107828855422e-19	10	22	8	0.36363636363636365	0.8	GO:0044154	GO:BP	histone H3-K14 acetylation	16324	11560		GO:0050789;GO:0036211	0	0.019230769230769232	R1	-	1	10	16314	8	14	2	16300	16324	0.5389795831374786
e019_R1	58	TRUE	1.9133186698726802e-22	36	24	12	0.5	0.3333333333333333	REAC:R-HSA-8939243	REAC	RUNX1 interacts with co-factors whose precise effect on RUNX1 targets is not known	10790	1823		GO:0036211	0	0.03225806451612903	R1	-	1	36	10754	12	12	24	10742	10790	0.40665481946740856
e019_R1	59	TRUE	1.1275464009618424e-37	52	33	19	0.5757575757575758	0.36538461538461536	GO:0051568	GO:BP	histone H3-K4 methylation	16324	14578		GO:0050789;GO:0036211	0	0.021739130434782608	R1	-	1	52	16272	19	14	33	16258	16324	0.45731738667704763
e019_R1	60	TRUE	2.3580812662137767e-12	438	33	15	0.45454545454545453	0.03424657534246575	GO:0006325	GO:BP	chromatin organization	16324	2169		GO:0050789;GO:0043412;GO:0016043	0	0.021739130434782608	R1	-	1	438	15886	15	18	423	15868	16324	0.11912930502753766
e019_R1	61	TRUE	5.83150809873119e-6	26	13	4	0.3076923076923077	0.15384615384615385	REAC:R-HSA-3238698	REAC	WNT ligand biogenesis and trafficking	10790	2529		GO:0022607	0	0.04	R1	-	1	26	10764	4	9	22	10755	10790	0.216258313113819
e019_R1	62	TRUE	2.7880480433866822e-12	23	25	7	0.28	0.30434782608695654	GO:1902455	GO:BP	negative regulation of stem cell population maintenance	16324	23330		GO:0050789	0	0.03333333333333333	R1	-	1	23	16301	7	18	16	16283	16324	0.29087888738655615
e019_R1	63	TRUE	1.0853837136634316e-10	416	23	12	0.5217391304347826	0.028846153846153848	GO:0002521	GO:BP	leukocyte differentiation	16324	1061		GO:0001775;GO:0002376;GO:0006351;GO:0050789;GO:0032502	0	0.017543859649122806	R1	-	1	416	15908	12	11	404	15897	16324	0.1182861720107097
e019_R1	64	TRUE	8.82640633332985e-18	46	18	10	0.5555555555555556	0.21739130434782608	REAC:R-HSA-2122947	REAC	NOTCH1 Intracellular Domain Regulates Transcription	10790	1447		GO:0050789;GO:0036211	0	0.018518518518518517	R1	-	1	46	10744	10	8	36	10736	10790	0.34588328448394373
e019_R1	65	TRUE	2.6603612231790424e-30	15	24	12	0.5	0.8	GO:1904507	GO:BP	positive regulation of telomere maintenance in response to DNA damage	16324	25027		GO:0006260;GO:0050789;GO:0050896;GO:0051276	0	0.025	R1	-	1	15	16309	12	12	3	16297	16324	0.6320482585454952
e019_R1	66	TRUE	9.841549165469595e-10	25	20	6	0.3	0.24	REAC:R-HSA-8854691	REAC	Interleukin-20 family signaling	10790	1182		GO:0050789;GO:0050896	0	0.0625	R1	-	1	25	10765	6	14	19	10751	10790	0.2668121862017511
e019_R1	67	TRUE	3.707845015064307e-6	755	19	10	0.5263157894736842	0.013245033112582781	GO:0000122	GO:BP	negative regulation of transcription by RNA polymerase II	16324	51		NA	0	0.3333333333333333	R1	-	1	755	15569	10	9	745	15560	16324	0.07802595212036054
e019_R1	68	TRUE	3.183988453972305e-8	21	17	5	0.29411764705882354	0.23809523809523808	REAC:R-HSA-6804115	REAC	TP53 regulates transcription of additional cell cycle genes whose exact role in the p53 pathway remain uncertain	10790	2326		GO:0050789;GO:0009057;GO:0065008;GO:0016070	0	0.03333333333333333	R1	-	1	21	10769	5	12	16	10757	10790	0.26334067351082324
e019_R1	70	TRUE	1.0240948310647683e-25	15	23	11	0.4782608695652174	0.7333333333333333	REAC:R-HSA-1362300	REAC	Transcription of E2F targets under negative control by p107 (RBL1) and p130 (RBL2) in complex with HDAC1	10790	2404		GO:0008150	0	0.015873015873015872	R1	-	1	15	10775	11	12	4	10763	10790	0.5915403453036083
e019_R1	71	TRUE	4.49501897842977e-5	5	24	3	0.125	0.6	GO:0006121	GO:BP	mitochondrial electron transport, succinate to ubiquinone	16324	2023		NA	0	0.1	R1	-	1	5	16319	3	21	2	16298	16324	0.27343314140469377
e019_R1	72	TRUE	1.3500890529210773e-89	46	46	39	0.8478260869565217	0.8478260869565217	KEGG:03050	KEGG	Proteasome	8161	216		GO:0006508;GO:0009057	0	0.0064516129032258064	R1	-	1	46	8115	39	7	7	8108	8161	0.8469634868332931
e019_R1	73	TRUE	1.1902095071484133e-8	60	13	6	0.46153846153846156	0.1	REAC:R-HSA-9033241	REAC	Peroxisomal protein import	10790	1638		GO:0044255;GO:0006082	0	0.05	R1	-	1	60	10730	6	7	54	10723	10790	0.212967018708787
e019_R1	74	TRUE	1.968163166180648e-8	516	17	10	0.5882352941176471	0.01937984496124031	GO:0007169	GO:BP	transmembrane receptor protein tyrosine kinase signaling pathway	16324	2796		GO:0050789	0	0.037037037037037035	R1	-	1	516	15808	10	7	506	15801	16324	0.10272205823910455
e019_R1	75	TRUE	2.6135986860585465e-22	15	29	10	0.3448275862068966	0.6666666666666666	GO:0090110	GO:BP	COPII-coated vesicle cargo loading	16324	19036		GO:0016192;GO:0016050;GO:0051641;GO:0061024	0	0.027777777777777776	R1	-	1	15	16309	10	19	5	16290	16324	0.47883100229786785
e019_R1	76	TRUE	0.003911888763479706	25	20	3	0.15	0.12	REAC:R-HSA-9705462	REAC	Inactivation of CSF3 (G-CSF) signaling	10790	1118		NA	0	0.5	R1	-	1	25	10765	3	17	22	10748	10790	0.13236775177848392
e019_R1	77	TRUE	6.035770454569968e-48	111	34	26	0.7647058823529411	0.23423423423423423	GO:0006413	GO:BP	translational initiation	16324	2222		GO:0006412;GO:0065003	0	0.022727272727272728	R1	-	1	111	16213	26	8	85	16205	16324	0.42133516945957944
e019_R1	78	TRUE	1.410694046864406e-4	29	7	3	0.42857142857142855	0.10344827586206896	REAC:R-HSA-983170	REAC	Antigen Presentation: Folding, assembly and peptide loading of class I MHC	10790	145		GO:0002376	0	0.14285714285714285	R1	-	1	29	10761	3	4	26	10757	10790	0.20958800404925063
e019_R1	79	TRUE	1.1115957542652484e-19	115	34	16	0.47058823529411764	0.1391304347826087	KEGG:01200	KEGG	Carbon metabolism	8161	184		GO:0006520;GO:0006091	0	0.016129032258064516	R1	-	1	115	8046	16	18	99	8028	8161	0.2505050777362516
e019_R1	80	TRUE	2.6871026066245084e-21	317	17	15	0.8823529411764706	0.0473186119873817	GO:0042391	GO:BP	regulation of membrane potential	16324	10714		GO:0007154;GO:0006811;GO:0050877;GO:0065008;GO:0050896;GO:0050789	0	0.012195121951219513	R1	-	1	317	16007	15	2	302	16005	16324	0.20190953466982248
e019_R1	81	TRUE	8.685249572176413e-33	59	23	17	0.7391304347826086	0.288135593220339	REAC:R-HSA-6790901	REAC	rRNA modification in the nucleus and cytosol	10790	2590		GO:0006396;GO:0042254	0	0.027777777777777776	R1	-	1	59	10731	17	6	42	10725	10790	0.45982033161258307
e019_R1	82	TRUE	4.6623961966517515e-37	80	30	21	0.7	0.2625	REAC:R-HSA-2559586	REAC	DNA Damage/Telomere Stress Induced Senescence	10790	420		GO:0065003	0	0.008695652173913044	R1	-	1	80	10710	21	9	59	10701	10790	0.42629451528361784
e019_R1	83	TRUE	8.158222801550173e-4	29	11	3	0.2727272727272727	0.10344827586206896	REAC:R-HSA-5669034	REAC	TNFs bind their physiological receptors	10790	2316		GO:0050789	0	0.125	R1	-	1	29	10761	3	8	26	10753	10790	0.16662136614998282
e019_R1	85	TRUE	0.0012807571413204464	124	12	4	0.3333333333333333	0.03225806451612903	KEGG:04650	KEGG	Natural killer cell mediated cytotoxicity	8161	328		NA	0	0.5	R1	-	1	124	8037	4	8	120	8029	8161	0.09980242329732891
e019_R1	86	TRUE	2.3340828269141978e-4	198	6	4	0.6666666666666666	0.020202020202020204	KEGG:05169	KEGG	Epstein-Barr virus infection	8161	443		NA	0	0.14285714285714285	R1	-	1	198	7963	4	2	194	7961	8161	0.11325175357072241
e019_R1	87	TRUE	0.001094663970428556	58	20	4	0.2	0.06896551724137931	REAC:R-HSA-8866654	REAC	E3 ubiquitin ligases ubiquitinate target proteins	10790	773		NA	0	0.5	R1	-	1	58	10732	4	16	54	10716	10790	0.11470229622684584
e019_R1	88	TRUE	3.775129214174996e-11	128	25	10	0.4	0.078125	REAC:R-HSA-6809371	REAC	Formation of the cornified envelope	10790	919		GO:0007154;GO:0016043;GO:0065008;GO:0007155;GO:0050789	0	0.022222222222222223	R1	-	1	128	10662	10	15	118	10647	10790	0.17276085166808836
e019_R1	89	TRUE	1.853030611687447e-4	35	22	4	0.18181818181818182	0.11428571428571428	GO:0006636	GO:BP	unsaturated fatty acid biosynthetic process	16324	2401		GO:0044255;GO:0006082	0	0.14285714285714285	R1	-	1	35	16289	4	18	31	16271	16324	0.14269926137318997
e019_R1	90	TRUE	1.185803931598333e-11	166	23	11	0.4782608695652174	0.06626506024096386	KEGG:04630	KEGG	JAK-STAT signaling pathway	8161	326		GO:0050789;GO:0050896	0	0.027777777777777776	R1	-	1	166	7995	11	12	155	7983	8161	0.17245468635059233
e019_R1	91	TRUE	6.885158456243246e-16	293	18	14	0.7777777777777778	0.04778156996587031	KEGG:04060	KEGG	Cytokine-cytokine receptor interaction	8161	248		GO:0002376;GO:0008283;GO:0001775;GO:0050789;GO:0043170	0	0.013157894736842105	R1	-	1	293	7868	14	4	279	7864	8161	0.18747887889546175
e019_R1	92	TRUE	2.7689432035717977e-12	516	20	13	0.65	0.025193798449612403	GO:0007169	GO:BP	transmembrane receptor protein tyrosine kinase signaling pathway	16324	2796		GO:0040011;GO:0050789;GO:0032502;GO:0006793;GO:0036211	0	0.01818181818181818	R1	-	1	516	15808	13	7	503	15801	16324	0.12379232357687177
e019_R1	93	TRUE	2.238555784475247e-9	25	26	6	0.23076923076923078	0.24	GO:0009081	GO:BP	branched-chain amino acid metabolic process	16324	3330		GO:0006520	0	0.07142857142857142	R1	-	1	25	16299	6	20	19	16279	16324	0.2341433047349534
e019_R1	94	TRUE	1.1082780502347247e-4	12	13	3	0.23076923076923078	0.25	GO:0034982	GO:BP	mitochondrial protein processing	16324	9222		GO:0006508;GO:0051604	0	0.3333333333333333	R1	-	1	12	16312	3	10	9	16302	16324	0.23961058025998686
e019_R1	95	TRUE	2.0127990229356358e-50	68	36	25	0.6944444444444444	0.36764705882352944	GO:0070098	GO:BP	chemokine-mediated signaling pathway	16324	16835		GO:0040011;GO:0050896;GO:0002376;GO:0050789;GO:0065009;GO:0044419	0	0.0051813471502590676	R1	-	1	68	16256	25	11	43	16245	16324	0.5038568754555934
e019_R1	96	TRUE	5.961385957029753e-21	168	19	15	0.7894736842105263	0.08928571428571429	KEGG:04141	KEGG	Protein processing in endoplasmic reticulum	8161	273		GO:0009057;GO:0050896;GO:0006508;GO:0015031	0	0.03333333333333333	R1	-	1	168	7993	15	4	153	7989	8161	0.26158217643634324
e019_R1	97	TRUE	1.4290937319972737e-4	79	11	4	0.36363636363636365	0.05063291139240506	KEGG:00983	KEGG	Drug metabolism - other enzymes	8161	157		NA	0	0.125	R1	-	1	79	8082	4	7	75	8075	8161	0.13281203878969797
e019_R1	99	TRUE	1.4721669161946826e-6	36	22	5	0.22727272727272727	0.1388888888888889	GO:0098703	GO:BP	calcium ion import across plasma membrane	16324	19885		GO:0051640;GO:0050789;GO:0051641;GO:0006811	0	0.02857142857142857	R1	-	1	36	16288	5	17	31	16271	16324	0.17625640883328994
e019_R1	101	TRUE	1.383224045703115e-4	71	12	4	0.3333333333333333	0.056338028169014086	KEGG:04622	KEGG	RIG-I-like receptor signaling pathway	8161	321		GO:0032502;GO:0002376;GO:0001775	0	0.2	R1	-	1	71	8090	4	8	67	8082	8161	0.1341441174906414
e019_R1	102	TRUE	9.475064478571646e-8	77	14	6	0.42857142857142855	0.07792207792207792	KEGG:05100	KEGG	Bacterial invasion of epithelial cells	8161	416		NA	0	0.05263157894736842	R1	-	1	77	8084	6	8	71	8076	8161	0.17972368245040396
e019_R1	103	TRUE	2.5085437901314955e-18	36	20	10	0.5	0.2777777777777778	REAC:R-HSA-76046	REAC	RNA Polymerase III Transcription Initiation	10790	1807		GO:0006351	0	0.05263157894736842	R1	-	1	36	10754	10	10	26	10744	10790	0.37115441994119247
e019_R1	104	TRUE	5.59214573967882e-12	34	16	7	0.4375	0.20588235294117646	REAC:R-HSA-177243	REAC	Interactions of Rev with host cellular proteins	10790	1161		GO:0051641;GO:0015931	0	0.05263157894736842	R1	-	1	34	10756	7	9	27	10747	10790	0.2986529818824137
e019_R1	105	TRUE	1.634603674933045e-11	71	16	8	0.5	0.11267605633802817	KEGG:04520	KEGG	Adherens junction	8161	310		GO:0007155;GO:0022607	0	0.05	R1	-	1	71	8090	8	8	63	8082	8161	0.23447752950394293
e019_R1	106	TRUE	1.4856818515499848e-5	67	18	5	0.2777777777777778	0.07462686567164178	KEGG:00010	KEGG	Glycolysis / Gluconeogenesis	8161	2		GO:0006082;GO:0006091;GO:0009117;GO:0005975	0	0.030303030303030304	R1	-	1	67	8094	5	13	62	8081	8161	0.14045485231324298
e019_R1	107	TRUE	7.569618525874518e-5	56	13	4	0.3076923076923077	0.07142857142857142	KEGG:05416	KEGG	Viral myocarditis	8161	486		NA	0	0.25	R1	-	1	56	8105	4	9	52	8096	8161	0.1455595643118822
e019_R1	110	TRUE	1.1029000581750935e-14	13	23	7	0.30434782608695654	0.5384615384615384	GO:0045039	GO:BP	protein insertion into mitochondrial inner membrane	16324	11931		GO:0061024;GO:0007005;GO:0015031	0	0.05263157894736842	R1	-	1	13	16311	7	16	6	16295	16324	0.40420690285702265
e019_R1	111	TRUE	1.794022894963645e-59	158	96	43	0.4479166666666667	0.2721518987341772	GO:0140053	GO:BP	mitochondrial gene expression	16324	20737		GO:0006790;GO:0009117;GO:0050789;GO:0006082;GO:0006412	0	0.014925373134328358	R1	-	1	158	16166	43	53	115	16113	16324	0.34427824048190003
e019_R1	112	TRUE	1.969908469847383e-30	81	17	16	0.9411764705882353	0.19753086419753085	KEGG:04146	KEGG	Peroxisome	8161	277		GO:0007031;GO:0015031	0	0.029411764705882353	R1	-	1	81	8080	16	1	65	8079	8161	0.4292078132584532
e019_R1	113	TRUE	3.3461865498524763e-13	168	18	11	0.6111111111111112	0.06547619047619048	KEGG:04141	KEGG	Protein processing in endoplasmic reticulum	8161	273		GO:0036211	0	0.02857142857142857	R1	-	1	168	7993	11	7	157	7986	8161	0.19553137175065582
e019_R1	114	TRUE	9.0677332733432e-9	752	16	11	0.6875	0.014627659574468085	GO:0007186	GO:BP	G protein-coupled receptor signaling pathway	16324	2809		GO:0050789	0	0.06666666666666667	R1	-	1	752	15572	11	5	741	15567	16324	0.09584209814861296
e019_R1	115	TRUE	8.987341183380416e-4	2	14	2	0.14285714285714285	1	GO:0140039	GO:BP	cell-cell adhesion in response to extracellular stimulus	16324	20727		GO:0007155	0	0.25	R1	-	1	2	16322	2	12	0	16310	16324	0.37782550696261225
e019_R1	117	TRUE	8.764136881999999e-6	718	21	10	0.47619047619047616	0.013927576601671309	GO:0097435	GO:BP	supramolecular fiber organization	16324	19703		GO:0065008;GO:0016043;GO:0050789	0	0.038461538461538464	R1	-	1	718	15606	10	11	708	15595	16324	0.07564590043051159
e019_R1	118	TRUE	5.001804505231504e-4	181	14	5	0.35714285714285715	0.027624309392265192	KEGG:04360	KEGG	Axon guidance	8161	299		NA	0	0.5	R1	-	1	181	7980	5	9	176	7971	8161	0.09429012275558601
e019_R1	119	TRUE	2.1927420622177573e-5	28	17	4	0.23529411764705882	0.14285714285714285	GO:0051482	GO:BP	positive regulation of cytosolic calcium ion concentration involved in phospholipase C-activating G protein-coupled signaling pathway	16324	14519		GO:0050789;GO:0065008	0	0.07692307692307693	R1	-	1	28	16296	4	13	24	16283	16324	0.18225439364287332
e019_R1	120	TRUE	9.143343817297284e-20	196	26	15	0.5769230769230769	0.07653061224489796	GO:0007160	GO:BP	cell-matrix adhesion	16324	2787		GO:0050789;GO:0050896;GO:0007155	0	0.013513513513513514	R1	-	1	196	16128	15	11	181	16117	16324	0.2071628378268433
e019_R1	121	TRUE	2.483365064320141e-15	40	24	9	0.375	0.225	GO:0045197	GO:BP	establishment or maintenance of epithelial cell apical/basal polarity	16324	12011		GO:0008150	0	0.043478260869565216	R1	-	1	40	16284	9	15	31	16269	16324	0.2891425369452884
e019_R1	122	TRUE	2.276208958569876e-7	19	9	4	0.4444444444444444	0.21052631578947367	REAC:R-HSA-5627117	REAC	RHO GTPases Activate ROCKs	10790	1758		GO:0006996	0	0.05555555555555555	R1	-	1	19	10771	4	5	15	10766	10790	0.3050715802090185
e019_R1	123	TRUE	7.109690347677041e-8	757	18	11	0.6111111111111112	0.01453104359313078	GO:0045321	GO:BP	leukocyte activation	16324	12051		GO:0050789;GO:0002376;GO:0001775	0	0.03225806451612903	R1	-	1	757	15567	11	7	746	15560	16324	0.08922477826778863
e019_R1	125	TRUE	6.496757908728981e-9	116	15	7	0.4666666666666667	0.0603448275862069	GO:0001508	GO:BP	action potential	16324	337		GO:0008015;GO:0065008;GO:0050877;GO:0050789	0	0.023809523809523808	R1	-	1	116	16208	7	8	109	16200	16324	0.16592338361977996
e019_R1	126	TRUE	1.475547411608186e-6	597	21	10	0.47619047619047616	0.01675041876046901	GO:0045597	GO:BP	positive regulation of cell differentiation	16324	12148		GO:0050789;GO:0032502;GO:0006793;GO:0036211	0	0.015384615384615385	R1	-	1	597	15727	10	11	587	15716	16324	0.0840559337924017
e019_R1	127	TRUE	8.468854209731333e-5	41	16	4	0.25	0.0975609756097561	GO:0048013	GO:BP	ephrin receptor signaling pathway	16324	13201		GO:0050789	0	0.09090909090909091	R1	-	1	41	16283	4	12	37	16271	16324	0.15487519466314187
e019_R1	128	TRUE	1.011567609005676e-6	40	17	5	0.29411764705882354	0.125	REAC:R-HSA-3928662	REAC	EPHB-mediated forward signaling	10790	783		GO:0040011;GO:0050789;GO:0007155	0	0.03571428571428571	R1	-	1	40	10750	5	12	35	10738	10790	0.1898259921198814
e019_R1	129	TRUE	2.1110272719027454e-6	14	19	4	0.21052631578947367	0.2857142857142857	REAC:R-HSA-3322077	REAC	Glycogen synthesis	10790	1019		GO:0044255;GO:0050789;GO:0051179	0	0.03125	R1	-	1	14	10776	4	15	10	10761	10790	0.24411750625111725
e019_R1	130	TRUE	1.7849757293590662e-8	39	20	6	0.3	0.15384615384615385	REAC:R-HSA-5674135	REAC	MAP2K and MAPK activation	10790	1280		GO:0050896;GO:0050877	0	0.02127659574468085	R1	-	1	39	10751	6	14	33	10737	10790	0.21282805257092116
e019_R1	131	TRUE	6.727982455878877e-7	31	20	5	0.25	0.16129032258064516	REAC:R-HSA-445095	REAC	Interaction between L1 and Ankyrins	10790	1159		GO:0008150	0	0.07142857142857142	R1	-	1	31	10759	5	15	26	10744	10790	0.19896740397454163
e019_R1	132	TRUE	8.12793763460738e-13	11	17	6	0.35294117647058826	0.5454545454545454	REAC:R-HSA-5625970	REAC	RHO GTPases activate KTN1	10790	1763		GO:0051640;GO:0006810;GO:0051641	0	0.024390243902439025	R1	-	1	11	10779	6	11	5	10768	10790	0.4380645009652249
e019_R1	133	TRUE	1.1307060655221494e-5	16	25	4	0.16	0.25	GO:0034375	GO:BP	high-density lipoprotein particle remodeling	16324	9049		GO:0032501;GO:0050789;GO:0006869;GO:0016043	0	0.034482758620689655	R1	-	1	16	16308	4	21	12	16287	16324	0.19902475686820642
e019_R1	136	TRUE	1.472767768379806e-16	9	22	7	0.3181818181818182	0.7777777777777778	GO:0090522	GO:BP	vesicle tethering involved in exocytosis	16324	19367		GO:0051640;GO:0022406;GO:0061024	0	0.02702702702702703	R1	-	1	9	16315	7	15	2	16300	16324	0.4970783670342918
e019_R1	137	TRUE	4.794366644698419e-15	13	18	7	0.3888888888888889	0.5384615384615384	REAC:R-HSA-416993	REAC	Trafficking of GluR2-containing AMPA receptors	10790	2400		GO:0050789;GO:0007154	0	0.034482758620689655	R1	-	1	13	10777	7	11	6	10766	10790	0.45684288238799214
e019_R1	138	TRUE	8.698018313286363e-7	15	15	4	0.26666666666666666	0.26666666666666666	GO:0007210	GO:BP	serotonin receptor signaling pathway	16324	2831		GO:0050789;GO:0050896	0	0.1	R1	-	1	15	16309	4	11	11	16298	16324	0.26599219244997646
e019_R1	139	TRUE	3.6049345487843085e-20	291	28	17	0.6071428571428571	0.058419243986254296	GO:0048193	GO:BP	Golgi vesicle transport	16324	13306		GO:0016192;GO:0051641	0	0.04	R1	-	1	291	16033	17	11	274	16022	16324	0.18461189868918906
e019_R1	141	TRUE	4.4591774820536116e-36	35	26	17	0.6538461538461539	0.4857142857142857	REAC:R-HSA-5663213	REAC	RHO GTPases Activate WASPs and WAVEs	10790	1760		GO:0050789;GO:0006996;GO:0022607	0	0.012195121951219513	R1	-	1	35	10755	17	9	18	10746	10790	0.5623383626491398
e019_R1	142	TRUE	2.7640420290995364e-43	239	38	31	0.8157894736842105	0.1297071129707113	REAC:R-HSA-8951664	REAC	Neddylation	10790	1474		GO:0006508;GO:0009057	0	0.030303030303030304	R1	-	1	239	10551	31	7	208	10544	10790	0.3205870959866155
e019_R1	143	TRUE	1.2878233658595643e-4	226	10	5	0.5	0.022123893805309734	GO:0030100	GO:BP	regulation of endocytosis	16324	7041		GO:0050789;GO:0016192	0	0.1111111111111111	R1	-	1	226	16098	5	5	221	16093	16324	0.10301044162078538
e019_R1	145	TRUE	1.7557608241092712e-10	22	20	6	0.3	0.2727272727272727	GO:0097502	GO:BP	mannosylation	16324	19730		GO:0036211	0	0.07692307692307693	R1	-	1	22	16302	6	14	16	16288	16324	0.2851205804965057
e019_R1	146	TRUE	9.698164870385856e-5	7	21	3	0.14285714285714285	0.42857142857142855	GO:2000643	GO:BP	positive regulation of early endosome to late endosome transport	16324	27203		GO:0050789;GO:0016192	0	0.043478260869565216	R1	-	1	7	16317	3	18	4	16299	16324	0.24690487421733948
e019_R1	147	TRUE	1.0329886665826323e-11	53	12	7	0.5833333333333334	0.1320754716981132	REAC:R-HSA-9662361	REAC	Sensory processing of sound by outer hair cells of the cochlea	10790	2080		GO:0022607;GO:0006996;GO:0032502;GO:0050877	0	0.05263157894736842	R1	-	1	53	10737	7	5	46	10732	10790	0.27606280877029604
e019_R1	148	TRUE	6.398628031258074e-6	81	6	4	0.6666666666666666	0.04938271604938271	KEGG:04662	KEGG	B cell receptor signaling pathway	8161	333		GO:0050789;GO:0002376	0	0.1111111111111111	R1	-	1	81	8080	4	2	77	8078	8161	0.1797021334580751
e019_R1	149	TRUE	2.3439704597545525e-8	7	3	3	1	0.42857142857142855	GO:0006689	GO:BP	ganglioside catabolic process	16324	2451		GO:0044255;GO:0043603	0	0.03125	R1	-	1	7	16317	3	0	4	16317	16324	0.6545734435421479
e019_R1	152	TRUE	3.401527921235808e-26	295	28	20	0.7142857142857143	0.06779661016949153	GO:0016236	GO:BP	macroautophagy	16324	5303		GO:0007033;GO:0006914;GO:0022411;GO:0007005;GO:0022607	0	0.02127659574468085	R1	-	1	295	16029	20	8	275	16021	16324	0.2166425332288574
e019_R1	153	TRUE	4.680203674471783e-18	8	15	7	0.4666666666666667	0.875	REAC:R-HSA-166665	REAC	Terminal pathway of complement	10790	2355		GO:0050789;GO:0050896;GO:0002376	0	0.038461538461538464	R1	-	1	8	10782	7	8	1	10774	10790	0.638675144022348
e019_R1	155	TRUE	1.90745136100657e-6	752	14	9	0.6428571428571429	0.011968085106382979	GO:0007186	GO:BP	G protein-coupled receptor signaling pathway	16324	2809		GO:0050789;GO:0050896	0	0.045454545454545456	R1	-	1	752	15572	9	5	743	15567	16324	0.08340729653846667
e019_R1	156	TRUE	6.697058456441587e-9	5	3	3	1	0.6	GO:1990410	GO:BP	adrenomedullin receptor signaling pathway	16324	26397		GO:0050789	0	0.0625	R1	-	1	5	16319	3	0	2	16319	16324	0.7745492076643277
e019_R1	157	TRUE	1.0008387640087382e-17	33	14	9	0.6428571428571429	0.2727272727272727	KEGG:04130	KEGG	SNARE interactions in vesicular transport	8161	267		GO:0016050;GO:0065008;GO:0006836;GO:0061024;GO:0046903;GO:0048284;GO:0022406;GO:0051640;GO:0016192	0	0.017241379310344827	R1	-	1	33	8128	9	5	24	8123	8161	0.4172860051859601
e019_R1	158	TRUE	0.00234461286503496	3	18	2	0.1111111111111111	0.6666666666666666	REAC:R-HSA-5635851	REAC	GLI proteins bind promoters of Hh responsive genes to promote transcription	10790	961		GO:0050789	0	0.1	R1	-	1	3	10787	2	16	1	10771	10790	0.271748993540266
e019_R1	159	TRUE	7.136979558391651e-33	44	27	16	0.5925925925925926	0.36363636363636365	GO:0042073	GO:BP	intraciliary transport	16324	10523		GO:0006810;GO:0051641	0	0.058823529411764705	R1	-	1	44	16280	16	11	28	16269	16324	0.463102806687097
e019_R1	160	TRUE	3.653717001672989e-12	140	18	10	0.5555555555555556	0.07142857142857142	KEGG:04120	KEGG	Ubiquitin mediated proteolysis	8161	265		GO:0036211	0	0.05555555555555555	R1	-	1	140	8021	10	8	130	8013	8161	0.19494622490724192
e019_R1	161	TRUE	8.752249816203953e-18	610	25	18	0.72	0.029508196721311476	GO:0016567	GO:BP	protein ubiquitination	16324	5381		GO:0006508;GO:0036211;GO:0009057	0	0.05	R1	-	1	610	15714	18	7	592	15707	16324	0.14095947573990975
e019_R1	162	TRUE	2.2531948488349223e-6	20	15	4	0.26666666666666666	0.2	KEGG:00100	KEGG	Steroid biosynthesis	8161	13		GO:0006629;GO:0006066	0	0.09090909090909091	R1	-	1	20	8141	4	11	16	8130	8161	0.22930948592896475
e019_R1	164	TRUE	2.4229559434940835e-4	393	19	7	0.3684210526315789	0.017811704834605598	GO:0007015	GO:BP	actin filament organization	16324	2683		GO:0016043	0	0.2	R1	-	1	393	15931	7	12	386	15919	16324	0.07668674830171056
e019_R1	165	TRUE	0.0024033519827168282	45	13	3	0.23076923076923078	0.06666666666666667	KEGG:02010	KEGG	ABC transporters	8161	199		NA	0	0.5	R1	-	1	45	8116	3	10	42	8106	8161	0.12150302609834976
e019_R1	166	TRUE	7.197835622276981e-9	212	13	8	0.6153846153846154	0.03773584905660377	REAC:R-HSA-416476	REAC	G alpha (q) signalling events	10790	934		GO:0032501;GO:0065008;GO:0050789	0	0.02631578947368421	R1	-	1	212	10578	8	5	204	10573	10790	0.14908326347322845
e019_R1	167	TRUE	8.814364877238147e-16	10	20	7	0.35	0.7	REAC:R-HSA-9754560	REAC	SARS-CoV-2 modulates autophagy	10790	2002		GO:0016050;GO:0061024;GO:0048284;GO:0050789;GO:0065003	0	0.038461538461538464	R1	-	1	10	10780	7	13	3	10767	10790	0.49435136484192627
e019_R1	168	TRUE	2.8184132254843432e-11	8	14	5	0.35714285714285715	0.625	REAC:R-HSA-5632681	REAC	Ligand-receptor interactions	10790	1253		GO:0006508	0	0.08333333333333333	R1	-	1	8	10782	5	9	3	10773	10790	0.4719559348268968
e019_R1	169	TRUE	1.5311060232272974e-8	69	21	7	0.3333333333333333	0.10144927536231885	KEGG:04612	KEGG	Antigen processing and presentation	8161	316		GO:0050789	0	0.03571428571428571	R1	-	1	69	8092	7	14	62	8078	8161	0.18022261811023363
e019_R1	170	TRUE	3.7107551921264294e-10	313	25	12	0.48	0.038338658146964855	REAC:R-HSA-418594	REAC	G alpha (i) signalling events	10790	933		GO:0008152;GO:0050789	0	0.030303030303030304	R1	-	1	313	10477	12	13	301	10464	10790	0.12949777332497459
e019_R1	171	TRUE	1.0655515211224862e-26	81	18	15	0.8333333333333334	0.18518518518518517	KEGG:04146	KEGG	Peroxisome	8161	277		GO:0006810;GO:0048285;GO:0051641;GO:0065008;GO:0007031;GO:0044255;GO:0006082	0	0.034482758620689655	R1	-	1	81	8080	15	3	66	8077	8161	0.3905299511105063
e019_R1	172	TRUE	1.1223801582140003e-16	41	18	9	0.5	0.21951219512195122	GO:1990542	GO:BP	mitochondrial transmembrane transport	16324	26442		GO:0015031	0	0.03571428571428571	R1	-	1	41	16283	9	9	32	16274	16324	0.33022724720759766
e019_R1	173	TRUE	2.0798202228101366e-15	24	18	8	0.4444444444444444	0.3333333333333333	REAC:R-HSA-6783589	REAC	Interleukin-6 family signaling	10790	1193		GO:0050789;GO:0050896	0	0.03571428571428571	R1	-	1	24	10766	8	10	16	10756	10790	0.3837207249534559
e019_R1	174	TRUE	6.985035210464544e-5	9	16	3	0.1875	0.3333333333333333	REAC:R-HSA-8985947	REAC	Interleukin-9 signaling	10790	1196		NA	0	0.058823529411764705	R1	-	1	9	10781	3	13	6	10768	10790	0.2491765383076245
e019_R1	175	TRUE	5.8390652467434925e-18	97	24	13	0.5416666666666666	0.13402061855670103	KEGG:03015	KEGG	mRNA surveillance pathway	8161	210		GO:0006793;GO:0036211	0	0.01	R1	-	1	97	8064	13	11	84	8053	8161	0.26549233361932884
e019_R1	176	TRUE	2.5853026206477324e-4	8	3	2	0.6666666666666666	0.25	REAC:R-HSA-9012546	REAC	Interleukin-18 signaling	10790	1179		NA	0	0.5	R1	-	1	8	10782	2	1	6	10781	10790	0.4080022432978254
e019_R1	177	TRUE	1.6711569305811685e-11	24	25	7	0.28	0.2916666666666667	REAC:R-HSA-180024	REAC	DARPP-32 events	10790	413		GO:0050789;GO:0050896	0	0.017543859649122806	R1	-	1	24	10766	7	18	17	10748	10790	0.2841488499136152
e019_R1	178	TRUE	3.477137450330111e-8	14	28	5	0.17857142857142858	0.35714285714285715	GO:0048268	GO:BP	clathrin coat assembly	16324	13356		GO:0016192;GO:0065003;GO:0043412;GO:0006396	0	0.047619047619047616	R1	-	1	14	16310	5	23	9	16287	16324	0.25164901690610425
e019_R1	179	TRUE	1.299803973216967e-9	10	21	5	0.23809523809523808	0.5	REAC:R-HSA-168799	REAC	Neurotoxicity of clostridium toxins	10790	1506		GO:0051180;GO:0050789;GO:0016192	0	0.05	R1	-	1	10	10780	5	16	5	10764	10790	0.344184212637605
e019_R1	181	TRUE	2.5803590778156335e-23	170	25	16	0.64	0.09411764705882353	GO:0045216	GO:BP	cell-cell junction organization	16324	12022		GO:0032501;GO:0022607	0	0.022222222222222223	R1	-	1	170	16154	16	9	154	16145	16324	0.24288829929367706
e019_R1	182	TRUE	2.7262655636822703e-8	6	19	4	0.21052631578947367	0.6666666666666666	GO:0098700	GO:BP	neurotransmitter loading into synaptic vesicle	16324	19883		GO:0046903;GO:0006836;GO:0015837	0	0.03225806451612903	R1	-	1	6	16318	4	15	2	16303	16324	0.3742668743993075
e019_R1	183	TRUE	8.272586528128324e-28	250	24	21	0.875	0.084	KEGG:04144	KEGG	Endocytosis	8161	275		GO:0050789;GO:0016192;GO:0051641	0	0.03571428571428571	R1	-	1	250	7911	21	3	229	7908	8161	0.2661105779440545
e019_R1	184	TRUE	0.0022281247511673325	91	7	3	0.42857142857142855	0.03296703296703297	KEGG:04657	KEGG	IL-17 signaling pathway	8161	329		NA	0	0.5	R1	-	1	91	8070	3	4	88	8066	8161	0.11647258183377819
e019_R1	185	TRUE	1.3104371866763772e-5	35	12	4	0.3333333333333333	0.11428571428571428	REAC:R-HSA-432720	REAC	Lysosome Vesicle Biogenesis	10790	1276		NA	0	0.3333333333333333	R1	-	1	35	10755	4	8	31	10747	10790	0.19370265597565772
e019_R1	186	TRUE	7.36860043850756e-18	7	20	7	0.35	1	REAC:R-HSA-420597	REAC	Nectin/Necl  trans heterodimerization	10790	1473		GO:0050789;GO:0007155	0	0.017543859649122806	R1	-	1	7	10783	7	13	0	10770	10790	0.5912512490529139
e019_R1	187	TRUE	1.9887629033370295e-5	62	3	3	1	0.04838709677419355	KEGG:05321	KEGG	Inflammatory bowel disease	8161	476		GO:0002376;GO:0001775;GO:0001816;GO:0050789;GO:0032502	0	0.0196078431372549	R1	-	1	62	8099	3	0	59	8099	8161	0.21917379706235252
e019_R1	188	TRUE	2.3674161462912188e-14	56	22	9	0.4090909090909091	0.16071428571428573	GO:0002224	GO:BP	toll-like receptor signaling pathway	16324	776		GO:0050789;GO:0002376;GO:0001816	0	0.010309278350515464	R1	-	1	56	16268	9	13	47	16255	16324	0.25487015147374564
e019_R1	190	TRUE	5.850590412103327e-7	417	12	8	0.6666666666666666	0.019184652278177457	REAC:R-HSA-5663202	REAC	Diseases of signal transduction by growth factor receptors and second messengers	10790	735		GO:0050789;GO:0008283	0	0.024390243902439025	R1	-	1	417	10373	8	4	409	10369	10790	0.10871665414175295
e019_R1	191	TRUE	1.1806855315776883e-8	33	4	4	1	0.12121212121212122	REAC:R-HSA-2172127	REAC	DAP12 interactions	10790	411		GO:0050789;GO:0002376;GO:0001775	0	0.06666666666666667	R1	-	1	33	10757	4	0	29	10757	10790	0.3476869594300624
e019_R1	192	TRUE	1.2533705680352722e-11	21	13	6	0.46153846153846156	0.2857142857142857	KEGG:00532	KEGG	Glycosaminoglycan biosynthesis - chondroitin sulfate / dermatan sulfate	8161	76		GO:0019538;GO:0009059	0	0.037037037037037035	R1	-	1	21	8140	6	7	15	8133	8161	0.36186576378825797
e019_R1	193	TRUE	2.2562982229351857e-13	12	13	6	0.46153846153846156	0.5	REAC:R-HSA-9013973	REAC	TICAM1-dependent activation of IRF3/IRF7	10790	2307		GO:0050896;GO:0002376;GO:0001816;GO:0050789;GO:0044419	0	0.011627906976744186	R1	-	1	12	10778	6	7	6	10771	10790	0.47978272774191677
e019_R1	194	TRUE	8.557980968430156e-17	8	21	7	0.3333333333333333	0.875	REAC:R-HSA-72731	REAC	Recycling of eIF2:GDP	10790	1860		GO:0006412;GO:0006396;GO:0032502	0	0.023255813953488372	R1	-	1	8	10782	7	14	1	10768	10790	0.5395856886233594
e019_R1	195	TRUE	9.308507714116528e-8	9	15	4	0.26666666666666666	0.4444444444444444	REAC:R-HSA-8964058	REAC	HDL remodeling	10790	1037		GO:0032501;GO:0006869;GO:0016043	0	0.041666666666666664	R1	-	1	9	10781	4	11	5	10770	10790	0.3435704726205024
e019_R1	198	TRUE	1.3249775386551837e-8	297	11	8	0.7272727272727273	0.026936026936026935	REAC:R-HSA-1474244	REAC	Extracellular matrix organization	10790	844		GO:0050789;GO:0001775	0	0.02702702702702703	R1	-	1	297	10493	8	3	289	10490	10790	0.13662862094135148
e019_R1	199	TRUE	5.194192162364747e-12	6	17	5	0.29411764705882354	0.8333333333333334	GO:0016255	GO:BP	attachment of GPI anchor to protein	16324	5311		GO:0044255;GO:0006793;GO:0036211	0	0.043478260869565216	R1	-	1	6	16318	5	12	1	16306	16324	0.4948036903982079
e019_R1	200	TRUE	5.156913273223246e-9	178	17	8	0.47058823529411764	0.0449438202247191	GO:0007596	GO:BP	blood coagulation	16324	3127		GO:0006508;GO:0050896;GO:0050817;GO:0051604;GO:0050886;GO:0050789;GO:0050878	0	0.017857142857142856	R1	-	1	178	16146	8	9	170	16137	16324	0.14291603747660464
e019_R1	202	TRUE	5.613857146364515e-20	111	19	13	0.6842105263157895	0.11711711711711711	REAC:R-HSA-166658	REAC	Complement cascade	10790	370		GO:0050789;GO:0050896;GO:0002376;GO:0044419	0	0.029411764705882353	R1	-	1	111	10679	13	6	98	10673	10790	0.28051356777600756
e019_R1	203	TRUE	9.77441976093633e-9	201	24	9	0.375	0.04477611940298507	GO:0071560	GO:BP	cellular response to transforming growth factor beta stimulus	16324	17710		GO:0050789;GO:0050896;GO:0032502	0	0.0625	R1	-	1	201	16123	9	15	192	16108	16324	0.12619706322276128
e019_R1	204	TRUE	3.2547921247059884e-6	108	17	6	0.35294117647058826	0.05555555555555555	KEGG:04931	KEGG	Insulin resistance	8161	381		GO:0050789;GO:0050896;GO:0006793;GO:0036211	0	0.03125	R1	-	1	108	8053	6	11	102	8042	8161	0.13581988840097936
e019_R1	205	TRUE	2.9350987133723404e-4	27	11	3	0.2727272727272727	0.1111111111111111	KEGG:05310	KEGG	Asthma	8161	474		NA	0	0.5	R1	-	1	27	8134	3	8	24	8126	8161	0.17236732249565792
e019_R1	206	TRUE	4.303708264178228e-5	30	18	4	0.2222222222222222	0.13333333333333333	REAC:R-HSA-5357956	REAC	TNFR1-induced NFkappaB signaling pathway	10790	2312		GO:0006520;GO:0043603;GO:0036211	0	0.08333333333333333	R1	-	1	30	10760	4	14	26	10746	10790	0.1703578919744739
e019_R1	207	TRUE	1.7508913529651083e-12	95	16	9	0.5625	0.09473684210526316	KEGG:04640	KEGG	Hematopoietic cell lineage	8161	327		GO:0007155;GO:0032502	0	0.058823529411764705	R1	-	1	95	8066	9	7	86	8059	8161	0.2276185096249507
e019_R1	210	TRUE	2.922849550346544e-4	128	3	3	1	0.0234375	REAC:R-HSA-6809371	REAC	Formation of the cornified envelope	10790	919		NA	0	0.3333333333333333	R1	-	1	128	10662	3	0	125	10662	10790	0.15220350101048255
e019_R1	211	TRUE	7.652588071553455e-7	36	18	5	0.2777777777777778	0.1388888888888889	REAC:R-HSA-6804757	REAC	Regulation of TP53 Degradation	10790	1906		GO:0050896;GO:0007154	0	0.045454545454545456	R1	-	1	36	10754	5	13	31	10741	10790	0.194546227444958
e019_R1	212	TRUE	6.8894951162176645e-28	41	29	15	0.5172413793103449	0.36585365853658536	REAC:R-HSA-383280	REAC	Nuclear Receptor transcription pathway	10790	1530		GO:0050789;GO:0050896;GO:0048511	0	0.01694915254237288	R1	-	1	41	10749	15	14	26	10735	10790	0.43322069162340654
e019_R1	214	TRUE	1.149684455446573e-9	293	9	8	0.8888888888888888	0.027303754266211604	KEGG:04060	KEGG	Cytokine-cytokine receptor interaction	8161	248		GO:0050789;GO:0050896;GO:0001816	0	0.05555555555555555	R1	-	1	293	7868	8	1	285	7867	8161	0.1523381514481678
e019_R1	215	TRUE	1.2100217438865638e-4	22	10	3	0.3	0.13636363636363635	KEGG:00900	KEGG	Terpenoid backbone biosynthesis	8161	129		NA	0	0.5	R1	-	1	22	8139	3	7	19	8132	8161	0.2008362885367374
e019_R1	218	TRUE	0.005773201358454699	55	11	3	0.2727272727272727	0.05454545454545454	REAC:R-HSA-936837	REAC	Ion transport by P-type ATPases	10790	1215		GO:0008150	0	0.2	R1	-	1	55	10735	3	8	52	10727	10790	0.1200551824245941
e019_R1	219	TRUE	4.358395648368839e-12	132	19	10	0.5263157894736842	0.07575757575757576	KEGG:04142	KEGG	Lysosome	8161	274		GO:0007033;GO:0065007	0	0.025	R1	-	1	132	8029	10	9	122	8020	8161	0.19535629952703987
e019_R1	220	TRUE	4.983918486340984e-12	11	22	6	0.2727272727272727	0.5454545454545454	REAC:R-HSA-112308	REAC	Presynaptic depolarization and calcium channel opening	10790	1700		GO:0016043;GO:0050789;GO:0065009;GO:0006811	0	0.02127659574468085	R1	-	1	11	10779	6	16	5	10763	10790	0.3848414174179118
e019_R1	221	TRUE	3.80675716861517e-12	95	17	9	0.5294117647058824	0.09473684210526316	KEGG:04640	KEGG	Hematopoietic cell lineage	8161	327		GO:0050789;GO:0050896	0	0.03225806451612903	R1	-	1	95	8066	9	8	86	8058	8161	0.22054427857674866
e019_R1	222	TRUE	1.814368349634569e-14	30	17	8	0.47058823529411764	0.26666666666666666	KEGG:00030	KEGG	Pentose phosphate pathway	8161	4		GO:0006091;GO:0009117	0	0.045454545454545456	R1	-	1	30	8131	8	9	22	8122	8161	0.35249388237815604
e019_R1	223	TRUE	3.3327358583834377e-41	27	26	17	0.6538461538461539	0.6296296296296297	GO:2000819	GO:BP	regulation of nucleotide-excision repair	16324	27358		GO:0051276;GO:0006281;GO:0050789;GO:0007059;GO:0032502	0	0.01020408163265306	R1	-	1	27	16297	17	9	10	16288	16324	0.6410412166711262
e019_R1	224	TRUE	1.2637439814675276e-15	115	22	11	0.5	0.09565217391304348	GO:0050852	GO:BP	T cell receptor signaling pathway	16324	14053		GO:0050789;GO:0002376;GO:0001775	0	0.018518518518518517	R1	-	1	115	16209	11	11	104	16198	16324	0.21651992402611955
e019_R1	225	TRUE	6.522451331677854e-6	50	21	5	0.23809523809523808	0.1	GO:1902475	GO:BP	L-alpha-amino acid transmembrane transport	16324	23346		GO:0006865	0	0.047619047619047616	R1	-	1	50	16274	5	16	45	16258	16324	0.15265034634776098
e019_R1	226	TRUE	4.3402389118777845e-28	17	28	12	0.42857142857142855	0.7058823529411765	GO:0061952	GO:BP	midbody abscission	16324	16664		GO:0006508;GO:0051641;GO:0007032;GO:0009057;GO:0007033;GO:0061024;GO:0016032;GO:0048284;GO:0050789;GO:0022411;GO:0044419;GO:0016192;GO:0022607	0	0.00684931506849315	R1	-	1	17	16307	12	16	5	16291	16324	0.5494399193233749
e019_R1	227	TRUE	6.96283012684711e-7	130	12	6	0.5	0.046153846153846156	KEGG:05322	KEGG	Systemic lupus erythematosus	8161	477		NA	0	0.5	R1	-	1	130	8031	6	6	124	8025	8161	0.1483658814682935
e019_R1	228	TRUE	2.3226580120555837e-51	108	39	31	0.7948717948717948	0.28703703703703703	KEGG:03013	KEGG	Nucleocytoplasmic transport	8161	209		GO:0051641;GO:0015931	0	0.009900990099009901	R1	-	1	108	8053	31	8	77	8045	8161	0.4739791026440959
e019_R1	230	TRUE	1.932306791952159e-4	233	18	6	0.3333333333333333	0.02575107296137339	GO:0051258	GO:BP	protein polymerization	16324	14374		GO:0051258	0	0.1	R1	-	1	233	16091	6	12	227	16079	16324	0.08937001419638611
e019_R1	231	TRUE	2.4684358473930503e-18	86	19	12	0.631578947368421	0.13953488372093023	KEGG:04610	KEGG	Complement and coagulation cascades	8161	314		GO:0050878;GO:0050817	0	0.02857142857142857	R1	-	1	86	8075	12	7	74	8068	8161	0.29380178281144453
e019_R1	232	TRUE	1.0401687215937518e-27	24	25	13	0.52	0.5416666666666666	REAC:R-HSA-379716	REAC	Cytosolic tRNA aminoacylation	10790	409		GO:0006520;GO:0016070	0	0.03333333333333333	R1	-	1	24	10766	13	12	11	10754	10790	0.5296552764905197
e019_R1	233	TRUE	7.613512514948153e-9	265	19	9	0.47368421052631576	0.033962264150943396	GO:0009101	GO:BP	glycoprotein biosynthetic process	16324	3349		GO:0019538;GO:0009059	0	0.07692307692307693	R1	-	1	265	16059	9	10	256	16049	16324	0.12356766859217024
e019_R1	234	TRUE	5.1272339103770034e-9	13	22	5	0.22727272727272727	0.38461538461538464	GO:0006122	GO:BP	mitochondrial electron transport, ubiquinol to cytochrome c	16324	2024		GO:0022900;GO:0045333	0	0.02564102564102564	R1	-	1	13	16311	5	17	8	16294	16324	0.29493640110808206
e019_R1	235	TRUE	3.2321836011668698e-24	9	22	9	0.4090909090909091	1	GO:0000301	GO:BP	retrograde transport, vesicle recycling within Golgi	16324	92		GO:0016192	0	0.07142857142857142	R1	-	1	9	16315	9	13	0	16302	16324	0.6393472767119946
e019_R1	237	TRUE	2.8593015598389034e-15	57	18	9	0.5	0.15789473684210525	GO:0006998	GO:BP	nuclear envelope organization	16324	2672		GO:0006810;GO:0051641;GO:0006997;GO:0061024;GO:0051640	0	0.05555555555555555	R1	-	1	57	16267	9	9	48	16258	16324	0.27965616101477536
e019_R1	238	TRUE	2.917967327689031e-14	297	19	13	0.6842105263157895	0.04377104377104377	REAC:R-HSA-1474244	REAC	Extracellular matrix organization	10790	844		GO:0043062;GO:0032502;GO:0045229	0	0.0625	R1	-	1	297	10493	13	6	284	10487	10790	0.16857737760743877
e019_R1	239	TRUE	1.0950810904889638e-17	147	26	14	0.5384615384615384	0.09523809523809523	REAC:R-HSA-212165	REAC	Epigenetic regulation of gene expression	10790	810		GO:0050789;GO:0032502;GO:0016043	0	0.02631578947368421	R1	-	1	147	10643	14	12	133	10631	10790	0.22251315551608034
e019_R1	240	TRUE	3.6207957789231967e-37	57	32	19	0.59375	0.3333333333333333	GO:0043967	GO:BP	histone H4 acetylation	16324	11489		GO:0036211	0	0.022727272727272728	R1	-	1	57	16267	19	13	38	16254	16324	0.4434710242712737
e019_R1	242	TRUE	1.48573801492917e-28	53	36	16	0.4444444444444444	0.3018867924528302	GO:0007062	GO:BP	sister chromatid cohesion	16324	2719		GO:0000280;GO:0051276;GO:0007059;GO:0050789	0	0.0136986301369863	R1	-	1	53	16271	16	20	37	16251	16324	0.36461298394631275
e019_R1	243	TRUE	1.8847742000141694e-4	297	13	6	0.46153846153846156	0.020202020202020204	REAC:R-HSA-1474244	REAC	Extracellular matrix organization	10790	844		NA	0	0.3333333333333333	R1	-	1	297	10493	6	7	291	10486	10790	0.09213376768703636
e019_R1	244	TRUE	8.19205890086244e-9	472	22	11	0.5	0.023305084745762712	GO:0007005	GO:BP	mitochondrion organization	16324	2676		GO:0051640;GO:0050789;GO:0048285;GO:0007005	0	0.021739130434782608	R1	-	1	472	15852	11	11	461	15841	16324	0.10327714045883239
e019_R1	245	TRUE	1.0147305574681027e-17	89	20	12	0.6	0.1348314606741573	KEGG:04211	KEGG	Longevity regulating pathway	8161	282		GO:0007154;GO:0050896;GO:0007033;GO:0006914;GO:0022411;GO:0022607	0	0.011494252873563218	R1	-	1	89	8072	12	8	77	8064	8161	0.28113755725947587
e019_R1	246	TRUE	3.8764458796156557e-10	84	24	8	0.3333333333333333	0.09523809523809523	GO:0045103	GO:BP	intermediate filament-based process	16324	11964		GO:0008150	0	0.2	R1	-	1	84	16240	8	16	76	16224	16324	0.1760061455464075
e019_R1	247	TRUE	5.908835060911212e-4	26	14	3	0.21428571428571427	0.11538461538461539	KEGG:00563	KEGG	Glycosylphosphatidylinositol (GPI)-anchor biosynthesis	8161	87		NA	0	0.25	R1	-	1	26	8135	3	11	23	8124	8161	0.15528552293156672
e019_R1	248	TRUE	2.859611058137621e-29	268	37	23	0.6216216216216216	0.08582089552238806	GO:0006401	GO:BP	RNA catabolic process	16324	2212		GO:0009057;GO:0016070;GO:0065008;GO:0050789;GO:0006412	0	0.010752688172043012	R1	-	1	268	16056	23	14	245	16042	16324	0.22699833312968395
e019_R1	249	TRUE	1.3573290455875923e-5	25	17	4	0.23529411764705882	0.16	GO:0014059	GO:BP	regulation of dopamine secretion	16324	4745		GO:0046903;GO:0050789	0	0.06666666666666667	R1	-	1	25	16299	4	13	21	16286	16324	0.19301391161502268
e019_R1	250	TRUE	7.6451345304682e-4	132	10	4	0.4	0.030303030303030304	KEGG:04142	KEGG	Lysosome	8161	274		NA	0	0.5	R1	-	1	132	8029	4	6	128	8023	8161	0.10657468904358271
e019_R1	251	TRUE	1.0907319776809228e-10	29	13	6	0.46153846153846156	0.20689655172413793	KEGG:04392	KEGG	Hippo signaling pathway - multiple species	8161	306		NA	0	0.25	R1	-	1	29	8132	6	7	23	8125	8161	0.30742776713688336
e019_R1	252	TRUE	8.376446342231528e-7	150	11	6	0.5454545454545454	0.04	KEGG:03040	KEGG	Spliceosome	8161	215		GO:0006396	0	0.09090909090909091	R1	-	1	150	8011	6	5	144	8006	8161	0.1441597036239823
e019_R1	255	TRUE	0.002347007281646391	31	14	3	0.21428571428571427	0.0967741935483871	REAC:R-HSA-450282	REAC	MAPK targets/ Nuclear events mediated by MAP kinases	10790	1283		NA	0	0.5	R1	-	1	31	10759	3	11	28	10748	10790	0.1423707948646659
e019_R1	256	TRUE	5.962477376482515e-11	124	12	8	0.6666666666666666	0.06451612903225806	KEGG:04611	KEGG	Platelet activation	8161	315		GO:0050789;GO:0032502;GO:0006811;GO:0051604	0	0.02127659574468085	R1	-	1	124	8037	8	4	116	8033	8161	0.2043713765043518
e019_R1	257	TRUE	1.153158854030636e-39	26	25	17	0.68	0.6538461538461539	REAC:R-HSA-77387	REAC	Insulin receptor recycling	10790	1150		GO:0006914;GO:1902600;GO:0050789	0	0.016129032258064516	R1	-	1	26	10764	17	8	9	10756	10790	0.6660059867012198
e019_R1	258	TRUE	1.6556217654691634e-6	168	11	6	0.5454545454545454	0.03571428571428571	KEGG:04141	KEGG	Protein processing in endoplasmic reticulum	8161	273		NA	0	0.5	R1	-	1	168	7993	6	5	162	7988	8161	0.1358007453307297
e019_R1	259	TRUE	0.001007829688753549	22	14	3	0.21428571428571427	0.13636363636363635	GO:0098719	GO:BP	sodium ion import across plasma membrane	16324	19900		GO:0006811	0	0.14285714285714285	R1	-	1	22	16302	3	11	19	16291	16324	0.1700532828312851
e019_R1	260	TRUE	3.759996922776328e-24	202	21	17	0.8095238095238095	0.08415841584158416	REAC:R-HSA-5617833	REAC	Cilium Assembly	10790	346		GO:0006996;GO:0022607	0	0.047619047619047616	R1	-	1	202	10588	17	4	185	10584	10790	0.25764928123549286
e019_R1	263	TRUE	1.1531935728134422e-81	83	49	39	0.7959183673469388	0.46987951807228917	GO:0045104	GO:BP	intermediate filament cytoskeleton organization	16324	11965		GO:0032501;GO:0006996;GO:0032502	0	0.04	R1	-	1	83	16241	39	10	44	16231	16324	0.6101040906048443
e019_R1	264	TRUE	9.980586158689539e-20	67	14	11	0.7857142857142857	0.16417910447761194	KEGG:05204	KEGG	Chemical carcinogenesis - DNA adducts	8161	449		GO:0006805;GO:0042440;GO:0042445;GO:0050896;GO:0006082	0	0.016129032258064516	R1	-	1	67	8094	11	3	56	8091	8161	0.35718437433170735
e019_R1	265	TRUE	6.828773014047017e-8	9	14	4	0.2857142857142857	0.4444444444444444	REAC:R-HSA-8874211	REAC	CREB3 factors activate genes	10790	274		NA	0	0.029411764705882353	R1	-	1	9	10781	4	10	5	10771	10790	0.35568711149762117
e019_R1	266	TRUE	6.18383011743214e-17	34	20	9	0.45	0.2647058823529412	GO:0070296	GO:BP	sarcoplasmic reticulum calcium ion transport	16324	16968		GO:0006811;GO:0008015;GO:0006936;GO:0050789;GO:0065009	0	0.00847457627118644	R1	-	1	34	16290	9	11	25	16279	16324	0.34410597795692116
e019_R1	267	TRUE	7.299569417009712e-41	249	51	31	0.6078431372549019	0.12449799196787148	GO:0042254	GO:BP	ribosome biogenesis	16324	10632		GO:0006396;GO:0042254	0	0.047619047619047616	R1	-	1	249	16075	31	20	218	16055	16324	0.2706803107629032
e019_R1	268	TRUE	8.779205369316336e-5	48	15	4	0.26666666666666666	0.08333333333333333	KEGG:00280	KEGG	Valine, leucine and isoleucine degradation	8161	31		GO:0006520;GO:0006091	0	0.0625	R1	-	1	48	8113	4	11	44	8102	8161	0.1463484452639185
e019_R1	269	TRUE	7.43089755071956e-5	174	20	6	0.3	0.034482758620689655	GO:0006839	GO:BP	mitochondrial transport	16324	2564		NA	0	0.25	R1	-	1	174	16150	6	14	168	16136	16324	0.09868323156635984
e019_R1	270	TRUE	7.629312927555279e-31	249	26	23	0.8846153846153846	0.09236947791164658	KEGG:05132	KEGG	Salmonella infection	8161	422		GO:0006810;GO:0051641	0	0.016129032258064516	R1	-	1	249	7912	23	3	226	7909	8161	0.28074978258112854
e019_R1	272	TRUE	5.939861604663689e-6	21	16	4	0.25	0.19047619047619047	REAC:R-HSA-4641263	REAC	Regulation of FZD by ubiquitination	10790	1875		NA	0	0.25	R1	-	1	21	10769	4	12	17	10757	10790	0.21689094330319642
e019_R1	273	TRUE	3.463231292297009e-68	34	32	28	0.875	0.8235294117647058	KEGG:03020	KEGG	RNA polymerase	8161	212		GO:0050789;GO:0006351	0	0.010638297872340425	R1	-	1	34	8127	28	4	6	8123	8161	0.848262983870803
e019_R1	274	TRUE	4.305656708383841e-32	64	23	17	0.7391304347826086	0.265625	REAC:R-HSA-211897	REAC	Cytochrome P450 - arranged by substrate type	10790	402		GO:0044255;GO:0006082;GO:0006805;GO:0050896	0	0.013513513513513514	R1	-	1	64	10726	17	6	47	10720	10790	0.4413173450106143
e019_R1	275	TRUE	4.9537852469071384e-5	33	5	3	0.6	0.09090909090909091	REAC:R-HSA-420092	REAC	Glucagon-type ligand receptors	10790	996		GO:0050789	0	0.1	R1	-	1	33	10757	3	2	30	10755	10790	0.2327692848877206
e019_R1	276	TRUE	1.579643181746793e-4	192	11	5	0.45454545454545453	0.026041666666666668	KEGG:05202	KEGG	Transcriptional misregulation in cancer	8161	447		NA	0	0.5	R1	-	1	192	7969	5	6	187	7963	8161	0.10447315943031997
e019_R1	278	TRUE	4.2404151305782903e-19	250	21	16	0.7619047619047619	0.064	KEGG:04144	KEGG	Endocytosis	8161	275		NA	0	0.1111111111111111	R1	-	1	250	7911	16	5	234	7906	8161	0.21554285557160172
e019_R1	279	TRUE	2.45862628049475e-13	73	18	9	0.5	0.1232876712328767	REAC:R-HSA-6807505	REAC	RNA polymerase II transcribes snRNA genes	10790	1812		GO:0050789;GO:0006396	0	0.1	R1	-	1	73	10717	9	9	64	10708	10790	0.24596023820896787
e019_R1	280	TRUE	4.5481303507488796e-36	97	33	22	0.6666666666666666	0.2268041237113402	REAC:R-HSA-5620912	REAC	Anchoring of the basal body to the plasma membrane	10790	141		GO:0006996;GO:0022607;GO:0031023	0	0.020833333333333332	R1	-	1	97	10693	22	11	75	10682	10790	0.3859310689148094
e019_R1	281	TRUE	4.2332737972718834e-35	20	19	14	0.7368421052631579	0.7	REAC:R-HSA-190840	REAC	Microtubule-dependent trafficking of connexons from Golgi to the plasma membrane	10790	1375		GO:0006996	0	0.013333333333333334	R1	-	1	20	10770	14	5	6	10765	10790	0.71767521590815
e019_R1	282	TRUE	7.7270915409194e-19	238	20	14	0.7	0.058823529411764705	GO:0030198	GO:BP	extracellular matrix organization	16324	7070		GO:0043062;GO:0045229	0	0.045454545454545456	R1	-	1	238	16086	14	6	224	16080	16324	0.20028061424928606
e019_R1	283	TRUE	1.4952270240305355e-4	308	14	6	0.42857142857142855	0.01948051948051948	GO:0006869	GO:BP	lipid transport	16324	2586		GO:0006869	0	0.1111111111111111	R1	-	1	308	16016	6	8	302	16008	16324	0.0882228154808643
e019_R1	284	TRUE	1.3731393257882583e-21	97	16	13	0.8125	0.13402061855670103	KEGG:03015	KEGG	mRNA surveillance pathway	8161	210		GO:0051641;GO:0009057;GO:0016070;GO:0050789;GO:0015931	0	0.018518518518518517	R1	-	1	97	8064	13	3	84	8061	8161	0.3274311457132988
e019_R1	285	TRUE	1.2461460351532533e-4	67	11	4	0.36363636363636365	0.05970149253731343	REAC:R-HSA-1650814	REAC	Collagen biosynthesis and modifying enzymes	10790	364		GO:0043062;GO:0045229	0	0.0625	R1	-	1	67	10723	4	7	63	10716	10790	0.14535174302695072
e019_R1	286	TRUE	2.8792099768802843e-18	227	22	14	0.6363636363636364	0.06167400881057269	GO:0090092	GO:BP	regulation of transmembrane receptor protein serine/threonine kinase signaling pathway	16324	19021		GO:0050896;GO:0050789;GO:0032502;GO:0006793;GO:0036211	0	0.012987012987012988	R1	-	1	227	16097	14	8	213	16089	16324	0.19527288683907634
e019_R1	287	TRUE	2.1096132406250576e-23	258	23	17	0.7391304347826086	0.06589147286821706	GO:0050804	GO:BP	modulation of chemical synaptic transmission	16324	14016		GO:0007154;GO:0050877;GO:0065008;GO:0007155;GO:0061024;GO:0050789;GO:0065009;GO:0022607	0	0.00909090909090909	R1	-	1	258	16066	17	6	241	16060	16324	0.21784791766771944
e019_R1	288	TRUE	1.6547246094664747e-4	76	4	3	0.75	0.039473684210526314	KEGG:05133	KEGG	Pertussis	8161	423		GO:0022411	0	0.08333333333333333	R1	-	1	76	8085	3	1	73	8084	8161	0.17076399251007132
e019_R1	290	TRUE	1.42386562393193e-20	64	14	11	0.7857142857142857	0.171875	REAC:R-HSA-1442490	REAC	Collagen degradation	10790	366		GO:0043062;GO:0045229	0	0.02631578947368421	R1	-	1	64	10726	11	3	53	10723	10790	0.36603404155689123
e019_R1	291	TRUE	2.221748003875078e-10	294	23	12	0.5217391304347826	0.04081632653061224	KEGG:04010	KEGG	MAPK signaling pathway	8161	238		GO:0050896;GO:0006793;GO:0036211	0	0.02127659574468085	R1	-	1	294	7867	12	11	282	7856	8161	0.13856417288973785
e019_R1	292	TRUE	4.513658953709408e-31	144	35	22	0.6285714285714286	0.1527777777777778	REAC:R-HSA-8856828	REAC	Clathrin-mediated endocytosis	10790	357		GO:0048753;GO:0016192;GO:0022607	0	0.01639344262295082	R1	-	1	144	10646	22	13	122	10633	10790	0.3058512631970748
e019_R1	293	TRUE	4.736694075742048e-19	410	29	18	0.6206896551724138	0.04390243902439024	GO:0061061	GO:BP	muscle structure development	16324	16048		GO:0006996;GO:0032502;GO:0022607	0	0.02702702702702703	R1	-	1	410	15914	18	11	392	15903	16324	0.1605654088846079
e019_R1	294	TRUE	5.270253659544051e-14	250	16	12	0.75	0.048	KEGG:04144	KEGG	Endocytosis	8161	275		GO:0016192;GO:0016050;GO:0051641	0	0.0625	R1	-	1	250	7911	12	4	238	7907	8161	0.18502155949813162
e019_R1	295	TRUE	2.6268856943335204e-17	107	18	11	0.6111111111111112	0.102803738317757	GO:0061640	GO:BP	cytoskeleton-dependent cytokinesis	16324	16508		GO:0008150	0	0.1	R1	-	1	107	16217	11	7	96	16210	16324	0.24891367458709118
e019_R1	296	TRUE	5.2340763184120666e-6	97	11	5	0.45454545454545453	0.05154639175257732	KEGG:04713	KEGG	Circadian entrainment	8161	342		GO:0006396	0	0.07692307692307693	R1	-	1	97	8064	5	6	92	8058	8161	0.1500616549688977
e019_R1	297	TRUE	9.149202787254671e-33	16	26	13	0.5	0.8125	GO:0043328	GO:BP	protein transport to vacuole involved in ubiquitin-dependent protein catabolic process via the multivesicular body sorting pathway	16324	11225		GO:0006508;GO:0007032;GO:0015031;GO:0009057;GO:0061024;GO:0016192;GO:0022607	0	0.014925373134328358	R1	-	1	16	16308	13	13	3	16295	16324	0.6369474162913845
e019_R1	298	TRUE	0.002066632453687576	247	7	4	0.5714285714285714	0.016194331983805668	REAC:R-HSA-425407	REAC	SLC-mediated transmembrane transport	10790	2024		NA	0	0.5	R1	-	1	247	10543	4	3	243	10540	10790	0.0934492915477954
e019_R1	299	TRUE	2.549301705287268e-11	35	18	7	0.3888888888888889	0.2	KEGG:00500	KEGG	Starch and sucrose metabolism	8161	62		GO:0006112;GO:0005976	0	0.02702702702702703	R1	-	1	35	8126	7	11	28	8115	8161	0.2767097654324027
e019_R1	301	TRUE	1.919309170292457e-93	103	54	48	0.8888888888888888	0.46601941747572817	REAC:R-HSA-611105	REAC	Respiratory electron transport	10790	1963		GO:0006119;GO:0022900;GO:0009117	0	0.015384615384615385	R1	-	1	103	10687	48	6	55	10681	10790	0.6413703416378034
e019_R1	302	TRUE	7.134076894217026e-6	40	10	4	0.4	0.1	GO:0045454	GO:BP	cell redox homeostasis	16324	12083		GO:0008150	0	0.25	R1	-	1	40	16284	4	6	36	16278	16324	0.19907978244686758
e019_R1	303	TRUE	3.1715042901180553e-12	15	17	6	0.35294117647058826	0.4	GO:0036376	GO:BP	sodium ion export across plasma membrane	16324	10121		GO:0050789;GO:0006811	0	0.012345679012345678	R1	-	1	15	16309	6	11	9	16298	16324	0.37512401819247876
e019_R1	304	TRUE	2.8291964909219284e-22	21	20	10	0.5	0.47619047619047616	GO:0007214	GO:BP	gamma-aminobutyric acid signaling pathway	16324	2835		GO:0007154;GO:0006811	0	0.02857142857142857	R1	-	1	21	16303	10	10	11	16293	16324	0.4873065597945362
e019_R1	305	TRUE	3.503093445616267e-57	82	30	28	0.9333333333333333	0.34146341463414637	REAC:R-HSA-381340	REAC	Transcriptional regulation of white adipocyte differentiation	10790	2426		GO:0050789	0	0.05	R1	-	1	82	10708	28	2	54	10706	10790	0.5628606718144179
e019_R1	307	TRUE	2.677582664865061e-14	108	11	9	0.8181818181818182	0.08333333333333333	KEGG:03013	KEGG	Nucleocytoplasmic transport	8161	209		GO:0051641;GO:0015931;GO:0044419	0	0.024390243902439025	R1	-	1	108	8053	9	2	99	8051	8161	0.2587844002390358
e019_R1	308	TRUE	2.3759146125549638e-6	179	11	6	0.5454545454545454	0.0335195530726257	REAC:R-HSA-72163	REAC	mRNA Splicing - Major Pathway	10790	2566		GO:0000375	0	0.09090909090909091	R1	-	1	179	10611	6	5	173	10606	10790	0.1322722667514438
e019_R1	309	TRUE	1.9216971598548414e-12	67	23	9	0.391304347826087	0.13432835820895522	REAC:R-HSA-1650814	REAC	Collagen biosynthesis and modifying enzymes	10790	364		GO:0036211	0	0.07142857142857142	R1	-	1	67	10723	9	14	58	10709	10790	0.22657407354446862
e019_R1	310	TRUE	4.4145422133986586e-12	393	25	13	0.52	0.03307888040712468	GO:0007015	GO:BP	actin filament organization	16324	2683		GO:0050789;GO:0006996	0	0.043478260869565216	R1	-	1	393	15931	13	12	380	15919	16324	0.12671100474965824
e019_R1	312	TRUE	1.8316324507390974e-25	20	13	10	0.7692307692307693	0.5	GO:0033141	GO:BP	positive regulation of peptidyl-serine phosphorylation of STAT protein	16324	8485		GO:0050896;GO:0008283;GO:0002376;GO:0001775;GO:0050789;GO:0006793;GO:0036211;GO:0044419	0	0.011627906976744186	R1	-	1	20	16304	10	3	10	16301	16324	0.6198124025431521
e019_R1	313	TRUE	3.6724704633159e-17	13	27	8	0.2962962962962963	0.6153846153846154	GO:0001682	GO:BP	tRNA 5'-leader removal	16324	398		GO:0006396	0	0.0625	R1	-	1	13	16311	8	19	5	16292	16324	0.4263831534573255
e019_R1	316	TRUE	7.308046482696249e-4	617	15	7	0.4666666666666667	0.011345218800648298	GO:0016071	GO:BP	mRNA metabolic process	16324	5222		GO:0006396	0	0.2	R1	-	1	617	15707	7	8	610	15699	16324	0.06820160039170116
e019_R1	317	TRUE	1.7139503116265733e-4	57	14	4	0.2857142857142857	0.07017543859649122	GO:1901607	GO:BP	alpha-amino acid biosynthetic process	16324	22595		GO:0006520	0	0.16666666666666666	R1	-	1	57	16267	4	10	53	16257	16324	0.1401729096710255
e019_R1	318	TRUE	2.0568751479862074e-10	19	21	6	0.2857142857142857	0.3157894736842105	REAC:R-HSA-5625900	REAC	RHO GTPases activate CIT	10790	1761		GO:0008150	0	0.058823529411764705	R1	-	1	19	10771	6	15	13	10756	10790	0.29907881913541684
e019_R1	320	TRUE	1.0880792349787843e-19	394	24	17	0.7083333333333334	0.04314720812182741	GO:0008380	GO:BP	RNA splicing	16324	3261		GO:0050789;GO:0000375	0	0.037037037037037035	R1	-	1	394	15930	17	7	377	15923	16324	0.1710659722672036
e019_R1	321	TRUE	2.9799674894623014e-8	19	20	5	0.25	0.2631578947368421	GO:0006613	GO:BP	cotranslational protein targeting to membrane	16324	2382		GO:0015031	0	0.06666666666666667	R1	-	1	19	16305	5	15	14	16290	16324	0.25560575719154355
e019_R1	322	TRUE	2.630820437608231e-7	394	19	9	0.47368421052631576	0.02284263959390863	GO:0008380	GO:BP	RNA splicing	16324	3261		GO:0006396	0	0.1	R1	-	1	394	15930	9	10	385	15920	16324	0.09999148690110168
e019_R1	324	TRUE	1.4929749454071225e-7	472	21	10	0.47619047619047616	0.0211864406779661	GO:0007005	GO:BP	mitochondrion organization	16324	2676		GO:0007005;GO:0061024	0	0.09090909090909091	R1	-	1	472	15852	10	11	462	15841	16324	0.095799893883298
e019_R1	325	TRUE	2.4316845100376564e-6	59	14	5	0.35714285714285715	0.0847457627118644	REAC:R-HSA-8943724	REAC	Regulation of PTEN gene transcription	10790	1891		GO:0050789;GO:0036211	0	0.0625	R1	-	1	59	10731	5	9	54	10722	10790	0.17189049236122825
e019_R1	326	TRUE	4.815270106698858e-6	15	6	3	0.5	0.2	KEGG:00730	KEGG	Thiamine metabolism	8161	118		NA	0	0.2	R1	-	1	15	8146	3	3	12	8143	8161	0.3154712419334631
e019_R1	327	TRUE	1.2229340986042515e-10	483	26	13	0.5	0.026915113871635612	GO:0051640	GO:BP	organelle localization	16324	14641		GO:0046903;GO:0051640;GO:0050789;GO:0016192	0	0.03571428571428571	R1	-	1	483	15841	13	13	470	15828	16324	0.11088155873660843
e019_R1	328	TRUE	9.638099076166613e-6	140	16	6	0.375	0.04285714285714286	REAC:R-HSA-3781865	REAC	Diseases of glycosylation	10790	727		GO:0043062;GO:0045229	0	0.07142857142857142	R1	-	1	140	10650	6	10	134	10640	10790	0.12328002639193336
e019_R1	329	TRUE	4.120169633823901e-5	169	5	4	0.8	0.023668639053254437	KEGG:04530	KEGG	Tight junction	8161	311		NA	0	0.5	R1	-	1	169	7992	4	1	165	7991	8161	0.13549359380701786
e019_R1	330	TRUE	2.0285279740781744e-21	81	14	12	0.8571428571428571	0.14814814814814814	KEGG:04146	KEGG	Peroxisome	8161	277		GO:0044255;GO:0006082	0	0.029411764705882353	R1	-	1	81	8080	12	2	69	8078	8161	0.35428708279341253
e019_R1	331	TRUE	2.1865599089373078e-4	168	13	5	0.38461538461538464	0.02976190476190476	KEGG:04141	KEGG	Protein processing in endoplasmic reticulum	8161	273		NA	0	0.3333333333333333	R1	-	1	168	7993	5	8	163	7985	8161	0.1024039669939362
e019_R1	333	TRUE	3.49261949292027e-39	79	24	21	0.875	0.26582278481012656	KEGG:03018	KEGG	RNA degradation	8161	211		GO:0050789;GO:0006396;GO:0042254;GO:0009057	0	0.009708737864077669	R1	-	1	79	8082	21	3	58	8079	8161	0.47997710301811863
e019_R1	334	TRUE	6.056566725984149e-22	185	14	13	0.9285714285714286	0.07027027027027027	GO:0071805	GO:BP	potassium ion transmembrane transport	16324	17873		GO:0006811	0	0.030303030303030304	R1	-	1	185	16139	13	1	172	16138	16324	0.2538760232864621
e019_R1	335	TRUE	3.9749443162483066e-7	108	26	7	0.2692307692307692	0.06481481481481481	GO:0072329	GO:BP	monocarboxylic acid catabolic process	16324	18323		GO:0044255;GO:0006082	0	0.04	R1	-	1	108	16216	7	19	101	16197	16324	0.1293842648117117
e019_R1	337	TRUE	4.133842107587438e-7	6	6	3	0.5	0.5	REAC:R-HSA-1566977	REAC	Fibronectin matrix formation	10790	895		GO:0007155	0	0.16666666666666666	R1	-	1	6	10784	3	3	3	10781	10790	0.4997218100890207
e019_R1	338	TRUE	5.438166433686499e-10	158	15	8	0.5333333333333333	0.05063291139240506	GO:0140053	GO:BP	mitochondrial gene expression	16324	20737		GO:0006412;GO:0016070	0	0.09090909090909091	R1	-	1	158	16166	8	7	150	16159	16324	0.16220842973213492
e019_R1	339	TRUE	2.9713368420025697e-34	33	22	16	0.7272727272727273	0.48484848484848486	KEGG:04130	KEGG	SNARE interactions in vesicular transport	8161	267		GO:0048284;GO:0016192;GO:0016050;GO:0061024	0	0.04	R1	-	1	33	8128	16	6	17	8122	8161	0.5925108014200818
e019_R1	341	TRUE	2.7077090983905436e-5	10	11	3	0.2727272727272727	0.3	REAC:R-HSA-9758881	REAC	Uptake of dietary cobalamins into enterocytes	10790	2491		GO:0006996;GO:0022607;GO:0031023	0	0.1	R1	-	1	10	10780	3	8	7	10772	10790	0.2853444330641643
e019_R1	342	TRUE	0.0018777360322956187	23	16	3	0.1875	0.13043478260869565	GO:0033617	GO:BP	mitochondrial cytochrome c oxidase assembly	16324	8757		GO:0065003	0	0.25	R1	-	1	23	16301	3	13	20	16288	16324	0.15539628345451717
e019_R1	343	TRUE	1.6760414987687676e-29	23	21	13	0.6190476190476191	0.5652173913043478	REAC:R-HSA-5620922	REAC	BBSome-mediated cargo-targeting to cilium	10790	192		GO:0032501;GO:0006810;GO:0051641;GO:0006996;GO:0051640;GO:0022607	0	0.016129032258064516	R1	-	1	23	10767	13	8	10	10759	10790	0.5906880353406743
e019_R1	346	TRUE	3.483579882839218e-5	238	8	5	0.625	0.02100840336134454	GO:0030198	GO:BP	extracellular matrix organization	16324	7070		GO:0043062;GO:0045229	0	0.125	R1	-	1	238	16086	5	3	233	16083	16324	0.11276677127927365
e019_R1	351	TRUE	3.4609802621761834e-6	23	13	4	0.3076923076923077	0.17391304347826086	REAC:R-HSA-8949215	REAC	Mitochondrial calcium ion transport	10790	1388		NA	0	0.2	R1	-	1	23	10767	4	9	19	10758	10790	0.2301073056926004
e019_R1	352	TRUE	8.042022545045189e-6	39	11	4	0.36363636363636365	0.10256410256410256	KEGG:00513	KEGG	Various types of N-glycan biosynthesis	8161	66		GO:0006811	0	0.08333333333333333	R1	-	1	39	8122	4	7	35	8115	8161	0.19116975899392394
e019_R1	354	TRUE	1.0421603136759447e-4	10	15	3	0.2	0.3	GO:0045050	GO:BP	protein insertion into ER membrane by stop-transfer membrane-anchor sequence	16324	11938		GO:0051234;GO:0051641	0	0.25	R1	-	1	10	16314	3	12	7	16302	16324	0.244385841536672
e019_R1	358	TRUE	1.338110269121381e-8	34	4	4	1	0.11764705882352941	REAC:R-HSA-156590	REAC	Glutathione conjugation	10790	1004		GO:0006807;GO:0006805;GO:0006725	0	0.043478260869565216	R1	-	1	34	10756	4	0	30	10756	10790	0.3425198348443633
e019_R1	361	TRUE	1.0668915297204005e-7	56	4	4	1	0.07142857142857142	KEGG:05416	KEGG	Viral myocarditis	8161	486		GO:0032502	0	0.125	R1	-	1	56	8105	4	0	52	8105	8161	0.26640799903126966
e019_R1	363	TRUE	1.4282486269084941e-10	12	4	4	1	0.3333333333333333	REAC:R-HSA-622323	REAC	Presynaptic nicotinic acetylcholine receptors	10790	1702		GO:0006936;GO:0065008	0	0.05555555555555555	R1	-	1	12	10778	4	0	8	10778	10790	0.577136118488939
e019_R1	364	TRUE	3.42478621853503e-9	4	3	3	1	0.75	REAC:R-HSA-1296061	REAC	HCN channels	10790	1033		GO:0065008;GO:0050896;GO:0007154;GO:0050789	0	0.02	R1	-	1	4	10786	3	0	1	10786	10790	0.8659852607661871
e019_R1	365	TRUE	3.077671065609418e-4	153	3	3	1	0.0196078431372549	KEGG:04514	KEGG	Cell adhesion molecules	8161	309		GO:0022607;GO:0050789;GO:0043062;GO:0045229	0	0.1111111111111111	R1	-	1	153	8008	3	0	150	8008	8161	0.13873469818294867
e019_R1	366	TRUE	1.8836324201942629e-7	12	3	3	1	0.25	REAC:R-HSA-211979	REAC	Eicosanoids	10790	797		GO:0042180;GO:0006766;GO:0032501;GO:0046483;GO:0044255;GO:0006082	0	0.02564102564102564	R1	-	1	12	10778	3	0	9	10778	10790	0.4997913720672289
e019_R1	367	TRUE	1.4733528604171467e-7	12	3	3	1	0.25	GO:0099558	GO:BP	maintenance of synapse structure	16324	20198		GO:0016043	0	0.2	R1	-	1	12	16312	3	0	9	16312	16324	0.4998621217897952
