module	monet_type	experiment_info	significant	p_value	term_size	query_size	intersection_size	precision	recall	term_id	source	term_name	effective_domain_size	source_order	parents	goslim_pir	perc_rank	cumelative_dist	genes	rank	P	N	tp	fp	fn	tn	tot_pop_valid	mcc
1	M1	e019_M1	TRUE	4.549032891844948e-78	158	85	50	0.5882352941176471	0.31645569620253167	GO:0140053	GO:BP	mitochondrial gene expression	16324	20737		GO:0016070;GO:0006412	0	0.02564102564102564	ENSG00000215251;ENSG00000243927;ENSG00000177646;ENSG00000196365;ENSG00000182180;ENSG00000164347;ENSG00000138035;ENSG00000119705;ENSG00000103202;ENSG00000061794;ENSG00000048544;ENSG00000137133;ENSG00000107815;ENSG00000131368;ENSG00000144381;ENSG00000239789;ENSG00000120662;ENSG00000101181;ENSG00000105379;ENSG00000108179;ENSG00000147586;ENSG00000156502;ENSG00000124279;ENSG00000148090;ENSG00000122033;ENSG00000085760;ENSG00000132591;ENSG00000151806;ENSG00000134905;ENSG00000122140;ENSG00000132300;ENSG00000119689;ENSG00000148187;ENSG00000174173;ENSG00000104980;ENSG00000115419;ENSG00000132463;ENSG00000172171;ENSG00000112031;ENSG00000113048;ENSG00000036473;ENSG00000139428;ENSG00000175110;ENSG00000181991;ENSG00000182199;ENSG00000244005;ENSG00000140374;ENSG00000181610;ENSG00000118246;ENSG00000125901;ENSG00000090263;ENSG00000102763;ENSG00000182810;ENSG00000125445;ENSG00000160194;ENSG00000123472;ENSG00000062582;ENSG00000116898;ENSG00000163319;ENSG00000172586;ENSG00000183010;ENSG00000155906;ENSG00000165526;ENSG00000175756;ENSG00000168924;ENSG00000156469;ENSG00000138095;ENSG00000136463;ENSG00000144029;ENSG00000137500;ENSG00000119673;ENSG00000067704;ENSG00000081177;ENSG00000108064;ENSG00000148672;ENSG00000135972;ENSG00000099821;ENSG00000156026;ENSG00000103707;ENSG00000120333;ENSG00000132676;ENSG00000132153;ENSG00000074071;ENSG00000164182;ENSG00000006744;ENSG00000168827;ENSG00000074582;ENSG00000023330;ENSG00000102738;ENSG00000050393	1	158	16166	50	35	108	16131	16324	0.4275355177331374
3	M1	e019_M1	TRUE	6.11506054441149e-7	752	79	20	0.25316455696202533	0.026595744680851064	GO:0007186	GO:BP	G protein-coupled receptor signaling pathway	16324	2809		GO:0050789	0	0.09090909090909091	ENSG00000004809;ENSG00000197296;ENSG00000108639;ENSG00000198018;ENSG00000111897;ENSG00000171860;ENSG00000023041;ENSG00000172954;ENSG00000085998;ENSG00000143570;ENSG00000151617;ENSG00000147246;ENSG00000158850;ENSG00000184857;ENSG00000185900;ENSG00000184992;ENSG00000157837;ENSG00000058668;ENSG00000144891;ENSG00000109929;ENSG00000125648;ENSG00000144567;ENSG00000168785;ENSG00000170412;ENSG00000196187;ENSG00000165678;ENSG00000146411;ENSG00000115353;ENSG00000163933;ENSG00000105983;ENSG00000149742;ENSG00000150625;ENSG00000134817;ENSG00000203737;ENSG00000163624;ENSG00000124532;ENSG00000126010;ENSG00000117479;ENSG00000159063;ENSG00000102195;ENSG00000106018;ENSG00000005206;ENSG00000198792;ENSG00000067842;ENSG00000169313;ENSG00000139133;ENSG00000197901;ENSG00000167191;ENSG00000163870;ENSG00000111684;ENSG00000066455;ENSG00000164180;ENSG00000175106;ENSG00000075673;ENSG00000100196;ENSG00000197977;ENSG00000171049;ENSG00000157111;ENSG00000003989;ENSG00000137207;ENSG00000139679;ENSG00000198121;ENSG00000168077;ENSG00000157600;ENSG00000054793;ENSG00000119787;ENSG00000050426;ENSG00000172292;ENSG00000155659;ENSG00000196715;ENSG00000123146;ENSG00000127080;ENSG00000111666;ENSG00000160216;ENSG00000114812;ENSG00000176894;ENSG00000198743;ENSG00000099282;ENSG00000197563;ENSG00000164187;ENSG00000164073;ENSG00000174749;ENSG00000069493;ENSG00000157087;ENSG00000206527;ENSG00000139624;ENSG00000197150	1	752	15572	20	59	732	15513	16324	0.06889280020828253
4	M1	e019_M1	TRUE	5.0940370198267413e-82	294	84	59	0.7023809523809523	0.20068027210884354	GO:0007178	GO:BP	transmembrane receptor protein serine/threonine kinase signaling pathway	16324	2803		GO:0032502;GO:0032501;GO:0006793;GO:0050896;GO:0050789;GO:0036211	0	0.005208333333333333	ENSG00000170365;ENSG00000106799;ENSG00000122641;ENSG00000163083;ENSG00000135409;ENSG00000241186;ENSG00000115170;ENSG00000139567;ENSG00000121989;ENSG00000113658;ENSG00000120693;ENSG00000095739;ENSG00000069702;ENSG00000101144;ENSG00000171243;ENSG00000153162;ENSG00000106991;ENSG00000137834;ENSG00000039319;ENSG00000107779;ENSG00000204217;ENSG00000169554;ENSG00000119699;ENSG00000175906;ENSG00000103710;ENSG00000125845;ENSG00000114739;ENSG00000149948;ENSG00000135503;ENSG00000125965;ENSG00000090539;ENSG00000141232;ENSG00000138696;ENSG00000168509;ENSG00000167550;ENSG00000180532;ENSG00000123610;ENSG00000156466;ENSG00000171236;ENSG00000120725;ENSG00000132879;ENSG00000197415;ENSG00000263761;ENSG00000123999;ENSG00000109065;ENSG00000128829;ENSG00000181965;ENSG00000138379;ENSG00000021300;ENSG00000152332;ENSG00000127578;ENSG00000106336;ENSG00000159459;ENSG00000116985;ENSG00000171604;ENSG00000147255;ENSG00000152785;ENSG00000054938;ENSG00000115956;ENSG00000173418;ENSG00000101938;ENSG00000134363;ENSG00000128791;ENSG00000173714;ENSG00000168675;ENSG00000070404;ENSG00000135414;ENSG00000187045;ENSG00000183691;ENSG00000125378;ENSG00000198742;ENSG00000180245;ENSG00000123612;ENSG00000100302;ENSG00000174136;ENSG00000112175;ENSG00000175189;ENSG00000156671;ENSG00000186795;ENSG00000164619;ENSG00000038295;ENSG00000111341;ENSG00000122176;ENSG00000143869;ENSG00000180875;ENSG00000228049	1	294	16030	59	25	235	16005	16324	0.3701043360454439
6	M1	e019_M1	TRUE	1.2636106400919894e-37	161	77	30	0.38961038961038963	0.18633540372670807	GO:0009060	GO:BP	aerobic respiration	16324	3312		GO:0022900;GO:0006119;GO:0009117	0	0.012658227848101266	ENSG00000111711;ENSG00000183978;ENSG00000167792;ENSG00000010256;ENSG00000104412;ENSG00000110880;ENSG00000189043;ENSG00000114054;ENSG00000131828;ENSG00000165637;ENSG00000105953;ENSG00000175768;ENSG00000169252;ENSG00000166340;ENSG00000140740;ENSG00000114573;ENSG00000078668;ENSG00000109919;ENSG00000115286;ENSG00000115944;ENSG00000085491;ENSG00000177469;ENSG00000100216;ENSG00000075785;ENSG00000110955;ENSG00000165629;ENSG00000176340;ENSG00000110090;ENSG00000215021;ENSG00000174437;ENSG00000248098;ENSG00000119421;ENSG00000112992;ENSG00000156515;ENSG00000105854;ENSG00000127948;ENSG00000008394;ENSG00000139180;ENSG00000158864;ENSG00000131100;ENSG00000130204;ENSG00000110717;ENSG00000164919;ENSG00000084754;ENSG00000128463;ENSG00000168291;ENSG00000179091;ENSG00000166347;ENSG00000138029;ENSG00000167283;ENSG00000147416;ENSG00000196597;ENSG00000023228;ENSG00000166136;ENSG00000184117;ENSG00000108774;ENSG00000159348;ENSG00000143653;ENSG00000018510;ENSG00000147684;ENSG00000198712;ENSG00000100243;ENSG00000101558;ENSG00000131148;ENSG00000122884;ENSG00000146729;ENSG00000173660;ENSG00000127184;ENSG00000173436;ENSG00000159720;ENSG00000130203;ENSG00000168653;ENSG00000083123;ENSG00000241837;ENSG00000128609;ENSG00000148334;ENSG00000198363;ENSG00000164405	1	161	16163	30	47	131	16116	16324	0.2645492192873154
7	M1	e019_M1	TRUE	3.7945859778845366e-34	41	56	20	0.35714285714285715	0.4878048780487805	REAC:R-HSA-383280	REAC	Nuclear Receptor transcription pathway	10790	1530		GO:0048511;GO:0050789;GO:0050896	0	0.013333333333333334	ENSG00000116717;ENSG00000109819;ENSG00000173153;ENSG00000155846;ENSG00000184481;ENSG00000133639;ENSG00000131408;ENSG00000186350;ENSG00000025434;ENSG00000151623;ENSG00000136931;ENSG00000186951;ENSG00000069667;ENSG00000151090;ENSG00000084676;ENSG00000140396;ENSG00000180530;ENSG00000143171;ENSG00000172819;ENSG00000077092;ENSG00000112033;ENSG00000112658;ENSG00000148200;ENSG00000029153;ENSG00000134852;ENSG00000129152;ENSG00000101849;ENSG00000131910;ENSG00000165671;ENSG00000198646;ENSG00000146278;ENSG00000111424;ENSG00000101076;ENSG00000012504;ENSG00000082014;ENSG00000130222;ENSG00000170485;ENSG00000169297;ENSG00000196482;ENSG00000145391;ENSG00000189266;ENSG00000163586;ENSG00000144852;ENSG00000117707;ENSG00000147166;ENSG00000106789;ENSG00000283930;ENSG00000107223;ENSG00000116833;ENSG00000132326;ENSG00000185551;ENSG00000119715;ENSG00000143365;ENSG00000043039;ENSG00000099860;ENSG00000104936;ENSG00000179195;ENSG00000160113;ENSG00000176293;ENSG00000153234;ENSG00000183722;ENSG00000163795;ENSG00000064835;ENSG00000130598;ENSG00000171988;ENSG00000118245;ENSG00000177200;ENSG00000010539;ENSG00000167470;ENSG00000101883;ENSG00000123095;ENSG00000009709;ENSG00000164749;ENSG00000151726;ENSG00000143257;ENSG00000171533;ENSG00000116353	1	41	10749	20	36	21	10713	10790	0.41481575912810265
8	M1	e019_M1	TRUE	1.1062237065491538e-44	86	50	29	0.58	0.3372093023255814	KEGG:04610	KEGG	Complement and coagulation cascades	8161	314		GO:0050789;GO:0050817;GO:0050878;GO:0050896	0	0.011235955056179775	ENSG00000146674;ENSG00000005961;ENSG00000113905;ENSG00000122194;ENSG00000122861;ENSG00000185010;ENSG00000101981;ENSG00000149131;ENSG00000164344;ENSG00000131187;ENSG00000124491;ENSG00000143278;ENSG00000115718;ENSG00000117525;ENSG00000019991;ENSG00000104432;ENSG00000123838;ENSG00000123843;ENSG00000182326;ENSG00000106366;ENSG00000167264;ENSG00000180210;ENSG00000167244;ENSG00000117601;ENSG00000017427;ENSG00000145431;ENSG00000184500;ENSG00000145649;ENSG00000167900;ENSG00000099937;ENSG00000163815;ENSG00000171560;ENSG00000184164;ENSG00000163453;ENSG00000173467;ENSG00000115461;ENSG00000168702;ENSG00000163536;ENSG00000166145;ENSG00000178149;ENSG00000188488;ENSG00000057593;ENSG00000091583;ENSG00000146678;ENSG00000141753;ENSG00000124570;ENSG00000149418;ENSG00000126218;ENSG00000182752;ENSG00000171557;ENSG00000198734;ENSG00000109758;ENSG00000126233;ENSG00000171564;ENSG00000064205;ENSG00000088926;ENSG00000173391;ENSG00000115457;ENSG00000198670;ENSG00000080618;ENSG00000115486;ENSG00000042980;ENSG00000116183;ENSG00000102359;ENSG00000105825;ENSG00000159167;ENSG00000125772;ENSG00000104368;ENSG00000047457;ENSG00000160323;ENSG00000139610;ENSG00000099769;ENSG00000124102;ENSG00000163389;ENSG00000186075	1	86	8075	29	21	57	8054	8161	0.4378602241136196
9	M1	e019_M1	TRUE	4.506548732530316e-54	610	71	51	0.7183098591549296	0.08360655737704918	GO:0016567	GO:BP	protein ubiquitination	16324	5381		GO:0009057;GO:0036211;GO:0006508	0	0.03333333333333333	ENSG00000169139;ENSG00000157450;ENSG00000161642;ENSG00000244687;ENSG00000172175;ENSG00000049759;ENSG00000142867;ENSG00000135144;ENSG00000173193;ENSG00000013561;ENSG00000131508;ENSG00000119401;ENSG00000010318;ENSG00000004838;ENSG00000101197;ENSG00000101871;ENSG00000183574;ENSG00000124226;ENSG00000125826;ENSG00000170142;ENSG00000180891;ENSG00000182247;ENSG00000183763;ENSG00000078967;ENSG00000130311;ENSG00000104343;ENSG00000170153;ENSG00000141527;ENSG00000139517;ENSG00000065371;ENSG00000198919;ENSG00000185019;ENSG00000151692;ENSG00000143258;ENSG00000022840;ENSG00000112130;ENSG00000170035;ENSG00000178498;ENSG00000072609;ENSG00000158717;ENSG00000171206;ENSG00000078140;ENSG00000109654;ENSG00000137075;ENSG00000132256;ENSG00000168894;ENSG00000102858;ENSG00000110171;ENSG00000134758;ENSG00000173926;ENSG00000014123;ENSG00000159202;ENSG00000081803;ENSG00000186187;ENSG00000163840;ENSG00000184787;ENSG00000123728;ENSG00000144015;ENSG00000049883;ENSG00000134253;ENSG00000160087;ENSG00000168411;ENSG00000135378;ENSG00000180233;ENSG00000196860;ENSG00000099864;ENSG00000137393;ENSG00000140367;ENSG00000018625;ENSG00000239305;ENSG00000178685;ENSG00000188120;ENSG00000110042;ENSG00000138496;ENSG00000258659	1	610	15714	51	20	559	15694	16324	0.23729607057539992
10	M1	e019_M1	TRUE	7.593280557268458e-8	755	71	20	0.28169014084507044	0.026490066225165563	GO:0000122	GO:BP	negative regulation of transcription by RNA polymerase II	16324	51		NA	0	0.05263157894736842	ENSG00000074219;ENSG00000136014;ENSG00000182568;ENSG00000101115;ENSG00000103449;ENSG00000049768;ENSG00000133937;ENSG00000169856;ENSG00000004700;ENSG00000143190;ENSG00000101126;ENSG00000143614;ENSG00000128573;ENSG00000176692;ENSG00000223775;ENSG00000277936;ENSG00000028277;ENSG00000148229;ENSG00000178409;ENSG00000257923;ENSG00000170608;ENSG00000115350;ENSG00000110344;ENSG00000137166;ENSG00000119042;ENSG00000276644;ENSG00000100479;ENSG00000054598;ENSG00000139910;ENSG00000131668;ENSG00000151503;ENSG00000177485;ENSG00000175470;ENSG00000159184;ENSG00000166439;ENSG00000128652;ENSG00000178919;ENSG00000125798;ENSG00000177084;ENSG00000177125;ENSG00000052850;ENSG00000170122;ENSG00000168255;ENSG00000131778;ENSG00000198597;ENSG00000160877;ENSG00000109101;ENSG00000065970;ENSG00000074410;ENSG00000198604;ENSG00000104953;ENSG00000123364;ENSG00000153560;ENSG00000179361;ENSG00000099331;ENSG00000103067;ENSG00000129911;ENSG00000176165;ENSG00000179772;ENSG00000104447;ENSG00000006377;ENSG00000175745;ENSG00000187140;ENSG00000104967;ENSG00000091656;ENSG00000095564;ENSG00000114861;ENSG00000186766;ENSG00000105880;ENSG00000128714;ENSG00000176678;ENSG00000144355;ENSG00000103241;ENSG00000164778;ENSG00000251493	1	755	15569	20	51	735	15518	16324	0.07409074667272257
11	M1	e019_M1	TRUE	9.18626781240049e-49	141	53	35	0.660377358490566	0.24822695035460993	KEGG:04140	KEGG	Autophagy - animal	8161	272		GO:0006914;GO:0007033;GO:0022607;GO:0022411;GO:0007005;GO:0050789	0	0.015625	ENSG00000104765;ENSG00000164938;ENSG00000106052;ENSG00000184979;ENSG00000078142;ENSG00000196455;ENSG00000230989;ENSG00000057663;ENSG00000145782;ENSG00000197548;ENSG00000152348;ENSG00000188554;ENSG00000157625;ENSG00000150764;ENSG00000035681;ENSG00000123240;ENSG00000034713;ENSG00000120696;ENSG00000023287;ENSG00000083290;ENSG00000175224;ENSG00000145016;ENSG00000126775;ENSG00000157954;ENSG00000205356;ENSG00000144848;ENSG00000011454;ENSG00000101844;ENSG00000170296;ENSG00000213934;ENSG00000168397;ENSG00000177169;ENSG00000165861;ENSG00000078804;ENSG00000148572;ENSG00000163625;ENSG00000139112;ENSG00000104969;ENSG00000123395;ENSG00000197769;ENSG00000130734;ENSG00000085382;ENSG00000154153;ENSG00000147894;ENSG00000119638;ENSG00000069509;ENSG00000155961;ENSG00000217128;ENSG00000121749;ENSG00000108389;ENSG00000163346;ENSG00000104946;ENSG00000168010;ENSG00000265491;ENSG00000132872;ENSG00000110046;ENSG00000164253;ENSG00000176714;ENSG00000222028;ENSG00000130748;ENSG00000103150;ENSG00000163820;ENSG00000104951;ENSG00000276600;ENSG00000172007;ENSG00000066739;ENSG00000118997;ENSG00000237693;ENSG00000070540;ENSG00000206418;ENSG00000060140;ENSG00000178809;ENSG00000274145;ENSG00000174885	1	141	8020	35	18	106	8002	8161	0.39903064943372857
12	M1	e019_M1	TRUE	1.621379323235748e-8	133	69	11	0.15942028985507245	0.08270676691729323	GO:0010466	GO:BP	negative regulation of peptidase activity	16324	4249		GO:0065009;GO:0050789	0	0.04	ENSG00000175206;ENSG00000145632;ENSG00000143387;ENSG00000197641;ENSG00000137033;ENSG00000113889;ENSG00000196415;ENSG00000118898;ENSG00000167880;ENSG00000163207;ENSG00000241973;ENSG00000266412;ENSG00000135047;ENSG00000143631;ENSG00000106538;ENSG00000057149;ENSG00000100448;ENSG00000167996;ENSG00000167748;ENSG00000157349;ENSG00000178363;ENSG00000241794;ENSG00000160213;ENSG00000197249;ENSG00000167914;ENSG00000105141;ENSG00000136155;ENSG00000206073;ENSG00000167131;ENSG00000158691;ENSG00000087086;ENSG00000143320;ENSG00000102309;ENSG00000168878;ENSG00000136943;ENSG00000108602;ENSG00000121552;ENSG00000170373;ENSG00000173080;ENSG00000125245;ENSG00000109861;ENSG00000103811;ENSG00000196743;ENSG00000204710;ENSG00000124429;ENSG00000163131;ENSG00000183479;ENSG00000157869;ENSG00000065833;ENSG00000025708;ENSG00000175315;ENSG00000153303;ENSG00000010438;ENSG00000138722;ENSG00000203782;ENSG00000119616;ENSG00000161905;ENSG00000170426;ENSG00000101439;ENSG00000242252;ENSG00000129451;ENSG00000139146;ENSG00000121903;ENSG00000165799;ENSG00000099953;ENSG00000170367;ENSG00000196344;ENSG00000084110;ENSG00000166396;ENSG00000087299;ENSG00000167799;ENSG00000162877;ENSG00000237114;ENSG00000182583	1	133	16191	11	58	122	16133	16324	0.10963665257885484
13	M1	e019_M1	TRUE	1.5391672641065387e-107	90	69	55	0.7971014492753623	0.6111111111111112	REAC:R-HSA-156902	REAC	Peptide chain elongation	10790	1633		GO:0044085;GO:0006412	0	0.017241379310344827	ENSG00000114391;ENSG00000147604;ENSG00000056586;ENSG00000092847;ENSG00000197756;ENSG00000122026;ENSG00000188846;ENSG00000100316;ENSG00000130255;ENSG00000100749;ENSG00000008988;ENSG00000118181;ENSG00000105372;ENSG00000147403;ENSG00000197958;ENSG00000124614;ENSG00000148303;ENSG00000140988;ENSG00000182899;ENSG00000156482;ENSG00000134419;ENSG00000168028;ENSG00000126001;ENSG00000174748;ENSG00000071082;ENSG00000143947;ENSG00000177600;ENSG00000156508;ENSG00000131469;ENSG00000135473;ENSG00000137818;ENSG00000116251;ENSG00000167526;ENSG00000135870;ENSG00000198034;ENSG00000185088;ENSG00000165496;ENSG00000198755;ENSG00000171863;ENSG00000112306;ENSG00000142676;ENSG00000102178;ENSG00000083845;ENSG00000175634;ENSG00000105640;ENSG00000161016;ENSG00000121060;ENSG00000198242;ENSG00000136942;ENSG00000162244;ENSG00000140986;ENSG00000165140;ENSG00000123908;ENSG00000163682;ENSG00000172809;ENSG00000189403;ENSG00000177954;ENSG00000197728;ENSG00000145425;ENSG00000254647;ENSG00000084093;ENSG00000006062;ENSG00000174720;ENSG00000109475;ENSG00000186468;ENSG00000166441;ENSG00000142534;ENSG00000177479;ENSG00000089157;ENSG00000149273;ENSG00000174444;ENSG00000142541	1	90	10700	55	14	35	10686	10790	0.6957613392955557
14	M1	e019_M1	TRUE	1.4237342006788436e-13	8	54	7	0.12962962962962962	0.875	REAC:R-HSA-5632681	REAC	Ligand-receptor interactions	10790	1253		GO:0050789;GO:0009059;GO:0019538	0	0.023255813953488372	ENSG00000118257;ENSG00000185920;ENSG00000144857;ENSG00000064309;ENSG00000153283;ENSG00000077943;ENSG00000139549;ENSG00000163501;ENSG00000164161;ENSG00000119630;ENSG00000117425;ENSG00000164690;ENSG00000100077;ENSG00000136156;ENSG00000106080;ENSG00000117090;ENSG00000068001;ENSG00000083857;ENSG00000114200;ENSG00000136213;ENSG00000168079;ENSG00000169604;ENSG00000092421;ENSG00000135622;ENSG00000138759;ENSG00000196968;ENSG00000102125;ENSG00000163898;ENSG00000010404;ENSG00000110328;ENSG00000169919;ENSG00000187097;ENSG00000171124;ENSG00000114554;ENSG00000076356;ENSG00000137872;ENSG00000141096;ENSG00000197594;ENSG00000104331;ENSG00000079931;ENSG00000115828;ENSG00000152894;ENSG00000164199;ENSG00000158966;ENSG00000109667;ENSG00000134249;ENSG00000153956;ENSG00000143502;ENSG00000124490;ENSG00000167261;ENSG00000122863;ENSG00000187676;ENSG00000178700;ENSG00000106714;ENSG00000168743;ENSG00000113532;ENSG00000110080;ENSG00000064225;ENSG00000120256;ENSG00000070614;ENSG00000033100;ENSG00000007402;ENSG00000166507;ENSG00000063180;ENSG00000135454;ENSG00000185090;ENSG00000169105;ENSG00000122254;ENSG00000104499	1	8	10782	7	47	1	10735	10790	0.33582697886761287
15	M1	e019_M1	TRUE	2.134411951435353e-42	165	61	33	0.5409836065573771	0.2	REAC:R-HSA-168898	REAC	Toll-like Receptor Cascades	10790	2389		GO:0002376;GO:0065009;GO:0001816;GO:0050896;GO:0050789;GO:0044419	0	0.004	ENSG00000172936;ENSG00000184216;ENSG00000135960;ENSG00000131080;ENSG00000129465;ENSG00000134070;ENSG00000115602;ENSG00000136697;ENSG00000137462;ENSG00000174125;ENSG00000174130;ENSG00000136869;ENSG00000154589;ENSG00000131323;ENSG00000136634;ENSG00000196083;ENSG00000112799;ENSG00000115594;ENSG00000136689;ENSG00000168040;ENSG00000150455;ENSG00000078902;ENSG00000122852;ENSG00000115008;ENSG00000104312;ENSG00000127666;ENSG00000164342;ENSG00000125538;ENSG00000003402;ENSG00000170458;ENSG00000198001;ENSG00000197329;ENSG00000144589;ENSG00000124602;ENSG00000128604;ENSG00000239732;ENSG00000187554;ENSG00000234729;ENSG00000180549;ENSG00000185507;ENSG00000174123;ENSG00000174516;ENSG00000102076;ENSG00000134970;ENSG00000243414;ENSG00000090376;ENSG00000086991;ENSG00000105501;ENSG00000168995;ENSG00000139946;ENSG00000185187;ENSG00000004139;ENSG00000196664;ENSG00000105492;ENSG00000101916;ENSG00000185303;ENSG00000038945;ENSG00000142512;ENSG00000133661;ENSG00000129450;ENSG00000187908;ENSG00000176641;ENSG00000188386;ENSG00000011275;ENSG00000155629;ENSG00000161640;ENSG00000255690;ENSG00000162722;ENSG00000162496	1	165	10625	33	28	132	10597	10790	0.323021472884966
16	M1	e019_M1	TRUE	5.460639800053306e-24	39	64	15	0.234375	0.38461538461538464	GO:0140467	GO:BP	integrated stress response signaling	16324	20877		GO:0050896	0	0.0625	ENSG00000156273;ENSG00000198517;ENSG00000119772;ENSG00000142182;ENSG00000125740;ENSG00000130522;ENSG00000157557;ENSG00000128272;ENSG00000162772;ENSG00000173334;ENSG00000092067;ENSG00000095794;ENSG00000175592;ENSG00000075426;ENSG00000171223;ENSG00000066336;ENSG00000105698;ENSG00000197063;ENSG00000169136;ENSG00000178573;ENSG00000140044;ENSG00000244405;ENSG00000116044;ENSG00000221869;ENSG00000170634;ENSG00000123268;ENSG00000137504;ENSG00000120690;ENSG00000006468;ENSG00000153879;ENSG00000118922;ENSG00000123405;ENSG00000165325;ENSG00000197757;ENSG00000168062;ENSG00000196182;ENSG00000170653;ENSG00000071575;ENSG00000185022;ENSG00000012822;ENSG00000176009;ENSG00000175197;ENSG00000156127;ENSG00000123685;ENSG00000198939;ENSG00000167074;ENSG00000165583;ENSG00000165030;ENSG00000106004;ENSG00000108924;ENSG00000079393;ENSG00000100429;ENSG00000105516;ENSG00000188676;ENSG00000082641;ENSG00000050344;ENSG00000170178;ENSG00000213523;ENSG00000116132;ENSG00000168454;ENSG00000143578;ENSG00000171617;ENSG00000242441;ENSG00000111269;ENSG00000124177;ENSG00000140543;ENSG00000135164;ENSG00000188636	1	39	16285	15	49	24	16236	16324	0.29812038192604146
17	M1	e019_M1	TRUE	6.562322816699484e-30	57	63	19	0.30158730158730157	0.3333333333333333	GO:0043967	GO:BP	histone H4 acetylation	16324	11489		GO:0036211	0	0.02564102564102564	ENSG00000116017;ENSG00000127337;ENSG00000204060;ENSG00000083168;ENSG00000172262;ENSG00000198026;ENSG00000048649;ENSG00000136504;ENSG00000071243;ENSG00000185787;ENSG00000120616;ENSG00000178028;ENSG00000166483;ENSG00000080603;ENSG00000135999;ENSG00000015171;ENSG00000162702;ENSG00000183495;ENSG00000123562;ENSG00000163159;ENSG00000112983;ENSG00000160685;ENSG00000153814;ENSG00000163875;ENSG00000176953;ENSG00000111653;ENSG00000168795;ENSG00000043143;ENSG00000077684;ENSG00000158636;ENSG00000167395;ENSG00000163848;ENSG00000102221;ENSG00000168395;ENSG00000075089;ENSG00000101189;ENSG00000184515;ENSG00000096070;ENSG00000166833;ENSG00000129534;ENSG00000172273;ENSG00000273274;ENSG00000176302;ENSG00000197213;ENSG00000127528;ENSG00000136144;ENSG00000158805;ENSG00000123485;ENSG00000011258;ENSG00000157259;ENSG00000116539;ENSG00000103485;ENSG00000109118;ENSG00000075151;ENSG00000156983;ENSG00000188994;ENSG00000075336;ENSG00000116990;ENSG00000189299;ENSG00000187003;ENSG00000073614;ENSG00000135838;ENSG00000138688;ENSG00000149308;ENSG00000187118;ENSG00000246705;ENSG00000162437;ENSG00000170965	1	57	16267	19	44	38	16223	16324	0.31454842134340083
19	M1	e019_M1	TRUE	1.32973956949093e-5	311	57	11	0.19298245614035087	0.03536977491961415	GO:0043087	GO:BP	regulation of GTPase activity	16324	11102		GO:0065009	0	0.1111111111111111	ENSG00000163629;ENSG00000158402;ENSG00000148384;ENSG00000100211;ENSG00000141068;ENSG00000130396;ENSG00000196712;ENSG00000197892;ENSG00000061273;ENSG00000101224;ENSG00000075391;ENSG00000119487;ENSG00000158578;ENSG00000135930;ENSG00000075292;ENSG00000197555;ENSG00000156299;ENSG00000107957;ENSG00000166689;ENSG00000107560;ENSG00000136636;ENSG00000137145;ENSG00000174485;ENSG00000116191;ENSG00000125779;ENSG00000128011;ENSG00000165304;ENSG00000105137;ENSG00000127328;ENSG00000144824;ENSG00000134504;ENSG00000153885;ENSG00000173276;ENSG00000111110;ENSG00000100139;ENSG00000068354;ENSG00000008130;ENSG00000118200;ENSG00000132793;ENSG00000157985;ENSG00000134369;ENSG00000119522;ENSG00000129250;ENSG00000179151;ENSG00000035499;ENSG00000133083;ENSG00000070759;ENSG00000169122;ENSG00000154548;ENSG00000266028;ENSG00000133121;ENSG00000272031;ENSG00000143375;ENSG00000221995;ENSG00000188343;ENSG00000101577;ENSG00000134940;ENSG00000165476;ENSG00000140577;ENSG00000180263;ENSG00000100403;ENSG00000160469;ENSG00000164855;ENSG00000102349	1	311	16013	11	46	300	15967	16324	0.07531302847637916
20	M1	e019_M1	TRUE	1.5935218848919736e-96	291	64	59	0.921875	0.2027491408934708	GO:0000375	GO:BP	RNA splicing, via transesterification reactions	16324	112		GO:0000375	0	0.02564102564102564	ENSG00000116752;ENSG00000177463;ENSG00000169976;ENSG00000125870;ENSG00000143368;ENSG00000096401;ENSG00000125743;ENSG00000189091;ENSG00000117360;ENSG00000101161;ENSG00000060688;ENSG00000076924;ENSG00000158545;ENSG00000131876;ENSG00000168883;ENSG00000084072;ENSG00000108883;ENSG00000104897;ENSG00000100813;ENSG00000115128;ENSG00000178691;ENSG00000112739;ENSG00000182004;ENSG00000101343;ENSG00000100941;ENSG00000143977;ENSG00000136875;ENSG00000196504;ENSG00000144028;ENSG00000131051;ENSG00000168438;ENSG00000100028;ENSG00000109606;ENSG00000174243;ENSG00000130520;ENSG00000139343;ENSG00000067596;ENSG00000077312;ENSG00000110107;ENSG00000163877;ENSG00000120688;ENSG00000086589;ENSG00000167088;ENSG00000183431;ENSG00000119953;ENSG00000100603;ENSG00000115524;ENSG00000167978;ENSG00000159140;ENSG00000240682;ENSG00000099995;ENSG00000169217;ENSG00000021776;ENSG00000124562;ENSG00000141543;ENSG00000171566;ENSG00000087365;ENSG00000100410;ENSG00000125835;ENSG00000133226;ENSG00000175467;ENSG00000124006;ENSG00000128739;ENSG00000162385	1	291	16033	59	5	232	16028	16324	0.4286414203321861
21	M1	e019_M1	TRUE	1.0978881220095002e-43	643	61	43	0.7049180327868853	0.06687402799377916	GO:0030036	GO:BP	actin cytoskeleton organization	16324	7022		GO:0065008;GO:0051261;GO:0050789;GO:0006996	0	0.008771929824561403	ENSG00000114346;ENSG00000077549;ENSG00000058272;ENSG00000072110;ENSG00000118193;ENSG00000171992;ENSG00000163466;ENSG00000128833;ENSG00000039560;ENSG00000092841;ENSG00000050405;ENSG00000197321;ENSG00000075624;ENSG00000162946;ENSG00000140575;ENSG00000130402;ENSG00000241553;ENSG00000178209;ENSG00000085733;ENSG00000198898;ENSG00000172531;ENSG00000165410;ENSG00000035403;ENSG00000136068;ENSG00000151914;ENSG00000135269;ENSG00000157483;ENSG00000198467;ENSG00000184009;ENSG00000196924;ENSG00000039068;ENSG00000133030;ENSG00000196923;ENSG00000116489;ENSG00000136807;ENSG00000167460;ENSG00000143632;ENSG00000213639;ENSG00000113758;ENSG00000148180;ENSG00000131171;ENSG00000143549;ENSG00000197694;ENSG00000100345;ENSG00000140416;ENSG00000159251;ENSG00000111229;ENSG00000172725;ENSG00000173898;ENSG00000196535;ENSG00000100014;ENSG00000115306;ENSG00000138760;ENSG00000128641;ENSG00000011426;ENSG00000130429;ENSG00000138071;ENSG00000001626;ENSG00000101367;ENSG00000123374;ENSG00000138594;ENSG00000197879;ENSG00000115091	1	643	15681	43	18	600	15663	16324	0.20953918782181158
22	M1	e019_M1	TRUE	4.27144066262509e-61	752	62	54	0.8709677419354839	0.07180851063829788	GO:0007186	GO:BP	G protein-coupled receptor signaling pathway	16324	2809		GO:0065009;GO:0050789;GO:0007154;GO:0050896	0	0.008771929824561403	ENSG00000166260;ENSG00000117152;ENSG00000169220;ENSG00000182901;ENSG00000180739;ENSG00000160360;ENSG00000118432;ENSG00000114353;ENSG00000139874;ENSG00000125510;ENSG00000165409;ENSG00000127074;ENSG00000214415;ENSG00000065135;ENSG00000121764;ENSG00000108551;ENSG00000121853;ENSG00000150594;ENSG00000143248;ENSG00000134489;ENSG00000148908;ENSG00000180914;ENSG00000163485;ENSG00000116329;ENSG00000123901;ENSG00000087460;ENSG00000081087;ENSG00000171700;ENSG00000002586;ENSG00000128271;ENSG00000180616;ENSG00000130643;ENSG00000087258;ENSG00000162009;ENSG00000164742;ENSG00000150681;ENSG00000078295;ENSG00000187513;ENSG00000143333;ENSG00000113262;ENSG00000128266;ENSG00000241563;ENSG00000149295;ENSG00000127955;ENSG00000151577;ENSG00000091844;ENSG00000134640;ENSG00000169403;ENSG00000138835;ENSG00000184845;ENSG00000147509;ENSG00000006007;ENSG00000082556;ENSG00000168412;ENSG00000159788;ENSG00000078549;ENSG00000120324;ENSG00000173175;ENSG00000179242;ENSG00000157005;ENSG00000090104;ENSG00000101180;ENSG00000132671	1	752	15572	54	8	698	15564	16324	0.24297184693759033
23	M1	e019_M1	TRUE	9.352793599227674e-36	64	39	21	0.5384615384615384	0.328125	REAC:R-HSA-8873719	REAC	RAB geranylgeranylation	10790	1743		GO:0016192;GO:0051640;GO:0015031;GO:0046903;GO:0022406;GO:0050789	0	0.015151515151515152	ENSG00000137955;ENSG00000115839;ENSG00000118873;ENSG00000142765;ENSG00000008294;ENSG00000079841;ENSG00000198722;ENSG00000122188;ENSG00000135631;ENSG00000196975;ENSG00000138834;ENSG00000167306;ENSG00000057608;ENSG00000130005;ENSG00000069974;ENSG00000102362;ENSG00000167994;ENSG00000143545;ENSG00000150977;ENSG00000167461;ENSG00000136925;ENSG00000175137;ENSG00000185236;ENSG00000119396;ENSG00000041353;ENSG00000147041;ENSG00000089169;ENSG00000092871;ENSG00000115648;ENSG00000203879;ENSG00000083635;ENSG00000117174;ENSG00000188419;ENSG00000179331;ENSG00000105649;ENSG00000105514;ENSG00000067208;ENSG00000111540;ENSG00000084733;ENSG00000198832;ENSG00000104093;ENSG00000118508;ENSG00000149927;ENSG00000137501;ENSG00000068383;ENSG00000170011;ENSG00000138771;ENSG00000124209;ENSG00000168461;ENSG00000092929;ENSG00000154803;ENSG00000164674;ENSG00000132698;ENSG00000169228;ENSG00000110723;ENSG00000166128;ENSG00000169213;ENSG00000156675;ENSG00000170113;ENSG00000166965;ENSG00000203668;ENSG00000272636	1	64	10726	21	18	43	10708	10790	0.417700130484981
24	M1	e019_M1	TRUE	2.220300003165319e-24	67	61	17	0.2786885245901639	0.2537313432835821	GO:2000628	GO:BP	regulation of miRNA metabolic process	16324	27188		GO:0048511;GO:0032502;GO:0006351;GO:0065009;GO:0050896;GO:0050789;GO:0036211	0	0.002232142857142857	ENSG00000142453;ENSG00000135679;ENSG00000105229;ENSG00000064393;ENSG00000131759;ENSG00000170345;ENSG00000134954;ENSG00000102554;ENSG00000141510;ENSG00000123358;ENSG00000172216;ENSG00000107643;ENSG00000100393;ENSG00000103275;ENSG00000091831;ENSG00000078900;ENSG00000169083;ENSG00000150907;ENSG00000101412;ENSG00000143799;ENSG00000132170;ENSG00000120738;ENSG00000131196;ENSG00000137203;ENSG00000171720;ENSG00000127445;ENSG00000168036;ENSG00000082701;ENSG00000159216;ENSG00000118260;ENSG00000245848;ENSG00000140464;ENSG00000124762;ENSG00000141027;ENSG00000100644;ENSG00000115415;ENSG00000172977;ENSG00000115966;ENSG00000114166;ENSG00000177606;ENSG00000109320;ENSG00000196498;ENSG00000166949;ENSG00000096717;ENSG00000100030;ENSG00000173039;ENSG00000185591;ENSG00000005339;ENSG00000139687;ENSG00000112062;ENSG00000116030;ENSG00000068024;ENSG00000033800;ENSG00000073282;ENSG00000116478;ENSG00000110092;ENSG00000141646;ENSG00000124151;ENSG00000113580;ENSG00000124813;ENSG00000175387	1	67	16257	17	44	50	16213	16324	0.26303225887487497
25	M1	e019_M1	TRUE	2.5232216347150495e-80	50	58	38	0.6551724137931034	0.76	REAC:R-HSA-211733	REAC	Regulation of activated PAK-2p34 by proteasome mediated degradation	10790	1910		GO:0009057;GO:0050789;GO:0006508	0	0.005847953216374269	ENSG00000131467;ENSG00000188021;ENSG00000106588;ENSG00000114062;ENSG00000197170;ENSG00000130706;ENSG00000175166;ENSG00000108671;ENSG00000119318;ENSG00000013275;ENSG00000126067;ENSG00000116688;ENSG00000154611;ENSG00000185627;ENSG00000151929;ENSG00000165916;ENSG00000197386;ENSG00000142507;ENSG00000159352;ENSG00000095261;ENSG00000103035;ENSG00000100804;ENSG00000143106;ENSG00000099341;ENSG00000110801;ENSG00000008018;ENSG00000101843;ENSG00000161057;ENSG00000100225;ENSG00000164944;ENSG00000007171;ENSG00000179262;ENSG00000100519;ENSG00000101182;ENSG00000092010;ENSG00000160803;ENSG00000129084;ENSG00000108344;ENSG00000136930;ENSG00000136813;ENSG00000159377;ENSG00000110497;ENSG00000173692;ENSG00000116750;ENSG00000185345;ENSG00000091164;ENSG00000041357;ENSG00000175354;ENSG00000101557;ENSG00000100902;ENSG00000100567;ENSG00000100764;ENSG00000127922;ENSG00000115233;ENSG00000069956;ENSG00000135018;ENSG00000066427;ENSG00000087191;ENSG00000163636;ENSG00000150991;ENSG00000086758	1	50	10740	38	20	12	10720	10790	0.7041755898458606
26	M1	e019_M1	TRUE	4.0534030752379057e-17	567	52	23	0.4423076923076923	0.04056437389770723	GO:1901137	GO:BP	carbohydrate derivative biosynthetic process	16324	22201		GO:0036211;GO:0009059	0	0.041666666666666664	ENSG00000196547;ENSG00000186452;ENSG00000118017;ENSG00000156162;ENSG00000165905;ENSG00000203618;ENSG00000185873;ENSG00000009830;ENSG00000119946;ENSG00000153029;ENSG00000176142;ENSG00000154889;ENSG00000157315;ENSG00000146453;ENSG00000170340;ENSG00000174607;ENSG00000033170;ENSG00000165282;ENSG00000197121;ENSG00000129925;ENSG00000012232;ENSG00000154529;ENSG00000101892;ENSG00000112303;ENSG00000115652;ENSG00000105668;ENSG00000169490;ENSG00000064763;ENSG00000148841;ENSG00000144959;ENSG00000152661;ENSG00000100258;ENSG00000158488;ENSG00000131446;ENSG00000135424;ENSG00000182197;ENSG00000102287;ENSG00000186919;ENSG00000101846;ENSG00000135902;ENSG00000130714;ENSG00000170088;ENSG00000103978;ENSG00000027847;ENSG00000147804;ENSG00000174684;ENSG00000149577;ENSG00000171551;ENSG00000154511;ENSG00000184005;ENSG00000178084;ENSG00000181027;ENSG00000121361;ENSG00000105696;ENSG00000104723;ENSG00000180340;ENSG00000143315;ENSG00000166736;ENSG00000139324;ENSG00000086848;ENSG00000198689	1	567	15757	23	29	544	15728	16324	0.12583037601988015
27	M1	e019_M1	TRUE	1.4572024104409504e-50	97	35	28	0.8	0.28865979381443296	REAC:R-HSA-5620912	REAC	Anchoring of the basal body to the plasma membrane	10790	141		GO:0006996;GO:0022607;GO:0031023	0	0.015384615384615385	ENSG00000051825;ENSG00000079335;ENSG00000100503;ENSG00000046651;ENSG00000103540;ENSG00000103494;ENSG00000104218;ENSG00000112742;ENSG00000152359;ENSG00000130559;ENSG00000119685;ENSG00000213066;ENSG00000141577;ENSG00000104983;ENSG00000142731;ENSG00000182504;ENSG00000147874;ENSG00000100629;ENSG00000119397;ENSG00000120647;ENSG00000156787;ENSG00000151849;ENSG00000160299;ENSG00000174799;ENSG00000182923;ENSG00000076382;ENSG00000121289;ENSG00000129680;ENSG00000137821;ENSG00000092020;ENSG00000213397;ENSG00000138180;ENSG00000137814;ENSG00000078674;ENSG00000198707;ENSG00000135315;ENSG00000139437;ENSG00000141933;ENSG00000214367;ENSG00000131351;ENSG00000136146;ENSG00000168014;ENSG00000132958;ENSG00000112877;ENSG00000135837;ENSG00000136811;ENSG00000136108;ENSG00000092036;ENSG00000198920;ENSG00000175455;ENSG00000164118;ENSG00000103995;ENSG00000083535;ENSG00000116213;ENSG00000163611;ENSG00000156876;ENSG00000116198;ENSG00000168944;ENSG00000249115;ENSG00000152240;ENSG00000101752	1	97	10693	28	7	69	10686	10790	0.47807572214498173
28	M1	e019_M1	TRUE	1.1378230647681908e-14	130	23	12	0.5217391304347826	0.09230769230769231	KEGG:05322	KEGG	Systemic lupus erythematosus	8161	477		GO:0065003	0	0.01020408163265306	ENSG00000197724;ENSG00000158711;ENSG00000198830;ENSG00000114841;ENSG00000144331;ENSG00000158373;ENSG00000274997;ENSG00000168148;ENSG00000177257;ENSG00000273703;ENSG00000275713;ENSG00000123636;ENSG00000203814;ENSG00000205581;ENSG00000155666;ENSG00000196569;ENSG00000059122;ENSG00000183598;ENSG00000198160;ENSG00000234289;ENSG00000168907;ENSG00000146192;ENSG00000276368;ENSG00000176208;ENSG00000158234;ENSG00000170370;ENSG00000185250;ENSG00000186862;ENSG00000136383;ENSG00000226650;ENSG00000134897;ENSG00000117859;ENSG00000118418;ENSG00000185130;ENSG00000105968;ENSG00000197763;ENSG00000161914;ENSG00000225614;ENSG00000129566;ENSG00000114670;ENSG00000225989;ENSG00000170234;ENSG00000149596;ENSG00000095321;ENSG00000197653;ENSG00000154222;ENSG00000179751;ENSG00000176542;ENSG00000151474;ENSG00000251192;ENSG00000198858;ENSG00000204490;ENSG00000102699;ENSG00000131055;ENSG00000250312;ENSG00000147488;ENSG00000226618;ENSG00000196866;ENSG00000273213	1	130	8031	12	11	118	8020	8161	0.21477272440873324
29	M1	e019_M1	TRUE	3.14288538373793e-21	64	43	15	0.3488372093023256	0.234375	REAC:R-HSA-421270	REAC	Cell-cell junction organization	10790	317		GO:0032501;GO:0007155;GO:0022607	0	0.020833333333333332	ENSG00000120509;ENSG00000104067;ENSG00000110400;ENSG00000177707;ENSG00000143217;ENSG00000130202;ENSG00000162706;ENSG00000182985;ENSG00000109943;ENSG00000150637;ENSG00000154721;ENSG00000166086;ENSG00000119139;ENSG00000164220;ENSG00000158769;ENSG00000163347;ENSG00000127533;ENSG00000115109;ENSG00000181847;ENSG00000113645;ENSG00000132849;ENSG00000178184;ENSG00000073350;ENSG00000114019;ENSG00000184697;ENSG00000107186;ENSG00000184166;ENSG00000118518;ENSG00000118900;ENSG00000143028;ENSG00000165376;ENSG00000183153;ENSG00000161091;ENSG00000105289;ENSG00000216490;ENSG00000278195;ENSG00000181418;ENSG00000165215;ENSG00000279486;ENSG00000134376;ENSG00000131899;ENSG00000138375;ENSG00000113946;ENSG00000126562;ENSG00000184292;ENSG00000180432;ENSG00000148204;ENSG00000095203;ENSG00000274641;ENSG00000148498;ENSG00000180090;ENSG00000135709;ENSG00000121743;ENSG00000114541;ENSG00000106086;ENSG00000120539;ENSG00000162949;ENSG00000176782	1	64	10726	15	28	49	10698	10790	0.2824736779367126
30	M1	e019_M1	TRUE	3.558179511642566e-9	449	38	15	0.39473684210526316	0.0334075723830735	REAC:R-HSA-9012999	REAC	RHO GTPase cycle	10790	1755		GO:0048285;GO:0007005	0	0.1111111111111111	ENSG00000106636;ENSG00000054654;ENSG00000126777;ENSG00000105701;ENSG00000138073;ENSG00000072210;ENSG00000141378;ENSG00000008952;ENSG00000109689;ENSG00000204977;ENSG00000107897;ENSG00000028116;ENSG00000147383;ENSG00000167323;ENSG00000204178;ENSG00000090615;ENSG00000196396;ENSG00000102531;ENSG00000169359;ENSG00000092108;ENSG00000136026;ENSG00000004866;ENSG00000066855;ENSG00000173230;ENSG00000041802;ENSG00000104369;ENSG00000144468;ENSG00000136478;ENSG00000143337;ENSG00000146842;ENSG00000144224;ENSG00000115504;ENSG00000198060;ENSG00000173218;ENSG00000164209;ENSG00000198513;ENSG00000147526;ENSG00000172071;ENSG00000136699;ENSG00000182934;ENSG00000198171;ENSG00000162738;ENSG00000129667;ENSG00000203485;ENSG00000164615;ENSG00000173040;ENSG00000121057;ENSG00000154305;ENSG00000137824;ENSG00000140983;ENSG00000182827;ENSG00000170632;ENSG00000164828;ENSG00000121940;ENSG00000176915;ENSG00000214253;ENSG00000145569;ENSG00000198814	1	449	10341	15	23	434	10318	10790	0.10512153729757771
31	M1	e019_M1	TRUE	5.891623666546875e-103	158	57	53	0.9298245614035088	0.33544303797468356	GO:0140053	GO:BP	mitochondrial gene expression	16324	20737		GO:0006412	0	0.07142857142857142	ENSG00000243147;ENSG00000108826;ENSG00000149792;ENSG00000167862;ENSG00000143436;ENSG00000185414;ENSG00000180992;ENSG00000130349;ENSG00000159111;ENSG00000112996;ENSG00000137547;ENSG00000136270;ENSG00000156928;ENSG00000165792;ENSG00000116221;ENSG00000128626;ENSG00000086504;ENSG00000166902;ENSG00000173141;ENSG00000106028;ENSG00000198015;ENSG00000112651;ENSG00000106591;ENSG00000055950;ENSG00000115364;ENSG00000154719;ENSG00000204316;ENSG00000179271;ENSG00000171861;ENSG00000262814;ENSG00000082515;ENSG00000105364;ENSG00000148824;ENSG00000182154;ENSG00000132313;ENSG00000197345;ENSG00000172590;ENSG00000172172;ENSG00000143314;ENSG00000182768;ENSG00000185608;ENSG00000111639;ENSG00000130312;ENSG00000162910;ENSG00000146701;ENSG00000174547;ENSG00000123297;ENSG00000158042;ENSG00000136897;ENSG00000169288;ENSG00000112110;ENSG00000178952;ENSG00000242485;ENSG00000204822;ENSG00000114686;ENSG00000175581;ENSG00000096080	1	158	16166	53	4	105	16162	16324	0.5563357715162348
32	M1	e019_M1	TRUE	7.896355056861457e-17	9	51	8	0.1568627450980392	0.8888888888888888	GO:0090522	GO:BP	vesicle tethering involved in exocytosis	16324	19367		GO:0022406;GO:0016192;GO:0061024;GO:0051640	0	0.024390243902439025	ENSG00000172270;ENSG00000148343;ENSG00000180488;ENSG00000136160;ENSG00000115590;ENSG00000131558;ENSG00000180104;ENSG00000182473;ENSG00000132437;ENSG00000144118;ENSG00000135480;ENSG00000006451;ENSG00000112685;ENSG00000120217;ENSG00000134452;ENSG00000180720;ENSG00000099875;ENSG00000197535;ENSG00000070367;ENSG00000138399;ENSG00000138131;ENSG00000090989;ENSG00000168434;ENSG00000032389;ENSG00000104341;ENSG00000138190;ENSG00000169180;ENSG00000116906;ENSG00000103051;ENSG00000135775;ENSG00000198862;ENSG00000136152;ENSG00000213380;ENSG00000144036;ENSG00000163507;ENSG00000115361;ENSG00000205359;ENSG00000179213;ENSG00000166685;ENSG00000059588;ENSG00000130787;ENSG00000168679;ENSG00000196376;ENSG00000119283;ENSG00000164597;ENSG00000118298;ENSG00000185149;ENSG00000123576;ENSG00000165644;ENSG00000188352;ENSG00000108599;ENSG00000155287;ENSG00000159496;ENSG00000149575;ENSG00000019102;ENSG00000164659	1	9	16315	8	43	1	16272	16324	0.3727809817839505
33	M1	e019_M1	TRUE	8.360397440867165e-33	39	54	18	0.3333333333333333	0.46153846153846156	GO:0007007	GO:BP	inner mitochondrial membrane organization	16324	2678		GO:0061024;GO:0015031;GO:0007005	0	0.017857142857142856	ENSG00000115159;ENSG00000132305;ENSG00000115317;ENSG00000099800;ENSG00000126953;ENSG00000184903;ENSG00000168275;ENSG00000162600;ENSG00000148950;ENSG00000100575;ENSG00000167136;ENSG00000113845;ENSG00000011295;ENSG00000184831;ENSG00000135940;ENSG00000131143;ENSG00000198836;ENSG00000141385;ENSG00000164466;ENSG00000165487;ENSG00000150779;ENSG00000080819;ENSG00000154174;ENSG00000106554;ENSG00000135093;ENSG00000156709;ENSG00000184047;ENSG00000182134;ENSG00000174917;ENSG00000126267;ENSG00000175193;ENSG00000004864;ENSG00000088888;ENSG00000007923;ENSG00000107020;ENSG00000155008;ENSG00000100347;ENSG00000115840;ENSG00000136758;ENSG00000134809;ENSG00000107745;ENSG00000109180;ENSG00000128654;ENSG00000173726;ENSG00000103642;ENSG00000137409;ENSG00000177034;ENSG00000004961;ENSG00000178449;ENSG00000133028;ENSG00000035141;ENSG00000014919;ENSG00000122696;ENSG00000122873;ENSG00000178741;ENSG00000173171	1	39	16285	18	36	21	16249	16324	0.39053350202122955
34	M1	e019_M1	TRUE	1.9272601640779954e-4	4	50	3	0.06	0.75	GO:0006556	GO:BP	S-adenosylmethionine biosynthetic process	16324	2330		GO:0006790	0	0.1	ENSG00000179588;ENSG00000160049;ENSG00000073712;ENSG00000162458;ENSG00000144744;ENSG00000159593;ENSG00000038274;ENSG00000168906;ENSG00000007168;ENSG00000146070;ENSG00000126247;ENSG00000162909;ENSG00000079462;ENSG00000173812;ENSG00000173674;ENSG00000100664;ENSG00000168092;ENSG00000247596;ENSG00000138363;ENSG00000138629;ENSG00000256812;ENSG00000154814;ENSG00000198692;ENSG00000147687;ENSG00000184203;ENSG00000081721;ENSG00000154027;ENSG00000106682;ENSG00000068079;ENSG00000138801;ENSG00000109814;ENSG00000163219;ENSG00000241484;ENSG00000142973;ENSG00000070669;ENSG00000066583;ENSG00000023318;ENSG00000178921;ENSG00000011347;ENSG00000100983;ENSG00000112699;ENSG00000151224;ENSG00000110921;ENSG00000137509;ENSG00000105254;ENSG00000141452;ENSG00000131069;ENSG00000184465;ENSG00000139344;ENSG00000121064;ENSG00000147471;ENSG00000122735;ENSG00000064666;ENSG00000141371;ENSG00000198812	1	4	16320	3	47	1	16273	16324	0.21161591874130672
35	M1	e019_M1	TRUE	1.5127420192193656e-33	237	51	27	0.5294117647058824	0.11392405063291139	GO:0016197	GO:BP	endosomal transport	16324	5293		GO:0051641;GO:0016192;GO:0006914	0	0.037037037037037035	ENSG00000211460;ENSG00000166166;ENSG00000028528;ENSG00000205302;ENSG00000177425;ENSG00000114520;ENSG00000129515;ENSG00000069329;ENSG00000130165;ENSG00000185722;ENSG00000164062;ENSG00000111237;ENSG00000090432;ENSG00000110047;ENSG00000131381;ENSG00000188493;ENSG00000172803;ENSG00000188732;ENSG00000159210;ENSG00000131475;ENSG00000131374;ENSG00000145362;ENSG00000136830;ENSG00000162639;ENSG00000136631;ENSG00000103966;ENSG00000089006;ENSG00000221978;ENSG00000122958;ENSG00000013016;ENSG00000024422;ENSG00000049283;ENSG00000116205;ENSG00000143401;ENSG00000184307;ENSG00000176108;ENSG00000187954;ENSG00000145214;ENSG00000136100;ENSG00000161594;ENSG00000110911;ENSG00000148158;ENSG00000085449;ENSG00000105186;ENSG00000119321;ENSG00000100170;ENSG00000151502;ENSG00000135297;ENSG00000164961;ENSG00000172661;ENSG00000099290;ENSG00000136051;ENSG00000176974;ENSG00000134183;ENSG00000103245	1	237	16087	27	24	210	16063	16324	0.24098131425342306
36	M1	e019_M1	TRUE	4.8224079099168247e-14	9	38	7	0.18421052631578946	0.7777777777777778	REAC:R-HSA-164940	REAC	Nef mediated downregulation of MHC class I complex cell surface expression	10790	1479		GO:0016192;GO:0048753;GO:0043473;GO:0046903;GO:0015031	0	0.023809523809523808	ENSG00000101199;ENSG00000187957;ENSG00000139436;ENSG00000182287;ENSG00000100280;ENSG00000143761;ENSG00000168286;ENSG00000010327;ENSG00000100083;ENSG00000166963;ENSG00000089818;ENSG00000129354;ENSG00000006837;ENSG00000154710;ENSG00000029725;ENSG00000103365;ENSG00000149823;ENSG00000125447;ENSG00000152061;ENSG00000135365;ENSG00000182240;ENSG00000008869;ENSG00000242247;ENSG00000272325;ENSG00000143367;ENSG00000160447;ENSG00000065609;ENSG00000175115;ENSG00000166747;ENSG00000182551;ENSG00000123106;ENSG00000003056;ENSG00000137177;ENSG00000141252;ENSG00000168118;ENSG00000103591;ENSG00000134287;ENSG00000177548;ENSG00000106367;ENSG00000138660;ENSG00000124313;ENSG00000166796;ENSG00000152056;ENSG00000004059;ENSG00000157191;ENSG00000213983;ENSG00000112210;ENSG00000149182;ENSG00000159713;ENSG00000119844;ENSG00000101246;ENSG00000156011;ENSG00000117308;ENSG00000186603;ENSG00000124772	1	9	10781	7	31	2	10750	10790	0.37762551350594903
37	M1	e019_M1	TRUE	2.6890864090620454e-36	107	53	24	0.4528301886792453	0.22429906542056074	GO:0036503	GO:BP	ERAD pathway	16324	10171		GO:0009057;GO:0015031;GO:0006508;GO:0050896	0	0.016129032258064516	ENSG00000068912;ENSG00000135506;ENSG00000084674;ENSG00000170881;ENSG00000051108;ENSG00000164897;ENSG00000115310;ENSG00000131871;ENSG00000069849;ENSG00000144746;ENSG00000139641;ENSG00000188603;ENSG00000139636;ENSG00000125744;ENSG00000118217;ENSG00000124783;ENSG00000134882;ENSG00000134910;ENSG00000001630;ENSG00000182087;ENSG00000144867;ENSG00000054356;ENSG00000100350;ENSG00000109133;ENSG00000136986;ENSG00000116406;ENSG00000065665;ENSG00000166471;ENSG00000072849;ENSG00000113194;ENSG00000114850;ENSG00000139970;ENSG00000133872;ENSG00000117868;ENSG00000101294;ENSG00000113161;ENSG00000071537;ENSG00000147475;ENSG00000170876;ENSG00000153395;ENSG00000115307;ENSG00000147955;ENSG00000080815;ENSG00000134824;ENSG00000134109;ENSG00000162298;ENSG00000102805;ENSG00000095981;ENSG00000159461;ENSG00000104853;ENSG00000107566;ENSG00000172046;ENSG00000138942;ENSG00000058262;ENSG00000178607	1	107	16217	24	29	83	16188	16324	0.3156335944903106
39	M1	e019_M1	TRUE	3.2473632850953553e-43	330	44	35	0.7954545454545454	0.10606060606060606	REAC:R-HSA-73894	REAC	DNA Repair	10790	423		GO:0006260;GO:0050789;GO:0036211;GO:0006281	0	0.011627906976744186	ENSG00000164053;ENSG00000197774;ENSG00000122512;ENSG00000158169;ENSG00000131944;ENSG00000187790;ENSG00000169689;ENSG00000175279;ENSG00000139372;ENSG00000114315;ENSG00000177302;ENSG00000273173;ENSG00000100726;ENSG00000187741;ENSG00000112146;ENSG00000168802;ENSG00000115392;ENSG00000136273;ENSG00000155304;ENSG00000162585;ENSG00000178966;ENSG00000132781;ENSG00000188996;ENSG00000175643;ENSG00000221829;ENSG00000136936;ENSG00000013573;ENSG00000113456;ENSG00000172613;ENSG00000183161;ENSG00000170522;ENSG00000174371;ENSG00000101407;ENSG00000204536;ENSG00000197062;ENSG00000163781;ENSG00000077152;ENSG00000185504;ENSG00000113318;ENSG00000181544;ENSG00000171792;ENSG00000204086;ENSG00000105486;ENSG00000112039;ENSG00000114026;ENSG00000140398;ENSG00000127586;ENSG00000092853;ENSG00000177853;ENSG00000136982;ENSG00000151164;ENSG00000101190;ENSG00000198690;ENSG00000143971	1	330	10460	35	9	295	10451	10790	0.2842428579005625
40	M1	e019_M1	TRUE	4.8506471622313965e-63	342	53	44	0.8301886792452831	0.1286549707602339	GO:0016055	GO:BP	Wnt signaling pathway	16324	5210		GO:0032502;GO:0032501;GO:0050896;GO:0050789;GO:0007154	0	0.007692307692307693	ENSG00000114251;ENSG00000174804;ENSG00000160223;ENSG00000163600;ENSG00000155760;ENSG00000162552;ENSG00000070018;ENSG00000107984;ENSG00000154342;ENSG00000157240;ENSG00000162337;ENSG00000156076;ENSG00000125084;ENSG00000105989;ENSG00000188763;ENSG00000104332;ENSG00000164930;ENSG00000177283;ENSG00000154764;ENSG00000163251;ENSG00000169218;ENSG00000183762;ENSG00000182704;ENSG00000161798;ENSG00000134245;ENSG00000163430;ENSG00000079557;ENSG00000147655;ENSG00000124935;ENSG00000102312;ENSG00000143816;ENSG00000140807;ENSG00000163975;ENSG00000145423;ENSG00000085741;ENSG00000241233;ENSG00000183579;ENSG00000111186;ENSG00000169884;ENSG00000108375;ENSG00000188064;ENSG00000127540;ENSG00000154856;ENSG00000185269;ENSG00000135925;ENSG00000110888;ENSG00000061492;ENSG00000146374;ENSG00000147257;ENSG00000198727;ENSG00000115596;ENSG00000002745;ENSG00000139292;ENSG00000120057	1	342	15982	44	9	298	15973	16324	0.322481654777309
41	M1	e019_M1	TRUE	6.866819958000774e-10	126	39	11	0.28205128205128205	0.0873015873015873	KEGG:00230	KEGG	Purine metabolism	8161	22		GO:0006082;GO:0043101;GO:0006793	0	0.016129032258064516	ENSG00000171497;ENSG00000198805;ENSG00000206075;ENSG00000173992;ENSG00000166741;ENSG00000120053;ENSG00000079739;ENSG00000112335;ENSG00000159335;ENSG00000106853;ENSG00000147164;ENSG00000142634;ENSG00000170502;ENSG00000042493;ENSG00000087842;ENSG00000156110;ENSG00000166800;ENSG00000163281;ENSG00000156136;ENSG00000177156;ENSG00000120437;ENSG00000172009;ENSG00000149313;ENSG00000054148;ENSG00000120686;ENSG00000165704;ENSG00000139684;ENSG00000240344;ENSG00000135069;ENSG00000244462;ENSG00000213145;ENSG00000196839;ENSG00000104472;ENSG00000137944;ENSG00000163655;ENSG00000167699;ENSG00000014641;ENSG00000130313;ENSG00000197894;ENSG00000169299;ENSG00000105220;ENSG00000103876;ENSG00000148834;ENSG00000180957;ENSG00000180817;ENSG00000126088;ENSG00000125166;ENSG00000173221;ENSG00000035687;ENSG00000099810;ENSG00000198931;ENSG00000117448;ENSG00000164111;ENSG00000182919	1	126	8035	11	28	115	8007	8161	0.14984617606505415
42	M1	e019_M1	TRUE	3.121612864335662e-40	222	46	29	0.6304347826086957	0.13063063063063063	GO:0006402	GO:BP	mRNA catabolic process	16324	2213		GO:0009057;GO:0016070;GO:0050789;GO:0065008	0	0.014492753623188406	ENSG00000100038;ENSG00000116698;ENSG00000120727;ENSG00000075975;ENSG00000114127;ENSG00000153250;ENSG00000101901;ENSG00000183496;ENSG00000128016;ENSG00000125107;ENSG00000131503;ENSG00000070366;ENSG00000111596;ENSG00000138767;ENSG00000184708;ENSG00000084070;ENSG00000187742;ENSG00000125386;ENSG00000144580;ENSG00000188425;ENSG00000157106;ENSG00000163694;ENSG00000198952;ENSG00000159592;ENSG00000055917;ENSG00000198265;ENSG00000078177;ENSG00000100226;ENSG00000080802;ENSG00000154640;ENSG00000166889;ENSG00000134644;ENSG00000134744;ENSG00000132466;ENSG00000242265;ENSG00000100354;ENSG00000149115;ENSG00000130695;ENSG00000092345;ENSG00000064655;ENSG00000076067;ENSG00000198791;ENSG00000155508;ENSG00000254726;ENSG00000152520;ENSG00000182973;ENSG00000122299;ENSG00000179912;ENSG00000161847;ENSG00000083544;ENSG00000113300;ENSG00000272886;ENSG00000126070	1	222	16102	29	17	193	16085	16324	0.2831116315836639
44	M1	e019_M1	TRUE	1.5448841213643353e-4	19	39	4	0.10256410256410256	0.21052631578947367	GO:0071786	GO:BP	endoplasmic reticulum tubular network organization	16324	17862		GO:0007029	0	0.5	ENSG00000169896;ENSG00000187713;ENSG00000213064;ENSG00000115255;ENSG00000166257;ENSG00000134198;ENSG00000168701;ENSG00000171045;ENSG00000135211;ENSG00000168476;ENSG00000145283;ENSG00000160131;ENSG00000160318;ENSG00000147676;ENSG00000184210;ENSG00000175514;ENSG00000104660;ENSG00000166091;ENSG00000137210;ENSG00000141699;ENSG00000130733;ENSG00000172057;ENSG00000132563;ENSG00000058799;ENSG00000119820;ENSG00000099194;ENSG00000148110;ENSG00000122490;ENSG00000100036;ENSG00000161558;ENSG00000170540;ENSG00000144035;ENSG00000107819;ENSG00000171928;ENSG00000179363;ENSG00000111371;ENSG00000086159;ENSG00000198326;ENSG00000092068;ENSG00000188822;ENSG00000170271;ENSG00000026652;ENSG00000188167;ENSG00000140688;ENSG00000198818;ENSG00000156738;ENSG00000080189;ENSG00000128699;ENSG00000164040;ENSG00000100652;ENSG00000173409;ENSG00000121680	1	19	16305	4	35	15	16270	16324	0.14553468105512588
45	M1	e019_M1	TRUE	4.930488778060105e-7	29	21	5	0.23809523809523808	0.1724137931034483	KEGG:04392	KEGG	Hippo signaling pathway - multiple species	8161	306		GO:0036211;GO:0006793	0	0.25	ENSG00000187840;ENSG00000104375;ENSG00000101109;ENSG00000136280;ENSG00000052723;ENSG00000101265;ENSG00000082146;ENSG00000175183;ENSG00000115694;ENSG00000211455;ENSG00000160551;ENSG00000114978;ENSG00000153179;ENSG00000251369;ENSG00000266094;ENSG00000148426;ENSG00000115540;ENSG00000135932;ENSG00000196792;ENSG00000125846;ENSG00000114209;ENSG00000102572;ENSG00000163681;ENSG00000143079;ENSG00000173542;ENSG00000128578;ENSG00000090372;ENSG00000115808;ENSG00000154274;ENSG00000107551;ENSG00000111790;ENSG00000134602;ENSG00000130844;ENSG00000108306;ENSG00000077063;ENSG00000197472;ENSG00000074211;ENSG00000166856;ENSG00000169330;ENSG00000130479;ENSG00000129951;ENSG00000198964;ENSG00000143093;ENSG00000168306;ENSG00000167216;ENSG00000203772;ENSG00000175766;ENSG00000111203;ENSG00000169131;ENSG00000185669;ENSG00000100027	1	29	8132	5	16	24	8116	8161	0.2001996453545238
46	M1	e019_M1	TRUE	5.70980144545629e-70	33	42	30	0.7142857142857143	0.9090909090909091	KEGG:04130	KEGG	SNARE interactions in vesicular transport	8161	267		GO:0016192;GO:0048284;GO:0061024;GO:0016050;GO:0006836;GO:0065008;GO:0051640;GO:0046903;GO:0022406	0	0.00909090909090909	ENSG00000067715;ENSG00000092531;ENSG00000105402;ENSG00000101152;ENSG00000106089;ENSG00000120370;ENSG00000166900;ENSG00000124333;ENSG00000100568;ENSG00000102003;ENSG00000105675;ENSG00000124222;ENSG00000125814;ENSG00000108433;ENSG00000174132;ENSG00000111450;ENSG00000079950;ENSG00000151532;ENSG00000170310;ENSG00000099940;ENSG00000177951;ENSG00000053501;ENSG00000164506;ENSG00000118640;ENSG00000105829;ENSG00000113734;ENSG00000103496;ENSG00000117758;ENSG00000008282;ENSG00000105518;ENSG00000143740;ENSG00000168993;ENSG00000135823;ENSG00000172322;ENSG00000124164;ENSG00000049245;ENSG00000178750;ENSG00000073969;ENSG00000104915;ENSG00000145920;ENSG00000168818;ENSG00000108587;ENSG00000139190;ENSG00000168899;ENSG00000117533;ENSG00000265808;ENSG00000166405;ENSG00000162236;ENSG00000099365;ENSG00000132639;ENSG00000220205	1	33	8128	30	12	3	8116	8161	0.8049600777697485
47	M1	e019_M1	TRUE	1.384049730082592e-31	79	23	18	0.782608695652174	0.22784810126582278	KEGG:03018	KEGG	RNA degradation	8161	211		GO:0009057;GO:0050789;GO:0042254;GO:0006396	0	0.010101010101010102	ENSG00000065243;ENSG00000164167;ENSG00000225921;ENSG00000136147;ENSG00000149016;ENSG00000108813;ENSG00000114316;ENSG00000174891;ENSG00000111732;ENSG00000130935;ENSG00000183011;ENSG00000204120;ENSG00000077348;ENSG00000198546;ENSG00000120699;ENSG00000170860;ENSG00000106355;ENSG00000130332;ENSG00000171311;ENSG00000095059;ENSG00000166938;ENSG00000175324;ENSG00000135698;ENSG00000083520;ENSG00000134508;ENSG00000113119;ENSG00000123737;ENSG00000181817;ENSG00000100330;ENSG00000128534;ENSG00000075914;ENSG00000197223;ENSG00000131725;ENSG00000130713;ENSG00000126787;ENSG00000107371;ENSG00000075884;ENSG00000137574;ENSG00000071246;ENSG00000118242;ENSG00000115368;ENSG00000155858;ENSG00000183876;ENSG00000070526;ENSG00000151883;ENSG00000146376;ENSG00000223496;ENSG00000130305;ENSG00000067365;ENSG00000170324	1	79	8082	18	5	61	8077	8161	0.41967665419317357
48	M1	e019_M1	TRUE	2.4088777544516254e-76	57	42	35	0.8333333333333334	0.6140350877192983	REAC:R-HSA-380108	REAC	Chemokine receptors bind chemokines	10790	332		GO:0040011;GO:0002376;GO:0065009;GO:0050896;GO:0050789;GO:0044419	0	0.006097560975609756	ENSG00000107562;ENSG00000156234;ENSG00000108702;ENSG00000131142;ENSG00000115009;ENSG00000169429;ENSG00000213088;ENSG00000172724;ENSG00000172156;ENSG00000186810;ENSG00000169245;ENSG00000163464;ENSG00000180871;ENSG00000163737;ENSG00000169248;ENSG00000124882;ENSG00000138755;ENSG00000262406;ENSG00000006606;ENSG00000124875;ENSG00000163739;ENSG00000038427;ENSG00000108700;ENSG00000129048;ENSG00000163736;ENSG00000137077;ENSG00000126353;ENSG00000145824;ENSG00000184451;ENSG00000151882;ENSG00000154645;ENSG00000174453;ENSG00000108691;ENSG00000163735;ENSG00000181374;ENSG00000102962;ENSG00000182585;ENSG00000117480;ENSG00000189377;ENSG00000163734;ENSG00000081041;ENSG00000109272;ENSG00000143185;ENSG00000213927;ENSG00000143184;ENSG00000110427;ENSG00000102970;ENSG00000106178;ENSG00000173578;ENSG00000183625	1	57	10733	35	7	22	10726	10790	0.7140706425014122
49	M1	e019_M1	TRUE	1.0740436453289067e-13	634	45	20	0.4444444444444444	0.031545741324921134	GO:0098660	GO:BP	inorganic ion transmembrane transport	16324	19866		GO:0032501;GO:0065008;GO:0050789;GO:0006811	0	0.011494252873563218	ENSG00000134121;ENSG00000134115;ENSG00000165029;ENSG00000107679;ENSG00000153822;ENSG00000157551;ENSG00000177807;ENSG00000101400;ENSG00000172575;ENSG00000168135;ENSG00000119326;ENSG00000162383;ENSG00000151150;ENSG00000161647;ENSG00000108852;ENSG00000007314;ENSG00000123700;ENSG00000149091;ENSG00000111181;ENSG00000104863;ENSG00000198947;ENSG00000177238;ENSG00000111052;ENSG00000181790;ENSG00000100427;ENSG00000134769;ENSG00000172164;ENSG00000183873;ENSG00000168807;ENSG00000185053;ENSG00000198569;ENSG00000172554;ENSG00000136531;ENSG00000150054;ENSG00000148943;ENSG00000107282;ENSG00000105711;ENSG00000182533;ENSG00000159261;ENSG00000184185;ENSG00000260458;ENSG00000147481;ENSG00000144452;ENSG00000171227;ENSG00000144136;ENSG00000177098;ENSG00000144285;ENSG00000162461;ENSG00000154330	1	634	15690	20	25	614	15665	16324	0.11037409878756263
50	M1	e019_M1	TRUE	8.889748754814845e-22	74	45	15	0.3333333333333333	0.20270270270270271	GO:0042273	GO:BP	ribosomal large subunit biogenesis	16324	10643		GO:0042254;GO:0006396	0	0.047619047619047616	ENSG00000111615;ENSG00000105373;ENSG00000132275;ENSG00000163563;ENSG00000187531;ENSG00000124214;ENSG00000106344;ENSG00000169714;ENSG00000173145;ENSG00000115816;ENSG00000164346;ENSG00000104356;ENSG00000163565;ENSG00000100029;ENSG00000121481;ENSG00000014164;ENSG00000109685;ENSG00000136271;ENSG00000142864;ENSG00000138442;ENSG00000197498;ENSG00000128191;ENSG00000080608;ENSG00000171490;ENSG00000113460;ENSG00000052749;ENSG00000148773;ENSG00000165732;ENSG00000103550;ENSG00000198042;ENSG00000168298;ENSG00000130826;ENSG00000188976;ENSG00000053372;ENSG00000173933;ENSG00000088205;ENSG00000140632;ENSG00000111641;ENSG00000134697;ENSG00000099284;ENSG00000124610;ENSG00000117395;ENSG00000125485;ENSG00000123064;ENSG00000132382;ENSG00000108592;ENSG00000167881;ENSG00000188739;ENSG00000155438	1	74	16250	15	30	59	16220	16324	0.25734066587248305
51	M1	e019_M1	TRUE	3.3411192004182933e-28	96	43	20	0.46511627906976744	0.20833333333333334	REAC:R-HSA-975956	REAC	Nonsense Mediated Decay (NMD) independent of the Exon Junction Complex (EJC)	10790	1521		GO:0042254;GO:0006396;GO:0006412	0	0.012987012987012988	ENSG00000178999;ENSG00000161970;ENSG00000122406;ENSG00000233927;ENSG00000179041;ENSG00000055130;ENSG00000163938;ENSG00000137807;ENSG00000104872;ENSG00000181163;ENSG00000110700;ENSG00000112984;ENSG00000101421;ENSG00000086102;ENSG00000108107;ENSG00000198373;ENSG00000170004;ENSG00000125691;ENSG00000115232;ENSG00000143621;ENSG00000100138;ENSG00000108298;ENSG00000037241;ENSG00000108829;ENSG00000101361;ENSG00000213741;ENSG00000115268;ENSG00000063177;ENSG00000111530;ENSG00000089009;ENSG00000142937;ENSG00000129351;ENSG00000153187;ENSG00000122966;ENSG00000104852;ENSG00000169564;ENSG00000138326;ENSG00000070756;ENSG00000265681;ENSG00000099783;ENSG00000137154;ENSG00000198901;ENSG00000144713;ENSG00000105193;ENSG00000164587;ENSG00000145220;ENSG00000186298;ENSG00000115053;ENSG00000164695	1	96	10694	20	23	76	10671	10790	0.3073122374919436
52	M1	e019_M1	TRUE	1.334335745806519e-8	168	22	9	0.4090909090909091	0.05357142857142857	KEGG:04141	KEGG	Protein processing in endoplasmic reticulum	8161	273		GO:0051641;GO:0036211;GO:0009059	0	0.027777777777777776	ENSG00000196549;ENSG00000206503;ENSG00000119977;ENSG00000114902;ENSG00000129128;ENSG00000151490;ENSG00000162736;ENSG00000139921;ENSG00000023171;ENSG00000143641;ENSG00000140612;ENSG00000089351;ENSG00000116729;ENSG00000118363;ENSG00000102595;ENSG00000102158;ENSG00000118705;ENSG00000130193;ENSG00000185825;ENSG00000204525;ENSG00000074695;ENSG00000134153;ENSG00000141458;ENSG00000084073;ENSG00000017260;ENSG00000183291;ENSG00000169446;ENSG00000161671;ENSG00000014257;ENSG00000164953;ENSG00000157916;ENSG00000214736;ENSG00000112697;ENSG00000204852;ENSG00000116138;ENSG00000125304;ENSG00000125912;ENSG00000110917;ENSG00000163527;ENSG00000134825;ENSG00000168778;ENSG00000127463;ENSG00000132182;ENSG00000067167;ENSG00000244038;ENSG00000269058;ENSG00000025796;ENSG00000143819;ENSG00000136731	1	168	7993	9	13	159	7980	8161	0.14225137693399512
53	M1	e019_M1	TRUE	1.3980666699923236e-66	68	45	32	0.7111111111111111	0.47058823529411764	GO:0045109	GO:BP	intermediate filament organization	16324	11970		GO:0006996	0	0.05555555555555555	ENSG00000204897;ENSG00000171345;ENSG00000131737;ENSG00000171360;ENSG00000074319;ENSG00000170486;ENSG00000186832;ENSG00000167767;ENSG00000186442;ENSG00000175084;ENSG00000171401;ENSG00000135443;ENSG00000139531;ENSG00000072121;ENSG00000186393;ENSG00000204889;ENSG00000139648;ENSG00000171431;ENSG00000205426;ENSG00000170465;ENSG00000135249;ENSG00000170477;ENSG00000170423;ENSG00000171346;ENSG00000135406;ENSG00000143013;ENSG00000116903;ENSG00000170819;ENSG00000185640;ENSG00000084652;ENSG00000185069;ENSG00000173908;ENSG00000171446;ENSG00000125898;ENSG00000205420;ENSG00000205542;ENSG00000120860;ENSG00000181404;ENSG00000170523;ENSG00000108417;ENSG00000197079;ENSG00000167916;ENSG00000170484;ENSG00000170454;ENSG00000164440;ENSG00000185479;ENSG00000185359;ENSG00000170442	1	68	16256	32	13	36	16243	16324	0.577090058595005
54	M1	e019_M1	TRUE	4.877403391883273e-7	105	36	8	0.2222222222222222	0.0761904761904762	REAC:R-HSA-425393	REAC	Transport of inorganic cations/anions and amino acids/oligopeptides	10790	2459		GO:0015849	0	0.045454545454545456	ENSG00000113441;ENSG00000116521;ENSG00000173638;ENSG00000085365;ENSG00000064651;ENSG00000187049;ENSG00000092439;ENSG00000185896;ENSG00000135916;ENSG00000169895;ENSG00000126062;ENSG00000197081;ENSG00000172893;ENSG00000103257;ENSG00000141424;ENSG00000057252;ENSG00000175130;ENSG00000142687;ENSG00000137216;ENSG00000068366;ENSG00000165782;ENSG00000123595;ENSG00000133703;ENSG00000175220;ENSG00000186889;ENSG00000090020;ENSG00000104635;ENSG00000181826;ENSG00000168003;ENSG00000123983;ENSG00000108582;ENSG00000134313;ENSG00000073060;ENSG00000103249;ENSG00000213281;ENSG00000072041;ENSG00000116857;ENSG00000132589;ENSG00000105281;ENSG00000076706;ENSG00000130821;ENSG00000089063;ENSG00000172915;ENSG00000033867;ENSG00000134294;ENSG00000152291;ENSG00000115107;ENSG00000168758	1	105	10685	8	28	97	10657	10790	0.1252409304066885
55	M1	e019_M1	TRUE	2.1092371892021826e-23	295	46	22	0.4782608695652174	0.07457627118644068	GO:0016236	GO:BP	macroautophagy	16324	5303		GO:0051641;GO:0016192;GO:0044419;GO:0006914;GO:0007033;GO:0022607;GO:0061024;GO:0016032;GO:0022411;GO:0007032	0	0.006802721088435374	ENSG00000177628;ENSG00000124356;ENSG00000147614;ENSG00000138674;ENSG00000133135;ENSG00000103056;ENSG00000023839;ENSG00000113719;ENSG00000182149;ENSG00000086065;ENSG00000136888;ENSG00000119541;ENSG00000134108;ENSG00000115561;ENSG00000158411;ENSG00000083937;ENSG00000021574;ENSG00000121039;ENSG00000111432;ENSG00000132612;ENSG00000116039;ENSG00000130724;ENSG00000143882;ENSG00000131165;ENSG00000033627;ENSG00000047249;ENSG00000255112;ENSG00000135245;ENSG00000162819;ENSG00000138592;ENSG00000100926;ENSG00000100554;ENSG00000009844;ENSG00000112149;ENSG00000071909;ENSG00000126733;ENSG00000250565;ENSG00000197530;ENSG00000166321;ENSG00000155097;ENSG00000106460;ENSG00000145740;ENSG00000213760;ENSG00000110719;ENSG00000138756;ENSG00000166575;ENSG00000177054	1	295	16029	22	24	273	16005	16324	0.18364423160639595
56	M1	e019_M1	TRUE	2.795186643515154e-31	394	45	28	0.6222222222222222	0.07106598984771574	GO:0008380	GO:BP	RNA splicing	16324	3261		GO:0009057;GO:0050789;GO:0000375	0	0.01818181818181818	ENSG00000165119;ENSG00000162692;ENSG00000125944;ENSG00000126457;ENSG00000168066;ENSG00000147140;ENSG00000112232;ENSG00000015479;ENSG00000072803;ENSG00000066044;ENSG00000182944;ENSG00000197451;ENSG00000157554;ENSG00000147274;ENSG00000096746;ENSG00000167085;ENSG00000115414;ENSG00000169813;ENSG00000089280;ENSG00000135829;ENSG00000122566;ENSG00000121774;ENSG00000135486;ENSG00000116560;ENSG00000126945;ENSG00000152795;ENSG00000165819;ENSG00000145388;ENSG00000092199;ENSG00000088930;ENSG00000044090;ENSG00000074266;ENSG00000214753;ENSG00000149187;ENSG00000138668;ENSG00000100201;ENSG00000120948;ENSG00000170144;ENSG00000135316;ENSG00000125970;ENSG00000105323;ENSG00000129636;ENSG00000063244;ENSG00000011304;ENSG00000155636;ENSG00000177733;ENSG00000108654	1	394	15930	28	17	366	15913	16324	0.2048927566031505
57	M1	e019_M1	TRUE	1.1682648496649887e-34	516	46	32	0.6956521739130435	0.06201550387596899	GO:0007169	GO:BP	transmembrane receptor protein tyrosine kinase signaling pathway	16324	2796		GO:0044255;GO:0065009;GO:0006793;GO:0050789;GO:0036211	0	0.003236245954692557	ENSG00000182578;ENSG00000171608;ENSG00000136573;ENSG00000105976;ENSG00000133056;ENSG00000185634;ENSG00000131746;ENSG00000033327;ENSG00000174791;ENSG00000160691;ENSG00000176105;ENSG00000106070;ENSG00000134853;ENSG00000079308;ENSG00000143322;ENSG00000145675;ENSG00000113721;ENSG00000135077;ENSG00000115904;ENSG00000167193;ENSG00000157404;ENSG00000141738;ENSG00000110395;ENSG00000099942;ENSG00000145715;ENSG00000154016;ENSG00000186716;ENSG00000163513;ENSG00000105647;ENSG00000051382;ENSG00000141736;ENSG00000122025;ENSG00000107338;ENSG00000178568;ENSG00000065361;ENSG00000170677;ENSG00000117461;ENSG00000097007;ENSG00000074966;ENSG00000077782;ENSG00000115325;ENSG00000101336;ENSG00000121879;ENSG00000147443;ENSG00000165458;ENSG00000107263	1	516	15808	32	14	484	15794	16324	0.2017610799350357
58	M1	e019_M1	TRUE	7.243668832655112e-39	297	40	31	0.775	0.10437710437710437	REAC:R-HSA-1474244	REAC	Extracellular matrix organization	10790	844		GO:0032501;GO:0032502;GO:0045229;GO:0043062	0	0.012048192771084338	ENSG00000113578;ENSG00000108821;ENSG00000118733;ENSG00000140285;ENSG00000137440;ENSG00000172179;ENSG00000119681;ENSG00000130635;ENSG00000197461;ENSG00000163359;ENSG00000137801;ENSG00000182492;ENSG00000113140;ENSG00000053747;ENSG00000142798;ENSG00000196878;ENSG00000164761;ENSG00000116774;ENSG00000112715;ENSG00000188157;ENSG00000100473;ENSG00000080573;ENSG00000063660;ENSG00000139219;ENSG00000142156;ENSG00000049089;ENSG00000116962;ENSG00000197467;ENSG00000102996;ENSG00000168542;ENSG00000164692;ENSG00000095587;ENSG00000100311;ENSG00000188783;ENSG00000114270;ENSG00000110799;ENSG00000204262;ENSG00000058085;ENSG00000034971;ENSG00000106333;ENSG00000205221;ENSG00000168487;ENSG00000092758;ENSG00000259384;ENSG00000112280;ENSG00000122711	1	297	10493	31	9	266	10484	10790	0.2786862464977096
59	M1	e019_M1	TRUE	1.231734263754754e-5	41	26	5	0.19230769230769232	0.12195121951219512	REAC:R-HSA-6782315	REAC	tRNA modification in the nucleus and cytosol	10790	2601		NA	0	0.14285714285714285	ENSG00000173744;ENSG00000142230;ENSG00000037897;ENSG00000160193;ENSG00000142875;ENSG00000136279;ENSG00000109917;ENSG00000047230;ENSG00000133265;ENSG00000198954;ENSG00000148291;ENSG00000145012;ENSG00000133627;ENSG00000097033;ENSG00000172315;ENSG00000148341;ENSG00000137073;ENSG00000105355;ENSG00000086200;ENSG00000081307;ENSG00000148356;ENSG00000101150;ENSG00000141985;ENSG00000141756;ENSG00000197930;ENSG00000143147;ENSG00000171033;ENSG00000154783;ENSG00000117385;ENSG00000136950;ENSG00000144034;ENSG00000153086;ENSG00000115556;ENSG00000165059;ENSG00000109956;ENSG00000111696;ENSG00000130950;ENSG00000135549;ENSG00000162704;ENSG00000241685;ENSG00000214517;ENSG00000145331;ENSG00000169340;ENSG00000148218;ENSG00000250151	1	41	10749	5	21	36	10728	10790	0.150582609260397
61	M1	e019_M1	TRUE	5.475657202319372e-14	51	41	10	0.24390243902439024	0.19607843137254902	GO:0001836	GO:BP	release of cytochrome c from mitochondria	16324	507		GO:0061024;GO:0065008;GO:0050896;GO:0007005;GO:0050789	0	0.014705882352941176	ENSG00000141682;ENSG00000015475;ENSG00000120471;ENSG00000171791;ENSG00000030110;ENSG00000072736;ENSG00000143384;ENSG00000153094;ENSG00000129473;ENSG00000140379;ENSG00000100450;ENSG00000167641;ENSG00000104081;ENSG00000133275;ENSG00000101782;ENSG00000171109;ENSG00000143801;ENSG00000137875;ENSG00000105327;ENSG00000063176;ENSG00000165943;ENSG00000180138;ENSG00000164484;ENSG00000122707;ENSG00000165646;ENSG00000215012;ENSG00000167971;ENSG00000176720;ENSG00000010379;ENSG00000151292;ENSG00000169118;ENSG00000079616;ENSG00000105784;ENSG00000144659;ENSG00000169594;ENSG00000135116;ENSG00000159433;ENSG00000244274;ENSG00000169857;ENSG00000196289;ENSG00000166341;ENSG00000181588;ENSG00000163440;ENSG00000239571	1	51	16273	10	31	41	16242	16324	0.21649584950496834
63	M1	e019_M1	TRUE	5.8052107392375724e-15	12	20	7	0.35	0.5833333333333334	REAC:R-HSA-4641265	REAC	Repression of WNT target genes	10790	1946		GO:0050789;GO:0032502;GO:0007154	0	0.03225806451612903	ENSG00000138795;ENSG00000196781;ENSG00000081059;ENSG00000186871;ENSG00000065717;ENSG00000152284;ENSG00000144485;ENSG00000106829;ENSG00000087095;ENSG00000126778;ENSG00000109061;ENSG00000140332;ENSG00000170448;ENSG00000163132;ENSG00000143933;ENSG00000164532;ENSG00000203877;ENSG00000183878;ENSG00000136630;ENSG00000109063;ENSG00000142599;ENSG00000106608;ENSG00000198807;ENSG00000134690;ENSG00000149503;ENSG00000158161;ENSG00000105146;ENSG00000139668;ENSG00000184302;ENSG00000112319;ENSG00000170577;ENSG00000112837;ENSG00000104313;ENSG00000100625;ENSG00000116273;ENSG00000138083;ENSG00000125492;ENSG00000164508;ENSG00000259431;ENSG00000177000;ENSG00000264424;ENSG00000163064;ENSG00000255346	1	12	10778	7	13	5	10765	10790	0.4510812082055428
64	M1	e019_M1	TRUE	2.9649762365795956e-19	130	38	15	0.39473684210526316	0.11538461538461539	GO:2001056	GO:BP	positive regulation of cysteine-type endopeptidase activity	16324	27584		GO:0065009;GO:0050789;GO:0001816;GO:0050896	0	0.009345794392523364	ENSG00000120868;ENSG00000177595;ENSG00000169372;ENSG00000091106;ENSG00000003400;ENSG00000105483;ENSG00000132906;ENSG00000162711;ENSG00000103313;ENSG00000103490;ENSG00000137496;ENSG00000150782;ENSG00000115604;ENSG00000125571;ENSG00000115598;ENSG00000167207;ENSG00000137752;ENSG00000115607;ENSG00000072818;ENSG00000160505;ENSG00000106144;ENSG00000142405;ENSG00000091592;ENSG00000132357;ENSG00000100453;ENSG00000153558;ENSG00000169900;ENSG00000106100;ENSG00000196954;ENSG00000137757;ENSG00000169955;ENSG00000176393;ENSG00000253548;ENSG00000123307;ENSG00000142347;ENSG00000163288;ENSG00000255501;ENSG00000047597;ENSG00000243708;ENSG00000141504;ENSG00000170476;ENSG00000204403;ENSG00000170236	1	130	16194	15	23	115	16171	16324	0.21019321626908527
66	M1	e019_M1	TRUE	3.1018845741651325e-73	34	31	29	0.9354838709677419	0.8529411764705882	KEGG:03020	KEGG	RNA polymerase	8161	212		GO:0006351;GO:0050789	0	0.010638297872340425	ENSG00000186141;ENSG00000005075;ENSG00000100142;ENSG00000105258;ENSG00000100413;ENSG00000117877;ENSG00000125630;ENSG00000161980;ENSG00000104825;ENSG00000113356;ENSG00000171453;ENSG00000137054;ENSG00000105849;ENSG00000163125;ENSG00000099817;ENSG00000101413;ENSG00000144231;ENSG00000126461;ENSG00000132664;ENSG00000177700;ENSG00000121851;ENSG00000103932;ENSG00000011007;ENSG00000168495;ENSG00000163882;ENSG00000111231;ENSG00000108469;ENSG00000168002;ENSG00000102978;ENSG00000111880;ENSG00000122484;ENSG00000141425;ENSG00000068654;ENSG00000058600;ENSG00000126756;ENSG00000198522;ENSG00000147669;ENSG00000047315;ENSG00000013503;ENSG00000105176;ENSG00000186184;ENSG00000241258;ENSG00000148606	1	34	8127	29	2	5	8125	8161	0.8928370985056344
67	M1	e019_M1	TRUE	1.2777045410969691e-23	238	40	20	0.5	0.08403361344537816	GO:0030198	GO:BP	extracellular matrix organization	16324	7070		GO:0045229;GO:0043062	0	0.02702702702702703	ENSG00000265203;ENSG00000182871;ENSG00000084636;ENSG00000104415;ENSG00000173372;ENSG00000106809;ENSG00000135919;ENSG00000083444;ENSG00000087303;ENSG00000171812;ENSG00000132561;ENSG00000149582;ENSG00000132693;ENSG00000081052;ENSG00000134871;ENSG00000163297;ENSG00000158270;ENSG00000145861;ENSG00000099985;ENSG00000135862;ENSG00000173432;ENSG00000197565;ENSG00000132703;ENSG00000143196;ENSG00000163520;ENSG00000148702;ENSG00000240654;ENSG00000206561;ENSG00000011465;ENSG00000169031;ENSG00000205863;ENSG00000120708;ENSG00000101680;ENSG00000188153;ENSG00000130702;ENSG00000170275;ENSG00000187955;ENSG00000187498;ENSG00000144810;ENSG00000091136;ENSG00000087085;ENSG00000142173;ENSG00000136999	1	238	16086	20	20	218	16066	16324	0.2007157280053245
68	M1	e019_M1	TRUE	0.006626072516303478	44	18	3	0.16666666666666666	0.06818181818181818	KEGG:00970	KEGG	Aminoacyl-tRNA biosynthesis	8161	153		NA	0	0.25	ENSG00000049860;ENSG00000213614;ENSG00000198648;ENSG00000138642;ENSG00000172239;ENSG00000115760;ENSG00000166123;ENSG00000164244;ENSG00000140105;ENSG00000076685;ENSG00000183527;ENSG00000108039;ENSG00000031698;ENSG00000106477;ENSG00000122042;ENSG00000107341;ENSG00000170445;ENSG00000113552;ENSG00000140939;ENSG00000249481;ENSG00000108591;ENSG00000141971;ENSG00000159374;ENSG00000179958;ENSG00000033178;ENSG00000132837;ENSG00000115155;ENSG00000143001;ENSG00000095906;ENSG00000196814;ENSG00000196865;ENSG00000167797;ENSG00000007384;ENSG00000239900;ENSG00000173457;ENSG00000103274;ENSG00000148634;ENSG00000136819;ENSG00000143486;ENSG00000074803;ENSG00000101104;ENSG00000122642	1	44	8117	3	15	41	8102	8161	0.103545400337109
69	M1	e019_M1	TRUE	6.16713452403372e-24	317	42	22	0.5238095238095238	0.0694006309148265	GO:0006816	GO:BP	calcium ion transport	16324	2551		GO:0006811	0	0.011904761904761904	ENSG00000169418;ENSG00000144935;ENSG00000072952;ENSG00000150995;ENSG00000088832;ENSG00000051128;ENSG00000123104;ENSG00000100991;ENSG00000182795;ENSG00000155875;ENSG00000196218;ENSG00000103942;ENSG00000185532;ENSG00000096433;ENSG00000187164;ENSG00000077157;ENSG00000178538;ENSG00000143756;ENSG00000064270;ENSG00000138741;ENSG00000160991;ENSG00000276045;ENSG00000145794;ENSG00000121769;ENSG00000198844;ENSG00000152413;ENSG00000137672;ENSG00000161681;ENSG00000117280;ENSG00000072315;ENSG00000133107;ENSG00000168959;ENSG00000198626;ENSG00000175938;ENSG00000198838;ENSG00000153714;ENSG00000138735;ENSG00000105583;ENSG00000129151;ENSG00000069018;ENSG00000142185;ENSG00000106341	1	317	16007	22	20	295	15987	16324	0.1856433716113555
70	M1	e019_M1	TRUE	9.26385499658634e-26	73	23	15	0.6521739130434783	0.2054794520547945	REAC:R-HSA-6807505	REAC	RNA polymerase II transcribes snRNA genes	10790	1812		GO:0050789;GO:0006396	0	0.09090909090909091	ENSG00000197050;ENSG00000171476;ENSG00000143373;ENSG00000092377;ENSG00000102786;ENSG00000134046;ENSG00000139579;ENSG00000138785;ENSG00000074657;ENSG00000057935;ENSG00000111328;ENSG00000127054;ENSG00000149262;ENSG00000165804;ENSG00000173559;ENSG00000146576;ENSG00000148153;ENSG00000089048;ENSG00000171169;ENSG00000064102;ENSG00000143493;ENSG00000101040;ENSG00000111728;ENSG00000104299;ENSG00000104613;ENSG00000143294;ENSG00000148411;ENSG00000151612;ENSG00000166211;ENSG00000111817;ENSG00000048405;ENSG00000108506;ENSG00000185085;ENSG00000166716;ENSG00000116254;ENSG00000164941;ENSG00000155115;ENSG00000164880;ENSG00000180423;ENSG00000138614;ENSG00000144406	1	73	10717	15	8	58	10709	10790	0.3638937253519319
71	M1	e019_M1	TRUE	2.23375833876751e-5	17	27	4	0.14814814814814814	0.23529411764705882	REAC:R-HSA-1482922	REAC	Acyl chain remodelling of PI	10790	111		GO:0044255;GO:0006793;GO:0006807	0	0.07692307692307693	ENSG00000095752;ENSG00000137070;ENSG00000169427;ENSG00000171303;ENSG00000197747;ENSG00000165125;ENSG00000109321;ENSG00000116711;ENSG00000117676;ENSG00000172346;ENSG00000104327;ENSG00000196154;ENSG00000079277;ENSG00000160307;ENSG00000163993;ENSG00000158747;ENSG00000160678;ENSG00000130529;ENSG00000184330;ENSG00000105499;ENSG00000188643;ENSG00000189334;ENSG00000196754;ENSG00000169906;ENSG00000155792;ENSG00000188015;ENSG00000197956;ENSG00000183864;ENSG00000183023;ENSG00000170791;ENSG00000133731;ENSG00000127412;ENSG00000171643;ENSG00000196420;ENSG00000158786;ENSG00000146090;ENSG00000163191;ENSG00000189181;ENSG00000140043;ENSG00000176294;ENSG00000127472	1	17	10773	4	23	13	10750	10790	0.18509585907045356
72	M1	e019_M1	TRUE	2.2880213464253747e-4	42	19	4	0.21052631578947367	0.09523809523809523	REAC:R-HSA-3769402	REAC	Deactivation of the beta-catenin transactivating complex	10790	431		NA	0	0.2	ENSG00000106689;ENSG00000129993;ENSG00000198728;ENSG00000122515;ENSG00000116128;ENSG00000168264;ENSG00000104903;ENSG00000196998;ENSG00000131263;ENSG00000137941;ENSG00000016082;ENSG00000197008;ENSG00000157216;ENSG00000184402;ENSG00000165156;ENSG00000162367;ENSG00000109787;ENSG00000162624;ENSG00000121454;ENSG00000145687;ENSG00000078699;ENSG00000106852;ENSG00000165821;ENSG00000161981;ENSG00000169744;ENSG00000143355;ENSG00000172789;ENSG00000130511;ENSG00000179044;ENSG00000171016;ENSG00000186174;ENSG00000167380;ENSG00000196693;ENSG00000228075;ENSG00000159556;ENSG00000148377;ENSG00000079313;ENSG00000163348;ENSG00000162761;ENSG00000198740;ENSG00000197056	1	42	10748	4	15	38	10733	10790	0.13937445057838224
73	M1	e019_M1	TRUE	6.820393021689869e-18	525	41	21	0.5121951219512195	0.04	GO:0099536	GO:BP	synaptic signaling	16324	20177		GO:0065008;GO:0050789;GO:0006811;GO:0050877;GO:0007154	0	0.0072992700729927005	ENSG00000198010;ENSG00000058335;ENSG00000109072;ENSG00000078018;ENSG00000163697;ENSG00000126583;ENSG00000008735;ENSG00000115234;ENSG00000142192;ENSG00000084234;ENSG00000157193;ENSG00000166342;ENSG00000185046;ENSG00000105464;ENSG00000106688;ENSG00000134909;ENSG00000176884;ENSG00000150672;ENSG00000089250;ENSG00000082458;ENSG00000183454;ENSG00000123384;ENSG00000121653;ENSG00000081479;ENSG00000116544;ENSG00000173020;ENSG00000176749;ENSG00000072062;ENSG00000198785;ENSG00000132535;ENSG00000075711;ENSG00000179841;ENSG00000160014;ENSG00000138798;ENSG00000105443;ENSG00000136854;ENSG00000152689;ENSG00000273079;ENSG00000070808;ENSG00000173406;ENSG00000154229	1	525	15799	21	20	504	15779	16324	0.13653020688540077
75	M1	e019_M1	TRUE	9.352941080122927e-19	32	32	11	0.34375	0.34375	REAC:R-HSA-8963899	REAC	Plasma lipoprotein remodeling	10790	1668		GO:0016043;GO:0050789;GO:0006869;GO:0032501	0	0.01	ENSG00000118137;ENSG00000130173;ENSG00000132855;ENSG00000064687;ENSG00000102245;ENSG00000123131;ENSG00000121410;ENSG00000129988;ENSG00000158874;ENSG00000130208;ENSG00000110243;ENSG00000091317;ENSG00000131050;ENSG00000087237;ENSG00000175445;ENSG00000117281;ENSG00000100342;ENSG00000134339;ENSG00000187559;ENSG00000100979;ENSG00000213398;ENSG00000234906;ENSG00000080910;ENSG00000244414;ENSG00000277494;ENSG00000184588;ENSG00000096006;ENSG00000211899;ENSG00000163382;ENSG00000139278;ENSG00000175336;ENSG00000172594;ENSG00000261701;ENSG00000073754;ENSG00000005421;ENSG00000169154;ENSG00000135929;ENSG00000182327;ENSG00000105852;ENSG00000109851	1	32	10758	11	21	21	10737	10790	0.34179796430563303
76	M1	e019_M1	TRUE	6.336623789823517e-29	43	33	16	0.48484848484848486	0.37209302325581395	REAC:R-HSA-1566948	REAC	Elastic fibre formation	10790	798		GO:0032502;GO:0045229;GO:0022607;GO:0043062	0	0.02857142857142857	ENSG00000113739;ENSG00000132031;ENSG00000197859;ENSG00000077942;ENSG00000175899;ENSG00000105664;ENSG00000049540;ENSG00000166033;ENSG00000117122;ENSG00000143369;ENSG00000183798;ENSG00000140092;ENSG00000049323;ENSG00000136378;ENSG00000162510;ENSG00000090006;ENSG00000092969;ENSG00000115380;ENSG00000160161;ENSG00000113083;ENSG00000151388;ENSG00000172638;ENSG00000178031;ENSG00000172037;ENSG00000172889;ENSG00000129038;ENSG00000165973;ENSG00000167992;ENSG00000140511;ENSG00000174792;ENSG00000113070;ENSG00000166147;ENSG00000118523;ENSG00000163378;ENSG00000138829;ENSG00000069764;ENSG00000168056;ENSG00000197614;ENSG00000124159;ENSG00000126545	1	43	10747	16	17	27	10730	10790	0.42274319238704966
77	M1	e019_M1	TRUE	2.0859473707510322e-22	33	26	12	0.46153846153846156	0.36363636363636365	REAC:R-HSA-68962	REAC	Activation of the pre-replicative complex	10790	103		GO:0006260	0	0.045454545454545456	ENSG00000147889;ENSG00000006634;ENSG00000097046;ENSG00000151012;ENSG00000115942;ENSG00000125885;ENSG00000136881;ENSG00000065328;ENSG00000138641;ENSG00000197771;ENSG00000091651;ENSG00000181274;ENSG00000198876;ENSG00000005483;ENSG00000101216;ENSG00000152193;ENSG00000169957;ENSG00000196116;ENSG00000120329;ENSG00000094804;ENSG00000183145;ENSG00000093009;ENSG00000146233;ENSG00000085840;ENSG00000164815;ENSG00000115947;ENSG00000125821;ENSG00000135437;ENSG00000135336;ENSG00000131013;ENSG00000161036;ENSG00000176399;ENSG00000184058;ENSG00000108932;ENSG00000236424;ENSG00000140522;ENSG00000090266;ENSG00000102743;ENSG00000166391	1	33	10757	12	14	21	10743	10790	0.40807424477949844
78	M1	e019_M1	TRUE	5.147043323421843e-18	294	37	20	0.5405405405405406	0.06802721088435375	KEGG:04010	KEGG	MAPK signaling pathway	8161	238		GO:0065009;GO:0006793;GO:0050896;GO:0006457;GO:0050789;GO:0036211	0	0.0045662100456621	ENSG00000133124;ENSG00000103266;ENSG00000157764;ENSG00000105568;ENSG00000135341;ENSG00000106211;ENSG00000132155;ENSG00000142208;ENSG00000143575;ENSG00000096384;ENSG00000197442;ENSG00000173110;ENSG00000146648;ENSG00000170315;ENSG00000169710;ENSG00000169032;ENSG00000137486;ENSG00000044574;ENSG00000137764;ENSG00000094631;ENSG00000087586;ENSG00000141480;ENSG00000113013;ENSG00000080824;ENSG00000034152;ENSG00000170606;ENSG00000086061;ENSG00000096060;ENSG00000109971;ENSG00000102882;ENSG00000095015;ENSG00000067606;ENSG00000126934;ENSG00000166333;ENSG00000198909;ENSG00000105401;ENSG00000078061;ENSG00000168259;ENSG00000100324	1	294	7867	20	17	274	7850	8161	0.18270717101722692
79	M1	e019_M1	TRUE	7.671847592198566e-35	166	37	26	0.7027027027027027	0.1566265060240964	KEGG:04630	KEGG	JAK-STAT signaling pathway	8161	326		GO:0050789;GO:0036211;GO:0006793;GO:0050896	0	0.005494505494505495	ENSG00000168610;ENSG00000185338;ENSG00000162434;ENSG00000100385;ENSG00000168685;ENSG00000113494;ENSG00000115145;ENSG00000105639;ENSG00000096968;ENSG00000115290;ENSG00000136738;ENSG00000185950;ENSG00000184557;ENSG00000178078;ENSG00000112964;ENSG00000142166;ENSG00000105397;ENSG00000140443;ENSG00000179295;ENSG00000119535;ENSG00000182511;ENSG00000178188;ENSG00000121966;ENSG00000111679;ENSG00000120833;ENSG00000148053;ENSG00000160791;ENSG00000081237;ENSG00000126561;ENSG00000100368;ENSG00000160999;ENSG00000169047;ENSG00000134352;ENSG00000147168;ENSG00000116678;ENSG00000077238;ENSG00000187266;ENSG00000173757;ENSG00000171105	1	166	7995	26	11	140	7984	8161	0.3262202189944493
80	M1	e019_M1	TRUE	2.1098573129795115e-5	278	39	9	0.23076923076923078	0.03237410071942446	GO:0016311	GO:BP	dephosphorylation	16324	5325		GO:0043603;GO:0009117;GO:0006629;GO:0006790;GO:0036211	0	0.047619047619047616	ENSG00000143418;ENSG00000143183;ENSG00000061987;ENSG00000197601;ENSG00000101856;ENSG00000066322;ENSG00000134851;ENSG00000187446;ENSG00000153132;ENSG00000112679;ENSG00000155093;ENSG00000110446;ENSG00000167645;ENSG00000116133;ENSG00000184575;ENSG00000110786;ENSG00000130829;ENSG00000120451;ENSG00000110057;ENSG00000094914;ENSG00000148719;ENSG00000033011;ENSG00000171631;ENSG00000166479;ENSG00000080031;ENSG00000153933;ENSG00000115275;ENSG00000077147;ENSG00000140284;ENSG00000149084;ENSG00000070961;ENSG00000139318;ENSG00000099797;ENSG00000167114;ENSG00000103222;ENSG00000164086;ENSG00000105223;ENSG00000145817;ENSG00000171100	1	278	16046	9	30	269	16016	16324	0.08084314020279612
81	M1	e019_M1	TRUE	1.369660852263033e-59	65	37	28	0.7567567567567568	0.4307692307692308	GO:0060260	GO:BP	regulation of transcription initiation by RNA polymerase II	16324	15310		GO:0050789	0	0.05	ENSG00000175221;ENSG00000148297;ENSG00000072310;ENSG00000120526;ENSG00000104973;ENSG00000008838;ENSG00000133997;ENSG00000159479;ENSG00000112282;ENSG00000161920;ENSG00000108590;ENSG00000184634;ENSG00000118579;ENSG00000105085;ENSG00000132964;ENSG00000112531;ENSG00000133398;ENSG00000141026;ENSG00000130772;ENSG00000108510;ENSG00000042429;ENSG00000089685;ENSG00000099917;ENSG00000123066;ENSG00000180182;ENSG00000126351;ENSG00000155868;ENSG00000107960;ENSG00000156603;ENSG00000144893;ENSG00000063322;ENSG00000060069;ENSG00000125686;ENSG00000152944;ENSG00000124641;ENSG00000112237;ENSG00000164758;ENSG00000277104;ENSG00000160563	1	65	16259	28	9	37	16250	16324	0.5697291360554633
83	M1	e019_M1	TRUE	2.8565396933369173e-14	250	33	14	0.42424242424242425	0.056	GO:0007389	GO:BP	pattern specification process	16324	2960		GO:0032501	0	0.07692307692307693	ENSG00000163743;ENSG00000105996;ENSG00000112312;ENSG00000160199;ENSG00000185630;ENSG00000253293;ENSG00000078399;ENSG00000134138;ENSG00000167081;ENSG00000128710;ENSG00000165495;ENSG00000136944;ENSG00000110851;ENSG00000143995;ENSG00000099256;ENSG00000110002;ENSG00000118526;ENSG00000260027;ENSG00000107807;ENSG00000105419;ENSG00000122592;ENSG00000170949;ENSG00000128709;ENSG00000135638;ENSG00000108511;ENSG00000234602;ENSG00000181904;ENSG00000180660;ENSG00000120094;ENSG00000182742;ENSG00000106031;ENSG00000120068;ENSG00000005073;ENSG00000128713;ENSG00000138356;ENSG00000105662;ENSG00000139438;ENSG00000232005	1	250	16074	14	19	236	16055	16324	0.1498732306036997
85	M1	e019_M1	TRUE	5.768435849924347e-5	36	16	4	0.25	0.1111111111111111	REAC:R-HSA-8939243	REAC	RUNX1 interacts with co-factors whose precise effect on RUNX1 targets is not known	10790	1823		GO:0036211	0	0.16666666666666666	ENSG00000090061;ENSG00000100523;ENSG00000089094;ENSG00000173889;ENSG00000010803;ENSG00000130940;ENSG00000183741;ENSG00000111752;ENSG00000180628;ENSG00000102098;ENSG00000185619;ENSG00000100307;ENSG00000156374;ENSG00000156860;ENSG00000166783;ENSG00000196369;ENSG00000198944;ENSG00000198879;ENSG00000272391;ENSG00000047634;ENSG00000010295;ENSG00000139351;ENSG00000111647;ENSG00000163935;ENSG00000166025;ENSG00000082438;ENSG00000085185;ENSG00000146872;ENSG00000102543;ENSG00000197721;ENSG00000119906;ENSG00000176635;ENSG00000176597;ENSG00000101493;ENSG00000171940;ENSG00000112787;ENSG00000196074;ENSG00000149050	1	36	10754	4	12	32	10742	10790	0.16483965988781138
86	M1	e019_M1	TRUE	7.409222259678352e-14	247	28	14	0.5	0.05668016194331984	REAC:R-HSA-425407	REAC	SLC-mediated transmembrane transport	10790	2024		GO:0032501;GO:0015849;GO:0042908	0	0.03333333333333333	ENSG00000138074;ENSG00000099992;ENSG00000137841;ENSG00000184895;ENSG00000109062;ENSG00000114796;ENSG00000125257;ENSG00000064547;ENSG00000174827;ENSG00000065054;ENSG00000185742;ENSG00000086015;ENSG00000163406;ENSG00000187961;ENSG00000172367;ENSG00000070019;ENSG00000079215;ENSG00000176463;ENSG00000188991;ENSG00000091138;ENSG00000146477;ENSG00000109572;ENSG00000197375;ENSG00000121314;ENSG00000069188;ENSG00000108474;ENSG00000139155;ENSG00000066230;ENSG00000131183;ENSG00000169860;ENSG00000197891;ENSG00000197208;ENSG00000084453;ENSG00000151704;ENSG00000168065;ENSG00000160321;ENSG00000124568	1	247	10543	14	14	233	10529	10790	0.1627198293651219
87	M1	e019_M1	TRUE	3.44500231787471e-12	129	19	10	0.5263157894736842	0.07751937984496124	KEGG:04114	KEGG	Oocyte meiosis	8161	263		GO:0007059	0	0.01818181818181818	ENSG00000135476;ENSG00000164611;ENSG00000141644;ENSG00000112640;ENSG00000138764;ENSG00000187522;ENSG00000142945;ENSG00000156858;ENSG00000172680;ENSG00000163909;ENSG00000163535;ENSG00000110422;ENSG00000134874;ENSG00000167995;ENSG00000183255;ENSG00000066027;ENSG00000078304;ENSG00000137266;ENSG00000166669;ENSG00000113196;ENSG00000154001;ENSG00000137713;ENSG00000129810;ENSG00000184887;ENSG00000164023;ENSG00000068971;ENSG00000005812;ENSG00000186017;ENSG00000243056;ENSG00000164107;ENSG00000164651;ENSG00000185112;ENSG00000196141;ENSG00000165462;ENSG00000009694;ENSG00000175322;ENSG00000130988	1	129	8032	10	9	119	8023	8161	0.1977202926804003
88	M1	e019_M1	TRUE	3.903258115529292e-12	128	36	11	0.3055555555555556	0.0859375	GO:0006888	GO:BP	endoplasmic reticulum to Golgi vesicle-mediated transport	16324	2600		GO:0051641;GO:0016192	0	0.047619047619047616	ENSG00000187258;ENSG00000086598;ENSG00000170348;ENSG00000164251;ENSG00000169223;ENSG00000109736;ENSG00000150961;ENSG00000099203;ENSG00000113615;ENSG00000186088;ENSG00000159685;ENSG00000165915;ENSG00000168938;ENSG00000205155;ENSG00000101310;ENSG00000164144;ENSG00000125255;ENSG00000159131;ENSG00000108465;ENSG00000111481;ENSG00000101438;ENSG00000186912;ENSG00000184840;ENSG00000121644;ENSG00000117500;ENSG00000146409;ENSG00000081760;ENSG00000101337;ENSG00000124302;ENSG00000141429;ENSG00000010319;ENSG00000165434;ENSG00000166557;ENSG00000158604;ENSG00000144278;ENSG00000112893;ENSG00000110900	1	128	16196	11	25	117	16171	16324	0.1586846218790147
89	M1	e019_M1	TRUE	2.5605157423493525e-19	196	27	16	0.5925925925925926	0.08163265306122448	REAC:R-HSA-112314	REAC	Neurotransmitter receptors and postsynaptic signal transmission	10790	1508		GO:0050789;GO:0007154	0	0.018518518518518517	ENSG00000135439;ENSG00000120251;ENSG00000155511;ENSG00000166592;ENSG00000119973;ENSG00000058404;ENSG00000145349;ENSG00000155974;ENSG00000148660;ENSG00000163596;ENSG00000146399;ENSG00000064419;ENSG00000180176;ENSG00000181467;ENSG00000244025;ENSG00000166111;ENSG00000171189;ENSG00000149782;ENSG00000166426;ENSG00000176723;ENSG00000152578;ENSG00000219545;ENSG00000144596;ENSG00000164418;ENSG00000105737;ENSG00000164488;ENSG00000150722;ENSG00000166862;ENSG00000196437;ENSG00000105605;ENSG00000215045;ENSG00000125675;ENSG00000163873;ENSG00000152208;ENSG00000163888;ENSG00000071677;ENSG00000149403	1	196	10594	16	11	180	10583	10790	0.21543385568369838
90	M1	e019_M1	TRUE	1.8452082944482386e-50	330	36	35	0.9722222222222222	0.10606060606060606	REAC:R-HSA-73894	REAC	DNA Repair	10790	423		GO:0006260;GO:0009059;GO:0006281;GO:0051276;GO:0050789	0	0.0038314176245210726	ENSG00000116062;ENSG00000113522;ENSG00000104320;ENSG00000166848;ENSG00000132604;ENSG00000139618;ENSG00000132383;ENSG00000106399;ENSG00000168496;ENSG00000095002;ENSG00000188486;ENSG00000253729;ENSG00000076242;ENSG00000100823;ENSG00000167670;ENSG00000051180;ENSG00000149311;ENSG00000079246;ENSG00000175054;ENSG00000183765;ENSG00000132646;ENSG00000197299;ENSG00000035928;ENSG00000012048;ENSG00000149554;ENSG00000067369;ENSG00000117748;ENSG00000147601;ENSG00000062822;ENSG00000020922;ENSG00000154767;ENSG00000165392;ENSG00000138376;ENSG00000073050;ENSG00000085224;ENSG00000196419;ENSG00000144554	1	330	10460	35	1	295	10459	10790	0.3164091278550755
91	M1	e019_M1	TRUE	1.8727335529074027e-17	144	34	15	0.4411764705882353	0.10416666666666667	REAC:R-HSA-8856828	REAC	Clathrin-mediated endocytosis	10790	357		GO:0016192;GO:0006508	0	0.03125	ENSG00000168615;ENSG00000177885;ENSG00000185527;ENSG00000169891;ENSG00000178996;ENSG00000137845;ENSG00000117560;ENSG00000140600;ENSG00000106266;ENSG00000197959;ENSG00000158517;ENSG00000100351;ENSG00000151422;ENSG00000187239;ENSG00000109686;ENSG00000151693;ENSG00000138814;ENSG00000106976;ENSG00000148848;ENSG00000076201;ENSG00000123329;ENSG00000147010;ENSG00000125733;ENSG00000153317;ENSG00000061938;ENSG00000165912;ENSG00000008056;ENSG00000107295;ENSG00000136717;ENSG00000100485;ENSG00000151694;ENSG00000159082;ENSG00000079805;ENSG00000043591;ENSG00000151651;ENSG00000130340;ENSG00000078053	1	144	10646	15	19	129	10627	10790	0.20962016378710124
92	M1	e019_M1	TRUE	3.649034371929478e-37	752	37	33	0.8918918918918919	0.043882978723404256	GO:0007186	GO:BP	G protein-coupled receptor signaling pathway	16324	2809		GO:0050789;GO:0007154;GO:0050896	0	0.011363636363636364	ENSG00000168539;ENSG00000181104;ENSG00000156052;ENSG00000135914;ENSG00000178394;ENSG00000164082;ENSG00000167600;ENSG00000125910;ENSG00000196277;ENSG00000170989;ENSG00000179546;ENSG00000006638;ENSG00000116741;ENSG00000163823;ENSG00000164411;ENSG00000135312;ENSG00000088256;ENSG00000183840;ENSG00000182621;ENSG00000116014;ENSG00000126266;ENSG00000102468;ENSG00000172020;ENSG00000169676;ENSG00000076928;ENSG00000155903;ENSG00000152939;ENSG00000181072;ENSG00000124493;ENSG00000060558;ENSG00000100739;ENSG00000213694;ENSG00000160683;ENSG00000146535;ENSG00000267534;ENSG00000156049;ENSG00000120063	1	752	15572	33	4	719	15568	16324	0.1923119058979313
94	M1	e019_M1	TRUE	9.51479205068316e-11	62	13	7	0.5384615384615384	0.11290322580645161	KEGG:03250	KEGG	Viral life cycle - HIV-1	8161	221		GO:0006351;GO:0006354;GO:0050789	0	0.05555555555555555	ENSG00000002746;ENSG00000145088;ENSG00000115750;ENSG00000144597;ENSG00000072364;ENSG00000162777;ENSG00000160993;ENSG00000105656;ENSG00000138468;ENSG00000173611;ENSG00000078403;ENSG00000167232;ENSG00000118985;ENSG00000186453;ENSG00000166012;ENSG00000171843;ENSG00000130382;ENSG00000139645;ENSG00000162931;ENSG00000148704;ENSG00000166326;ENSG00000171056;ENSG00000103168;ENSG00000135899;ENSG00000172493;ENSG00000128886;ENSG00000023191;ENSG00000143498;ENSG00000105707;ENSG00000104885;ENSG00000169385;ENSG00000136169;ENSG00000144218;ENSG00000082258;ENSG00000204764;ENSG00000128915	1	62	8099	7	6	55	8093	8161	0.24420897832712682
95	M1	e019_M1	TRUE	6.739741683434469e-28	101	29	18	0.6206896551724138	0.1782178217821782	REAC:R-HSA-977606	REAC	Regulation of Complement cascade	10790	1873		GO:0002376;GO:0050789;GO:0050896	0	0.041666666666666664	ENSG00000107611;ENSG00000166126;ENSG00000125730;ENSG00000106804;ENSG00000197405;ENSG00000000971;ENSG00000120054;ENSG00000178772;ENSG00000039537;ENSG00000066651;ENSG00000153563;ENSG00000172116;ENSG00000134365;ENSG00000205403;ENSG00000146038;ENSG00000153823;ENSG00000149021;ENSG00000134812;ENSG00000134830;ENSG00000176919;ENSG00000157131;ENSG00000113600;ENSG00000134389;ENSG00000145321;ENSG00000085063;ENSG00000169908;ENSG00000178904;ENSG00000175274;ENSG00000052344;ENSG00000116785;ENSG00000152592;ENSG00000021852;ENSG00000112936;ENSG00000075461;ENSG00000135048;ENSG00000081800	1	101	10689	18	11	83	10678	10790	0.3295641761058304
96	M1	e019_M1	TRUE	3.7136597023547767e-25	31	34	13	0.38235294117647056	0.41935483870967744	GO:0099022	GO:BP	vesicle tethering	16324	20073		GO:0061024;GO:0065003;GO:0016050	0	0.030303030303030304	ENSG00000170266;ENSG00000167515;ENSG00000188283;ENSG00000196459;ENSG00000015592;ENSG00000132854;ENSG00000007255;ENSG00000054116;ENSG00000107938;ENSG00000171853;ENSG00000174446;ENSG00000132405;ENSG00000101746;ENSG00000023608;ENSG00000181029;ENSG00000236699;ENSG00000146826;ENSG00000164975;ENSG00000165684;ENSG00000168497;ENSG00000170043;ENSG00000167632;ENSG00000187268;ENSG00000243725;ENSG00000160218;ENSG00000182400;ENSG00000153339;ENSG00000137502;ENSG00000197165;ENSG00000094975;ENSG00000256060;ENSG00000104976;ENSG00000168538;ENSG00000235173;ENSG00000173626;ENSG00000145309	1	31	16293	13	21	18	16272	16324	0.39923275300758054
98	M1	e019_M1	TRUE	0.0038601921315043527	247	24	6	0.25	0.024291497975708502	REAC:R-HSA-425407	REAC	SLC-mediated transmembrane transport	10790	2024		GO:0006865	0	0.25	ENSG00000132517;ENSG00000174327;ENSG00000265107;ENSG00000138944;ENSG00000139514;ENSG00000151690;ENSG00000131386;ENSG00000126251;ENSG00000121634;ENSG00000165794;ENSG00000181704;ENSG00000105369;ENSG00000029364;ENSG00000105677;ENSG00000139644;ENSG00000135052;ENSG00000185897;ENSG00000181885;ENSG00000204979;ENSG00000157593;ENSG00000136052;ENSG00000165474;ENSG00000164707;ENSG00000133065;ENSG00000189143;ENSG00000122557;ENSG00000213658;ENSG00000144057;ENSG00000184349;ENSG00000174417;ENSG00000155755;ENSG00000182544;ENSG00000197646;ENSG00000144648;ENSG00000040487;ENSG00000127774	1	247	10543	6	18	241	10525	10790	0.07169726019725692
99	M1	e019_M1	TRUE	9.076729199563443e-11	239	22	11	0.5	0.04602510460251046	REAC:R-HSA-8951664	REAC	Neddylation	10790	1474		GO:0051641;GO:0016192	0	0.25	ENSG00000169016;ENSG00000150527;ENSG00000165617;ENSG00000169946;ENSG00000116809;ENSG00000173163;ENSG00000143033;ENSG00000008083;ENSG00000067082;ENSG00000139154;ENSG00000101997;ENSG00000179111;ENSG00000169019;ENSG00000140365;ENSG00000125633;ENSG00000160796;ENSG00000157538;ENSG00000150773;ENSG00000114744;ENSG00000148444;ENSG00000145781;ENSG00000170619;ENSG00000196233;ENSG00000266074;ENSG00000188243;ENSG00000180964;ENSG00000110442;ENSG00000119979;ENSG00000184828;ENSG00000108799;ENSG00000149600;ENSG00000137948;ENSG00000198918;ENSG00000103544;ENSG00000180592	1	239	10551	11	11	228	10540	10790	0.1467611018421478
100	M1	e019_M1	TRUE	5.345113438953752e-4	744	29	10	0.3448275862068966	0.013440860215053764	GO:0098609	GO:BP	cell-cell adhesion	16324	19855		GO:0007155	0	0.5	ENSG00000062038;ENSG00000240184;ENSG00000196422;ENSG00000075275;ENSG00000118946;ENSG00000148468;ENSG00000189184;ENSG00000066032;ENSG00000103335;ENSG00000119004;ENSG00000008300;ENSG00000254221;ENSG00000165194;ENSG00000253910;ENSG00000174928;ENSG00000144369;ENSG00000261934;ENSG00000125247;ENSG00000168903;ENSG00000113555;ENSG00000172828;ENSG00000143126;ENSG00000013523;ENSG00000169851;ENSG00000150394;ENSG00000127418;ENSG00000280165;ENSG00000253873;ENSG00000253159;ENSG00000161682;ENSG00000278565;ENSG00000276547;ENSG00000262209;ENSG00000112852;ENSG00000253537	1	744	15580	10	19	734	15561	16324	0.06052894780722254
101	M1	e019_M1	TRUE	2.3324083273754947e-11	168	18	10	0.5555555555555556	0.05952380952380952	KEGG:04141	KEGG	Protein processing in endoplasmic reticulum	8161	273		GO:0009057;GO:0006508;GO:0050896	0	0.07142857142857142	ENSG00000070010;ENSG00000180667;ENSG00000169696;ENSG00000104881;ENSG00000088833;ENSG00000146426;ENSG00000155368;ENSG00000182446;ENSG00000183137;ENSG00000162543;ENSG00000104691;ENSG00000167671;ENSG00000137055;ENSG00000136935;ENSG00000135821;ENSG00000115685;ENSG00000158552;ENSG00000034533;ENSG00000143845;ENSG00000173960;ENSG00000215114;ENSG00000164902;ENSG00000151092;ENSG00000140798;ENSG00000183475;ENSG00000198650;ENSG00000138182;ENSG00000203780;ENSG00000101220;ENSG00000137842;ENSG00000175073;ENSG00000198168;ENSG00000137869;ENSG00000163053;ENSG00000117543	1	168	7993	10	8	158	7985	8161	0.17713613589400254
102	M1	e019_M1	TRUE	2.1836365198772644e-53	108	33	30	0.9090909090909091	0.2777777777777778	KEGG:03013	KEGG	Nucleocytoplasmic transport	8161	209		GO:0015931;GO:0015031	0	0.00909090909090909	ENSG00000102900;ENSG00000153201;ENSG00000160789;ENSG00000124789;ENSG00000114030;ENSG00000120253;ENSG00000095319;ENSG00000047410;ENSG00000101146;ENSG00000153207;ENSG00000108424;ENSG00000162231;ENSG00000155561;ENSG00000111581;ENSG00000136352;ENSG00000182481;ENSG00000176046;ENSG00000102753;ENSG00000110713;ENSG00000213024;ENSG00000030066;ENSG00000085415;ENSG00000136997;ENSG00000157020;ENSG00000113569;ENSG00000186432;ENSG00000126883;ENSG00000125450;ENSG00000180198;ENSG00000069248;ENSG00000163904;ENSG00000132341;ENSG00000093000;ENSG00000100401;ENSG00000065150	1	108	8053	30	3	78	8050	8161	0.49952425333021244
103	M1	e019_M1	TRUE	4.935659159750571e-13	118	33	11	0.3333333333333333	0.09322033898305085	GO:0006820	GO:BP	monoatomic anion transport	16324	2553		GO:0016043;GO:0065008;GO:0006865;GO:0006811	0	0.023809523809523808	ENSG00000143753;ENSG00000164889;ENSG00000113621;ENSG00000143324;ENSG00000142494;ENSG00000100372;ENSG00000101842;ENSG00000124067;ENSG00000171488;ENSG00000171492;ENSG00000160801;ENSG00000136802;ENSG00000197147;ENSG00000140199;ENSG00000112759;ENSG00000124785;ENSG00000146828;ENSG00000100263;ENSG00000171017;ENSG00000139370;ENSG00000132911;ENSG00000113504;ENSG00000145495;ENSG00000135318;ENSG00000112337;ENSG00000101974;ENSG00000149150;ENSG00000165349;ENSG00000104549;ENSG00000160013;ENSG00000114544;ENSG00000121577;ENSG00000131389;ENSG00000070214;ENSG00000188394	1	118	16206	11	22	107	16184	16324	0.17325582249500548
104	M1	e019_M1	TRUE	4.700888888618983e-19	23	33	10	0.30303030303030304	0.43478260869565216	GO:1902455	GO:BP	negative regulation of stem cell population maintenance	16324	23330		GO:0032501;GO:0050789;GO:0032502	0	0.02631578947368421	ENSG00000168556;ENSG00000123933;ENSG00000009950;ENSG00000108788;ENSG00000059728;ENSG00000164105;ENSG00000030419;ENSG00000100916;ENSG00000119950;ENSG00000127511;ENSG00000153922;ENSG00000105856;ENSG00000054267;ENSG00000040633;ENSG00000174744;ENSG00000123411;ENSG00000111707;ENSG00000251380;ENSG00000114115;ENSG00000179630;ENSG00000212899;ENSG00000213347;ENSG00000164576;ENSG00000121207;ENSG00000153487;ENSG00000032219;ENSG00000146247;ENSG00000070444;ENSG00000164684;ENSG00000186918;ENSG00000132823;ENSG00000155307;ENSG00000136715;ENSG00000114113	1	23	16301	10	23	13	16278	16324	0.3619100970485666
105	M1	e019_M1	TRUE	4.933580071228954e-38	55	25	19	0.76	0.34545454545454546	REAC:R-HSA-9639288	REAC	Amino acids regulate mTORC1	10790	136		GO:0050789;GO:0007154;GO:0050896	0	0.021739130434782608	ENSG00000239282;ENSG00000274070;ENSG00000165115;ENSG00000134248;ENSG00000116954;ENSG00000025039;ENSG00000083750;ENSG00000114388;ENSG00000145979;ENSG00000155876;ENSG00000106268;ENSG00000171916;ENSG00000149357;ENSG00000161204;ENSG00000198000;ENSG00000100150;ENSG00000051620;ENSG00000221926;ENSG00000188186;ENSG00000103148;ENSG00000052795;ENSG00000164654;ENSG00000177058;ENSG00000142207;ENSG00000080546;ENSG00000103091;ENSG00000127580;ENSG00000161791;ENSG00000140006;ENSG00000164603;ENSG00000135763;ENSG00000186895;ENSG00000185163;ENSG00000169618	1	55	10735	19	6	36	10729	10790	0.5108495726335697
108	M1	e019_M1	TRUE	2.91896534770028e-11	59	21	8	0.38095238095238093	0.13559322033898305	REAC:R-HSA-6790901	REAC	rRNA modification in the nucleus and cytosol	10790	2590		GO:0044419;GO:0042254;GO:0006396	0	0.03571428571428571	ENSG00000125968;ENSG00000071462;ENSG00000241945;ENSG00000177971;ENSG00000065548;ENSG00000122068;ENSG00000108651;ENSG00000166634;ENSG00000136718;ENSG00000131652;ENSG00000033050;ENSG00000163634;ENSG00000145725;ENSG00000105821;ENSG00000132361;ENSG00000132467;ENSG00000171163;ENSG00000105321;ENSG00000160392;ENSG00000100296;ENSG00000166704;ENSG00000196652;ENSG00000133316;ENSG00000114767;ENSG00000198157;ENSG00000136286;ENSG00000051596;ENSG00000150990;ENSG00000134987;ENSG00000176566;ENSG00000005100;ENSG00000168781;ENSG00000055483;ENSG00000162522	1	59	10731	8	13	51	10718	10790	0.22484806094953355
109	M1	e019_M1	TRUE	3.784010935764867e-21	294	29	20	0.6896551724137931	0.06802721088435375	KEGG:04010	KEGG	MAPK signaling pathway	8161	238		GO:0050789;GO:0050896	0	0.013333333333333334	ENSG00000089022;ENSG00000162493;ENSG00000165682;ENSG00000188130;ENSG00000108861;ENSG00000107968;ENSG00000169967;ENSG00000065559;ENSG00000076984;ENSG00000085511;ENSG00000108984;ENSG00000185386;ENSG00000162889;ENSG00000171435;ENSG00000156711;ENSG00000103319;ENSG00000091436;ENSG00000149930;ENSG00000114738;ENSG00000073803;ENSG00000185650;ENSG00000111266;ENSG00000120129;ENSG00000198131;ENSG00000100884;ENSG00000166452;ENSG00000139625;ENSG00000189042;ENSG00000141639;ENSG00000171051;ENSG00000158050;ENSG00000140795;ENSG00000114779;ENSG00000198771	1	294	7867	20	9	274	7858	8161	0.20945828589113774
110	M1	e019_M1	TRUE	2.9320872042802443e-9	291	30	11	0.36666666666666664	0.037800687285223365	GO:0006302	GO:BP	double-strand break repair	16324	2154		GO:0006266;GO:0006281	0	0.05555555555555555	ENSG00000152422;ENSG00000174405;ENSG00000175198;ENSG00000169598;ENSG00000070501;ENSG00000129484;ENSG00000169621;ENSG00000182952;ENSG00000039650;ENSG00000105866;ENSG00000121864;ENSG00000137074;ENSG00000101457;ENSG00000174306;ENSG00000146776;ENSG00000090447;ENSG00000042088;ENSG00000178381;ENSG00000114626;ENSG00000146909;ENSG00000187736;ENSG00000107447;ENSG00000151500;ENSG00000140264;ENSG00000067798;ENSG00000163637;ENSG00000144354;ENSG00000162599;ENSG00000056050;ENSG00000176842;ENSG00000115112;ENSG00000124496;ENSG00000156030;ENSG00000188573	1	291	16033	11	19	280	16014	16324	0.11312170327710393
111	M1	e019_M1	TRUE	9.129339999593507e-40	185	33	25	0.7575757575757576	0.13513513513513514	GO:0071805	GO:BP	potassium ion transmembrane transport	16324	17873		GO:0065009;GO:0050789;GO:0006811;GO:0065008	0	0.010869565217391304	ENSG00000159248;ENSG00000053918;ENSG00000198668;ENSG00000158445;ENSG00000055118;ENSG00000126391;ENSG00000129159;ENSG00000026559;ENSG00000162975;ENSG00000180509;ENSG00000175538;ENSG00000081248;ENSG00000075043;ENSG00000035664;ENSG00000176076;ENSG00000185760;ENSG00000175548;ENSG00000145555;ENSG00000143473;ENSG00000164794;ENSG00000182674;ENSG00000137825;ENSG00000168263;ENSG00000170615;ENSG00000157388;ENSG00000159197;ENSG00000117013;ENSG00000184156;ENSG00000171126;ENSG00000168418;ENSG00000178342;ENSG00000166006;ENSG00000158286	1	185	16139	25	8	160	16131	16324	0.3172967579347852
112	M1	e019_M1	TRUE	2.0700823071436068e-30	25	25	14	0.56	0.56	REAC:R-HSA-8982491	REAC	Glycogen metabolism	10790	1010		GO:0005976;GO:0006112	0	0.025	ENSG00000104904;ENSG00000104812;ENSG00000056998;ENSG00000068308;ENSG00000164185;ENSG00000158526;ENSG00000143450;ENSG00000163754;ENSG00000119938;ENSG00000068976;ENSG00000100504;ENSG00000186732;ENSG00000161217;ENSG00000100994;ENSG00000132825;ENSG00000155096;ENSG00000196090;ENSG00000180304;ENSG00000139354;ENSG00000118804;ENSG00000102230;ENSG00000103111;ENSG00000132434;ENSG00000185100;ENSG00000102893;ENSG00000156873;ENSG00000067177;ENSG00000044446;ENSG00000142920;ENSG00000114480;ENSG00000111713;ENSG00000164776;ENSG00000116885	1	25	10765	14	11	11	10754	10790	0.5589781699953553
114	M1	e019_M1	TRUE	5.132071958467723e-5	35	16	4	0.25	0.11428571428571428	REAC:R-HSA-432720	REAC	Lysosome Vesicle Biogenesis	10790	1276		NA	0	0.3333333333333333	ENSG00000181090;ENSG00000172500;ENSG00000101134;ENSG00000152455;ENSG00000011451;ENSG00000081051;ENSG00000153046;ENSG00000161692;ENSG00000148143;ENSG00000171060;ENSG00000166446;ENSG00000112200;ENSG00000157578;ENSG00000178814;ENSG00000155545;ENSG00000170779;ENSG00000105556;ENSG00000092094;ENSG00000131848;ENSG00000100478;ENSG00000029639;ENSG00000188010;ENSG00000134262;ENSG00000196511;ENSG00000180902;ENSG00000221838;ENSG00000171467;ENSG00000081014;ENSG00000122482;ENSG00000203785;ENSG00000006116;ENSG00000130584;ENSG00000204611	1	35	10755	4	12	31	10743	10790	0.1672329661030077
115	M1	e019_M1	TRUE	6.273024821625687e-45	239	33	30	0.9090909090909091	0.12552301255230125	REAC:R-HSA-8951664	REAC	Neddylation	10790	1474		GO:0009057;GO:0050789;GO:0036211;GO:0006508	0	0.017543859649122806	ENSG00000163960;ENSG00000130725;ENSG00000113558;ENSG00000166266;ENSG00000144524;ENSG00000134086;ENSG00000167986;ENSG00000139842;ENSG00000113851;ENSG00000158290;ENSG00000168090;ENSG00000049167;ENSG00000036257;ENSG00000100387;ENSG00000166200;ENSG00000143476;ENSG00000129559;ENSG00000134574;ENSG00000198612;ENSG00000111652;ENSG00000103363;ENSG00000141030;ENSG00000154582;ENSG00000169727;ENSG00000108094;ENSG00000138663;ENSG00000143207;ENSG00000145041;ENSG00000121022;ENSG00000119599;ENSG00000187837;ENSG00000043093;ENSG00000145604	1	239	10551	30	3	209	10548	10790	0.33379642953382455
116	M1	e019_M1	TRUE	2.505799663424617e-28	140	27	19	0.7037037037037037	0.1357142857142857	REAC:R-HSA-1474228	REAC	Degradation of the extracellular matrix	10790	692		GO:0008152;GO:0045229;GO:0022411;GO:0050896;GO:0043062	0	0.022222222222222223	ENSG00000137673;ENSG00000118113;ENSG00000120659;ENSG00000166670;ENSG00000139329;ENSG00000196611;ENSG00000137745;ENSG00000186340;ENSG00000145681;ENSG00000035862;ENSG00000123342;ENSG00000149968;ENSG00000087245;ENSG00000196104;ENSG00000154736;ENSG00000116977;ENSG00000157150;ENSG00000003436;ENSG00000111799;ENSG00000132692;ENSG00000156103;ENSG00000167346;ENSG00000126838;ENSG00000100985;ENSG00000107742;ENSG00000158859;ENSG00000170498;ENSG00000157766;ENSG00000108688;ENSG00000102265;ENSG00000152377;ENSG00000100234;ENSG00000157227	1	140	10650	19	8	121	10642	10790	0.30570697891658055
117	M1	e019_M1	TRUE	1.8515972052184397e-6	249	13	7	0.5384615384615384	0.028112449799196786	KEGG:05132	KEGG	Salmonella infection	8161	422		GO:0008655	0	0.043478260869565216	ENSG00000137100;ENSG00000170962;ENSG00000127831;ENSG00000165169;ENSG00000115073;ENSG00000142186;ENSG00000104671;ENSG00000187051;ENSG00000151229;ENSG00000177963;ENSG00000186638;ENSG00000164188;ENSG00000088782;ENSG00000109466;ENSG00000124225;ENSG00000124237;ENSG00000166847;ENSG00000168890;ENSG00000094841;ENSG00000273045;ENSG00000159055;ENSG00000130717;ENSG00000132912;ENSG00000121350;ENSG00000143179;ENSG00000131966;ENSG00000198276;ENSG00000006747;ENSG00000128872;ENSG00000245680;ENSG00000135407;ENSG00000115539	1	249	7912	7	6	242	7906	8161	0.11796907780476716
118	M1	e019_M1	TRUE	8.105860955092012e-17	100	23	12	0.5217391304347826	0.12	REAC:R-HSA-5668541	REAC	TNFR2 non-canonical NF-kB pathway	10790	2315		GO:0002376;GO:0044419;GO:0050896	0	0.14285714285714285	ENSG00000125726;ENSG00000139193;ENSG00000181634;ENSG00000215788;ENSG00000102524;ENSG00000159958;ENSG00000177575;ENSG00000240505;ENSG00000239697;ENSG00000006327;ENSG00000167751;ENSG00000112379;ENSG00000100376;ENSG00000048462;ENSG00000161955;ENSG00000124107;ENSG00000149657;ENSG00000110841;ENSG00000165996;ENSG00000124157;ENSG00000243509;ENSG00000164252;ENSG00000124233;ENSG00000142515;ENSG00000185674;ENSG00000166482;ENSG00000166788;ENSG00000006282;ENSG00000079689;ENSG00000087494;ENSG00000073849;ENSG00000155893	1	100	10690	12	11	88	10679	10790	0.2471830538699055
119	M1	e019_M1	TRUE	1.3719294271468345e-16	366	24	17	0.7083333333333334	0.04644808743169399	KEGG:04080	KEGG	Neuroactive ligand-receptor interaction	8161	258		GO:0009914;GO:0050789;GO:0015833;GO:0046903	0	0.02564102564102564	ENSG00000169836;ENSG00000115263;ENSG00000152207;ENSG00000006128;ENSG00000075073;ENSG00000010310;ENSG00000159224;ENSG00000118702;ENSG00000065325;ENSG00000008517;ENSG00000112818;ENSG00000141434;ENSG00000213420;ENSG00000197635;ENSG00000219200;ENSG00000146469;ENSG00000110245;ENSG00000172058;ENSG00000120937;ENSG00000078098;ENSG00000127324;ENSG00000168955;ENSG00000165269;ENSG00000152266;ENSG00000183844;ENSG00000142484;ENSG00000164129;ENSG00000134443;ENSG00000131096;ENSG00000173198;ENSG00000176358;ENSG00000147437	1	366	7795	17	7	349	7788	8161	0.17410046395003967
120	M1	e019_M1	TRUE	3.6336332245634953e-9	39	16	6	0.375	0.15384615384615385	REAC:R-HSA-6783310	REAC	Fanconi Anemia Pathway	10790	886		GO:0051276;GO:0006259;GO:0050789;GO:0050896	0	0.02631578947368421	ENSG00000172732;ENSG00000154920;ENSG00000132207;ENSG00000188827;ENSG00000175595;ENSG00000173846;ENSG00000173273;ENSG00000111145;ENSG00000109339;ENSG00000196793;ENSG00000107771;ENSG00000165801;ENSG00000196700;ENSG00000107854;ENSG00000164896;ENSG00000118655;ENSG00000280789;ENSG00000131370;ENSG00000120733;ENSG00000265817;ENSG00000066735;ENSG00000161082;ENSG00000187783;ENSG00000085999;ENSG00000160282;ENSG00000151465;ENSG00000138459;ENSG00000155090;ENSG00000110756;ENSG00000145014;ENSG00000133454;ENSG00000149346	1	39	10751	6	10	33	10741	10790	0.23848507712881814
121	M1	e019_M1	TRUE	2.4344752275607915e-6	44	19	5	0.2631578947368421	0.11363636363636363	KEGG:00970	KEGG	Aminoacyl-tRNA biosynthesis	8161	153		GO:0006520;GO:0016070	0	0.07692307692307693	ENSG00000116120;ENSG00000158796;ENSG00000204065;ENSG00000090861;ENSG00000143742;ENSG00000133789;ENSG00000012211;ENSG00000074603;ENSG00000161996;ENSG00000149929;ENSG00000185418;ENSG00000138030;ENSG00000185238;ENSG00000130227;ENSG00000152952;ENSG00000116747;ENSG00000169764;ENSG00000110048;ENSG00000128536;ENSG00000102904;ENSG00000143374;ENSG00000131459;ENSG00000153037;ENSG00000031823;ENSG00000198380;ENSG00000163738;ENSG00000007520;ENSG00000134440;ENSG00000171806;ENSG00000154258;ENSG00000122674;ENSG00000100883	1	44	8117	5	14	39	8103	8161	0.17004224176525362
123	M1	e019_M1	TRUE	6.803489189138791e-18	24	19	9	0.47368421052631576	0.375	REAC:R-HSA-6783589	REAC	Interleukin-6 family signaling	10790	1193		GO:0050789;GO:0036211;GO:0006793	0	0.037037037037037035	ENSG00000136244;ENSG00000159723;ENSG00000122756;ENSG00000242689;ENSG00000006016;ENSG00000175505;ENSG00000160712;ENSG00000137642;ENSG00000151892;ENSG00000168621;ENSG00000113594;ENSG00000150281;ENSG00000164946;ENSG00000163874;ENSG00000168515;ENSG00000077458;ENSG00000128342;ENSG00000144647;ENSG00000198759;ENSG00000204548;ENSG00000003147;ENSG00000150893;ENSG00000163377;ENSG00000167941;ENSG00000162623;ENSG00000112293;ENSG00000178199;ENSG00000146530;ENSG00000188811;ENSG00000112761;ENSG00000204140	1	24	10766	9	10	15	10756	10790	0.42032208511933816
124	M1	e019_M1	TRUE	1.0650780725951745e-8	5	19	4	0.21052631578947367	0.8	REAC:R-HSA-5624138	REAC	Trafficking of myristoylated proteins to the cilium	10790	2401		NA	0	0.2	ENSG00000156973;ENSG00000163606;ENSG00000109103;ENSG00000213465;ENSG00000073417;ENSG00000102931;ENSG00000188211;ENSG00000150787;ENSG00000183638;ENSG00000182108;ENSG00000160191;ENSG00000141556;ENSG00000138669;ENSG00000198398;ENSG00000184601;ENSG00000138175;ENSG00000235162;ENSG00000109193;ENSG00000182575;ENSG00000113971;ENSG00000102218;ENSG00000172113;ENSG00000175970;ENSG00000107719;ENSG00000151014;ENSG00000129353;ENSG00000158764;ENSG00000179914;ENSG00000131378;ENSG00000169570;ENSG00000213214	1	5	10785	4	15	1	10770	10790	0.40994402534038493
125	M1	e019_M1	TRUE	2.5143305053522207e-23	20	30	11	0.36666666666666664	0.55	GO:0033141	GO:BP	positive regulation of peptidyl-serine phosphorylation of STAT protein	16324	8485		GO:0002376;GO:0008283;GO:0001775;GO:0006793;GO:0050896;GO:0050789;GO:0036211;GO:0044419	0	0.011764705882352941	ENSG00000171855;ENSG00000159110;ENSG00000124731;ENSG00000168267;ENSG00000008438;ENSG00000110169;ENSG00000026751;ENSG00000140564;ENSG00000142961;ENSG00000135413;ENSG00000153827;ENSG00000183346;ENSG00000126705;ENSG00000154734;ENSG00000188379;ENSG00000120242;ENSG00000103174;ENSG00000050767;ENSG00000144357;ENSG00000236637;ENSG00000137080;ENSG00000147873;ENSG00000233816;ENSG00000124232;ENSG00000145882;ENSG00000147869;ENSG00000228083;ENSG00000120235;ENSG00000234829;ENSG00000214042;ENSG00000131044	1	20	16304	11	19	9	16285	16324	0.4482590986708114
126	M1	e019_M1	TRUE	8.774499405333128e-12	15	17	6	0.35294117647058826	0.4	REAC:R-HSA-1362300	REAC	Transcription of E2F targets under negative control by p107 (RBL1) and p130 (RBL2) in complex with HDAC1	10790	2404		GO:0050789;GO:0032502	0	0.0625	ENSG00000165891;ENSG00000129173;ENSG00000156802;ENSG00000114126;ENSG00000133740;ENSG00000267796;ENSG00000137804;ENSG00000101057;ENSG00000262993;ENSG00000183814;ENSG00000146918;ENSG00000189308;ENSG00000162063;ENSG00000039600;ENSG00000166478;ENSG00000169347;ENSG00000205659;ENSG00000007968;ENSG00000173456;ENSG00000167548;ENSG00000185697;ENSG00000181751;ENSG00000145868;ENSG00000126453;ENSG00000185164;ENSG00000101544;ENSG00000243480;ENSG00000140534;ENSG00000118263;ENSG00000180979;ENSG00000160094	1	15	10775	6	11	9	10764	10790	0.3748104101036565
128	M1	e019_M1	TRUE	9.124509379524452e-35	394	28	25	0.8928571428571429	0.06345177664974619	GO:0008380	GO:BP	RNA splicing	16324	3261		GO:0050789;GO:0000375	0	0.03225806451612903	ENSG00000029363;ENSG00000179335;ENSG00000112081;ENSG00000115875;ENSG00000136450;ENSG00000113141;ENSG00000150459;ENSG00000122692;ENSG00000136527;ENSG00000153914;ENSG00000164548;ENSG00000188529;ENSG00000100650;ENSG00000111786;ENSG00000157212;ENSG00000116350;ENSG00000108848;ENSG00000007392;ENSG00000135250;ENSG00000070950;ENSG00000134748;ENSG00000124193;ENSG00000167258;ENSG00000161547;ENSG00000116754;ENSG00000205937;ENSG00000096063;ENSG00000013441;ENSG00000102021;ENSG00000054118;ENSG00000132485	1	394	15930	25	3	369	15927	16324	0.23463314715907777
129	M1	e019_M1	TRUE	5.541971208752379e-26	26	29	13	0.4482758620689655	0.5	REAC:R-HSA-389960	REAC	Formation of tubulin folding intermediates by CCT/TriC	10790	921		GO:0051641;GO:0051234;GO:0050789	0	0.009615384615384616	ENSG00000131462;ENSG00000165280;ENSG00000167552;ENSG00000113575;ENSG00000261609;ENSG00000169067;ENSG00000167553;ENSG00000089597;ENSG00000239672;ENSG00000137285;ENSG00000117399;ENSG00000129521;ENSG00000166226;ENSG00000131238;ENSG00000104695;ENSG00000221914;ENSG00000156261;ENSG00000123416;ENSG00000089289;ENSG00000108840;ENSG00000132141;ENSG00000120438;ENSG00000146731;ENSG00000154473;ENSG00000108679;ENSG00000150753;ENSG00000115484;ENSG00000135624;ENSG00000163468;ENSG00000119414;ENSG00000116663	1	26	10764	13	16	13	10748	10790	0.47209041524426404
131	M1	e019_M1	TRUE	8.496046500322263e-9	132	18	8	0.4444444444444444	0.06060606060606061	KEGG:04142	KEGG	Lysosome	8161	274		NA	0	0.14285714285714285	ENSG00000144749;ENSG00000144802;ENSG00000100299;ENSG00000198799;ENSG00000198892;ENSG00000100418;ENSG00000089248;ENSG00000203857;ENSG00000197586;ENSG00000171302;ENSG00000203859;ENSG00000128242;ENSG00000064042;ENSG00000139263;ENSG00000110013;ENSG00000172410;ENSG00000197253;ENSG00000006118;ENSG00000170382;ENSG00000079263;ENSG00000141012;ENSG00000181523;ENSG00000174080;ENSG00000108784;ENSG00000138744;ENSG00000113273;ENSG00000137976;ENSG00000109323;ENSG00000072954;ENSG00000177202	1	132	8029	8	10	124	8019	8161	0.15962000765760004
132	M1	e019_M1	TRUE	6.000649187229621e-12	49	21	8	0.38095238095238093	0.16326530612244897	REAC:R-HSA-373752	REAC	Netrin-1 signaling	10790	1500		GO:0032989	0	0.019230769230769232	ENSG00000187323;ENSG00000113763;ENSG00000065320;ENSG00000067141;ENSG00000107731;ENSG00000171587;ENSG00000162068;ENSG00000188986;ENSG00000182168;ENSG00000101158;ENSG00000145191;ENSG00000164008;ENSG00000111361;ENSG00000178928;ENSG00000179046;ENSG00000074527;ENSG00000100505;ENSG00000256061;ENSG00000163462;ENSG00000185049;ENSG00000115211;ENSG00000100442;ENSG00000119718;ENSG00000125848;ENSG00000145934;ENSG00000162490;ENSG00000150471;ENSG00000070785;ENSG00000170425;ENSG00000139726	1	49	10741	8	13	41	10728	10790	0.2472210645539468
133	M1	e019_M1	TRUE	3.2961946553410293e-4	2	12	2	0.16666666666666666	1	REAC:R-HSA-3359473	REAC	Defective MMADHC causes MMAHCD	10790	562		NA	0	0.2	ENSG00000131979;ENSG00000127837;ENSG00000132763;ENSG00000168288;ENSG00000070778;ENSG00000117000;ENSG00000117523;ENSG00000186591;ENSG00000141084;ENSG00000128585;ENSG00000213995;ENSG00000101193;ENSG00000153561;ENSG00000141433;ENSG00000119801;ENSG00000182150;ENSG00000092051;ENSG00000145916;ENSG00000141034;ENSG00000162923;ENSG00000152484;ENSG00000118557;ENSG00000183036;ENSG00000090316;ENSG00000163216;ENSG00000136883;ENSG00000122783;ENSG00000153774;ENSG00000178372;ENSG00000169885	1	2	10788	2	10	0	10778	10790	0.4080590325192136
134	M1	e019_M1	TRUE	1.316918550955266e-9	643	24	13	0.5416666666666666	0.02021772939346812	GO:0030036	GO:BP	actin cytoskeleton organization	16324	7022		GO:0050789;GO:0006996	0	0.021739130434782608	ENSG00000106683;ENSG00000075340;ENSG00000087274;ENSG00000148700;ENSG00000147099;ENSG00000067900;ENSG00000197971;ENSG00000155366;ENSG00000137843;ENSG00000037637;ENSG00000134318;ENSG00000138639;ENSG00000154065;ENSG00000072422;ENSG00000146950;ENSG00000084112;ENSG00000169314;ENSG00000116691;ENSG00000174705;ENSG00000126882;ENSG00000167178;ENSG00000104140;ENSG00000047365;ENSG00000111554;ENSG00000176371;ENSG00000172830;ENSG00000182541;ENSG00000021762;ENSG00000182010;ENSG00000140015	1	643	15681	13	11	630	15670	16324	0.09908072352443467
136	M1	e019_M1	TRUE	4.0507965283452866e-14	161	29	12	0.41379310344827586	0.07453416149068323	GO:0017148	GO:BP	negative regulation of translation	16324	5419		GO:0009057;GO:0016070;GO:0050789;GO:0006412	0	0.018518518518518517	ENSG00000110367;ENSG00000065978;ENSG00000040341;ENSG00000073792;ENSG00000166164;ENSG00000129245;ENSG00000114416;ENSG00000105939;ENSG00000138757;ENSG00000145907;ENSG00000079785;ENSG00000204842;ENSG00000143569;ENSG00000135387;ENSG00000102081;ENSG00000168283;ENSG00000100220;ENSG00000009307;ENSG00000136231;ENSG00000005007;ENSG00000103194;ENSG00000159217;ENSG00000155363;ENSG00000090621;ENSG00000048828;ENSG00000135114;ENSG00000107164;ENSG00000038358;ENSG00000087302;ENSG00000168884	1	161	16163	12	17	149	16146	16324	0.1724371899103534
137	M1	e019_M1	TRUE	5.979403036414887e-20	438	30	19	0.6333333333333333	0.04337899543378995	GO:0006325	GO:BP	chromatin organization	16324	2169		GO:0016043;GO:0050789;GO:0032502;GO:0036211	0	0.015151515151515152	ENSG00000164916;ENSG00000121741;ENSG00000175029;ENSG00000089902;ENSG00000079432;ENSG00000169375;ENSG00000085276;ENSG00000130816;ENSG00000120798;ENSG00000196591;ENSG00000153147;ENSG00000162521;ENSG00000159692;ENSG00000167491;ENSG00000141568;ENSG00000182979;ENSG00000088305;ENSG00000065526;ENSG00000106462;ENSG00000004487;ENSG00000178951;ENSG00000102054;ENSG00000168214;ENSG00000149480;ENSG00000111642;ENSG00000101096;ENSG00000071655;ENSG00000113648;ENSG00000142611;ENSG00000181449	1	438	15886	19	11	419	15875	16324	0.16105011056753976
138	M1	e019_M1	TRUE	9.397615237670836e-23	155	28	16	0.5714285714285714	0.1032258064516129	GO:0008154	GO:BP	actin polymerization or depolymerization	16324	3199		GO:0051258;GO:0032502;GO:0050789;GO:0006996	0	0.012345679012345678	ENSG00000163554;ENSG00000107554;ENSG00000106299;ENSG00000166313;ENSG00000082074;ENSG00000112290;ENSG00000015285;ENSG00000124507;ENSG00000136754;ENSG00000151491;ENSG00000158195;ENSG00000142273;ENSG00000108798;ENSG00000173166;ENSG00000175866;ENSG00000254999;ENSG00000071051;ENSG00000171475;ENSG00000132970;ENSG00000007237;ENSG00000055163;ENSG00000132334;ENSG00000125753;ENSG00000100266;ENSG00000140368;ENSG00000061676;ENSG00000115935;ENSG00000196405;ENSG00000077420;ENSG00000154380	1	155	16169	16	12	139	16157	16324	0.24018311420944238
139	M1	e019_M1	TRUE	9.074070933861802e-18	12	26	8	0.3076923076923077	0.6666666666666666	GO:0001867	GO:BP	complement activation, lectin pathway	16324	519		GO:0044419;GO:0002376;GO:0050789;GO:0050896	0	0.008849557522123894	ENSG00000154134;ENSG00000118004;ENSG00000127241;ENSG00000102678;ENSG00000184374;ENSG00000165471;ENSG00000009724;ENSG00000160339;ENSG00000163661;ENSG00000085265;ENSG00000055955;ENSG00000196468;ENSG00000169344;ENSG00000159189;ENSG00000142748;ENSG00000138080;ENSG00000158815;ENSG00000189129;ENSG00000177051;ENSG00000138675;ENSG00000184613;ENSG00000156427;ENSG00000215695;ENSG00000132205;ENSG00000008516;ENSG00000165275;ENSG00000243449;ENSG00000078579;ENSG00000070388	1	12	16312	8	18	4	16294	16324	0.45235530696902676
140	M1	e019_M1	TRUE	4.708007656919953e-18	23	23	9	0.391304347826087	0.391304347826087	GO:0042744	GO:BP	hydrogen peroxide catabolic process	16324	10914		GO:0008152	0	0.09090909090909091	ENSG00000206172;ENSG00000244734;ENSG00000188219;ENSG00000124523;ENSG00000130656;ENSG00000286219;ENSG00000130517;ENSG00000223609;ENSG00000196565;ENSG00000086506;ENSG00000213931;ENSG00000169062;ENSG00000206177;ENSG00000133742;ENSG00000165322;ENSG00000117983;ENSG00000088451;ENSG00000257017;ENSG00000161013;ENSG00000185201;ENSG00000160256;ENSG00000144840;ENSG00000198843;ENSG00000139151;ENSG00000232804;ENSG00000240771;ENSG00000139178;ENSG00000153982;ENSG00000271383	1	23	16301	9	14	14	16287	16324	0.3904455048103211
141	M1	e019_M1	TRUE	3.361700417391572e-16	10	18	7	0.3888888888888889	0.7	REAC:R-HSA-9754560	REAC	SARS-CoV-2 modulates autophagy	10790	2002		GO:0065003;GO:0048284;GO:0061024;GO:0016050;GO:0050789	0	0.04	ENSG00000003987;ENSG00000188559;ENSG00000135966;ENSG00000166887;ENSG00000198382;ENSG00000184056;ENSG00000136643;ENSG00000156931;ENSG00000160695;ENSG00000164077;ENSG00000132330;ENSG00000139719;ENSG00000215305;ENSG00000169551;ENSG00000136874;ENSG00000008256;ENSG00000104142;ENSG00000169758;ENSG00000006715;ENSG00000166971;ENSG00000198756;ENSG00000151445;ENSG00000117143;ENSG00000058729;ENSG00000138658;ENSG00000178922;ENSG00000138386;ENSG00000171097;ENSG00000115282	1	10	10780	7	11	3	10769	10790	0.5211820518195608
142	M1	e019_M1	TRUE	1.7242881436683318e-9	10	22	5	0.22727272727272727	0.5	REAC:R-HSA-193697	REAC	p75NTR regulates axonogenesis	10790	2583		GO:0050789	0	0.03333333333333333	ENSG00000064300;ENSG00000134259;ENSG00000176697;ENSG00000144668;ENSG00000225950;ENSG00000185652;ENSG00000139626;ENSG00000083457;ENSG00000165197;ENSG00000124664;ENSG00000176490;ENSG00000167208;ENSG00000126698;ENSG00000138613;ENSG00000146072;ENSG00000013563;ENSG00000185924;ENSG00000256223;ENSG00000169953;ENSG00000040608;ENSG00000176920;ENSG00000204634;ENSG00000077984;ENSG00000105929;ENSG00000171606;ENSG00000162267;ENSG00000126861;ENSG00000105695;ENSG00000099866	1	10	10780	5	17	5	10763	10790	0.33622391152223235
144	M1	e019_M1	TRUE	1.6377863368329526e-5	366	17	8	0.47058823529411764	0.02185792349726776	KEGG:04080	KEGG	Neuroactive ligand-receptor interaction	8161	258		GO:0009914;GO:0050789;GO:0015833;GO:0046903	0	0.1111111111111111	ENSG00000173585;ENSG00000145708;ENSG00000147571;ENSG00000156298;ENSG00000106113;ENSG00000163794;ENSG00000143252;ENSG00000204370;ENSG00000105438;ENSG00000198856;ENSG00000108381;ENSG00000132744;ENSG00000171522;ENSG00000132718;ENSG00000064545;ENSG00000281500;ENSG00000178623;ENSG00000161381;ENSG00000198835;ENSG00000049769;ENSG00000090674;ENSG00000205336;ENSG00000160190;ENSG00000109163;ENSG00000145040;ENSG00000117411;ENSG00000164849;ENSG00000022567;ENSG00000178473	1	366	7795	8	9	358	7786	8161	0.09398220180588371
145	M1	e019_M1	TRUE	0.0017632972689565522	23	17	3	0.17647058823529413	0.13043478260869565	REAC:R-HSA-73980	REAC	RNA Polymerase III Transcription Termination	10790	1811		NA	0	0.5	ENSG00000124766;ENSG00000137936;ENSG00000129824;ENSG00000169474;ENSG00000130544;ENSG00000198353;ENSG00000185420;ENSG00000171970;ENSG00000132005;ENSG00000188375;ENSG00000152137;ENSG00000147548;ENSG00000170364;ENSG00000174332;ENSG00000008441;ENSG00000133106;ENSG00000141905;ENSG00000205857;ENSG00000139233;ENSG00000134595;ENSG00000142556;ENSG00000179387;ENSG00000086232;ENSG00000170802;ENSG00000146757;ENSG00000004776;ENSG00000280969;ENSG00000055957;ENSG00000147862	1	23	10767	3	14	20	10753	10790	0.1501622661885478
146	M1	e019_M1	TRUE	9.795891215013631e-11	72	12	7	0.5833333333333334	0.09722222222222222	REAC:R-HSA-3108214	REAC	SUMOylation of DNA damage response and repair proteins	10790	2045		GO:0006281;GO:0050789;GO:0036211	0	0.05	ENSG00000198681;ENSG00000176396;ENSG00000102316;ENSG00000126752;ENSG00000135924;ENSG00000187601;ENSG00000184675;ENSG00000163029;ENSG00000156831;ENSG00000255302;ENSG00000198887;ENSG00000046774;ENSG00000107672;ENSG00000178021;ENSG00000124839;ENSG00000169189;ENSG00000170085;ENSG00000167981;ENSG00000178171;ENSG00000176401;ENSG00000198934;ENSG00000141446;ENSG00000255150;ENSG00000214107;ENSG00000177383;ENSG00000185115;ENSG00000233573;ENSG00000185404;ENSG00000257315	1	72	10718	7	5	65	10713	10790	0.23634153329686003
148	M1	e019_M1	TRUE	8.273559391707906e-27	81	22	16	0.7272727272727273	0.19753086419753085	KEGG:04146	KEGG	Peroxisome	8161	277		GO:0015031;GO:0007031	0	0.03125	ENSG00000034693;ENSG00000162735;ENSG00000101986;ENSG00000173208;ENSG00000116675;ENSG00000142655;ENSG00000162928;ENSG00000215193;ENSG00000107537;ENSG00000187855;ENSG00000104883;ENSG00000112357;ENSG00000128482;ENSG00000111412;ENSG00000136379;ENSG00000157911;ENSG00000183856;ENSG00000100344;ENSG00000166821;ENSG00000114757;ENSG00000164751;ENSG00000138138;ENSG00000101417;ENSG00000185818;ENSG00000140943;ENSG00000164398;ENSG00000100626;ENSG00000111911;ENSG00000117791	1	81	8080	16	6	65	8074	8161	0.37622753485806765
149	M1	e019_M1	TRUE	3.93712778112006e-14	14	25	7	0.28	0.5	GO:0035721	GO:BP	intraciliary retrograde transport	16324	9698		GO:0051641;GO:0006810	0	0.05263157894736842	ENSG00000131089;ENSG00000118965;ENSG00000123607;ENSG00000214944;ENSG00000165138;ENSG00000151414;ENSG00000078246;ENSG00000066629;ENSG00000187535;ENSG00000160602;ENSG00000143319;ENSG00000157796;ENSG00000154217;ENSG00000163913;ENSG00000160200;ENSG00000104804;ENSG00000159625;ENSG00000119650;ENSG00000241878;ENSG00000141519;ENSG00000143924;ENSG00000168096;ENSG00000166352;ENSG00000168026;ENSG00000184867;ENSG00000104880;ENSG00000067248;ENSG00000104129;ENSG00000166402	1	14	16310	7	18	7	16292	16324	0.3734658270835957
150	M1	e019_M1	TRUE	4.7989151909111594e-6	54	17	5	0.29411764705882354	0.09259259259259259	REAC:R-HSA-5620924	REAC	Intraflagellar transport	10790	1207		GO:0051641;GO:0006810;GO:0051640	0	0.1111111111111111	ENSG00000101405;ENSG00000117245;ENSG00000074706;ENSG00000168067;ENSG00000111961;ENSG00000173327;ENSG00000133878;ENSG00000101350;ENSG00000131437;ENSG00000130758;ENSG00000108669;ENSG00000075945;ENSG00000265190;ENSG00000084731;ENSG00000164825;ENSG00000105655;ENSG00000158106;ENSG00000100055;ENSG00000181652;ENSG00000164169;ENSG00000142675;ENSG00000198420;ENSG00000171365;ENSG00000085377;ENSG00000187091;ENSG00000141298;ENSG00000258102;ENSG00000134398;ENSG00000213973	1	54	10736	5	12	49	10724	10790	0.1627522810307348
151	M1	e019_M1	TRUE	5.678179877963194e-5	69	10	4	0.4	0.057971014492753624	KEGG:04920	KEGG	Adipocytokine signaling pathway	8161	370		NA	0	0.07692307692307693	ENSG00000248746;ENSG00000066185;ENSG00000131264;ENSG00000036672;ENSG00000166925;ENSG00000196290;ENSG00000214717;ENSG00000139722;ENSG00000115806;ENSG00000159289;ENSG00000166886;ENSG00000142698;ENSG00000050748;ENSG00000155959;ENSG00000107187;ENSG00000130066;ENSG00000075420;ENSG00000130307;ENSG00000145358;ENSG00000158062;ENSG00000138443;ENSG00000131791;ENSG00000162373;ENSG00000198945;ENSG00000162409;ENSG00000007944;ENSG00000132356;ENSG00000177791;ENSG00000185002	1	69	8092	4	6	65	8086	8161	0.1497846475600361
153	M1	e019_M1	TRUE	2.921029050596652e-14	516	28	16	0.5714285714285714	0.031007751937984496	GO:0007169	GO:BP	transmembrane receptor protein tyrosine kinase signaling pathway	16324	2796		GO:0007155;GO:0050789;GO:0006996	0	0.008620689655172414	ENSG00000008710;ENSG00000136238;ENSG00000150760;ENSG00000065534;ENSG00000140682;ENSG00000100842;ENSG00000180370;ENSG00000158092;ENSG00000127947;ENSG00000108262;ENSG00000088538;ENSG00000111859;ENSG00000136205;ENSG00000169398;ENSG00000089159;ENSG00000154556;ENSG00000154447;ENSG00000095370;ENSG00000077264;ENSG00000120899;ENSG00000095637;ENSG00000147224;ENSG00000129675;ENSG00000114423;ENSG00000101213;ENSG00000143537;ENSG00000050820;ENSG00000102606;ENSG00000149269	1	516	15808	16	12	500	15796	16324	0.12789385605146547
156	M1	e019_M1	TRUE	3.977852003152547e-6	18	17	4	0.23529411764705882	0.2222222222222222	REAC:R-HSA-1369062	REAC	ABC transporters in lipid homeostasis	10790	5		GO:0032501;GO:0050789;GO:0006869	0	0.0625	ENSG00000128602;ENSG00000138075;ENSG00000143921;ENSG00000106603;ENSG00000168421;ENSG00000131507;ENSG00000169692;ENSG00000133069;ENSG00000119185;ENSG00000167775;ENSG00000213625;ENSG00000183726;ENSG00000170743;ENSG00000172350;ENSG00000169241;ENSG00000160179;ENSG00000171680;ENSG00000089057;ENSG00000148154;ENSG00000122375;ENSG00000160539;ENSG00000105767;ENSG00000139971;ENSG00000187688;ENSG00000196689;ENSG00000130032;ENSG00000068137;ENSG00000188175	1	18	10772	4	13	14	10759	10790	0.22741240428911566
157	M1	e019_M1	TRUE	1.1569928758545669e-6	8	6	3	0.5	0.375	REAC:R-HSA-75158	REAC	TRAIL  signaling	10790	2335		NA	0	0.125	ENSG00000104689;ENSG00000173530;ENSG00000121858;ENSG00000135587;ENSG00000204970;ENSG00000119688;ENSG00000167925;ENSG00000204965;ENSG00000251664;ENSG00000204967;ENSG00000204962;ENSG00000182534;ENSG00000255408;ENSG00000204963;ENSG00000204969;ENSG00000250120;ENSG00000249158;ENSG00000081842;ENSG00000204961;ENSG00000130300;ENSG00000120519;ENSG00000248383;ENSG00000272674;ENSG00000239389;ENSG00000113212;ENSG00000242419;ENSG00000113211;ENSG00000162687	1	8	10782	3	3	5	10779	10790	0.4326512909439398
158	M1	e019_M1	TRUE	6.5203796239298034e-15	210	20	13	0.65	0.06190476190476191	KEGG:04015	KEGG	Rap1 signaling pathway	8161	243		GO:0050789	0	0.0625	ENSG00000213445;ENSG00000068831;ENSG00000116473;ENSG00000160271;ENSG00000133818;ENSG00000111832;ENSG00000138698;ENSG00000127314;ENSG00000070087;ENSG00000076864;ENSG00000001631;ENSG00000105538;ENSG00000089199;ENSG00000079337;ENSG00000139631;ENSG00000163879;ENSG00000091428;ENSG00000152932;ENSG00000158186;ENSG00000136237;ENSG00000124596;ENSG00000173706;ENSG00000176406;ENSG00000137204;ENSG00000157680;ENSG00000158987;ENSG00000228716;ENSG00000185189	1	210	7951	13	7	197	7944	8161	0.19542042340620067
159	M1	e019_M1	TRUE	7.296277350814103e-10	11	17	5	0.29411764705882354	0.45454545454545453	REAC:R-HSA-5625970	REAC	RHO GTPases activate KTN1	10790	1763		GO:0051641;GO:0006810;GO:0051640	0	0.03225806451612903	ENSG00000129749;ENSG00000174343;ENSG00000100023;ENSG00000126214;ENSG00000137171;ENSG00000129460;ENSG00000197019;ENSG00000174996;ENSG00000158615;ENSG00000137463;ENSG00000123505;ENSG00000104892;ENSG00000126858;ENSG00000168280;ENSG00000182606;ENSG00000155980;ENSG00000058453;ENSG00000106665;ENSG00000165233;ENSG00000118162;ENSG00000004846;ENSG00000260325;ENSG00000116786;ENSG00000136720;ENSG00000041880;ENSG00000115993;ENSG00000162396;ENSG00000121210	1	11	10779	5	12	6	10767	10790	0.3648422500177124
160	M1	e019_M1	TRUE	1.6760414987687676e-29	23	21	13	0.6190476190476191	0.5652173913043478	REAC:R-HSA-5620922	REAC	BBSome-mediated cargo-targeting to cilium	10790	192		GO:0051641;GO:0022607;GO:0043473;GO:0032501;GO:0006810;GO:0051640;GO:0006996	0	0.01694915254237288	ENSG00000103024;ENSG00000125124;ENSG00000140463;ENSG00000243989;ENSG00000136872;ENSG00000163818;ENSG00000163093;ENSG00000122507;ENSG00000174483;ENSG00000160050;ENSG00000182645;ENSG00000113966;ENSG00000145692;ENSG00000179941;ENSG00000089127;ENSG00000075891;ENSG00000138686;ENSG00000125863;ENSG00000181004;ENSG00000165533;ENSG00000214413;ENSG00000133169;ENSG00000135723;ENSG00000259571;ENSG00000173653;ENSG00000254550;ENSG00000132840;ENSG00000113492	1	23	10767	13	8	10	10759	10790	0.5906880353406743
161	M1	e019_M1	TRUE	3.443054182298573e-20	83	28	13	0.4642857142857143	0.1566265060240964	GO:0046634	GO:BP	regulation of alpha-beta T cell activation	16324	12981		GO:0032502;GO:0002376;GO:0001775;GO:0001816;GO:0050896;GO:0050789;GO:0044419	0	0.0045045045045045045	ENSG00000057657;ENSG00000125347;ENSG00000134460;ENSG00000113302;ENSG00000168811;ENSG00000096996;ENSG00000081985;ENSG00000110944;ENSG00000162594;ENSG00000138378;ENSG00000105246;ENSG00000197272;ENSG00000111537;ENSG00000166888;ENSG00000137265;ENSG00000170581;ENSG00000113520;ENSG00000107485;ENSG00000172183;ENSG00000073861;ENSG00000269404;ENSG00000137270;ENSG00000123388;ENSG00000120913;ENSG00000064195;ENSG00000163357;ENSG00000215421;ENSG00000165312	1	83	16241	13	15	70	16226	16324	0.2676225202354997
162	M1	e019_M1	TRUE	5.640173682596491e-10	74	22	8	0.36363636363636365	0.10810810810810811	KEGG:01230	KEGG	Biosynthesis of amino acids	8161	188		GO:0006091;GO:0009117;GO:0005975;GO:0006082;GO:0050789;GO:0050896	0	0.015625	ENSG00000131981;ENSG00000117450;ENSG00000111716;ENSG00000163931;ENSG00000136810;ENSG00000106541;ENSG00000158828;ENSG00000074800;ENSG00000187608;ENSG00000125868;ENSG00000172757;ENSG00000167815;ENSG00000084207;ENSG00000167658;ENSG00000111669;ENSG00000142168;ENSG00000100412;ENSG00000135457;ENSG00000117592;ENSG00000196262;ENSG00000071127;ENSG00000152518;ENSG00000137693;ENSG00000111640;ENSG00000067225;ENSG00000149925;ENSG00000102144;ENSG00000116288	1	74	8087	8	14	66	8073	8161	0.19447339154918256
163	M1	e019_M1	TRUE	3.06419437099536e-11	30	21	7	0.3333333333333333	0.23333333333333334	KEGG:00020	KEGG	Citrate cycle (TCA cycle)	8161	3		GO:0043603;GO:0044255;GO:0009117;GO:0006082;GO:0006790	0	0.02631578947368421	ENSG00000163528;ENSG00000111275;ENSG00000107959;ENSG00000172340;ENSG00000136143;ENSG00000076043;ENSG00000169599;ENSG00000062485;ENSG00000161533;ENSG00000117054;ENSG00000167969;ENSG00000109519;ENSG00000138413;ENSG00000127884;ENSG00000143149;ENSG00000112096;ENSG00000128928;ENSG00000137124;ENSG00000184470;ENSG00000139131;ENSG00000162836;ENSG00000163541;ENSG00000166411;ENSG00000144827;ENSG00000091483;ENSG00000109576;ENSG00000065154;ENSG00000083720	1	30	8131	7	14	23	8117	8161	0.27667564407690143
165	M1	e019_M1	TRUE	4.553456559576053e-36	43	25	18	0.72	0.4186046511627907	KEGG:03022	KEGG	Basal transcription factors	8161	213		GO:0065003;GO:0006351;GO:0050789	0	0.017241379310344827	ENSG00000012061;ENSG00000140307;ENSG00000066136;ENSG00000148835;ENSG00000100219;ENSG00000132274;ENSG00000112592;ENSG00000182521;ENSG00000158773;ENSG00000137413;ENSG00000106290;ENSG00000141384;ENSG00000179583;ENSG00000130699;ENSG00000102387;ENSG00000064995;ENSG00000106546;ENSG00000147133;ENSG00000028839;ENSG00000001167;ENSG00000120656;ENSG00000184486;ENSG00000197780;ENSG00000064313;ENSG00000178913;ENSG00000165632;ENSG00000165417;ENSG00000120837	1	43	8118	18	7	25	8111	8161	0.547257602008179
166	M1	e019_M1	TRUE	2.0704319661958886e-10	449	15	11	0.7333333333333333	0.024498886414253896	REAC:R-HSA-9012999	REAC	RHO GTPase cycle	10790	1755		GO:0050789	0	0.07142857142857142	ENSG00000135828;ENSG00000155849;ENSG00000062598;ENSG00000177105;ENSG00000174255;ENSG00000135298;ENSG00000147459;ENSG00000187650;ENSG00000100124;ENSG00000152430;ENSG00000187595;ENSG00000163584;ENSG00000122644;ENSG00000130762;ENSG00000031081;ENSG00000110237;ENSG00000101977;ENSG00000126217;ENSG00000128512;ENSG00000135097;ENSG00000151135;ENSG00000102890;ENSG00000134533;ENSG00000130052;ENSG00000205916;ENSG00000262860;ENSG00000285077	1	449	10341	11	4	438	10337	10790	0.12923638034207882
167	M1	e019_M1	TRUE	1.8957928577748932e-22	366	21	19	0.9047619047619048	0.05191256830601093	KEGG:04080	KEGG	Neuroactive ligand-receptor interaction	8161	258		GO:0006869;GO:0032501;GO:0046903;GO:0050789;GO:0009914	0	0.02702702702702703	ENSG00000122585;ENSG00000096395;ENSG00000102539;ENSG00000137252;ENSG00000161610;ENSG00000106128;ENSG00000091972;ENSG00000174697;ENSG00000157017;ENSG00000142552;ENSG00000124678;ENSG00000139574;ENSG00000106772;ENSG00000056291;ENSG00000197044;ENSG00000166573;ENSG00000069482;ENSG00000148734;ENSG00000168216;ENSG00000189152;ENSG00000164128;ENSG00000182687;ENSG00000140479;ENSG00000108849;ENSG00000183395;ENSG00000152034;ENSG00000204174	1	366	7795	19	2	347	7793	8161	0.21103159046231926
168	M1	e019_M1	TRUE	1.5325407996669134e-5	133	18	6	0.3333333333333333	0.045112781954887216	REAC:R-HSA-9660821	REAC	ADORA2B mediated anti-inflammatory cytokines production	10790	8		GO:0050789	0	0.05555555555555555	ENSG00000115138;ENSG00000185231;ENSG00000171130;ENSG00000166603;ENSG00000124089;ENSG00000179639;ENSG00000067113;ENSG00000141934;ENSG00000170262;ENSG00000101670;ENSG00000151655;ENSG00000177728;ENSG00000107518;ENSG00000104901;ENSG00000167772;ENSG00000162407;ENSG00000070193;ENSG00000145730;ENSG00000258839;ENSG00000176136;ENSG00000198774;ENSG00000087116;ENSG00000179431;ENSG00000006625;ENSG00000266964;ENSG00000101440;ENSG00000144227	1	133	10657	6	12	127	10645	10790	0.11892711041531263
169	M1	e019_M1	TRUE	4.621379721787282e-16	12	15	7	0.4666666666666667	0.5833333333333334	REAC:R-HSA-375281	REAC	Hormone ligand-binding receptors	10790	1072		GO:0043412;GO:0006396	0	0.03225806451612903	ENSG00000104826;ENSG00000135346;ENSG00000134200;ENSG00000149735;ENSG00000179600;ENSG00000131808;ENSG00000138039;ENSG00000135083;ENSG00000178096;ENSG00000086289;ENSG00000108309;ENSG00000167118;ENSG00000124217;ENSG00000142544;ENSG00000124615;ENSG00000137251;ENSG00000169814;ENSG00000165813;ENSG00000188690;ENSG00000128923;ENSG00000125900;ENSG00000170917;ENSG00000157014;ENSG00000174177;ENSG00000154080;ENSG00000155275;ENSG00000183208	1	12	10778	7	8	5	10770	10790	0.5211578395483348
170	M1	e019_M1	TRUE	4.2021245519870424e-17	53	18	10	0.5555555555555556	0.18867924528301888	REAC:R-HSA-9662361	REAC	Sensory processing of sound by outer hair cells of the cochlea	10790	2080		GO:0032502;GO:0022607;GO:0065008;GO:0050789;GO:0050877	0	0.02702702702702703	ENSG00000047932;ENSG00000170471;ENSG00000107736;ENSG00000150275;ENSG00000112782;ENSG00000006611;ENSG00000042781;ENSG00000095397;ENSG00000184792;ENSG00000074276;ENSG00000095777;ENSG00000099834;ENSG00000136010;ENSG00000176058;ENSG00000174502;ENSG00000169994;ENSG00000119888;ENSG00000137474;ENSG00000039523;ENSG00000187147;ENSG00000134285;ENSG00000155962;ENSG00000091536;ENSG00000144908;ENSG00000182771;ENSG00000187017;ENSG00000166265	1	53	10737	10	8	43	10729	10790	0.3219591035056457
172	M1	e019_M1	TRUE	1.583759348818403e-8	87	21	7	0.3333333333333333	0.08045977011494253	GO:0006493	GO:BP	protein O-linked glycosylation	16324	2277		GO:0036211	0	0.045454545454545456	ENSG00000086062;ENSG00000167531;ENSG00000133424;ENSG00000129657;ENSG00000173821;ENSG00000139200;ENSG00000078081;ENSG00000168386;ENSG00000183963;ENSG00000187714;ENSG00000144559;ENSG00000254737;ENSG00000225201;ENSG00000257594;ENSG00000119514;ENSG00000181773;ENSG00000171298;ENSG00000118600;ENSG00000109586;ENSG00000091490;ENSG00000177830;ENSG00000115665;ENSG00000142197;ENSG00000106692;ENSG00000179913;ENSG00000139044;ENSG00000254402	1	87	16237	7	14	80	16223	16324	0.16168464077531575
173	M1	e019_M1	TRUE	6.666089234485591e-7	110	27	7	0.25925925925925924	0.06363636363636363	GO:0010001	GO:BP	glial cell differentiation	16324	3901		GO:0032502	0	0.08333333333333333	ENSG00000122877;ENSG00000135903;ENSG00000187098;ENSG00000182968;ENSG00000132780;ENSG00000176887;ENSG00000143842;ENSG00000139163;ENSG00000171316;ENSG00000105967;ENSG00000068323;ENSG00000134532;ENSG00000110693;ENSG00000185960;ENSG00000100146;ENSG00000004534;ENSG00000181722;ENSG00000105997;ENSG00000205927;ENSG00000171794;ENSG00000049246;ENSG00000005513;ENSG00000112561;ENSG00000198914;ENSG00000166532;ENSG00000185668;ENSG00000167157	1	110	16214	7	20	103	16194	16324	0.12563487686982977
174	M1	e019_M1	TRUE	7.022277291815958e-14	64	18	9	0.5	0.140625	REAC:R-HSA-373755	REAC	Semaphorin interactions	10790	2070		GO:0050789;GO:0032989	0	0.012987012987012988	ENSG00000164050;ENSG00000004399;ENSG00000196189;ENSG00000187764;ENSG00000112902;ENSG00000198753;ENSG00000104998;ENSG00000160007;ENSG00000152214;ENSG00000172602;ENSG00000173156;ENSG00000132640;ENSG00000108830;ENSG00000196576;ENSG00000115963;ENSG00000173137;ENSG00000147202;ENSG00000196914;ENSG00000187123;ENSG00000241935;ENSG00000177947;ENSG00000111678;ENSG00000213413;ENSG00000156232;ENSG00000100852;ENSG00000185033;ENSG00000091482	1	64	10726	9	9	55	10717	10790	0.2630194585534101
175	M1	e019_M1	TRUE	3.7091084713237163e-9	128	18	8	0.4444444444444444	0.0625	REAC:R-HSA-6809371	REAC	Formation of the cornified envelope	10790	919		NA	0	0.2	ENSG00000176194;ENSG00000187288;ENSG00000134762;ENSG00000118520;ENSG00000184363;ENSG00000081277;ENSG00000089916;ENSG00000057294;ENSG00000099308;ENSG00000134760;ENSG00000132323;ENSG00000112183;ENSG00000164051;ENSG00000143318;ENSG00000159079;ENSG00000149231;ENSG00000134765;ENSG00000188505;ENSG00000145592;ENSG00000162592;ENSG00000134755;ENSG00000179477;ENSG00000121316;ENSG00000134757;ENSG00000197632;ENSG00000109424;ENSG00000143194	1	128	10662	8	10	120	10652	10790	0.16332522009168776
176	M1	e019_M1	TRUE	4.075001308856779e-9	12	21	5	0.23809523809523808	0.4166666666666667	REAC:R-HSA-8866907	REAC	Activation of the TFAP2 (AP-2) family of transcription factors	10790	100		GO:0006259	0	0.14285714285714285	ENSG00000008196;ENSG00000087510;ENSG00000115758;ENSG00000057468;ENSG00000119684;ENSG00000125931;ENSG00000111247;ENSG00000136929;ENSG00000093167;ENSG00000034510;ENSG00000100206;ENSG00000130948;ENSG00000081386;ENSG00000148120;ENSG00000066697;ENSG00000164741;ENSG00000168936;ENSG00000130957;ENSG00000164442;ENSG00000089335;ENSG00000136842;ENSG00000180573;ENSG00000206053;ENSG00000163431;ENSG00000064787;ENSG00000175395;ENSG00000179862	1	12	10778	5	16	7	10762	10790	0.3139793326546238
177	M1	e019_M1	TRUE	9.614699035495737e-26	42	27	14	0.5185185185185185	0.3333333333333333	REAC:R-HSA-75893	REAC	TNF signaling	10790	2311		GO:0002376;GO:0065009;GO:0050896;GO:0050789;GO:0044419	0	0.004807692307692308	ENSG00000104833;ENSG00000118503;ENSG00000165806;ENSG00000101966;ENSG00000164305;ENSG00000179526;ENSG00000028137;ENSG00000104365;ENSG00000126456;ENSG00000102871;ENSG00000026025;ENSG00000055332;ENSG00000136560;ENSG00000055208;ENSG00000127191;ENSG00000110330;ENSG00000183735;ENSG00000269335;ENSG00000064012;ENSG00000213341;ENSG00000177889;ENSG00000175104;ENSG00000263528;ENSG00000070831;ENSG00000023445;ENSG00000067182;ENSG00000137275	1	42	10748	14	13	28	10735	10790	0.4139424139265074
178	M1	e019_M1	TRUE	6.908778243742971e-52	57	27	24	0.8888888888888888	0.42105263157894735	REAC:R-HSA-6799198	REAC	Complex I biogenesis	10790	371		GO:0006119;GO:0065003;GO:0009117	0	0.01694915254237288	ENSG00000198886;ENSG00000183648;ENSG00000131495;ENSG00000136521;ENSG00000164258;ENSG00000198786;ENSG00000178127;ENSG00000130414;ENSG00000115204;ENSG00000145494;ENSG00000151366;ENSG00000100209;ENSG00000119013;ENSG00000147123;ENSG00000140990;ENSG00000099795;ENSG00000178057;ENSG00000065518;ENSG00000165264;ENSG00000184752;ENSG00000109270;ENSG00000137806;ENSG00000198888;ENSG00000130159;ENSG00000186010;ENSG00000123545;ENSG00000174886	1	57	10733	24	3	33	10730	10790	0.6105165316705992
179	M1	e019_M1	TRUE	3.7688832852207215e-9	373	25	11	0.44	0.029490616621983913	GO:0005975	GO:BP	carbohydrate metabolic process	16324	1887		GO:0006082;GO:0006091;GO:0009117;GO:0005975	0	0.037037037037037035	ENSG00000144834;ENSG00000167468;ENSG00000160211;ENSG00000168734;ENSG00000141401;ENSG00000173486;ENSG00000085662;ENSG00000124767;ENSG00000137710;ENSG00000119782;ENSG00000171314;ENSG00000142657;ENSG00000065621;ENSG00000013583;ENSG00000164434;ENSG00000109107;ENSG00000114491;ENSG00000108515;ENSG00000128951;ENSG00000111674;ENSG00000176890;ENSG00000125877;ENSG00000151005;ENSG00000164687;ENSG00000170950;ENSG00000162688;ENSG00000149591	1	373	15951	11	14	362	15937	16324	0.1093352498948108
180	M1	e019_M1	TRUE	1.5702217938076799e-4	7	24	3	0.125	0.42857142857142855	GO:1903288	GO:BP	positive regulation of potassium ion import across plasma membrane	16324	23975		GO:0050789	0	0.2	ENSG00000138134;ENSG00000111913;ENSG00000272514;ENSG00000166797;ENSG00000063515;ENSG00000120709;ENSG00000149089;ENSG00000105576;ENSG00000107929;ENSG00000146021;ENSG00000117266;ENSG00000175329;ENSG00000198883;ENSG00000196632;ENSG00000060237;ENSG00000213231;ENSG00000103994;ENSG00000149716;ENSG00000165238;ENSG00000118308;ENSG00000180116;ENSG00000228253;ENSG00000022976;ENSG00000116882;ENSG00000132359;ENSG00000137473	1	7	16317	3	21	4	16296	16324	0.23088026839982057
181	M1	e019_M1	TRUE	3.328820939687019e-11	7	17	5	0.29411764705882354	0.7142857142857143	REAC:R-HSA-162791	REAC	Attachment of GPI anchor to uPAR	10790	181		GO:0044255;GO:0036211;GO:0006793	0	0.05	ENSG00000162551;ENSG00000130303;ENSG00000163295;ENSG00000163283;ENSG00000062716;ENSG00000087111;ENSG00000188092;ENSG00000197858;ENSG00000101464;ENSG00000126259;ENSG00000140945;ENSG00000117419;ENSG00000164303;ENSG00000139734;ENSG00000149328;ENSG00000089876;ENSG00000283706;ENSG00000276536;ENSG00000125037;ENSG00000118094;ENSG00000075568;ENSG00000142892;ENSG00000124155;ENSG00000198899;ENSG00000163286;ENSG00000137449	1	7	10783	5	12	2	10771	10790	0.45784748657917307
182	M1	e019_M1	TRUE	2.0621005189350796e-4	22	12	3	0.25	0.13636363636363635	KEGG:00900	KEGG	Terpenoid backbone biosynthesis	8161	129		NA	0	0.5	ENSG00000180398;ENSG00000148459;ENSG00000164494;ENSG00000170777;ENSG00000108061;ENSG00000187754;ENSG00000111907;ENSG00000197043;ENSG00000183773;ENSG00000160752;ENSG00000187021;ENSG00000169683;ENSG00000099949;ENSG00000060982;ENSG00000138430;ENSG00000135090;ENSG00000076554;ENSG00000108666;ENSG00000068878;ENSG00000157870;ENSG00000175093;ENSG00000116771;ENSG00000197181;ENSG00000233276;ENSG00000120915;ENSG00000152670	1	22	8139	3	9	19	8130	8161	0.18302758975174777
184	M1	e019_M1	TRUE	9.741333698590793e-5	16	13	3	0.23076923076923078	0.1875	KEGG:00450	KEGG	Selenocompound metabolism	8161	58		NA	0	0.3333333333333333	ENSG00000198431;ENSG00000198682;ENSG00000138646;ENSG00000135374;ENSG00000129235;ENSG00000155324;ENSG00000086205;ENSG00000053702;ENSG00000148795;ENSG00000166734;ENSG00000108439;ENSG00000104112;ENSG00000147813;ENSG00000188321;ENSG00000106617;ENSG00000167701;ENSG00000156966;ENSG00000023572;ENSG00000166401;ENSG00000129596;ENSG00000116761;ENSG00000112812;ENSG00000142025;ENSG00000159658;ENSG00000171487;ENSG00000185792	1	16	8145	3	10	13	8135	8161	0.20661246381308643
185	M1	e019_M1	TRUE	2.8184132254843432e-11	8	14	5	0.35714285714285715	0.625	REAC:R-HSA-446388	REAC	Regulation of cytoskeletal remodeling and cell spreading by IPP complex components	10790	1915		GO:0007155	0	0.16666666666666666	ENSG00000197702;ENSG00000188677;ENSG00000148484;ENSG00000169756;ENSG00000107140;ENSG00000138964;ENSG00000138193;ENSG00000124733;ENSG00000168939;ENSG00000165609;ENSG00000197712;ENSG00000122550;ENSG00000186231;ENSG00000135596;ENSG00000172578;ENSG00000103254;ENSG00000180917;ENSG00000149781;ENSG00000189046;ENSG00000187210;ENSG00000128059;ENSG00000197429;ENSG00000197928;ENSG00000101311;ENSG00000197363;ENSG00000186086	1	8	10782	5	9	3	10773	10790	0.4719559348268968
186	M1	e019_M1	TRUE	1.927440264067239e-8	80	23	7	0.30434782608695654	0.0875	GO:0007565	GO:BP	female pregnancy	16324	3114		GO:0032501	0	0.14285714285714285	ENSG00000184502;ENSG00000231924;ENSG00000101188;ENSG00000109472;ENSG00000141574;ENSG00000163710;ENSG00000130234;ENSG00000133636;ENSG00000174358;ENSG00000119655;ENSG00000153802;ENSG00000221826;ENSG00000138593;ENSG00000171388;ENSG00000204941;ENSG00000243130;ENSG00000183668;ENSG00000134013;ENSG00000132581;ENSG00000243137;ENSG00000170848;ENSG00000169006;ENSG00000187054;ENSG00000167757;ENSG00000124467;ENSG00000136488	1	80	16244	7	16	73	16228	16324	0.16106899889040222
187	M1	e019_M1	TRUE	1.3635656426375245e-10	41	10	6	0.6	0.14634146341463414	KEGG:03440	KEGG	Homologous recombination	8161	235		GO:0006281	0	0.03571428571428571	ENSG00000108384;ENSG00000126215;ENSG00000182185;ENSG00000188042;ENSG00000081154;ENSG00000138119;ENSG00000087076;ENSG00000083093;ENSG00000196584;ENSG00000169914;ENSG00000168672;ENSG00000136492;ENSG00000116984;ENSG00000124275;ENSG00000129197;ENSG00000172955;ENSG00000165355;ENSG00000163312;ENSG00000171763;ENSG00000108176;ENSG00000179761;ENSG00000109184;ENSG00000134265;ENSG00000248905;ENSG00000130997;ENSG00000141376	1	41	8120	6	4	35	8116	8161	0.29475929777250187
188	M1	e019_M1	TRUE	1.0433703616445215e-8	41	20	6	0.3	0.14634146341463414	GO:1990542	GO:BP	mitochondrial transmembrane transport	16324	26442		GO:0015031	0	0.1	ENSG00000112763;ENSG00000163114;ENSG00000125995;ENSG00000137776;ENSG00000157800;ENSG00000139637;ENSG00000005486;ENSG00000176049;ENSG00000242114;ENSG00000270170;ENSG00000076258;ENSG00000126768;ENSG00000091010;ENSG00000177673;ENSG00000120675;ENSG00000189037;ENSG00000165650;ENSG00000134375;ENSG00000101298;ENSG00000205981;ENSG00000205560;ENSG00000077935;ENSG00000102078;ENSG00000175229;ENSG00000183035;ENSG00000174032	1	41	16283	6	14	35	16269	16324	0.2081638632943748
189	M1	e019_M1	TRUE	3.3971064550060354e-6	28	11	4	0.36363636363636365	0.14285714285714285	REAC:R-HSA-525793	REAC	Myogenesis	10790	1423		GO:0032502	0	0.1	ENSG00000187079;ENSG00000007866;ENSG00000122691;ENSG00000099991;ENSG00000116604;ENSG00000081189;ENSG00000177426;ENSG00000170604;ENSG00000149548;ENSG00000213999;ENSG00000172081;ENSG00000152601;ENSG00000068305;ENSG00000154175;ENSG00000139793;ENSG00000102243;ENSG00000165886;ENSG00000178403;ENSG00000139352;ENSG00000076770;ENSG00000170162;ENSG00000203883;ENSG00000144560;ENSG00000230797;ENSG00000156925;ENSG00000119669	1	28	10762	4	7	24	10755	10790	0.2267044307698455
190	M1	e019_M1	TRUE	1.3106402184669802e-13	32	25	8	0.32	0.25	GO:0045730	GO:BP	respiratory burst	16324	12272		GO:0008152	0	0.03571428571428571	ENSG00000051523;ENSG00000165168;ENSG00000116701;ENSG00000111348;ENSG00000169750;ENSG00000135002;ENSG00000007952;ENSG00000128340;ENSG00000120963;ENSG00000132254;ENSG00000196408;ENSG00000089682;ENSG00000008277;ENSG00000164708;ENSG00000172331;ENSG00000135905;ENSG00000115216;ENSG00000166845;ENSG00000010818;ENSG00000167656;ENSG00000044459;ENSG00000057757;ENSG00000073734;ENSG00000100365;ENSG00000177688;ENSG00000164099	1	32	16292	8	17	24	16275	16324	0.2816016859276503
191	M1	e019_M1	TRUE	9.6798593030429e-7	105	17	6	0.35294117647058826	0.05714285714285714	GO:0031047	GO:BP	RNA-mediated gene silencing	16324	7387		GO:0050789;GO:0006396	0	0.1	ENSG00000100697;ENSG00000180228;ENSG00000139546;ENSG00000214706;ENSG00000172301;ENSG00000197381;ENSG00000165061;ENSG00000215641;ENSG00000127838;ENSG00000113761;ENSG00000273514;ENSG00000152219;ENSG00000196867;ENSG00000162959;ENSG00000143793;ENSG00000242498;ENSG00000134627;ENSG00000172667;ENSG00000213588;ENSG00000111727;ENSG00000007080;ENSG00000173451;ENSG00000266967;ENSG00000206557;ENSG00000184571;ENSG00000115827	1	105	16219	6	11	99	16208	16324	0.13994963029734991
192	M1	e019_M1	TRUE	3.5769621999373155e-13	37	24	8	0.3333333333333333	0.21621621621621623	GO:0000731	GO:BP	DNA synthesis involved in DNA repair	16324	217		GO:0006281;GO:0009059	0	0.020833333333333332	ENSG00000009413;ENSG00000170734;ENSG00000146143;ENSG00000107077;ENSG00000167196;ENSG00000124535;ENSG00000135945;ENSG00000156885;ENSG00000077514;ENSG00000014138;ENSG00000066135;ENSG00000051341;ENSG00000172795;ENSG00000175482;ENSG00000101751;ENSG00000144645;ENSG00000148814;ENSG00000122678;ENSG00000106628;ENSG00000166454;ENSG00000135842;ENSG00000169469;ENSG00000127663;ENSG00000124104;ENSG00000127311;ENSG00000176853	1	37	16287	8	16	29	16271	16324	0.2671360723984255
193	M1	e019_M1	TRUE	1.2871793698507135e-5	103	25	6	0.24	0.05825242718446602	GO:0034341	GO:BP	response to type II interferon	16324	9028		GO:0006520;GO:0050896	0	0.06666666666666667	ENSG00000102393;ENSG00000102172;ENSG00000023909;ENSG00000115919;ENSG00000162654;ENSG00000133313;ENSG00000162645;ENSG00000151552;ENSG00000105835;ENSG00000112972;ENSG00000183044;ENSG00000117226;ENSG00000117228;ENSG00000104687;ENSG00000154451;ENSG00000167508;ENSG00000140263;ENSG00000135677;ENSG00000124357;ENSG00000180185;ENSG00000095380;ENSG00000130707;ENSG00000171989;ENSG00000149476;ENSG00000001084;ENSG00000119125	1	103	16221	6	19	97	16202	16324	0.11558442586821224
194	M1	e019_M1	TRUE	3.063856100089164e-4	175	25	6	0.24	0.03428571428571429	GO:0070646	GO:BP	protein modification by small protein removal	16324	17165		GO:0036211;GO:0006508	0	0.5	ENSG00000172845;ENSG00000131788;ENSG00000108175;ENSG00000148516;ENSG00000019549;ENSG00000128228;ENSG00000167182;ENSG00000079387;ENSG00000100600;ENSG00000184160;ENSG00000177030;ENSG00000134588;ENSG00000257727;ENSG00000145390;ENSG00000167034;ENSG00000065485;ENSG00000170468;ENSG00000175727;ENSG00000131864;ENSG00000226430;ENSG00000247746;ENSG00000223443;ENSG00000204335;ENSG00000026297;ENSG00000121578	1	175	16149	6	19	169	16130	16324	0.08719461456122199
195	M1	e019_M1	TRUE	1.3580101500863829e-6	5	12	3	0.25	0.6	KEGG:00524	KEGG	Neomycin, kanamycin and gentamicin biosynthesis	8161	73		NA	0	0.07692307692307693	ENSG00000107317;ENSG00000143155;ENSG00000111271;ENSG00000159399;ENSG00000213401;ENSG00000146410;ENSG00000256269;ENSG00000116649;ENSG00000215440;ENSG00000102471;ENSG00000134900;ENSG00000254986;ENSG00000156510;ENSG00000160883;ENSG00000125384;ENSG00000242950;ENSG00000170927;ENSG00000117640;ENSG00000168575;ENSG00000122420;ENSG00000115902;ENSG00000160951;ENSG00000118514;ENSG00000088035;ENSG00000099998	1	5	8156	3	9	2	8147	8161	0.38675204326471024
197	M1	e019_M1	TRUE	0.0025408346342171858	394	17	6	0.35294117647058826	0.015228426395939087	GO:0008380	GO:BP	RNA splicing	16324	3261		NA	0	0.5	ENSG00000144736;ENSG00000106245;ENSG00000244234;ENSG00000126522;ENSG00000020129;ENSG00000184281;ENSG00000152404;ENSG00000129518;ENSG00000082068;ENSG00000152969;ENSG00000157884;ENSG00000256671;ENSG00000174276;ENSG00000095485;ENSG00000117614;ENSG00000157219;ENSG00000166803;ENSG00000160799;ENSG00000103047;ENSG00000186532;ENSG00000227345;ENSG00000103005;ENSG00000085465;ENSG00000146858;ENSG00000186924	1	394	15930	6	11	388	15919	16324	0.06917454959037386
198	M1	e019_M1	TRUE	2.1842460371439273e-10	60	15	7	0.4666666666666667	0.11666666666666667	REAC:R-HSA-9033241	REAC	Peroxisomal protein import	10790	1638		GO:0044255;GO:0006082	0	0.05555555555555555	ENSG00000112874;ENSG00000105552;ENSG00000121691;ENSG00000180011;ENSG00000101473;ENSG00000176746;ENSG00000131373;ENSG00000118894;ENSG00000164904;ENSG00000240303;ENSG00000123975;ENSG00000088280;ENSG00000005381;ENSG00000087008;ENSG00000102910;ENSG00000172426;ENSG00000149972;ENSG00000156521;ENSG00000163157;ENSG00000115042;ENSG00000056487;ENSG00000215077;ENSG00000126790;ENSG00000115425;ENSG00000103061	1	60	10730	7	8	53	10722	10790	0.23135755527267055
199	M1	e019_M1	TRUE	2.4696510986070264e-8	43	22	6	0.2727272727272727	0.13953488372093023	GO:0097720	GO:BP	calcineurin-mediated signaling	16324	19795		GO:0050789;GO:0006811	0	0.02564102564102564	ENSG00000120910;ENSG00000221823;ENSG00000169306;ENSG00000100678;ENSG00000107758;ENSG00000142178;ENSG00000159200;ENSG00000100968;ENSG00000160584;ENSG00000128805;ENSG00000170145;ENSG00000175463;ENSG00000006740;ENSG00000125449;ENSG00000160741;ENSG00000161180;ENSG00000100056;ENSG00000105507;ENSG00000167779;ENSG00000163728;ENSG00000147434;ENSG00000135447;ENSG00000131771;ENSG00000118160;ENSG00000086544	1	43	16281	6	16	37	16265	16324	0.19357810268497816
200	M1	e019_M1	TRUE	9.242790825998301e-5	84	21	5	0.23809523809523808	0.05952380952380952	GO:0045103	GO:BP	intermediate filament-based process	16324	11964		GO:0008150	0	0.3333333333333333	ENSG00000087074;ENSG00000107874;ENSG00000148798;ENSG00000164877;ENSG00000122786;ENSG00000050730;ENSG00000150316;ENSG00000146618;ENSG00000141503;ENSG00000088756;ENSG00000132688;ENSG00000162520;ENSG00000142632;ENSG00000067064;ENSG00000104722;ENSG00000185298;ENSG00000110697;ENSG00000154319;ENSG00000100285;ENSG00000127990;ENSG00000174844;ENSG00000097096;ENSG00000102302;ENSG00000111046;ENSG00000122483	1	84	16240	5	16	79	16224	16324	0.11685074493229895
201	M1	e019_M1	TRUE	2.5474722115652224e-18	24	21	9	0.42857142857142855	0.375	GO:0031145	GO:BP	anaphase-promoting complex-dependent catabolic process	16324	7447		GO:0009057;GO:0007049;GO:0006508;GO:0050789;GO:0036211	0	0.015625	ENSG00000112029;ENSG00000148429;ENSG00000172943;ENSG00000166133;ENSG00000134779;ENSG00000145029;ENSG00000176386;ENSG00000149179;ENSG00000176248;ENSG00000129055;ENSG00000109680;ENSG00000163508;ENSG00000053900;ENSG00000171540;ENSG00000067334;ENSG00000100271;ENSG00000110200;ENSG00000089053;ENSG00000162929;ENSG00000164162;ENSG00000166295;ENSG00000153107;ENSG00000166548;ENSG00000173947;ENSG00000175697	1	24	16300	9	12	15	16288	16324	0.40006802151682336
202	M1	e019_M1	TRUE	2.460928797873639e-7	90	14	6	0.42857142857142855	0.06666666666666667	KEGG:04970	KEGG	Salivary secretion	8161	394		NA	0	0.25	ENSG00000166863;ENSG00000162896;ENSG00000125522;ENSG00000170369;ENSG00000143536;ENSG00000171195;ENSG00000175567;ENSG00000164574;ENSG00000169605;ENSG00000288611;ENSG00000177599;ENSG00000138434;ENSG00000156453;ENSG00000171201;ENSG00000122986;ENSG00000134551;ENSG00000127863;ENSG00000187733;ENSG00000111215;ENSG00000126550;ENSG00000101441;ENSG00000132465;ENSG00000183971;ENSG00000183979;ENSG00000143110	1	90	8071	6	8	84	8063	8161	0.16573918520767336
203	M1	e019_M1	TRUE	1.264734633922004e-14	31	20	8	0.4	0.25806451612903225	GO:0006506	GO:BP	GPI anchor biosynthetic process	16324	2284		GO:0044255;GO:0006793;GO:0036211;GO:0009059	0	0.034482758620689655	ENSG00000015413;ENSG00000165195;ENSG00000115756;ENSG00000185808;ENSG00000179085;ENSG00000187416;ENSG00000110881;ENSG00000108684;ENSG00000159884;ENSG00000007541;ENSG00000141404;ENSG00000135845;ENSG00000150403;ENSG00000100564;ENSG00000173264;ENSG00000255072;ENSG00000176244;ENSG00000149218;ENSG00000136908;ENSG00000005471;ENSG00000160097;ENSG00000213199;ENSG00000134146;ENSG00000146433;ENSG00000157214	1	31	16293	8	12	23	16281	16324	0.32026268846884104
204	M1	e019_M1	TRUE	1.5565340036420894e-14	13	24	7	0.2916666666666667	0.5384615384615384	GO:1900095	GO:BP	regulation of dosage compensation by inactivation of X chromosome	16324	21301		GO:0050789;GO:0036211	0	0.029411764705882353	ENSG00000025293;ENSG00000076108;ENSG00000134014;ENSG00000134759;ENSG00000128283;ENSG00000125967;ENSG00000163171;ENSG00000123119;ENSG00000188895;ENSG00000166595;ENSG00000106331;ENSG00000161896;ENSG00000119729;ENSG00000205899;ENSG00000178761;ENSG00000157827;ENSG00000139620;ENSG00000174579;ENSG00000109911;ENSG00000103510;ENSG00000005302;ENSG00000143452;ENSG00000171219;ENSG00000114982;ENSG00000253626	1	13	16311	7	17	6	16294	16324	0.39566333152413824
205	M1	e019_M1	TRUE	1.5235319629986028e-5	108	12	5	0.4166666666666667	0.046296296296296294	KEGG:03013	KEGG	Nucleocytoplasmic transport	8161	209		GO:0051641;GO:0006810	0	0.05555555555555555	ENSG00000198492;ENSG00000185728;ENSG00000113742;ENSG00000069535;ENSG00000175520;ENSG00000139496;ENSG00000119392;ENSG00000081791;ENSG00000198088;ENSG00000170633;ENSG00000123427;ENSG00000163467;ENSG00000136243;ENSG00000145721;ENSG00000161281;ENSG00000168872;ENSG00000134030;ENSG00000109832;ENSG00000114770;ENSG00000108559;ENSG00000135778;ENSG00000103460;ENSG00000189221;ENSG00000174938;ENSG00000184428	1	108	8053	5	7	103	8046	8161	0.13547605082309433
206	M1	e019_M1	TRUE	4.93512697798679e-15	581	24	16	0.6666666666666666	0.027538726333907058	GO:0098662	GO:BP	inorganic cation transmembrane transport	16324	19868		GO:0050877;GO:0006811;GO:0050896	0	0.018867924528301886	ENSG00000184144;ENSG00000018236;ENSG00000163531;ENSG00000091129;ENSG00000108797;ENSG00000177272;ENSG00000170049;ENSG00000169282;ENSG00000182255;ENSG00000111262;ENSG00000160233;ENSG00000198553;ENSG00000069424;ENSG00000101323;ENSG00000152049;ENSG00000177301;ENSG00000166828;ENSG00000143105;ENSG00000168447;ENSG00000111319;ENSG00000151079;ENSG00000153253;ENSG00000162572;ENSG00000104755;ENSG00000176022	1	581	15743	16	8	565	15735	16324	0.13070358444705024
207	M1	e019_M1	TRUE	5.082090138473354e-4	66	15	4	0.26666666666666666	0.06060606060606061	REAC:R-HSA-1234176	REAC	Oxygen-dependent proline hydroxylation of Hypoxia-inducible Factor Alpha	10790	1567		NA	0	0.5	ENSG00000020633;ENSG00000064692;ENSG00000181788;ENSG00000129474;ENSG00000124440;ENSG00000135100;ENSG00000198300;ENSG00000135766;ENSG00000105204;ENSG00000269858;ENSG00000172985;ENSG00000160145;ENSG00000169371;ENSG00000118156;ENSG00000130700;ENSG00000129221;ENSG00000121104;ENSG00000034677;ENSG00000110436;ENSG00000013374;ENSG00000165556;ENSG00000140297;ENSG00000170871;ENSG00000143867	1	66	10724	4	11	62	10713	10790	0.1246806224160067
210	M1	e019_M1	TRUE	3.741087555734409e-8	410	21	10	0.47619047619047616	0.024390243902439025	GO:0061061	GO:BP	muscle structure development	16324	16048		GO:0032502;GO:0022607;GO:0006996	0	0.06666666666666667	ENSG00000022267;ENSG00000090924;ENSG00000088387;ENSG00000154553;ENSG00000148677;ENSG00000135636;ENSG00000036448;ENSG00000165959;ENSG00000092529;ENSG00000183091;ENSG00000086967;ENSG00000102683;ENSG00000164309;ENSG00000006788;ENSG00000120729;ENSG00000122729;ENSG00000196091;ENSG00000133055;ENSG00000168530;ENSG00000123096;ENSG00000138347;ENSG00000133020;ENSG00000174611;ENSG00000127124	1	410	15914	10	11	400	15903	16324	0.10345911021955975
211	M1	e019_M1	TRUE	1.0581473858801857e-7	119	20	7	0.35	0.058823529411764705	GO:0006937	GO:BP	regulation of muscle contraction	16324	2633		GO:0006936;GO:0050789;GO:0032502	0	0.04	ENSG00000125503;ENSG00000074590;ENSG00000215375;ENSG00000173482;ENSG00000189182;ENSG00000111245;ENSG00000169877;ENSG00000263155;ENSG00000101608;ENSG00000134571;ENSG00000198752;ENSG00000092054;ENSG00000163492;ENSG00000143776;ENSG00000177182;ENSG00000101335;ENSG00000131097;ENSG00000130176;ENSG00000172927;ENSG00000160808;ENSG00000166866;ENSG00000186020;ENSG00000135540;ENSG00000174945	1	119	16205	7	13	112	16192	16324	0.14109883610126225
212	M1	e019_M1	TRUE	2.240674465667963e-10	8	22	5	0.22727272727272727	0.625	GO:0070537	GO:BP	histone H2A K63-linked deubiquitination	16324	17102		GO:0050789;GO:0036211;GO:0006508;GO:0050896	0	0.018867924528301886	ENSG00000138346;ENSG00000256683;ENSG00000101773;ENSG00000023892;ENSG00000158019;ENSG00000165660;ENSG00000147130;ENSG00000105393;ENSG00000185515;ENSG00000198554;ENSG00000105122;ENSG00000087206;ENSG00000177683;ENSG00000155087;ENSG00000163322;ENSG00000175984;ENSG00000167771;ENSG00000177150;ENSG00000118707;ENSG00000196159;ENSG00000125459;ENSG00000151176;ENSG00000109016;ENSG00000165895	1	8	16316	5	17	3	16299	16324	0.3764224080215787
213	M1	e019_M1	TRUE	3.7630856765764263e-4	15	16	3	0.1875	0.2	REAC:R-HSA-71336	REAC	Pentose phosphate pathway	10790	1631		GO:0006091;GO:0009117	0	0.2	ENSG00000150687;ENSG00000038382;ENSG00000119912;ENSG00000188641;ENSG00000037757;ENSG00000151023;ENSG00000110811;ENSG00000153574;ENSG00000212864;ENSG00000198331;ENSG00000197713;ENSG00000104371;ENSG00000171174;ENSG00000145879;ENSG00000102897;ENSG00000125144;ENSG00000213085;ENSG00000177225;ENSG00000205358;ENSG00000119927;ENSG00000167447;ENSG00000183696;ENSG00000127125;ENSG00000184599	1	15	10775	3	13	12	10762	10790	0.19248991453220443
214	M1	e019_M1	TRUE	1.837307009122184e-6	297	17	8	0.47058823529411764	0.026936026936026935	REAC:R-HSA-1474244	REAC	Extracellular matrix organization	10790	844		GO:0007155	0	0.09090909090909091	ENSG00000090659;ENSG00000108622;ENSG00000005844;ENSG00000156886;ENSG00000170956;ENSG00000174807;ENSG00000079385;ENSG00000111321;ENSG00000124469;ENSG00000100380;ENSG00000076662;ENSG00000086548;ENSG00000164326;ENSG00000105376;ENSG00000181552;ENSG00000116983;ENSG00000105388;ENSG00000070985;ENSG00000104938;ENSG00000007306;ENSG00000204624;ENSG00000134256;ENSG00000146833;ENSG00000170044	1	297	10493	8	9	289	10484	10790	0.10757584146967669
217	M1	e019_M1	TRUE	1.8130065206726416e-7	13	12	4	0.3333333333333333	0.3076923076923077	REAC:R-HSA-432047	REAC	Passive transport by Aquaporins	10790	1628		GO:0042044	0	0.16666666666666666	ENSG00000161921;ENSG00000198794;ENSG00000166224;ENSG00000174599;ENSG00000125991;ENSG00000103042;ENSG00000151117;ENSG00000133935;ENSG00000089356;ENSG00000115446;ENSG00000010282;ENSG00000185499;ENSG00000167580;ENSG00000135517;ENSG00000079150;ENSG00000064601;ENSG00000079332;ENSG00000165272;ENSG00000103569;ENSG00000189280;ENSG00000132406;ENSG00000036565;ENSG00000196937;ENSG00000109084	1	13	10777	4	8	9	10769	10790	0.3194688533353987
218	M1	e019_M1	TRUE	1.273252122973782e-49	48	24	21	0.875	0.4375	GO:0043966	GO:BP	histone H3 acetylation	16324	11488		GO:0036211;GO:0006508	0	0.023809523809523808	ENSG00000095574;ENSG00000119760;ENSG00000163635;ENSG00000196367;ENSG00000162227;ENSG00000176476;ENSG00000120533;ENSG00000171148;ENSG00000036549;ENSG00000117505;ENSG00000108773;ENSG00000187325;ENSG00000151332;ENSG00000166337;ENSG00000102710;ENSG00000196284;ENSG00000149474;ENSG00000124422;ENSG00000173011;ENSG00000087152;ENSG00000163872;ENSG00000138411;ENSG00000135801;ENSG00000152382	1	48	16276	21	3	27	16273	16324	0.6180022909760994
219	M1	e019_M1	TRUE	2.2763007717198903e-42	18	22	16	0.7272727272727273	0.8888888888888888	REAC:R-HSA-8964315	REAC	G beta:gamma signalling through BTK	10790	937		NA	0	0.012987012987012988	ENSG00000170255;ENSG00000172380;ENSG00000126895;ENSG00000242616;ENSG00000158292;ENSG00000114450;ENSG00000176533;ENSG00000198216;ENSG00000069966;ENSG00000165970;ENSG00000148408;ENSG00000076344;ENSG00000078369;ENSG00000174021;ENSG00000127920;ENSG00000186469;ENSG00000127928;ENSG00000182732;ENSG00000172354;ENSG00000162188;ENSG00000111664;ENSG00000127588;ENSG00000167414;ENSG00000167083	1	18	10772	16	6	2	10766	10790	0.8036756566219849
220	M1	e019_M1	TRUE	8.237379861340698e-18	58	14	10	0.7142857142857143	0.1724137931034483	KEGG:04330	KEGG	Notch signaling pathway	8161	295		GO:0050789	0	0.024390243902439025	ENSG00000101384;ENSG00000184916;ENSG00000074181;ENSG00000134250;ENSG00000128917;ENSG00000171611;ENSG00000184384;ENSG00000196782;ENSG00000182809;ENSG00000267680;ENSG00000065413;ENSG00000148123;ENSG00000107954;ENSG00000176871;ENSG00000114857;ENSG00000131094;ENSG00000100060;ENSG00000106003;ENSG00000101346;ENSG00000141314;ENSG00000158156;ENSG00000180257;ENSG00000198346	1	58	8103	10	4	48	8099	8161	0.3489802251874869
221	M1	e019_M1	TRUE	1.5163813718268174e-9	60	22	7	0.3181818181818182	0.11666666666666667	GO:0031124	GO:BP	mRNA 3'-end processing	16324	7432		GO:0006396	0	0.0625	ENSG00000165494;ENSG00000172409;ENSG00000154727;ENSG00000145819;ENSG00000136709;ENSG00000119929;ENSG00000164736;ENSG00000154743;ENSG00000143458;ENSG00000111912;ENSG00000182173;ENSG00000126890;ENSG00000112667;ENSG00000160075;ENSG00000160917;ENSG00000168876;ENSG00000101935;ENSG00000144460;ENSG00000168564;ENSG00000091009;ENSG00000132394;ENSG00000187959;ENSG00000214309	1	60	16264	7	15	53	16249	16324	0.19092264938894085
223	M1	e019_M1	TRUE	4.906459052691018e-5	14	12	3	0.25	0.21428571428571427	KEGG:00533	KEGG	Glycosaminoglycan biosynthesis - keratan sulfate	8161	77		GO:0009059;GO:0019538	0	0.09090909090909091	ENSG00000174808;ENSG00000144591;ENSG00000173540;ENSG00000145050;ENSG00000105889;ENSG00000164647;ENSG00000143457;ENSG00000008513;ENSG00000139985;ENSG00000240592;ENSG00000113384;ENSG00000108405;ENSG00000185267;ENSG00000174059;ENSG00000260916;ENSG00000140835;ENSG00000278889;ENSG00000181744;ENSG00000198108;ENSG00000131873;ENSG00000078795;ENSG00000183196;ENSG00000172940	1	14	8147	3	9	11	8138	8161	0.23023355317775618
224	M1	e019_M1	TRUE	0.0016340838117980315	5	9	2	0.2222222222222222	0.4	REAC:R-HSA-2161517	REAC	Abacavir transmembrane transport	10790	41		GO:0006810	0	0.16666666666666666	ENSG00000151348;ENSG00000163463;ENSG00000269964;ENSG00000068697;ENSG00000099377;ENSG00000198881;ENSG00000100744;ENSG00000149428;ENSG00000112499;ENSG00000154813;ENSG00000105251;ENSG00000101435;ENSG00000106565;ENSG00000137731;ENSG00000172663;ENSG00000175003;ENSG00000107669;ENSG00000095932;ENSG00000284862;ENSG00000196526;ENSG00000236279;ENSG00000196196;ENSG00000180638	1	5	10785	2	7	3	10778	10790	0.297713837977957
225	M1	e019_M1	TRUE	3.788402381382439e-5	155	10	5	0.5	0.03225806451612903	REAC:R-HSA-418555	REAC	G alpha (s) signalling events	10790	935		GO:0008150	0	0.125	ENSG00000070031;ENSG00000080293;ENSG00000140474;ENSG00000114302;ENSG00000110711;ENSG00000170776;ENSG00000183943;ENSG00000145491;ENSG00000065989;ENSG00000172890;ENSG00000186471;ENSG00000118507;ENSG00000159263;ENSG00000188738;ENSG00000136449;ENSG00000111254;ENSG00000064199;ENSG00000147081;ENSG00000186642;ENSG00000023516;ENSG00000114547;ENSG00000150667;ENSG00000179454	1	155	10635	5	5	150	10630	10790	0.12430463147560684
226	M1	e019_M1	TRUE	5.093441237083309e-20	29	22	10	0.45454545454545453	0.3448275862068966	GO:0001990	GO:BP	regulation of systemic arterial blood pressure by hormone	16324	610		GO:0008015;GO:0065008;GO:0050886	0	0.01639344262295082	ENSG00000159899;ENSG00000163273;ENSG00000135744;ENSG00000180772;ENSG00000143839;ENSG00000164400;ENSG00000198223;ENSG00000090554;ENSG00000049130;ENSG00000127129;ENSG00000078401;ENSG00000124205;ENSG00000168398;ENSG00000128607;ENSG00000125388;ENSG00000172123;ENSG00000117298;ENSG00000092009;ENSG00000175426;ENSG00000159640;ENSG00000102109;ENSG00000148926;ENSG00000138792	1	29	16295	10	12	19	16283	16324	0.39497346225907
229	M1	e019_M1	TRUE	1.4384998248511465e-20	33	15	10	0.6666666666666666	0.30303030303030304	REAC:R-HSA-2172127	REAC	DAP12 interactions	10790	411		GO:0001775;GO:0002376;GO:0050789;GO:0050896	0	0.01639344262295082	ENSG00000011600;ENSG00000288206;ENSG00000275434;ENSG00000258227;ENSG00000096264;ENSG00000101307;ENSG00000095970;ENSG00000186407;ENSG00000178789;ENSG00000134539;ENSG00000205809;ENSG00000237508;ENSG00000276011;ENSG00000204345;ENSG00000167851;ENSG00000125780;ENSG00000125810;ENSG00000186074;ENSG00000188038;ENSG00000254415;ENSG00000205810;ENSG00000103855;ENSG00000275452	1	33	10757	10	5	23	10752	10790	0.44840213963802467
230	M1	e019_M1	TRUE	1.2623845254789111e-11	11	9	5	0.5555555555555556	0.45454545454545453	REAC:R-HSA-112308	REAC	Presynaptic depolarization and calcium channel opening	10790	1700		GO:0065009;GO:0050789;GO:0006811	0	0.024390243902439025	ENSG00000141837;ENSG00000067191;ENSG00000189067;ENSG00000183808;ENSG00000167535;ENSG00000004766;ENSG00000142330;ENSG00000099625;ENSG00000188820;ENSG00000048991;ENSG00000165995;ENSG00000067445;ENSG00000150361;ENSG00000182389;ENSG00000151067;ENSG00000143862;ENSG00000157782;ENSG00000164325;ENSG00000122203;ENSG00000136059;ENSG00000198483;ENSG00000150938;ENSG00000088320	1	11	10779	5	4	6	10775	10790	0.5020620744192135
233	M1	e019_M1	TRUE	3.3449711969375526e-9	49	13	6	0.46153846153846156	0.12244897959183673	REAC:R-HSA-72165	REAC	mRNA Splicing - Minor Pathway	10790	2567		GO:0000375	0	0.1111111111111111	ENSG00000185946;ENSG00000163798;ENSG00000156017;ENSG00000100319;ENSG00000185272;ENSG00000185361;ENSG00000169249;ENSG00000184209;ENSG00000113638;ENSG00000155330;ENSG00000134597;ENSG00000275895;ENSG00000187607;ENSG00000197362;ENSG00000139767;ENSG00000196110;ENSG00000168566;ENSG00000090470;ENSG00000174236;ENSG00000142039;ENSG00000140694;ENSG00000180071;ENSG00000198837	1	49	10741	6	7	43	10734	10790	0.2360681186639859
234	M1	e019_M1	TRUE	1.224821437762815e-35	39	23	16	0.6956521739130435	0.41025641025641024	GO:0002183	GO:BP	cytoplasmic translational initiation	16324	748		GO:0065003;GO:0006412	0	0.023809523809523808	ENSG00000175390;ENSG00000084623;ENSG00000104131;ENSG00000128731;ENSG00000215301;ENSG00000151247;ENSG00000110321;ENSG00000184110;ENSG00000147677;ENSG00000130811;ENSG00000114867;ENSG00000104408;ENSG00000100129;ENSG00000161960;ENSG00000083799;ENSG00000156976;ENSG00000149100;ENSG00000144566;ENSG00000107581;ENSG00000063046;ENSG00000100353;ENSG00000133112;ENSG00000106263	1	39	16285	16	7	23	16278	16324	0.5334027509684276
235	M1	e019_M1	TRUE	7.299147509060269e-5	9	15	3	0.2	0.3333333333333333	GO:0070383	GO:BP	DNA cytosine deamination	16324	17018		GO:0016070;GO:0050789;GO:0006304	0	0.0625	ENSG00000067955;ENSG00000114125;ENSG00000132128;ENSG00000239713;ENSG00000169129;ENSG00000150540;ENSG00000092330;ENSG00000266338;ENSG00000102977;ENSG00000117616;ENSG00000164713;ENSG00000180329;ENSG00000205413;ENSG00000139890;ENSG00000119862;ENSG00000160714;ENSG00000179750;ENSG00000128394;ENSG00000111144;ENSG00000179364;ENSG00000197863;ENSG00000103066	1	9	16315	3	12	6	16303	16324	0.2576765447081535
238	M1	e019_M1	TRUE	2.3431092637625663e-4	36	8	3	0.375	0.08333333333333333	KEGG:03030	KEGG	DNA replication	8161	214		GO:0009117	0	0.07142857142857142	ENSG00000048392;ENSG00000156239;ENSG00000078725;ENSG00000129292;ENSG00000167985;ENSG00000165516;ENSG00000162374;ENSG00000135686;ENSG00000185324;ENSG00000185432;ENSG00000188566;ENSG00000167325;ENSG00000173917;ENSG00000183576;ENSG00000172922;ENSG00000171848;ENSG00000105612;ENSG00000107331;ENSG00000104889;ENSG00000185798;ENSG00000136104;ENSG00000136444	1	36	8125	3	5	33	8120	8161	0.1751696961236861
241	M1	e019_M1	TRUE	3.0274007199894675e-4	10	20	3	0.15	0.3	GO:0035871	GO:BP	protein K11-linked deubiquitination	16324	9807		GO:0042440;GO:0036211;GO:0006508	0	0.125	ENSG00000157077;ENSG00000152492;ENSG00000116525;ENSG00000089723;ENSG00000120215;ENSG00000156463;ENSG00000072134;ENSG00000102921;ENSG00000154124;ENSG00000113369;ENSG00000264522;ENSG00000133104;ENSG00000136021;ENSG00000170374;ENSG00000163106;ENSG00000107165;ENSG00000101850;ENSG00000169918;ENSG00000077498;ENSG00000165124;ENSG00000188778;ENSG00000254656	1	10	16314	3	17	7	16297	16324	0.2114600131998364
246	M1	e019_M1	TRUE	4.057797628404061e-4	12	19	3	0.15789473684210525	0.25	GO:0006388	GO:BP	tRNA splicing, via endonucleolytic cleavage and ligation	16324	2202		GO:0006396	0	0.3333333333333333	ENSG00000103507;ENSG00000143344;ENSG00000124256;ENSG00000139651;ENSG00000117751;ENSG00000171262;ENSG00000124019;ENSG00000153140;ENSG00000176125;ENSG00000176261;ENSG00000198089;ENSG00000167037;ENSG00000161040;ENSG00000135974;ENSG00000164283;ENSG00000177143;ENSG00000113838;ENSG00000132932;ENSG00000147400;ENSG00000137996;ENSG00000185842;ENSG00000134438	1	12	16312	3	16	9	16296	16324	0.19794281110957535
248	M1	e019_M1	TRUE	0.001694145313721116	16	5	2	0.4	0.125	KEGG:00360	KEGG	Phenylalanine metabolism	8161	42		NA	0	0.3333333333333333	ENSG00000105722;ENSG00000186038;ENSG00000160310;ENSG00000165832;ENSG00000131061;ENSG00000239857;ENSG00000175573;ENSG00000111218;ENSG00000154832;ENSG00000131471;ENSG00000106560;ENSG00000179144;ENSG00000166046;ENSG00000174606;ENSG00000131480;ENSG00000167702;ENSG00000139718;ENSG00000019485;ENSG00000204315;ENSG00000205544;ENSG00000162076;ENSG00000123561	1	16	8145	2	3	14	8142	8161	0.22279752382997287
250	M1	e019_M1	TRUE	4.6002500225928656e-5	132	6	4	0.6666666666666666	0.030303030303030304	KEGG:04728	KEGG	Dopaminergic synapse	8161	352		NA	0	0.07142857142857142	ENSG00000113328;ENSG00000104290;ENSG00000162989;ENSG00000120457;ENSG00000069696;ENSG00000162728;ENSG00000087448;ENSG00000126107;ENSG00000111142;ENSG00000092850;ENSG00000162390;ENSG00000074755;ENSG00000186967;ENSG00000185340;ENSG00000149639;ENSG00000148339;ENSG00000244617;ENSG00000141580;ENSG00000185838;ENSG00000159212;ENSG00000135736;ENSG00000169064	1	132	8029	4	2	128	8027	8161	0.13987219961867095
251	M1	e019_M1	TRUE	2.8038495172299005e-6	184	11	6	0.5454545454545454	0.03260869565217391	REAC:R-HSA-9013149	REAC	RAC1 GTPase cycle	10790	1744		GO:0050789	0	0.25	ENSG00000006607;ENSG00000171450;ENSG00000011478;ENSG00000124126;ENSG00000124198;ENSG00000066777;ENSG00000114735;ENSG00000163577;ENSG00000128656;ENSG00000003393;ENSG00000123178;ENSG00000214114;ENSG00000130413;ENSG00000147408;ENSG00000151475;ENSG00000165507;ENSG00000183833;ENSG00000106069;ENSG00000206206;ENSG00000158104;ENSG00000031003;ENSG00000168952	1	184	10606	6	5	178	10601	10790	0.13037912137514643
252	M1	e019_M1	TRUE	2.0223836090839998e-7	9	18	4	0.2222222222222222	0.4444444444444444	REAC:R-HSA-390696	REAC	Adrenoceptors	10790	120		GO:0032501;GO:0065008;GO:0050789;GO:0007154	0	0.034482758620689655	ENSG00000171873;ENSG00000168404;ENSG00000274286;ENSG00000144476;ENSG00000170214;ENSG00000166148;ENSG00000196639;ENSG00000072163;ENSG00000159267;ENSG00000074855;ENSG00000120907;ENSG00000167964;ENSG00000163703;ENSG00000078814;ENSG00000125875;ENSG00000152990;ENSG00000171503;ENSG00000128594;ENSG00000162631;ENSG00000196358;ENSG00000165338;ENSG00000138617	1	9	10781	4	14	5	10767	10790	0.31348232035998347
253	M1	e019_M1	TRUE	8.880785223021586e-17	15	21	8	0.38095238095238093	0.5333333333333333	REAC:R-HSA-111447	REAC	Activation of BAD and translocation to mitochondria 	10790	72		GO:0050789	0	0.021739130434782608	ENSG00000128245;ENSG00000111057;ENSG00000166913;ENSG00000111276;ENSG00000175793;ENSG00000118689;ENSG00000134308;ENSG00000124788;ENSG00000108953;ENSG00000087088;ENSG00000136485;ENSG00000141582;ENSG00000164045;ENSG00000145335;ENSG00000113712;ENSG00000103197;ENSG00000184304;ENSG00000170759;ENSG00000164924;ENSG00000170027;ENSG00000002330;ENSG00000171132	1	15	10775	8	13	7	10762	10790	0.44985452714955543
254	M1	e019_M1	TRUE	9.61700051487206e-10	11	18	5	0.2777777777777778	0.45454545454545453	REAC:R-HSA-1362409	REAC	Mitochondrial iron-sulfur cluster biogenesis	10790	1389		GO:0006790;GO:0022607	0	0.0625	ENSG00000138796;ENSG00000137714;ENSG00000105755;ENSG00000267673;ENSG00000159423;ENSG00000116096;ENSG00000137106;ENSG00000169504;ENSG00000164951;ENSG00000182054;ENSG00000214113;ENSG00000002549;ENSG00000182512;ENSG00000165060;ENSG00000128309;ENSG00000159445;ENSG00000165688;ENSG00000119431;ENSG00000004779;ENSG00000140905;ENSG00000116791;ENSG00000162368	1	11	10779	5	13	6	10766	10790	0.3545068445415424
255	M1	e019_M1	TRUE	7.429887763284703e-18	115	22	12	0.5454545454545454	0.10434782608695652	GO:0050852	GO:BP	T cell receptor signaling pathway	16324	14053		GO:0001775;GO:0002376;GO:0032502;GO:0050789	0	0.01098901098901099	ENSG00000198821;ENSG00000110448;ENSG00000178562;ENSG00000005020;ENSG00000111252;ENSG00000004468;ENSG00000163519;ENSG00000010610;ENSG00000070159;ENSG00000134242;ENSG00000122223;ENSG00000163599;ENSG00000198851;ENSG00000115085;ENSG00000116824;ENSG00000010810;ENSG00000182866;ENSG00000117091;ENSG00000167286;ENSG00000203747;ENSG00000183918;ENSG00000160654	1	115	16209	12	10	103	16199	16324	0.23648485302169317
256	M1	e019_M1	TRUE	1.5888084592141177e-13	144	21	11	0.5238095238095238	0.0763888888888889	REAC:R-HSA-8856828	REAC	Clathrin-mediated endocytosis	10790	357		GO:0016192	0	0.034482758620689655	ENSG00000106278;ENSG00000259207;ENSG00000198910;ENSG00000135597;ENSG00000085832;ENSG00000138448;ENSG00000118473;ENSG00000178950;ENSG00000140022;ENSG00000063245;ENSG00000042753;ENSG00000142627;ENSG00000183020;ENSG00000082781;ENSG00000133961;ENSG00000205726;ENSG00000118785;ENSG00000153071;ENSG00000197822;ENSG00000175591;ENSG00000181240;ENSG00000175416	1	144	10646	11	10	133	10636	10790	0.19644179963164185
257	M1	e019_M1	TRUE	1.5459373352564144e-45	17	22	16	0.7272727272727273	0.9411764705882353	GO:0035720	GO:BP	intraciliary anterograde transport	16324	9697		GO:0051641;GO:0006810	0	0.05263157894736842	ENSG00000105948;ENSG00000118096;ENSG00000068885;ENSG00000096872;ENSG00000122970;ENSG00000204104;ENSG00000135338;ENSG00000103351;ENSG00000128581;ENSG00000196659;ENSG00000032742;ENSG00000101052;ENSG00000197557;ENSG00000109083;ENSG00000138002;ENSG00000081870;ENSG00000128944;ENSG00000086288;ENSG00000100360;ENSG00000107831;ENSG00000114446;ENSG00000102879	1	17	16307	16	6	1	16301	16324	0.8271436843383413
258	M1	e019_M1	TRUE	4.965598103635467e-6	56	18	5	0.2777777777777778	0.08928571428571429	GO:0008589	GO:BP	regulation of smoothened signaling pathway	16324	3274		GO:0065009;GO:0050789	0	0.1111111111111111	ENSG00000145743;ENSG00000106571;ENSG00000074047;ENSG00000107882;ENSG00000136319;ENSG00000163482;ENSG00000165259;ENSG00000278129;ENSG00000089123;ENSG00000178150;ENSG00000120051;ENSG00000184305;ENSG00000154642;ENSG00000152409;ENSG00000197077;ENSG00000172818;ENSG00000118420;ENSG00000169933;ENSG00000043355;ENSG00000159708;ENSG00000164197	1	56	16268	5	13	51	16255	16324	0.15589372316599798
260	M1	e019_M1	TRUE	8.198906551481995e-8	56	9	5	0.5555555555555556	0.08928571428571429	KEGG:00480	KEGG	Glutathione metabolism	8161	61		GO:0006725;GO:0006805;GO:0006807	0	0.045454545454545456	ENSG00000213339;ENSG00000066654;ENSG00000120756;ENSG00000147419;ENSG00000167378;ENSG00000117602;ENSG00000134201;ENSG00000168765;ENSG00000134202;ENSG00000116996;ENSG00000002726;ENSG00000110887;ENSG00000134184;ENSG00000185633;ENSG00000213366;ENSG00000091640;ENSG00000112308;ENSG00000182346;ENSG00000164933;ENSG00000171936;ENSG00000255526	1	56	8105	5	4	51	8101	8161	0.22084723141755846
261	M1	e019_M1	TRUE	3.8120837579393885e-7	58	11	5	0.45454545454545453	0.08620689655172414	KEGG:04923	KEGG	Regulation of lipolysis in adipocytes	8161	373		GO:0044255;GO:0050789;GO:0051179	0	0.05263157894736842	ENSG00000011198;ENSG00000166819;ENSG00000079435;ENSG00000170323;ENSG00000166527;ENSG00000205846;ENSG00000213186;ENSG00000173267;ENSG00000177108;ENSG00000100335;ENSG00000132704;ENSG00000109854;ENSG00000167874;ENSG00000073464;ENSG00000147465;ENSG00000123689;ENSG00000177666;ENSG00000147872;ENSG00000167612;ENSG00000163788;ENSG00000214456	1	58	8103	5	6	53	8097	8161	0.1956849083007571
262	M1	e019_M1	TRUE	2.8639862342251074e-34	25	17	14	0.8235294117647058	0.56	REAC:R-HSA-8854691	REAC	Interleukin-20 family signaling	10790	1182		GO:0050789;GO:0050896	0	0.0625	ENSG00000243646;ENSG00000142677;ENSG00000127318;ENSG00000164485;ENSG00000185436;ENSG00000016402;ENSG00000162891;ENSG00000174564;ENSG00000161634;ENSG00000111536;ENSG00000142224;ENSG00000165023;ENSG00000116209;ENSG00000162892;ENSG00000162595;ENSG00000170385;ENSG00000135632;ENSG00000182393;ENSG00000197110;ENSG00000183709;ENSG00000113583	1	25	10765	14	3	11	10762	10790	0.6785097297350006
264	M1	e019_M1	TRUE	8.586419097228352e-16	7	12	6	0.5	0.8571428571428571	REAC:R-HSA-5576894	REAC	Phase 1 - inactivation of fast Na+ channels	10790	1643		GO:0050789;GO:0006811	0	0.05555555555555555	ENSG00000204936;ENSG00000147533;ENSG00000175497;ENSG00000171385;ENSG00000100346;ENSG00000184408;ENSG00000130226;ENSG00000115041;ENSG00000174992;ENSG00000038219;ENSG00000182132;ENSG00000239779;ENSG00000120049;ENSG00000133687;ENSG00000185774;ENSG00000109610;ENSG00000012171;ENSG00000166762;ENSG00000215784;ENSG00000185739;ENSG00000075213	1	7	10783	6	6	1	10777	10790	0.654380422544209
266	M1	e019_M1	TRUE	3.3015832951357696e-8	25	16	5	0.3125	0.2	GO:0014059	GO:BP	regulation of dopamine secretion	16324	4745		GO:0050789;GO:0046903	0	0.04	ENSG00000085514;ENSG00000113805;ENSG00000110514;ENSG00000134207;ENSG00000055147;ENSG00000107281;ENSG00000108018;ENSG00000105290;ENSG00000068650;ENSG00000213023;ENSG00000262655;ENSG00000129990;ENSG00000182272;ENSG00000144619;ENSG00000048707;ENSG00000121716;ENSG00000165983;ENSG00000196335;ENSG00000110975;ENSG00000176204;ENSG00000173227	1	25	16299	5	11	20	16288	16324	0.24908762871110277
268	M1	e019_M1	TRUE	8.216863816430049e-4	107	11	4	0.36363636363636365	0.037383177570093455	REAC:R-HSA-8957275	REAC	Post-translational protein phosphorylation	10790	1687		NA	0	0.3333333333333333	ENSG00000160963;ENSG00000111670;ENSG00000203778;ENSG00000177706;ENSG00000178522;ENSG00000158079;ENSG00000181195;ENSG00000064652;ENSG00000171209;ENSG00000187689;ENSG00000212122;ENSG00000090581;ENSG00000165219;ENSG00000157734;ENSG00000162630;ENSG00000183655;ENSG00000101327;ENSG00000186998;ENSG00000111344;ENSG00000080200	1	107	10683	4	7	103	10676	10790	0.11403794625688621
269	M1	e019_M1	TRUE	1.9386332129854416e-12	32	15	7	0.4666666666666667	0.21875	REAC:R-HSA-418990	REAC	Adherens junctions interactions	10790	117		GO:0007155;GO:0022607	0	0.07692307692307693	ENSG00000276231;ENSG00000071282;ENSG00000141448;ENSG00000099889;ENSG00000071991;ENSG00000008086;ENSG00000155099;ENSG00000129910;ENSG00000186130;ENSG00000160460;ENSG00000198576;ENSG00000152700;ENSG00000115592;ENSG00000145526;ENSG00000040731;ENSG00000081138;ENSG00000113100;ENSG00000113361;ENSG00000154162;ENSG00000076351	1	32	10758	7	8	25	10750	10790	0.3181673923078296
270	M1	e019_M1	TRUE	1.7393860900509045e-6	36	8	4	0.5	0.1111111111111111	REAC:R-HSA-390522	REAC	Striated Muscle Contraction	10790	2225		GO:0006936	0	0.1111111111111111	ENSG00000105963;ENSG00000125775;ENSG00000100079;ENSG00000176148;ENSG00000115295;ENSG00000229117;ENSG00000166289;ENSG00000169509;ENSG00000105048;ENSG00000136274;ENSG00000151876;ENSG00000114854;ENSG00000150776;ENSG00000118194;ENSG00000129991;ENSG00000147124;ENSG00000158806;ENSG00000116783;ENSG00000143669;ENSG00000269096	1	36	10754	4	4	32	10750	10790	0.23460800168061635
271	M1	e019_M1	TRUE	1.5727563556140182e-12	91	11	8	0.7272727272727273	0.08791208791208792	KEGG:04657	KEGG	IL-17 signaling pathway	8161	329		GO:0050789;GO:0050896	0	0.09090909090909091	ENSG00000109471;ENSG00000112115;ENSG00000112116;ENSG00000144730;ENSG00000127743;ENSG00000177663;ENSG00000056736;ENSG00000275793;ENSG00000056972;ENSG00000166090;ENSG00000222046;ENSG00000164292;ENSG00000163701;ENSG00000092607;ENSG00000115084;ENSG00000166455;ENSG00000148680;ENSG00000189050;ENSG00000114805;ENSG00000165323	1	91	8070	8	3	83	8067	8161	0.25054777428918257
273	M1	e019_M1	TRUE	8.410798079534013e-5	124	7	4	0.5714285714285714	0.03225806451612903	KEGG:04650	KEGG	Natural killer cell mediated cytotoxicity	8161	328		GO:0001906;GO:0002376;GO:0044419;GO:0050896	0	0.125	ENSG00000213809;ENSG00000136122;ENSG00000184060;ENSG00000160285;ENSG00000203722;ENSG00000015532;ENSG00000105650;ENSG00000132549;ENSG00000139266;ENSG00000155918;ENSG00000183542;ENSG00000242802;ENSG00000183214;ENSG00000135678;ENSG00000111981;ENSG00000141449;ENSG00000144583;ENSG00000184232;ENSG00000185621;ENSG00000273111	1	124	8037	4	3	120	8034	8161	0.1332315334499904
274	M1	e019_M1	TRUE	1.5584552224122996e-6	14	18	4	0.2222222222222222	0.2857142857142857	GO:2001034	GO:BP	positive regulation of double-strand break repair via nonhomologous end joining	16324	27566		GO:0006259;GO:0050789;GO:0001775;GO:0002376	0	0.02857142857142857	ENSG00000008128;ENSG00000163660;ENSG00000179083;ENSG00000161526;ENSG00000170955;ENSG00000171984;ENSG00000253251;ENSG00000173575;ENSG00000139697;ENSG00000127527;ENSG00000122376;ENSG00000152242;ENSG00000205609;ENSG00000009780;ENSG00000142065;ENSG00000133247;ENSG00000185947;ENSG00000189180;ENSG00000117691;ENSG00000181666	1	14	16310	4	14	10	16296	16324	0.2512501161729504
275	M1	e019_M1	TRUE	6.041515527409115e-15	107	18	10	0.5555555555555556	0.09345794392523364	GO:0061640	GO:BP	cytoskeleton-dependent cytokinesis	16324	16508		GO:0008150	0	0.2	ENSG00000108387;ENSG00000145439;ENSG00000180096;ENSG00000125354;ENSG00000184702;ENSG00000171160;ENSG00000124688;ENSG00000100167;ENSG00000154997;ENSG00000164402;ENSG00000186001;ENSG00000186522;ENSG00000140623;ENSG00000138758;ENSG00000122304;ENSG00000073598;ENSG00000214097;ENSG00000183305;ENSG00000140265;ENSG00000179604	1	107	16217	10	8	97	16209	16324	0.22603981412953325
276	M1	e019_M1	TRUE	2.0186350231110004e-6	17	16	4	0.25	0.23529411764705882	GO:0006474	GO:BP	N-terminal protein amino acid acetylation	16324	2262		GO:0036211;GO:0051604	0	0.5	ENSG00000164463;ENSG00000167393;ENSG00000232960;ENSG00000102030;ENSG00000164134;ENSG00000171428;ENSG00000111726;ENSG00000134684;ENSG00000185567;ENSG00000242028;ENSG00000156269;ENSG00000144712;ENSG00000154781;ENSG00000144868;ENSG00000163995;ENSG00000172766;ENSG00000146147;ENSG00000250254;ENSG00000174429;ENSG00000164929	1	17	16307	4	12	13	16295	16324	0.24176968403764146
277	M1	e019_M1	TRUE	3.0528371656902296e-6	83	11	5	0.45454545454545453	0.060240963855421686	REAC:R-HSA-1483255	REAC	PI Metabolism	10790	1577		NA	0	0.125	ENSG00000150867;ENSG00000087053;ENSG00000100241;ENSG00000133812;ENSG00000187583;ENSG00000087589;ENSG00000106400;ENSG00000149798;ENSG00000111737;ENSG00000198853;ENSG00000103381;ENSG00000109618;ENSG00000047346;ENSG00000114331;ENSG00000063601;ENSG00000165525;ENSG00000213047;ENSG00000145476;ENSG00000133114;ENSG00000211450	1	83	10707	5	6	78	10701	10790	0.16338810074053364
279	M1	e019_M1	TRUE	2.885930268068807e-15	425	20	14	0.7	0.03294117647058824	GO:0002757	GO:BP	immune response-activating signaling pathway	16324	1287		GO:0050789;GO:0002376	0	0.01639344262295082	ENSG00000160293;ENSG00000095585;ENSG00000102010;ENSG00000124181;ENSG00000026103;ENSG00000197943;ENSG00000105974;ENSG00000072135;ENSG00000086730;ENSG00000043462;ENSG00000141968;ENSG00000109458;ENSG00000177455;ENSG00000113263;ENSG00000134215;ENSG00000070190;ENSG00000155926;ENSG00000087266;ENSG00000135605;ENSG00000010671	1	425	15899	14	6	411	15893	16324	0.14823552318571112
280	M1	e019_M1	TRUE	0.00221644490543201	23	17	3	0.17647058823529413	0.13043478260869565	GO:0046599	GO:BP	regulation of centriole replication	16324	12959		GO:0050789	0	0.5	ENSG00000025770;ENSG00000123473;ENSG00000165689;ENSG00000075218;ENSG00000116871;ENSG00000066933;ENSG00000100578;ENSG00000178252;ENSG00000107816;ENSG00000166004;ENSG00000197261;ENSG00000066279;ENSG00000076826;ENSG00000130177;ENSG00000135451;ENSG00000165475;ENSG00000011405;ENSG00000072682;ENSG00000116127;ENSG00000166436	1	23	16301	3	14	20	16287	16324	0.15068981931867367
282	M1	e019_M1	TRUE	8.12187853483006e-10	36	16	6	0.375	0.16666666666666666	GO:0034381	GO:BP	plasma lipoprotein particle clearance	16324	9055		GO:0051641;GO:0016192;GO:0050789;GO:0032501	0	0.030303030303030304	ENSG00000147852;ENSG00000189056;ENSG00000130164;ENSG00000169174;ENSG00000163956;ENSG00000184381;ENSG00000198911;ENSG00000157978;ENSG00000167780;ENSG00000179674;ENSG00000175879;ENSG00000114650;ENSG00000186480;ENSG00000163291;ENSG00000125637;ENSG00000184530;ENSG00000108352;ENSG00000169926;ENSG00000145860	1	36	16288	6	10	30	16278	16324	0.24892629547621595
286	M1	e019_M1	TRUE	1.2304632525093603e-5	49	9	4	0.4444444444444444	0.08163265306122448	REAC:R-HSA-6811440	REAC	Retrograde transport at the Trans-Golgi-Network	10790	1974		NA	0	0.16666666666666666	ENSG00000144747;ENSG00000144674;ENSG00000129204;ENSG00000175582;ENSG00000163746;ENSG00000154917;ENSG00000170832;ENSG00000140650;ENSG00000155428;ENSG00000130513;ENSG00000038002;ENSG00000100417;ENSG00000160445;ENSG00000008323;ENSG00000159873;ENSG00000150551;ENSG00000185917;ENSG00000134901;ENSG00000183662	1	49	10741	4	5	45	10736	10790	0.1890383429642647
288	M1	e019_M1	TRUE	2.8088492290895537e-7	11	16	4	0.25	0.36363636363636365	GO:0050665	GO:BP	hydrogen peroxide biosynthetic process	16324	13943		GO:0008152	0	0.07692307692307693	ENSG00000140279;ENSG00000138768;ENSG00000117010;ENSG00000111879;ENSG00000142444;ENSG00000140274;ENSG00000153066;ENSG00000115657;ENSG00000080166;ENSG00000137857;ENSG00000155542;ENSG00000171819;ENSG00000175820;ENSG00000175309;ENSG00000130558;ENSG00000088298;ENSG00000115705;ENSG00000140254;ENSG00000134538	1	11	16313	4	12	7	16301	16324	0.30094753363697285
289	M1	e019_M1	TRUE	1.7459394367494095e-5	11	9	3	0.3333333333333333	0.2727272727272727	REAC:R-HSA-211999	REAC	CYP2E1 reactions	10790	282		GO:0046483;GO:0006725;GO:0019748	0	0.09090909090909091	ENSG00000117586;ENSG00000186827;ENSG00000049249;ENSG00000162739;ENSG00000105404;ENSG00000134594;ENSG00000100711;ENSG00000086300;ENSG00000002919;ENSG00000149547;ENSG00000204323;ENSG00000167371;ENSG00000180481;ENSG00000145375;ENSG00000168070;ENSG00000255974;ENSG00000006757;ENSG00000198077;ENSG00000197838	1	11	10779	3	6	8	10773	10790	0.30086804708515047
290	M1	e019_M1	TRUE	6.207673479623856e-10	239	10	8	0.8	0.03347280334728033	REAC:R-HSA-8951664	REAC	Neddylation	10790	1474		GO:0036211	0	0.2	ENSG00000082153;ENSG00000148925;ENSG00000135108;ENSG00000107872;ENSG00000162517;ENSG00000198642;ENSG00000133243;ENSG00000145919;ENSG00000003096;ENSG00000064726;ENSG00000099910;ENSG00000120705;ENSG00000118564;ENSG00000166233;ENSG00000152910;ENSG00000100364;ENSG00000162413;ENSG00000244486;ENSG00000197622	1	239	10551	8	2	231	10549	10790	0.16097635177222203
292	M1	e019_M1	TRUE	5.113685734006857e-8	128	15	7	0.4666666666666667	0.0546875	REAC:R-HSA-6809371	REAC	Formation of the cornified envelope	10790	919		GO:0050789	0	0.05	ENSG00000133710;ENSG00000167754;ENSG00000178172;ENSG00000186474;ENSG00000167759;ENSG00000129437;ENSG00000204909;ENSG00000073150;ENSG00000110218;ENSG00000164047;ENSG00000096088;ENSG00000129744;ENSG00000089041;ENSG00000169035;ENSG00000142459;ENSG00000158315;ENSG00000174839;ENSG00000108947;ENSG00000170379	1	128	10662	7	8	121	10654	10790	0.15673219826034754
293	M1	e019_M1	TRUE	1.1916861916869715e-10	71	7	6	0.8571428571428571	0.08450704225352113	KEGG:04622	KEGG	RIG-I-like receptor signaling pathway	8161	321		GO:0002376;GO:0001816;GO:0050896;GO:0050789;GO:0044419	0	0.022222222222222223	ENSG00000107201;ENSG00000115267;ENSG00000140968;ENSG00000198933;ENSG00000108771;ENSG00000163512;ENSG00000101695;ENSG00000117595;ENSG00000140853;ENSG00000181481;ENSG00000086666;ENSG00000125531;ENSG00000115297;ENSG00000235961;ENSG00000133874;ENSG00000060709;ENSG00000173068;ENSG00000247315;ENSG00000140455	1	71	8090	6	1	65	8089	8161	0.26768636531541057
294	M1	e019_M1	TRUE	2.6108990409527894e-4	26	11	3	0.2727272727272727	0.11538461538461539	KEGG:00790	KEGG	Folate biosynthesis	8161	125		NA	0	0.3333333333333333	ENSG00000089775;ENSG00000189252;ENSG00000132570;ENSG00000165584;ENSG00000166228;ENSG00000188290;ENSG00000115421;ENSG00000183077;ENSG00000154227;ENSG00000184220;ENSG00000186051;ENSG00000186487;ENSG00000082269;ENSG00000134716;ENSG00000158882;ENSG00000151240;ENSG00000005801;ENSG00000171759;ENSG00000229809	1	26	8135	3	8	23	8127	8161	0.17571989088471446
295	M1	e019_M1	TRUE	2.738791889918385e-9	36	19	6	0.3157894736842105	0.16666666666666666	GO:0045023	GO:BP	G0 to G1 transition	16324	11924		GO:0006281;GO:0032502;GO:0050789	0	0.027777777777777776	ENSG00000010030;ENSG00000151702;ENSG00000250506;ENSG00000141380;ENSG00000049618;ENSG00000105610;ENSG00000256453;ENSG00000063169;ENSG00000189079;ENSG00000130024;ENSG00000205683;ENSG00000077080;ENSG00000120832;ENSG00000166503;ENSG00000204390;ENSG00000214021;ENSG00000139083;ENSG00000124374;ENSG00000125831	1	36	16288	6	13	30	16275	16324	0.22819805184525158
296	M1	e019_M1	TRUE	2.9065427181932577e-21	27	19	10	0.5263157894736842	0.37037037037037035	GO:2000819	GO:BP	regulation of nucleotide-excision repair	16324	27358		GO:0032502;GO:0006281;GO:0051276;GO:0007059;GO:0050789	0	0.010526315789473684	ENSG00000177565;ENSG00000108604;ENSG00000136518;ENSG00000249915;ENSG00000173473;ENSG00000073584;ENSG00000164032;ENSG00000080503;ENSG00000104856;ENSG00000163104;ENSG00000009954;ENSG00000163939;ENSG00000077097;ENSG00000127616;ENSG00000139613;ENSG00000117713;ENSG00000116016;ENSG00000133884;ENSG00000102038	1	27	16297	10	9	17	16288	16324	0.4407442965814203
297	M1	e019_M1	TRUE	5.995962313118527e-12	68	19	8	0.42105263157894735	0.11764705882352941	GO:0045109	GO:BP	intermediate filament organization	16324	11970		GO:0032502;GO:0006996	0	0.0625	ENSG00000170421;ENSG00000154127;ENSG00000182636;ENSG00000185104;ENSG00000128422;ENSG00000167768;ENSG00000186081;ENSG00000186395;ENSG00000092098;ENSG00000172867;ENSG00000153975;ENSG00000171403;ENSG00000154277;ENSG00000096696;ENSG00000163631;ENSG00000146457;ENSG00000186847;ENSG00000173226;ENSG00000197915	1	68	16256	8	11	60	16245	16324	0.2209530603318673
298	M1	e019_M1	TRUE	2.218597615156589e-27	10	18	10	0.5555555555555556	1	REAC:R-HSA-2470946	REAC	Cohesin Loading onto Chromatin	10790	363		GO:0051276	0	0.023255813953488372	ENSG00000101972;ENSG00000160710;ENSG00000108055;ENSG00000175216;ENSG00000121892;ENSG00000146670;ENSG00000083642;ENSG00000213782;ENSG00000141867;ENSG00000118007;ENSG00000174197;ENSG00000080345;ENSG00000072501;ENSG00000164190;ENSG00000129933;ENSG00000135913;ENSG00000062650;ENSG00000182872;ENSG00000164754	1	10	10780	10	8	0	10772	10790	0.7450793712276456
301	M1	e019_M1	TRUE	1.2297018092586864e-8	26	12	5	0.4166666666666667	0.19230769230769232	REAC:R-HSA-1187000	REAC	Fertilization	10790	894		GO:0008150	0	0.1	ENSG00000197471;ENSG00000103310;ENSG00000013297;ENSG00000182566;ENSG00000185905;ENSG00000188372;ENSG00000178343;ENSG00000254521;ENSG00000182264;ENSG00000100312;ENSG00000141316;ENSG00000149506;ENSG00000133195;ENSG00000088827;ENSG00000167280;ENSG00000196071;ENSG00000173950;ENSG00000144043	1	26	10764	5	7	21	10757	10790	0.2819287363434204
303	M1	e019_M1	TRUE	1.1563573324681225e-4	2	8	2	0.25	1	REAC:R-HSA-4755609	REAC	Defective DHDDS causes RP59	10790	509		NA	0	0.25	ENSG00000117682;ENSG00000153989;ENSG00000036054;ENSG00000135124;ENSG00000153936;ENSG00000114374;ENSG00000116396;ENSG00000214338;ENSG00000186675;ENSG00000016864;ENSG00000198874;ENSG00000179598;ENSG00000141627;ENSG00000165118;ENSG00000172986;ENSG00000188542;ENSG00000131398;ENSG00000099999	1	2	10788	2	6	0	10782	10790	0.49986093728002484
304	M1	e019_M1	TRUE	2.3097547037702405e-6	89	10	5	0.5	0.056179775280898875	REAC:R-HSA-442755	REAC	Activation of NMDA receptors and postsynaptic events	10790	85		GO:0036211;GO:0006793	0	0.047619047619047616	ENSG00000152495;ENSG00000091732;ENSG00000008118;ENSG00000148481;ENSG00000004660;ENSG00000100034;ENSG00000168930;ENSG00000183049;ENSG00000065057;ENSG00000213079;ENSG00000134072;ENSG00000110931;ENSG00000123552;ENSG00000068784;ENSG00000164089;ENSG00000211598;ENSG00000197768;ENSG00000204449	1	89	10701	5	5	84	10696	10790	0.1655963194342833
305	M1	e019_M1	TRUE	1.9085204496856615e-4	12	15	3	0.2	0.25	GO:0099558	GO:BP	maintenance of synapse structure	16324	20198		GO:0016043	0	0.5	ENSG00000010704;ENSG00000073670;ENSG00000108231;ENSG00000065618;ENSG00000168256;ENSG00000106327;ENSG00000105245;ENSG00000159166;ENSG00000123500;ENSG00000186897;ENSG00000176095;ENSG00000258429;ENSG00000171603;ENSG00000178502;ENSG00000054803;ENSG00000164816;ENSG00000102924;ENSG00000139899	1	12	16312	3	12	9	16300	16324	0.2229693126504238
309	M1	e019_M1	TRUE	1.5441269956460074e-17	9	17	7	0.4117647058823529	0.7777777777777778	GO:0097646	GO:BP	calcitonin family receptor signaling pathway	16324	19765		GO:0050789	0	0.03225806451612903	ENSG00000004948;ENSG00000110680;ENSG00000122679;ENSG00000131477;ENSG00000132329;ENSG00000064989;ENSG00000175305;ENSG00000162992;ENSG00000121351;ENSG00000129757;ENSG00000139515;ENSG00000100982;ENSG00000163581;ENSG00000136867;ENSG00000124782;ENSG00000182759;ENSG00000125851;ENSG00000188517	1	9	16315	7	10	2	16305	16324	0.5656091734260785
311	M1	e019_M1	TRUE	3.4677857267342095e-4	3	8	2	0.25	0.6666666666666666	REAC:R-HSA-5619099	REAC	Defective AVP does not bind AVPR1A,B and causes neurohypophyseal diabetes insipidus (NDI)	10790	467		NA	0	0.3333333333333333	ENSG00000101200;ENSG00000005379;ENSG00000100300;ENSG00000230522;ENSG00000173548;ENSG00000183628;ENSG00000241127;ENSG00000110318;ENSG00000158301;ENSG00000006015;ENSG00000159871;ENSG00000135074;ENSG00000268629;ENSG00000118276;ENSG00000164039;ENSG00000115844;ENSG00000171612;ENSG00000198049	1	3	10787	2	6	1	10781	10790	0.4080022432978254
315	M1	e019_M1	TRUE	8.527031489864655e-8	54	9	5	0.5555555555555556	0.09259259259259259	REAC:R-HSA-5620924	REAC	Intraflagellar transport	10790	1207		GO:0051641;GO:0006810	0	0.2	ENSG00000168589;ENSG00000185483;ENSG00000119333;ENSG00000213123;ENSG00000100246;ENSG00000159256;ENSG00000167065;ENSG00000126870;ENSG00000264364;ENSG00000186193;ENSG00000171368;ENSG00000119878;ENSG00000162384;ENSG00000182223;ENSG00000089091;ENSG00000024526;ENSG00000107362;ENSG00000156575	1	54	10736	5	4	49	10732	10790	0.22542004858558332
317	M1	e019_M1	TRUE	1.2095959065590415e-5	21	5	3	0.6	0.14285714285714285	REAC:R-HSA-392154	REAC	Nitric oxide stimulates guanylate cyclase	10790	1515		GO:0050789	0	0.0625	ENSG00000162378;ENSG00000152402;ENSG00000149743;ENSG00000167487;ENSG00000196236;ENSG00000156172;ENSG00000164116;ENSG00000102390;ENSG00000106524;ENSG00000154099;ENSG00000153904;ENSG00000135537;ENSG00000077585;ENSG00000061918;ENSG00000164088;ENSG00000180205;ENSG00000137817;ENSG00000166105	1	21	10769	3	2	18	10767	10790	0.29217244621993554
318	M1	e019_M1	TRUE	2.110152001614868e-12	15	16	6	0.375	0.4	GO:1904507	GO:BP	positive regulation of telomere maintenance in response to DNA damage	16324	25027		GO:0051276;GO:0006259;GO:0050789;GO:0050896	0	0.034482758620689655	ENSG00000184922;ENSG00000142409;ENSG00000106483;ENSG00000153391;ENSG00000170322;ENSG00000152583;ENSG00000169592;ENSG00000101442;ENSG00000128908;ENSG00000104213;ENSG00000107614;ENSG00000183066;ENSG00000167202;ENSG00000154144;ENSG00000105738;ENSG00000122741;ENSG00000141562;ENSG00000113812	1	15	16309	6	10	9	16299	16324	0.3867165026782493
320	M1	e019_M1	TRUE	0.0010946120672065893	2	15	2	0.13333333333333333	1	GO:0043629	GO:BP	ncRNA polyadenylation	16324	11410		GO:0016070	0	0.25	ENSG00000174010;ENSG00000186226;ENSG00000156050;ENSG00000106261;ENSG00000163006;ENSG00000147905;ENSG00000170967;ENSG00000170419;ENSG00000176428;ENSG00000135094;ENSG00000150676;ENSG00000151498;ENSG00000104450;ENSG00000123600;ENSG00000112941;ENSG00000187866;ENSG00000121274;ENSG00000166816	1	2	16322	2	13	0	16309	16324	0.3650029276557092
324	M1	e019_M1	TRUE	6.684172675621506e-5	12	12	3	0.25	0.25	REAC:R-HSA-8851680	REAC	Butyrophilin (BTN) family interactions	10790	248		GO:0006082;GO:0044255	0	0.125	ENSG00000213949;ENSG00000159199;ENSG00000011028;ENSG00000134575;ENSG00000114988;ENSG00000218336;ENSG00000001561;ENSG00000095303;ENSG00000026950;ENSG00000073756;ENSG00000106868;ENSG00000111801;ENSG00000186470;ENSG00000124212;ENSG00000164604;ENSG00000136816;ENSG00000174482;ENSG00000106771	1	12	10778	3	9	9	10769	10790	0.24916496567081095
325	M1	e019_M1	TRUE	3.4449967343249445e-12	9	9	5	0.5555555555555556	0.5555555555555556	REAC:R-HSA-428542	REAC	Regulation of commissural axon pathfinding by SLIT and ROBO	10790	1913		GO:0048511;GO:0050789;GO:0032989;GO:0040011	0	0.013157894736842105	ENSG00000145147;ENSG00000169855;ENSG00000185008;ENSG00000184347;ENSG00000187122;ENSG00000124171;ENSG00000116117;ENSG00000170903;ENSG00000196220;ENSG00000101745;ENSG00000154133;ENSG00000167105;ENSG00000111665;ENSG00000122694;ENSG00000120318;ENSG00000105778;ENSG00000089820;ENSG00000175414	1	9	10781	5	4	4	10777	10790	0.5551845324593679
326	M1	e019_M1	TRUE	2.7878744738381924e-18	52	18	10	0.5555555555555556	0.19230769230769232	GO:0051568	GO:BP	histone H3-K4 methylation	16324	14578		GO:0036211	0	0.024390243902439025	ENSG00000101266;ENSG00000070770;ENSG00000276410;ENSG00000099381;ENSG00000173120;ENSG00000105127;ENSG00000172534;ENSG00000164091;ENSG00000117222;ENSG00000118058;ENSG00000100888;ENSG00000147162;ENSG00000129691;ENSG00000162961;ENSG00000196363;ENSG00000133895;ENSG00000168310;ENSG00000118513	1	52	16272	10	8	42	16264	16324	0.3256845164670465
327	M1	e019_M1	TRUE	7.522794168166718e-12	14	18	6	0.3333333333333333	0.42857142857142855	REAC:R-HSA-177504	REAC	Retrograde neurotrophin signalling	10790	1973		GO:0016192;GO:0065008	0	0.020833333333333332	ENSG00000122705;ENSG00000006125;ENSG00000176986;ENSG00000141367;ENSG00000196586;ENSG00000161203;ENSG00000101460;ENSG00000157540;ENSG00000148396;ENSG00000070371;ENSG00000004975;ENSG00000073921;ENSG00000196961;ENSG00000100934;ENSG00000113282;ENSG00000198400;ENSG00000122126;ENSG00000082898	1	14	10776	6	12	8	10764	10790	0.37705236921256635
328	M1	e019_M1	TRUE	9.861171558379122e-13	12	18	6	0.3333333333333333	0.5	GO:0000727	GO:BP	double-strand break repair via break-induced replication	16324	214		GO:0006281;GO:0050789;GO:0032392	0	0.02040816326530612	ENSG00000073111;ENSG00000104738;ENSG00000076003;ENSG00000185513;ENSG00000133101;ENSG00000112118;ENSG00000146047;ENSG00000100297;ENSG00000140525;ENSG00000124635;ENSG00000131236;ENSG00000166508;ENSG00000171444;ENSG00000149136;ENSG00000130726;ENSG00000122779;ENSG00000160224;ENSG00000092201	1	12	16312	6	12	6	16300	16324	0.4077226235559965
333	M1	e019_M1	TRUE	1.8355078817706864e-5	37	4	3	0.75	0.08108108108108109	KEGG:05340	KEGG	Primary immunodeficiency	8161	481		GO:0050789	0	0.16666666666666666	ENSG00000164331;ENSG00000064490;ENSG00000244754;ENSG00000136535;ENSG00000133111;ENSG00000143390;ENSG00000020577;ENSG00000173928;ENSG00000214941;ENSG00000164808;ENSG00000106078;ENSG00000155085;ENSG00000181827;ENSG00000132436;ENSG00000000460;ENSG00000091527;ENSG00000172244	1	37	8124	3	1	34	8123	8161	0.2457255435232949
335	M1	e019_M1	TRUE	1.4329562573273162e-9	16	13	5	0.38461538461538464	0.3125	REAC:R-HSA-399956	REAC	CRMPs in Sema3A signaling	10790	275		NA	0	0.5	ENSG00000172572;ENSG00000074317;ENSG00000162302;ENSG00000072832;ENSG00000124702;ENSG00000104442;ENSG00000144395;ENSG00000147647;ENSG00000113657;ENSG00000157851;ENSG00000151640;ENSG00000179148;ENSG00000092964;ENSG00000156206;ENSG00000165506;ENSG00000157152;ENSG00000185666	1	16	10774	5	8	11	10766	10790	0.3458157189268625
336	M1	e019_M1	TRUE	0.0032015159272728755	58	9	3	0.3333333333333333	0.05172413793103448	REAC:R-HSA-8866654	REAC	E3 ubiquitin ligases ubiquitinate target proteins	10790	773		NA	0	0.3333333333333333	ENSG00000119048;ENSG00000162607;ENSG00000144366;ENSG00000102908;ENSG00000186197;ENSG00000005436;ENSG00000095787;ENSG00000185264;ENSG00000133302;ENSG00000146414;ENSG00000182158;ENSG00000024048;ENSG00000243978;ENSG00000087995;ENSG00000171199;ENSG00000172840;ENSG00000183760	1	58	10732	3	6	55	10726	10790	0.12959166151401955
338	M1	e019_M1	TRUE	1.3803203255175653e-5	71	7	4	0.5714285714285714	0.056338028169014086	REAC:R-HSA-909733	REAC	Interferon alpha/beta signaling	10790	1168		GO:0044419;GO:0050896	0	0.125	ENSG00000163481;ENSG00000184584;ENSG00000143556;ENSG00000185745;ENSG00000145506;ENSG00000119917;ENSG00000067048;ENSG00000115459;ENSG00000172901;ENSG00000119922;ENSG00000108406;ENSG00000204010;ENSG00000181038;ENSG00000198729;ENSG00000204138;ENSG00000205307;ENSG00000186803	1	71	10719	4	3	67	10716	10790	0.17800256426791333
339	M1	e019_M1	TRUE	1.2625067137543037e-15	8	12	6	0.5	0.75	GO:0097104	GO:BP	postsynaptic membrane assembly	16324	19532		GO:0050877;GO:0007155;GO:0016192;GO:0022607;GO:0044085;GO:0061024;GO:0065008;GO:0050789	0	0.010869565217391304	ENSG00000071205;ENSG00000179915;ENSG00000169760;ENSG00000196338;ENSG00000141741;ENSG00000041515;ENSG00000167861;ENSG00000101333;ENSG00000112041;ENSG00000123179;ENSG00000159409;ENSG00000133401;ENSG00000197982;ENSG00000146938;ENSG00000157617;ENSG00000165246;ENSG00000169992	1	8	16316	6	6	2	16310	16324	0.612147220569612
344	M1	e019_M1	TRUE	4.2702101214999364e-7	34	7	4	0.5714285714285714	0.11764705882352941	KEGG:05330	KEGG	Allograft rejection	8161	479		GO:0016192;GO:0002376;GO:0001775;GO:0046903	0	0.037037037037037035	ENSG00000121594;ENSG00000114013;ENSG00000175826;ENSG00000205423;ENSG00000116266;ENSG00000196126;ENSG00000122359;ENSG00000076944;ENSG00000138772;ENSG00000123094;ENSG00000162065;ENSG00000173868;ENSG00000198502;ENSG00000115226;ENSG00000150656;ENSG00000196101;ENSG00000145416	1	34	8127	4	3	30	8124	8161	0.2580396628031224
346	M1	e019_M1	TRUE	7.199194816051064e-10	38	15	6	0.4	0.15789473684210525	GO:0019755	GO:BP	one-carbon compound transport	16324	6367		GO:0006810	0	0.09090909090909091	ENSG00000029534;ENSG00000158856;ENSG00000104267;ENSG00000142794;ENSG00000112077;ENSG00000004939;ENSG00000170180;ENSG00000219481;ENSG00000104960;ENSG00000070182;ENSG00000114923;ENSG00000167434;ENSG00000156256;ENSG00000105371;ENSG00000166947;ENSG00000080493;ENSG00000163864	1	38	16286	6	9	32	16277	16324	0.250256116703883
348	M1	e019_M1	TRUE	8.25882244856881e-6	101	11	5	0.45454545454545453	0.04950495049504951	REAC:R-HSA-5689603	REAC	UCH proteinases	10790	2477		GO:0032502	0	0.047619047619047616	ENSG00000136574;ENSG00000183072;ENSG00000121068;ENSG00000143970;ENSG00000171456;ENSG00000262919;ENSG00000147121;ENSG00000055609;ENSG00000089225;ENSG00000166987;ENSG00000167674;ENSG00000162814;ENSG00000147050;ENSG00000204406;ENSG00000141431;ENSG00000165097;ENSG00000183734	1	101	10689	5	6	96	10683	10790	0.14768615569361845
349	M1	e019_M1	TRUE	2.9641741457141243e-28	24	16	12	0.75	0.5	REAC:R-HSA-379716	REAC	Cytosolic tRNA aminoacylation	10790	409		GO:0006520;GO:0016070	0	0.04	ENSG00000172053;ENSG00000136628;ENSG00000115866;ENSG00000008405;ENSG00000091140;ENSG00000254772;ENSG00000166986;ENSG00000196305;ENSG00000106305;ENSG00000133706;ENSG00000121671;ENSG00000164022;ENSG00000113643;ENSG00000065427;ENSG00000106105;ENSG00000124802;ENSG00000096171	1	24	10766	12	4	12	10762	10790	0.6116901687633546
350	M1	e019_M1	TRUE	3.632416003700971e-5	801	17	9	0.5294117647058824	0.011235955056179775	GO:0007167	GO:BP	enzyme-linked receptor protein signaling pathway	16324	2794		GO:0050789	0	0.1	ENSG00000198252;ENSG00000165731;ENSG00000169071;ENSG00000143851;ENSG00000132670;ENSG00000112655;ENSG00000066468;ENSG00000166225;ENSG00000181409;ENSG00000153233;ENSG00000154237;ENSG00000140538;ENSG00000146094;ENSG00000142949;ENSG00000130669;ENSG00000071242;ENSG00000100614	1	801	15523	9	8	792	15515	16324	0.07179782832588626
351	M1	e019_M1	TRUE	1.1967806142203739e-8	55	16	6	0.375	0.10909090909090909	GO:0043299	GO:BP	leukocyte degranulation	16324	11197		GO:0007155;GO:0016192;GO:0002376;GO:0001775;GO:0046903;GO:0050789	0	0.013333333333333334	ENSG00000000938;ENSG00000104814;ENSG00000149534;ENSG00000105851;ENSG00000143226;ENSG00000072694;ENSG00000180353;ENSG00000165025;ENSG00000076641;ENSG00000088053;ENSG00000011422;ENSG00000111199;ENSG00000012124;ENSG00000160255;ENSG00000254087;ENSG00000269556;ENSG00000108443	1	55	16269	6	10	49	16259	16324	0.20087970760013515
352	M1	e019_M1	TRUE	8.561519822331881e-13	157	11	9	0.8181818181818182	0.05732484076433121	KEGG:04390	KEGG	Hippo signaling pathway	8161	304		GO:0050789	0	0.1	ENSG00000151748;ENSG00000142279;ENSG00000073711;ENSG00000126016;ENSG00000170037;ENSG00000144791;ENSG00000144283;ENSG00000131023;ENSG00000143514;ENSG00000107863;ENSG00000180900;ENSG00000018408;ENSG00000152104;ENSG00000166263;ENSG00000134698;ENSG00000196730;ENSG00000150457	1	157	8004	9	2	148	8002	8161	0.21368492189605237
353	M1	e019_M1	TRUE	2.1553066276265206e-27	43	15	13	0.8666666666666667	0.3023255813953488	KEGG:03022	KEGG	Basal transcription factors	8161	213		GO:0016070;GO:0009059	0	0.018518518518518517	ENSG00000188342;ENSG00000163161;ENSG00000171681;ENSG00000002016;ENSG00000020426;ENSG00000272047;ENSG00000197265;ENSG00000134058;ENSG00000125651;ENSG00000111358;ENSG00000137947;ENSG00000153767;ENSG00000134480;ENSG00000110768;ENSG00000104884;ENSG00000134899;ENSG00000152467	1	43	8118	13	2	30	8116	8161	0.5105776067829196
355	M1	e019_M1	TRUE	1.029448045810609e-5	41	10	4	0.4	0.0975609756097561	REAC:R-HSA-163841	REAC	Gamma carboxylation, hypusine formation and arylsulfatase activation	10790	976		NA	0	0.3333333333333333	ENSG00000144455;ENSG00000153208;ENSG00000183087;ENSG00000162438;ENSG00000137563;ENSG00000179163;ENSG00000139629;ENSG00000156170;ENSG00000087301;ENSG00000108963;ENSG00000163521;ENSG00000158525;ENSG00000137573;ENSG00000132026;ENSG00000141337;ENSG00000151033	1	41	10749	4	6	37	10743	10790	0.19613304859122038
357	M1	e019_M1	TRUE	0.001949573050661166	104	14	4	0.2857142857142857	0.038461538461538464	GO:1904375	GO:BP	regulation of protein localization to cell periphery	16324	24916		GO:0051641;GO:0050789	0	0.125	ENSG00000104918;ENSG00000121297;ENSG00000169188;ENSG00000137968;ENSG00000198885;ENSG00000250571;ENSG00000129968;ENSG00000076716;ENSG00000163491;ENSG00000156599;ENSG00000080822;ENSG00000136247;ENSG00000169508;ENSG00000241697;ENSG00000099904;ENSG00000183098	1	104	16220	4	10	100	16210	16324	0.10286314187978683
358	M1	e019_M1	TRUE	2.1321569488565093e-6	4	14	3	0.21428571428571427	0.75	REAC:R-HSA-1296025	REAC	ATP sensitive Potassium channels	10790	35		NA	0	0.25	ENSG00000069431;ENSG00000187486;ENSG00000100949;ENSG00000112486;ENSG00000166171;ENSG00000144481;ENSG00000143420;ENSG00000136381;ENSG00000149970;ENSG00000116260;ENSG00000120820;ENSG00000006071;ENSG00000174951;ENSG00000147119;ENSG00000069943;ENSG00000168671	1	4	10786	3	11	1	10775	10790	0.4005324506052578
359	M1	e019_M1	TRUE	5.343820701121744e-4	23	12	3	0.25	0.13043478260869565	REAC:R-HSA-2453902	REAC	The canonical retinoid cycle in rods (twilight vision)	10790	2364		NA	0	0.5	ENSG00000141506;ENSG00000118271;ENSG00000126091;ENSG00000147724;ENSG00000163885;ENSG00000087250;ENSG00000140497;ENSG00000138207;ENSG00000119537;ENSG00000046653;ENSG00000116745;ENSG00000108576;ENSG00000065923;ENSG00000162365;ENSG00000187048;ENSG00000130304	1	23	10767	3	9	20	10758	10790	0.179329963913061
360	M1	e019_M1	TRUE	2.3892873703397768e-23	67	13	12	0.9230769230769231	0.1791044776119403	KEGG:05204	KEGG	Chemical carcinogenesis - DNA adducts	8161	449		GO:0044255;GO:0006082;GO:0050896;GO:0042440;GO:0006805;GO:0042445	0	0.0125	ENSG00000165841;ENSG00000160868;ENSG00000241635;ENSG00000244122;ENSG00000167165;ENSG00000242515;ENSG00000138109;ENSG00000244474;ENSG00000242366;ENSG00000241119;ENSG00000243135;ENSG00000108242;ENSG00000171234;ENSG00000100197;ENSG00000211893;ENSG00000070269	1	67	8094	12	1	55	8093	8161	0.4049753353882775
364	M1	e019_M1	TRUE	3.202545453455757e-8	9	12	4	0.3333333333333333	0.4444444444444444	REAC:R-HSA-1296052	REAC	Ca2+ activated K+ channels	10790	284		GO:0006811;GO:0051606	0	0.05555555555555555	ENSG00000145936;ENSG00000156113;ENSG00000016490;ENSG00000196557;ENSG00000138135;ENSG00000197584;ENSG00000183813;ENSG00000135643;ENSG00000135148;ENSG00000100031;ENSG00000184709;ENSG00000124140;ENSG00000167930;ENSG00000101187;ENSG00000163017;ENSG00000182489	1	9	10781	4	8	5	10773	10790	0.38431102292627906
365	M1	e019_M1	TRUE	4.237446876710237e-5	9	13	3	0.23076923076923078	0.3333333333333333	GO:0045959	GO:BP	negative regulation of complement activation, classical pathway	16324	12453		GO:0050789	0	0.05263157894736842	ENSG00000196352;ENSG00000203710;ENSG00000140678;ENSG00000117322;ENSG00000133048;ENSG00000007062;ENSG00000117394;ENSG00000101203;ENSG00000126878;ENSG00000150556;ENSG00000185885;ENSG00000104921;ENSG00000154518;ENSG00000114999;ENSG00000148600;ENSG00000185127	1	9	16315	3	10	6	16305	16324	0.276874050248828
367	M1	e019_M1	TRUE	3.752955658994019e-4	2	10	2	0.2	1	GO:1905551	GO:BP	negative regulation of protein localization to endoplasmic reticulum	16324	25931		GO:0050789	0	0.5	ENSG00000152595;ENSG00000145741;ENSG00000076248;ENSG00000115514;ENSG00000070476;ENSG00000157927;ENSG00000134717;ENSG00000170836;ENSG00000143499;ENSG00000151575;ENSG00000196531;ENSG00000197183;ENSG00000153237;ENSG00000182552;ENSG00000136682;ENSG00000253506	1	2	16322	2	8	0	16314	16324	0.4471039843229439
371	M1	e019_M1	TRUE	0.003214915687164957	6	10	2	0.2	0.3333333333333333	REAC:R-HSA-6793080	REAC	rRNA modification in the mitochondrion	10790	2589		NA	0	0.5	ENSG00000117481;ENSG00000122085;ENSG00000183770;ENSG00000125398;ENSG00000137090;ENSG00000125482;ENSG00000121211;ENSG00000131470;ENSG00000213551;ENSG00000104177;ENSG00000133422;ENSG00000248099;ENSG00000162419;ENSG00000110844;ENSG00000085982;ENSG00000114487	1	6	10784	2	8	4	10776	10790	0.2576720554142239
373	M1	e019_M1	TRUE	8.987341183380416e-4	2	14	2	0.14285714285714285	1	GO:0099044	GO:BP	vesicle tethering to endoplasmic reticulum	16324	20079		NA	0	0.5	ENSG00000126264;ENSG00000010270;ENSG00000131748;ENSG00000163964;ENSG00000184984;ENSG00000133019;ENSG00000177875;ENSG00000122591;ENSG00000132681;ENSG00000007933;ENSG00000102452;ENSG00000100359;ENSG00000148219;ENSG00000133657;ENSG00000182162;ENSG00000204442	1	2	16322	2	12	0	16310	16324	0.37782550696261225
374	M1	e019_M1	TRUE	8.313022624773632e-24	13	14	9	0.6428571428571429	0.6923076923076923	GO:0001682	GO:BP	tRNA 5'-leader removal	16324	398		GO:0006396	0	0.07142857142857142	ENSG00000172336;ENSG00000178718;ENSG00000167272;ENSG00000157426;ENSG00000198839;ENSG00000105171;ENSG00000124787;ENSG00000088367;ENSG00000163684;ENSG00000164967;ENSG00000125352;ENSG00000141428;ENSG00000163608;ENSG00000152464;ENSG00000148688;ENSG00000079691	1	13	16311	9	5	4	16306	16324	0.6668494361427048
379	M1	e019_M1	TRUE	6.399204832288178e-5	11	12	3	0.25	0.2727272727272727	GO:0006825	GO:BP	copper ion transport	16324	2556		GO:0006811	0	0.1	ENSG00000165240;ENSG00000177556;ENSG00000121753;ENSG00000108479;ENSG00000164221;ENSG00000171357;ENSG00000102984;ENSG00000152904;ENSG00000127952;ENSG00000277656;ENSG00000109771;ENSG00000123191;ENSG00000143891;ENSG00000239388;ENSG00000169397;ENSG00000275896	1	11	16313	3	9	8	16304	16324	0.2605962519806926
381	M1	e019_M1	TRUE	5.8448127075926394e-5	48	14	4	0.2857142857142857	0.08333333333333333	KEGG:00280	KEGG	Valine, leucine and isoleucine degradation	8161	31		GO:0006082	0	0.1111111111111111	ENSG00000117305;ENSG00000148450;ENSG00000126432;ENSG00000167315;ENSG00000065911;ENSG00000196177;ENSG00000162433;ENSG00000004455;ENSG00000147853;ENSG00000060971;ENSG00000117862;ENSG00000213965;ENSG00000137767;ENSG00000116586;ENSG00000063241;ENSG00000138495	1	48	8113	4	10	44	8103	8161	0.1517034898621019
382	M1	e019_M1	TRUE	2.1609327618384105e-5	96	14	5	0.35714285714285715	0.052083333333333336	KEGG:04666	KEGG	Fc gamma R-mediated phagocytosis	8161	335		GO:0002376;GO:0050789	0	0.07692307692307693	ENSG00000186111;ENSG00000075651;ENSG00000141293;ENSG00000113448;ENSG00000173402;ENSG00000164078;ENSG00000129219;ENSG00000197122;ENSG00000105221;ENSG00000103653;ENSG00000179776;ENSG00000131016;ENSG00000198561;ENSG00000143398;ENSG00000140750;ENSG00000151320	1	96	8065	5	9	91	8056	8161	0.13279062296947677
384	M1	e019_M1	TRUE	8.815224257522533e-6	19	5	3	0.6	0.15789473684210525	REAC:R-HSA-77595	REAC	Processing of Intronless Pre-mRNAs	10790	1709		NA	0	0.14285714285714285	ENSG00000101138;ENSG00000090060;ENSG00000151846;ENSG00000176473;ENSG00000124191;ENSG00000174016;ENSG00000168269;ENSG00000177613;ENSG00000198846;ENSG00000166896;ENSG00000197808;ENSG00000101079;ENSG00000243789;ENSG00000156958;ENSG00000180479	1	19	10771	3	2	16	10769	10790	0.30723193818323286
388	M1	e019_M1	TRUE	3.971526438893554e-18	20	14	8	0.5714285714285714	0.4	GO:0051923	GO:BP	sulfation	16324	14785		GO:0006082;GO:0006066;GO:0006790;GO:0009117	0	0.03225806451612903	ENSG00000136541;ENSG00000175662;ENSG00000088002;ENSG00000105398;ENSG00000173597;ENSG00000132768;ENSG00000130540;ENSG00000055070;ENSG00000198203;ENSG00000115970;ENSG00000196502;ENSG00000271303;ENSG00000196228;ENSG00000168582;ENSG00000198075	1	20	16304	8	6	12	16298	16324	0.4775637247050547
390	M1	e019_M1	TRUE	0.00518819151764454	10	8	2	0.25	0.2	REAC:R-HSA-9758881	REAC	Uptake of dietary cobalamins into enterocytes	10790	2491		NA	0	0.25	ENSG00000196136;ENSG00000197540;ENSG00000170542;ENSG00000196616;ENSG00000050555;ENSG00000117154;ENSG00000234809;ENSG00000262576;ENSG00000122133;ENSG00000141086;ENSG00000165879;ENSG00000168925;ENSG00000168928;ENSG00000226660;ENSG00000248144	1	10	10780	2	6	8	10774	10790	0.22296383323929744
391	M1	e019_M1	TRUE	2.7850240779197215e-12	285	14	10	0.7142857142857143	0.03508771929824561	GO:0050808	GO:BP	synapse organization	16324	14020		GO:0016043	0	0.07692307692307693	ENSG00000070610;ENSG00000131626;ENSG00000143847;ENSG00000153113;ENSG00000166387;ENSG00000139220;ENSG00000177380;ENSG00000135049;ENSG00000174521;ENSG00000130477;ENSG00000187672;ENSG00000186472;ENSG00000135912;ENSG00000186377;ENSG00000164061	1	285	16039	10	4	275	16035	16324	0.15587532390830172
396	M1	e019_M1	TRUE	8.069382260811465e-6	115	11	5	0.45454545454545453	0.043478260869565216	GO:0031109	GO:BP	microtubule polymerization or depolymerization	16324	7417		GO:0006996	0	0.25	ENSG00000152192;ENSG00000134222;ENSG00000084764;ENSG00000115266;ENSG00000125319;ENSG00000104237;ENSG00000130487;ENSG00000104427;ENSG00000164123;ENSG00000196169;ENSG00000215595;ENSG00000196900;ENSG00000152433;ENSG00000186185;ENSG00000184659	1	115	16209	5	6	110	16203	16324	0.1389385024287649
401	M1	e019_M1	TRUE	6.880801438722496e-4	673	14	7	0.5	0.010401188707280832	GO:0032880	GO:BP	regulation of protein localization	16324	8304		GO:0050789	0	0.2	ENSG00000168439;ENSG00000087470;ENSG00000120694;ENSG00000092820;ENSG00000184900;ENSG00000120265;ENSG00000141522;ENSG00000147065;ENSG00000118939;ENSG00000102024;ENSG00000072506;ENSG00000107862;ENSG00000159023;ENSG00000158710;ENSG00000188906	1	673	15651	7	7	666	15644	16324	0.06760554062266624
402	M1	e019_M1	TRUE	1.173413823310012e-21	60	15	11	0.7333333333333333	0.18333333333333332	GO:0031124	GO:BP	mRNA 3'-end processing	16324	7432		GO:0006396	0	0.03333333333333333	ENSG00000071894;ENSG00000167005;ENSG00000101811;ENSG00000129315;ENSG00000186153;ENSG00000119203;ENSG00000149532;ENSG00000165934;ENSG00000125755;ENSG00000111605;ENSG00000122257;ENSG00000176102;ENSG00000140009;ENSG00000145216;ENSG00000134371	1	60	16264	11	4	49	16260	16324	0.36566925674060347
403	M1	e019_M1	TRUE	1.802536121806739e-16	610	15	14	0.9333333333333333	0.022950819672131147	GO:0016567	GO:BP	protein ubiquitination	16324	5381		GO:0009057;GO:0036211;GO:0006508	0	0.02702702702702703	ENSG00000123124;ENSG00000163961;ENSG00000072401;ENSG00000123091;ENSG00000156587;ENSG00000130985;ENSG00000185651;ENSG00000108854;ENSG00000109332;ENSG00000101665;ENSG00000069869;ENSG00000078747;ENSG00000104517;ENSG00000170248;ENSG00000077721	1	610	15714	14	1	596	15713	16324	0.14326540177171446
404	M1	e019_M1	TRUE	3.485384132291202e-6	4	15	3	0.2	0.75	GO:0070681	GO:BP	glutaminyl-tRNAGln biosynthesis via transamidation	16324	17192		GO:0006520;GO:0016070	0	0.1	ENSG00000186687;ENSG00000154930;ENSG00000181192;ENSG00000125656;ENSG00000138777;ENSG00000090857;ENSG00000116874;ENSG00000072778;ENSG00000152256;ENSG00000198130;ENSG00000130348;ENSG00000257218;ENSG00000059691;ENSG00000082212;ENSG00000130299	1	4	16320	3	12	1	16308	16324	0.38704909169669266
409	M1	e019_M1	TRUE	9.567070338659917e-11	26	14	6	0.42857142857142855	0.23076923076923078	REAC:R-HSA-3000170	REAC	Syndecan interactions	10790	2236		GO:0050789;GO:0008283	0	0.02857142857142857	ENSG00000110492;ENSG00000261371;ENSG00000124145;ENSG00000169439;ENSG00000132470;ENSG00000027075;ENSG00000065675;ENSG00000140992;ENSG00000115884;ENSG00000138685;ENSG00000163932;ENSG00000162512;ENSG00000163814;ENSG00000198286;ENSG00000149294	1	26	10764	6	8	20	10756	10790	0.3132980274891759
410	M1	e019_M1	TRUE	6.499109146082458e-8	88	12	6	0.5	0.06818181818181818	KEGG:04512	KEGG	ECM-receptor interaction	8161	308		GO:0007155;GO:0050789;GO:0016192	0	0.027777777777777776	ENSG00000117335;ENSG00000085117;ENSG00000150093;ENSG00000010278;ENSG00000173546;ENSG00000164171;ENSG00000005884;ENSG00000135404;ENSG00000135218;ENSG00000177697;ENSG00000007264;ENSG00000091409;ENSG00000196776;ENSG00000198053;ENSG00000214063	1	88	8073	6	6	82	8067	8161	0.1817709916932151
411	M1	e019_M1	TRUE	2.6784743947226664e-5	200	8	5	0.625	0.025	REAC:R-HSA-68877	REAC	Mitotic Prometaphase	10790	1404		GO:0007059;GO:0051234;GO:0051640	0	0.05555555555555555	ENSG00000101004;ENSG00000088970;ENSG00000128849;ENSG00000196544;ENSG00000163071;ENSG00000072864;ENSG00000116830;ENSG00000002822;ENSG00000138778;ENSG00000122417;ENSG00000013810;ENSG00000107890;ENSG00000258890;ENSG00000217442;ENSG00000166579	1	200	10590	5	3	195	10587	10790	0.12247827212729319
412	M1	e019_M1	TRUE	1.5434803227824339e-10	574	15	11	0.7333333333333333	0.01916376306620209	GO:0000226	GO:BP	microtubule cytoskeleton organization	16324	65		GO:0050789;GO:0006996	0	0.038461538461538464	ENSG00000164087;ENSG00000111860;ENSG00000163539;ENSG00000130779;ENSG00000139323;ENSG00000147044;ENSG00000166974;ENSG00000127914;ENSG00000075413;ENSG00000109171;ENSG00000129422;ENSG00000116584;ENSG00000074054;ENSG00000072518;ENSG00000135525	1	574	15750	11	4	563	15746	16324	0.11495390946482532
415	M1	e019_M1	TRUE	6.210043233117329e-25	28	10	10	1	0.35714285714285715	REAC:R-HSA-3928663	REAC	EPHA-mediated growth cone collapse	10790	782		GO:0050789;GO:0032989	0	0.030303030303030304	ENSG00000070886;ENSG00000169242;ENSG00000044524;ENSG00000145242;ENSG00000141441;ENSG00000183317;ENSG00000099617;ENSG00000135333;ENSG00000143590;ENSG00000187244;ENSG00000243364;ENSG00000133640;ENSG00000176055;ENSG00000080224	1	28	10762	10	0	18	10762	10790	0.5971151603416045
416	M1	e019_M1	TRUE	5.088992014997495e-15	9	11	6	0.5454545454545454	0.6666666666666666	REAC:R-HSA-629597	REAC	Highly calcium permeable nicotinic acetylcholine receptors	10790	1065		GO:0007154;GO:0006811;GO:0050896	0	0.041666666666666664	ENSG00000101204;ENSG00000160716;ENSG00000117971;ENSG00000120903;ENSG00000147432;ENSG00000128610;ENSG00000163032;ENSG00000196517;ENSG00000169684;ENSG00000151233;ENSG00000111886;ENSG00000146276;ENSG00000187848;ENSG00000109991	1	9	10781	6	5	3	10776	10790	0.6026590880862449
417	M1	e019_M1	TRUE	8.018391080785159e-12	14	7	5	0.7142857142857143	0.35714285714285715	REAC:R-HSA-193775	REAC	Synthesis of bile acids and bile salts via 24-hydroxycholesterol	10790	2272		GO:0042445;GO:0006066;GO:0042180;GO:0006629;GO:0006807;GO:0050896;GO:0006725;GO:0019748	0	0.023255813953488372	ENSG00000189306;ENSG00000168490;ENSG00000184497;ENSG00000263961;ENSG00000120594;ENSG00000198610;ENSG00000196139;ENSG00000187134;ENSG00000116212;ENSG00000122787;ENSG00000151632;ENSG00000136868;ENSG00000196704;ENSG00000141294	1	14	10776	5	2	9	10774	10790	0.5046499160136165
418	M1	e019_M1	TRUE	0.0018002546011226708	11	5	2	0.4	0.18181818181818182	REAC:R-HSA-2485179	REAC	Activation of the phototransduction cascade	10790	102		NA	0	0.5	ENSG00000130561;ENSG00000163914;ENSG00000198055;ENSG00000170820;ENSG00000136044;ENSG00000120500;ENSG00000170298;ENSG00000153790;ENSG00000196684;ENSG00000162444;ENSG00000131831;ENSG00000136110;ENSG00000109113;ENSG00000150051	1	11	10779	2	3	9	10776	10790	0.26919222039092333
419	M1	e019_M1	TRUE	0.0011574144453226438	16	4	2	0.5	0.125	KEGG:00360	KEGG	Phenylalanine metabolism	8161	42		NA	0	0.25	ENSG00000006534;ENSG00000081181;ENSG00000059804;ENSG00000133063;ENSG00000187180;ENSG00000166170;ENSG00000177082;ENSG00000171877;ENSG00000136536;ENSG00000141569;ENSG00000132746;ENSG00000155816;ENSG00000173262;ENSG00000137959	1	16	8145	2	2	14	8143	8161	0.24932530371606307
425	M1	e019_M1	TRUE	4.93152764291557e-11	30	13	6	0.46153846153846156	0.2	GO:0007035	GO:BP	vacuolar acidification	16324	2699		GO:0065008	0	0.03333333333333333	ENSG00000182220;ENSG00000128524;ENSG00000185344;ENSG00000121807;ENSG00000137312;ENSG00000013588;ENSG00000116685;ENSG00000136710;ENSG00000134243;ENSG00000149541;ENSG00000071553;ENSG00000133318;ENSG00000186318;ENSG00000244045	1	30	16294	6	7	24	16287	16324	0.30301116284446417
426	M1	e019_M1	TRUE	6.943903536773941e-17	97	9	9	1	0.09278350515463918	REAC:R-HSA-5620912	REAC	Anchoring of the basal body to the plasma membrane	10790	141		GO:0022607;GO:0006996	0	0.125	ENSG00000108641;ENSG00000156313;ENSG00000092200;ENSG00000110274;ENSG00000054282;ENSG00000123810;ENSG00000135541;ENSG00000140553;ENSG00000144061;ENSG00000131697;ENSG00000011143;ENSG00000048342;ENSG00000005700;ENSG00000119509	1	97	10693	9	0	88	10693	10790	0.303358136598924
430	M1	e019_M1	TRUE	0.0018002546011226708	11	5	2	0.4	0.18181818181818182	REAC:R-HSA-71288	REAC	Creatine metabolism	10790	391		GO:0006793;GO:0006807	0	0.2	ENSG00000104879;ENSG00000106638;ENSG00000145332;ENSG00000102048;ENSG00000143222;ENSG00000135931;ENSG00000132386;ENSG00000154059;ENSG00000131730;ENSG00000163686;ENSG00000214814;ENSG00000105643;ENSG00000120314	1	11	10779	2	3	9	10776	10790	0.26919222039092333
435	M1	e019_M1	TRUE	4.1731185966527004e-10	46	12	6	0.5	0.13043478260869565	GO:0090329	GO:BP	regulation of DNA-templated DNA replication	16324	19233		GO:0006260;GO:0065009;GO:0050789	0	0.04	ENSG00000075131;ENSG00000111602;ENSG00000162441;ENSG00000141994;ENSG00000147536;ENSG00000181938;ENSG00000089177;ENSG00000131153;ENSG00000167291;ENSG00000153404;ENSG00000170703;ENSG00000159147;ENSG00000101003	1	46	16278	6	6	40	16272	16324	0.2543897550198454
437	M1	e019_M1	TRUE	2.2320419857000326e-6	23	12	4	0.3333333333333333	0.17391304347826086	REAC:R-HSA-373753	REAC	Nephrin family interactions	10790	1497		NA	0	0.25	ENSG00000186867;ENSG00000110148;ENSG00000161270;ENSG00000183853;ENSG00000116218;ENSG00000185565;ENSG00000182667;ENSG00000183715;ENSG00000149571;ENSG00000172260;ENSG00000072657;ENSG00000163394;ENSG00000111700	1	23	10767	4	8	19	10759	10790	0.23962068213521864
439	M1	e019_M1	TRUE	7.169806301676648e-7	755	13	9	0.6923076923076923	0.011920529801324504	GO:0000122	GO:BP	negative regulation of transcription by RNA polymerase II	16324	51		GO:0050789	0	0.5	ENSG00000163930;ENSG00000063978;ENSG00000094916;ENSG00000102974;ENSG00000276043;ENSG00000006194;ENSG00000067066;ENSG00000100811;ENSG00000108468;ENSG00000122565;ENSG00000169057;ENSG00000131747;ENSG00000143815	1	755	15569	9	4	746	15565	16324	0.0868410003013702
440	M1	e019_M1	TRUE	2.7647621633636533e-14	53	12	8	0.6666666666666666	0.1509433962264151	REAC:R-HSA-6811436	REAC	COPI-independent Golgi-to-ER retrograde traffic	10790	266		GO:0051234;GO:0051640;GO:0006996	0	0.016666666666666666	ENSG00000186834;ENSG00000060339;ENSG00000144635;ENSG00000077380;ENSG00000138107;ENSG00000197102;ENSG00000137497;ENSG00000158560;ENSG00000146425;ENSG00000175203;ENSG00000204843;ENSG00000010017;ENSG00000088986	1	53	10737	8	4	45	10733	10790	0.3158352565849607
442	M1	e019_M1	TRUE	2.0995737296657143e-4	21	10	3	0.3	0.14285714285714285	REAC:R-HSA-379726	REAC	Mitochondrial tRNA aminoacylation	10790	1391		GO:0006520;GO:0016070	0	0.1111111111111111	ENSG00000140521;ENSG00000183549;ENSG00000117593;ENSG00000167107;ENSG00000158793;ENSG00000011376;ENSG00000161513;ENSG00000137513;ENSG00000143224;ENSG00000162813;ENSG00000100890;ENSG00000182362;ENSG00000021826	1	21	10769	3	7	18	10762	10790	0.20597253960598022
444	M1	e019_M1	TRUE	8.850901992549381e-8	104	11	6	0.5454545454545454	0.057692307692307696	REAC:R-HSA-194138	REAC	Signaling by VEGF	10790	2187		GO:0050789;GO:0050896	0	0.038461538461538464	ENSG00000123159;ENSG00000099250;ENSG00000161638;ENSG00000102189;ENSG00000010322;ENSG00000102755;ENSG00000128052;ENSG00000157500;ENSG00000129946;ENSG00000100284;ENSG00000027869;ENSG00000037280;ENSG00000141198	1	104	10686	6	5	98	10681	10790	0.17519429814376858
446	M1	e019_M1	TRUE	3.970080006928417e-13	29	7	6	0.8571428571428571	0.20689655172413793	KEGG:04744	KEGG	Phototransduction	8161	356		GO:0050877;GO:0065009;GO:0050789;GO:0051606	0	0.02857142857142857	ENSG00000105641;ENSG00000198570;ENSG00000165997;ENSG00000132518;ENSG00000048545;ENSG00000223953;ENSG00000186479;ENSG00000112599;ENSG00000108370;ENSG00000114349;ENSG00000101890;ENSG00000186326	1	29	8132	6	1	23	8131	8161	0.4202990021795124
450	M1	e019_M1	TRUE	0.0016340838117980315	5	9	2	0.2222222222222222	0.4	REAC:R-HSA-2161517	REAC	Abacavir transmembrane transport	10790	41		GO:0032501;GO:0042908	0	0.25	ENSG00000182179;ENSG00000085563;ENSG00000137193;ENSG00000162733;ENSG00000171786;ENSG00000118777;ENSG00000141665;ENSG00000165078;ENSG00000113249;ENSG00000088766;ENSG00000070915;ENSG00000145850	1	5	10785	2	7	3	10778	10790	0.297713837977957
452	M1	e019_M1	TRUE	2.198972469833245e-11	33	11	6	0.5454545454545454	0.18181818181818182	GO:0035510	GO:BP	DNA dealkylation	16324	9565		GO:0006304	0	0.0625	ENSG00000159176;ENSG00000048740;ENSG00000111701;ENSG00000112249;ENSG00000166199;ENSG00000068615;ENSG00000148584;ENSG00000100325;ENSG00000138303;ENSG00000109775;ENSG00000157181;ENSG00000254445	1	33	16291	6	5	27	16286	16324	0.3141746659272888
455	M1	e019_M1	TRUE	0.0013287599650350975	41	9	3	0.3333333333333333	0.07317073170731707	GO:1990542	GO:BP	mitochondrial transmembrane transport	16324	26442		GO:0006810	0	0.3333333333333333	ENSG00000121310;ENSG00000163946;ENSG00000172232;ENSG00000142784;ENSG00000177542;ENSG00000196873;ENSG00000177181;ENSG00000182902;ENSG00000065060;ENSG00000213221;ENSG00000159784;ENSG00000206072	1	41	16283	3	6	38	16277	16324	0.15523482026224267
456	M1	e019_M1	TRUE	7.1623054900771485e-9	183	11	7	0.6363636363636364	0.03825136612021858	GO:0006457	GO:BP	protein folding	16324	2254		GO:0006457	0	0.09090909090909091	ENSG00000167004;ENSG00000110958;ENSG00000128595;ENSG00000155660;ENSG00000130175;ENSG00000166794;ENSG00000179218;ENSG00000049449;ENSG00000149257;ENSG00000185624;ENSG00000166598;ENSG00000147799	1	183	16141	7	4	176	16137	16324	0.15418838867149784
457	M1	e019_M1	TRUE	2.036595634627038e-19	59	12	10	0.8333333333333334	0.1694915254237288	REAC:R-HSA-6790901	REAC	rRNA modification in the nucleus and cytosol	10790	2590		GO:0042254;GO:0006396	0	0.05	ENSG00000165271;ENSG00000171824;ENSG00000156697;ENSG00000055044;ENSG00000164338;ENSG00000183751;ENSG00000065183;ENSG00000124383;ENSG00000129514;ENSG00000120800;ENSG00000115946;ENSG00000164934	1	59	10731	10	2	49	10729	10790	0.37459032678543647
466	M1	e019_M1	TRUE	3.062450875261272e-9	82	10	6	0.6	0.07317073170731707	GO:0019646	GO:BP	aerobic electron transport chain	16324	6286		GO:0022900;GO:0045333	0	0.037037037037037035	ENSG00000172115;ENSG00000196683;ENSG00000136783;ENSG00000143153;ENSG00000073578;ENSG00000156467;ENSG00000169021;ENSG00000075239;ENSG00000184076;ENSG00000196636;ENSG00000117118	1	82	16242	6	4	76	16238	16324	0.20836254434766846
468	M1	e019_M1	TRUE	2.5848372577995836e-6	5	11	3	0.2727272727272727	0.6	GO:0061088	GO:BP	regulation of sequestering of zinc ion	16324	16075		GO:0050789;GO:0051179	0	0.09090909090909091	ENSG00000151778;ENSG00000115194;ENSG00000148985;ENSG00000145354;ENSG00000205060;ENSG00000104154;ENSG00000128973;ENSG00000158014;ENSG00000161609;ENSG00000147654;ENSG00000168824	1	5	16319	3	8	2	16311	16324	0.4042637316695262
471	M1	e019_M1	TRUE	3.5953013500355463e-6	8	8	3	0.375	0.375	REAC:R-HSA-201688	REAC	WNT mediated activation of DVL	10790	2530		GO:0050789;GO:0032502	0	0.05	ENSG00000138802;ENSG00000169641;ENSG00000120278;ENSG00000161202;ENSG00000115355;ENSG00000167566;ENSG00000151746;ENSG00000107404;ENSG00000117155;ENSG00000213923;ENSG00000115977	1	8	10782	3	5	5	10777	10790	0.3745362641439436
475	M1	e019_M1	TRUE	2.785353558349119e-25	33	10	10	1	0.30303030303030304	GO:0051932	GO:BP	synaptic transmission, GABAergic	16324	14791		GO:0006811;GO:0007154	0	0.027777777777777776	ENSG00000151834;ENSG00000163812;ENSG00000163285;ENSG00000113327;ENSG00000145864;ENSG00000182256;ENSG00000166206;ENSG00000022355;ENSG00000145863;ENSG00000186297	1	33	16291	10	0	23	16291	16324	0.5500937021982282
477	M1	e019_M1	TRUE	0.003672372552563262	12	6	2	0.3333333333333333	0.16666666666666666	REAC:R-HSA-8851680	REAC	Butyrophilin (BTN) family interactions	10790	248		NA	0	0.5	ENSG00000124557;ENSG00000158125;ENSG00000173511;ENSG00000168101;ENSG00000167333;ENSG00000168491;ENSG00000109208;ENSG00000166912;ENSG00000198585;ENSG00000106351	1	12	10778	2	4	10	10774	10790	0.2351119753667887
479	M1	e019_M1	TRUE	1.240526574813918e-7	147	9	6	0.6666666666666666	0.04081632653061224	REAC:R-HSA-453279	REAC	Mitotic G1 phase and G1/S transition	10790	1400		GO:0006260	0	0.034482758620689655	ENSG00000119335;ENSG00000145386;ENSG00000101868;ENSG00000167513;ENSG00000147854;ENSG00000170312;ENSG00000134057;ENSG00000170430;ENSG00000187514;ENSG00000112242	1	147	10643	6	3	141	10640	10790	0.16276619733273123
481	M1	e019_M1	TRUE	1.95289790906481e-5	140	10	5	0.5	0.03571428571428571	KEGG:04120	KEGG	Ubiquitin mediated proteolysis	8161	265		GO:0065009;GO:0050789	0	0.07142857142857142	ENSG00000079999;ENSG00000198056;ENSG00000109670;ENSG00000146232;ENSG00000077150;ENSG00000166167;ENSG00000069399;ENSG00000100906;ENSG00000099804;ENSG00000174989	1	140	8021	5	5	135	8016	8161	0.13024696411680775
482	M1	e019_M1	TRUE	1.0848365048713064e-8	36	10	5	0.5	0.1388888888888889	GO:0006891	GO:BP	intra-Golgi vesicle-mediated transport	16324	2602		GO:0016192	0	0.09090909090909091	ENSG00000184432;ENSG00000089154;ENSG00000095139;ENSG00000102804;ENSG00000122218;ENSG00000129083;ENSG00000169515;ENSG00000105669;ENSG00000181789;ENSG00000197448	1	36	16288	5	5	31	16283	16324	0.26273108437205533
486	M1	e019_M1	TRUE	1.432077566460209e-14	41	9	7	0.7777777777777778	0.17073170731707318	GO:0048013	GO:BP	ephrin receptor signaling pathway	16324	13201		GO:0050789;GO:0032989	0	0.016129032258064516	ENSG00000163785;ENSG00000182580;ENSG00000143727;ENSG00000066248;ENSG00000126458;ENSG00000116106;ENSG00000125266;ENSG00000154928;ENSG00000133216;ENSG00000090776	1	41	16283	7	2	34	16281	16324	0.3637859966061596
488	M1	e019_M1	TRUE	5.477910828273583e-11	5	7	4	0.5714285714285714	0.8	GO:0006003	GO:BP	fructose 2,6-bisphosphate metabolic process	16324	1915		GO:0006793	0	0.1111111111111111	ENSG00000084734;ENSG00000106633;ENSG00000170525;ENSG00000180448;ENSG00000158571;ENSG00000183318;ENSG00000114268;ENSG00000123836;ENSG00000089639	1	5	16319	4	3	1	16316	16324	0.6760094609805831
496	M1	e019_M1	TRUE	0.0025805856841200465	195	9	4	0.4444444444444444	0.020512820512820513	GO:0022618	GO:BP	ribonucleoprotein complex assembly	16324	6987		GO:0065003	0	0.5	ENSG00000174231;ENSG00000182718;ENSG00000116161;ENSG00000175792;ENSG00000183207;ENSG00000089220;ENSG00000242372;ENSG00000165527;ENSG00000234745	1	195	16129	4	5	191	16124	16324	0.09350142397681602
497	M1	e019_M1	TRUE	1.7080635377434056e-10	20	8	5	0.625	0.25	REAC:R-HSA-190840	REAC	Microtubule-dependent trafficking of connexons from Golgi to the plasma membrane	10790	1375		GO:0006996	0	0.012658227848101266	ENSG00000214274;ENSG00000137267;ENSG00000101624;ENSG00000176014;ENSG00000164683;ENSG00000188229;ENSG00000127824;ENSG00000258947;ENSG00000147364	1	20	10770	5	3	15	10767	10790	0.3946244935675386
498	M1	e019_M1	TRUE	9.733851046471895e-17	8	9	6	0.6666666666666666	0.75	GO:0009304	GO:BP	tRNA transcription	16324	3527		GO:0006351	0	0.06666666666666667	ENSG00000077235;ENSG00000125484;ENSG00000115207;ENSG00000119285;ENSG00000171956;ENSG00000148308;ENSG00000119041;ENSG00000185024;ENSG00000164379	1	8	16316	6	3	2	16313	16324	0.706955093017759
499	M1	e019_M1	TRUE	1.1286771880904286e-8	23	5	4	0.8	0.17391304347826086	KEGG:03430	KEGG	Mismatch repair	8161	234		GO:0065009;GO:0050789	0	0.016129032258064516	ENSG00000143321;ENSG00000105447;ENSG00000204103;ENSG00000049541;ENSG00000133119;ENSG00000163918;ENSG00000137699;ENSG00000086189;ENSG00000111445	1	23	8138	4	1	19	8137	8161	0.3723268370713035
500	M1	e019_M1	TRUE	3.3133303903416654e-13	8	8	5	0.625	0.625	GO:1905821	GO:BP	positive regulation of chromosome condensation	16324	26158		GO:0051276;GO:0050789	0	0.037037037037037035	ENSG00000176624;ENSG00000010292;ENSG00000158941;ENSG00000109805;ENSG00000183337;ENSG00000113810;ENSG00000077463;ENSG00000136824;ENSG00000121152	1	8	16316	5	3	3	16313	16324	0.6248161314047561
506	M1	e019_M1	TRUE	0.00755802996352037	60	3	2	0.6666666666666666	0.03333333333333333	KEGG:04978	KEGG	Mineral absorption	8161	402		NA	0	0.5	ENSG00000165775;ENSG00000198356;ENSG00000128335;ENSG00000137078;ENSG00000225697;ENSG00000170509;ENSG00000203667;ENSG00000182093;ENSG00000091513	1	60	8101	2	1	58	8100	8161	0.14799938947213834
508	M1	e019_M1	TRUE	0.0020893135016598905	70	7	3	0.42857142857142855	0.04285714285714286	REAC:R-HSA-9013026	REAC	RHOB GTPase cycle	10790	1768		NA	0	0.5	ENSG00000185615;ENSG00000128683;ENSG00000149599;ENSG00000080845;ENSG00000078269;ENSG00000138823;ENSG00000132694;ENSG00000112851;ENSG00000065613	1	70	10720	3	4	67	10716	10790	0.133953195226476
509	M1	e019_M1	TRUE	3.646498032705004e-8	4	5	3	0.6	0.75	REAC:R-HSA-111957	REAC	Cam-PDE 1 activation	10790	292		NA	0	0.06666666666666667	ENSG00000166908;ENSG00000189369;ENSG00000105887;ENSG00000115252;ENSG00000131116;ENSG00000123360;ENSG00000254535;ENSG00000154678	1	4	10786	3	2	1	10784	10790	0.6706856348787557
512	M1	e019_M1	TRUE	7.199688332190912e-4	13	3	2	0.6666666666666666	0.15384615384615385	REAC:R-HSA-1483213	REAC	Synthesis of PE	10790	2258		GO:0044255;GO:0006793;GO:0006807	0	0.16666666666666666	ENSG00000100288;ENSG00000110721;ENSG00000167139;ENSG00000137478;ENSG00000163749;ENSG00000163001;ENSG00000148935;ENSG00000124939	1	13	10777	2	1	11	10776	10790	0.3199147590433374
516	M1	e019_M1	TRUE	1.6562257384616513e-6	182	6	5	0.8333333333333334	0.027472527472527472	REAC:R-HSA-6791226	REAC	Major pathway of rRNA processing in the nucleolus and cytosol	10790	1319		NA	0	0.25	ENSG00000163564;ENSG00000136891;ENSG00000107833;ENSG00000037474;ENSG00000161956;ENSG00000162408;ENSG00000001497;ENSG00000141456	1	182	10608	5	1	177	10607	10790	0.14955216768534085
518	M1	e019_M1	TRUE	4.729651838620191e-5	253	8	5	0.625	0.019762845849802372	GO:0060070	GO:BP	canonical Wnt signaling pathway	16324	15163		GO:0050789	0	0.043478260869565216	ENSG00000173801;ENSG00000141551;ENSG00000133026;ENSG00000134982;ENSG00000119314;ENSG00000196470;ENSG00000044115;ENSG00000103126	1	253	16071	5	3	248	16068	16324	0.10925911801654305
519	M1	e019_M1	TRUE	1.5518168978523563e-4	321	8	5	0.625	0.01557632398753894	GO:0001558	GO:BP	regulation of cell growth	16324	362		GO:0050789;GO:0016049	0	0.034482758620689655	ENSG00000171552;ENSG00000128050;ENSG00000141564;ENSG00000198793;ENSG00000164327;ENSG00000118515;ENSG00000105723;ENSG00000138069	1	321	16003	5	3	316	16000	16324	0.0965401126683731
521	M1	e019_M1	TRUE	1.5771011473701425e-4	114	8	4	0.5	0.03508771929824561	GO:0006354	GO:BP	DNA-templated transcription elongation	16324	2179		NA	0	0.25	ENSG00000000419;ENSG00000196235;ENSG00000011243;ENSG00000102241;ENSG00000140395;ENSG00000100425;ENSG00000006712;ENSG00000144021	1	114	16210	4	4	110	16206	16324	0.13109380824223438
522	M1	e019_M1	TRUE	1.4905418046078547e-12	10	8	5	0.625	0.5	GO:0006086	GO:BP	acetyl-CoA biosynthetic process from pyruvate	16324	1995		GO:0006082;GO:0006790;GO:0043603;GO:0009117	0	0.018518518518518517	ENSG00000005882;ENSG00000067992;ENSG00000004799;ENSG00000133835;ENSG00000112659;ENSG00000142082;ENSG00000110435;ENSG00000150768	1	10	16314	5	3	5	16311	16324	0.5587771474956351
526	M1	e019_M1	TRUE	0.00163485071940949	516	8	5	0.625	0.009689922480620155	GO:0007169	GO:BP	transmembrane receptor protein tyrosine kinase signaling pathway	16324	2796		GO:0050789	0	0.3333333333333333	ENSG00000134996;ENSG00000092445;ENSG00000026508;ENSG00000116285;ENSG00000167601;ENSG00000160867;ENSG00000148082;ENSG00000152822	1	516	15808	5	3	511	15805	16324	0.0751003072066136
530	M1	e019_M1	TRUE	1.5699189555309e-7	43	5	4	0.8	0.09302325581395349	KEGG:04975	KEGG	Fat digestion and absorption	8161	399		NA	0	0.14285714285714285	ENSG00000137392;ENSG00000175535;ENSG00000205629;ENSG00000185339;ENSG00000183597;ENSG00000182333;ENSG00000266200	1	43	8118	4	1	39	8117	8161	0.2718010904188306
537	M1	e019_M1	TRUE	4.058013682848037e-9	56	6	5	0.8333333333333334	0.08928571428571429	REAC:R-HSA-72187	REAC	mRNA 3'-end processing	10790	2560		GO:0051641;GO:0015931	0	0.02564102564102564	ENSG00000079134;ENSG00000114503;ENSG00000100722;ENSG00000125676;ENSG00000136937;ENSG00000087087;ENSG00000100227	1	56	10734	5	1	51	10733	10790	0.27185532000641077
538	M1	e019_M1	TRUE	4.0450065126721583e-10	32	7	5	0.7142857142857143	0.15625	GO:0000184	GO:BP	nuclear-transcribed mRNA catabolic process, nonsense-mediated decay	16324	61		GO:0009057;GO:0016070;GO:0050789	0	0.03333333333333333	ENSG00000108349;ENSG00000132773;ENSG00000102317;ENSG00000125351;ENSG00000151461;ENSG00000170473;ENSG00000265241	1	32	16292	5	2	27	16290	16324	0.3335582575338848
539	M1	e019_M1	TRUE	8.936883115589823e-7	6	7	3	0.42857142857142855	0.5	GO:0043985	GO:BP	histone H4-R3 methylation	16324	11504		GO:0036211	0	0.0625	ENSG00000079819;ENSG00000074201;ENSG00000100462;ENSG00000116455;ENSG00000164068;ENSG00000132792;ENSG00000082397	1	6	16318	3	4	3	16314	16324	0.46269728311258734
541	M1	e019_M1	TRUE	1.155685808954309e-9	39	7	5	0.7142857142857143	0.1282051282051282	GO:0000387	GO:BP	spliceosomal snRNP assembly	16324	119		GO:0065003;GO:0044085	0	0.06666666666666667	ENSG00000179409;ENSG00000092208;ENSG00000064703;ENSG00000163517;ENSG00000109534;ENSG00000023734;ENSG00000082516	1	39	16285	5	2	34	16283	16324	0.30202728554100916
542	M1	e019_M1	TRUE	7.191127522026894e-4	47	7	3	0.42857142857142855	0.06382978723404255	GO:0030490	GO:BP	maturation of SSU-rRNA	16324	7180		GO:0006396	0	0.5	ENSG00000167721;ENSG00000115761;ENSG00000011485;ENSG00000122965;ENSG00000090273;ENSG00000135372;ENSG00000110063	1	47	16277	3	4	44	16273	16324	0.16455650854828324
544	M1	e019_M1	TRUE	8.934907802782842e-5	48	5	3	0.6	0.0625	KEGG:00280	KEGG	Valine, leucine and isoleucine degradation	8161	31		GO:0006520	0	0.125	ENSG00000078070;ENSG00000130347;ENSG00000110074;ENSG00000198754;ENSG00000100116;ENSG00000003509;ENSG00000131844	1	48	8113	3	2	45	8111	8161	0.19237622312586009
545	M1	e019_M1	TRUE	1.1575292559735745e-4	26	7	3	0.42857142857142855	0.11538461538461539	GO:0006783	GO:BP	heme biosynthetic process	16324	2524		GO:0046483;GO:0006725;GO:0042440;GO:0006807	0	0.125	ENSG00000126814;ENSG00000114023;ENSG00000066926;ENSG00000175606;ENSG00000130770;ENSG00000176715;ENSG00000131269	1	26	16298	3	4	23	16294	16324	0.22177256045766944
546	M1	e019_M1	TRUE	0.001458588739305353	5	7	2	0.2857142857142857	0.4	GO:0006561	GO:BP	proline biosynthetic process	16324	2334		GO:0006520	0	0.16666666666666666	ENSG00000146282;ENSG00000124608;ENSG00000143811;ENSG00000122643;ENSG00000059573;ENSG00000069998;ENSG00000120254	1	5	16319	2	5	3	16314	16324	0.3378234558305842
554	M1	e019_M1	TRUE	0.0019686926383220243	7	6	2	0.3333333333333333	0.2857142857142857	GO:0090481	GO:BP	pyrimidine nucleotide-sugar transmembrane transport	16324	19340		GO:0015931	0	0.3333333333333333	ENSG00000102100;ENSG00000117620;ENSG00000062282;ENSG00000168282;ENSG00000152127;ENSG00000172318	1	7	16317	2	4	5	16313	16324	0.30833246705843087
555	M1	e019_M1	TRUE	1.402283292107443e-5	17	6	3	0.5	0.17647058823529413	REAC:R-HSA-1482922	REAC	Acyl chain remodelling of PI	10790	111		GO:0050789	0	0.0625	ENSG00000188257;ENSG00000108839;ENSG00000166192;ENSG00000170890;ENSG00000153246;ENSG00000166825	1	17	10773	3	3	14	10770	10790	0.29642422485841025
556	M1	e019_M1	TRUE	2.595406918949957e-10	38	6	5	0.8333333333333334	0.13157894736842105	GO:0006749	GO:BP	glutathione metabolic process	16324	2502		GO:0008152	0	0.058823529411764705	ENSG00000243955;ENSG00000244067;ENSG00000170899;ENSG00000125703;ENSG00000182793;ENSG00000174156	1	38	16286	5	1	33	16285	16324	0.3306538753858264
558	M1	e019_M1	TRUE	3.0668451472686815e-7	190	5	5	1	0.02631578947368421	REAC:R-HSA-202733	REAC	Cell surface interactions at the vascular wall	10790	315		GO:0061024;GO:0008037;GO:0002376;GO:0050896;GO:0050789	0	0.03125	ENSG00000254709;ENSG00000128322;ENSG00000169575;ENSG00000128218;ENSG00000211679;ENSG00000211677	1	190	10600	5	0	185	10600	10790	0.16082407404634833
559	M1	e019_M1	TRUE	8.903071185168995e-6	86	6	4	0.6666666666666666	0.046511627906976744	GO:2000781	GO:BP	positive regulation of double-strand break repair	16324	27321		GO:0050789	0	0.047619047619047616	ENSG00000099385;ENSG00000112419;ENSG00000134278;ENSG00000106635;ENSG00000110987;ENSG00000222038	1	86	16238	4	2	82	16236	16324	0.17519284283353875
560	M1	e019_M1	TRUE	7.753125395769736e-5	97	3	3	1	0.030927835051546393	KEGG:03015	KEGG	mRNA surveillance pathway	8161	210		GO:0051641;GO:0015931	0	0.07142857142857142	ENSG00000101888;ENSG00000132661;ENSG00000214050;ENSG00000147206;ENSG00000135824;ENSG00000188647	1	97	8064	3	0	94	8064	8161	0.17484699361506978
563	M1	e019_M1	TRUE	1.6823886609382738e-5	18	6	3	0.5	0.16666666666666666	REAC:R-HSA-1362277	REAC	Transcription of E2F targets under negative control by DREAM complex	10790	2403		NA	0	0.1111111111111111	ENSG00000205250;ENSG00000111875;ENSG00000125952;ENSG00000163602;ENSG00000100084;ENSG00000198176	1	18	10772	3	3	15	10769	10790	0.2880323694995814
564	M1	e019_M1	TRUE	1.1146369672977628e-5	176	4	4	1	0.022727272727272728	REAC:R-HSA-2990846	REAC	SUMOylation	10790	2044		NA	0	0.125	ENSG00000107290;ENSG00000130254;ENSG00000126261;ENSG00000197579;ENSG00000188612;ENSG00000160633	1	176	10614	4	0	172	10614	10790	0.1495488216541882
568	M1	e019_M1	TRUE	3.463417820212668e-4	4	5	2	0.4	0.5	GO:0051664	GO:BP	nuclear pore localization	16324	14664		GO:0051641;GO:0006997	0	0.16666666666666666	ENSG00000110906;ENSG00000115241;ENSG00000113368;ENSG00000164163;ENSG00000176619;ENSG00000164512	1	4	16320	2	3	2	16317	16324	0.4470628757260096
573	M1	e019_M1	TRUE	8.247897213789242e-5	99	3	3	1	0.030303030303030304	KEGG:00564	KEGG	Glycerophospholipid metabolism	8161	88		NA	0	0.25	ENSG00000174915;ENSG00000127526;ENSG00000184743;ENSG00000110108;ENSG00000123684;ENSG00000172197	1	99	8062	3	0	96	8062	8161	0.17305038764408862
580	M1	e019_M1	TRUE	1.0922713846977185e-10	46	5	5	1	0.10869565217391304	GO:0006120	GO:BP	mitochondrial electron transport, NADH to ubiquinone	16324	2022		GO:0022900;GO:0045333;GO:0009117	0	0.017543859649122806	ENSG00000198763;ENSG00000198840;ENSG00000198695;ENSG00000125356;ENSG00000212907	1	46	16278	5	0	41	16278	16324	0.32927581790284716
585	M1	e019_M1	TRUE	4.794700705949071e-8	8	3	3	1	0.375	REAC:R-HSA-72731	REAC	Recycling of eIF2:GDP	10790	1860		GO:0008152	0	0.05	ENSG00000125977;ENSG00000137200;ENSG00000130741;ENSG00000144895;ENSG00000134001	1	8	10782	3	0	5	10782	10790	0.612230495533098
591	M1	e019_M1	TRUE	7.648241063294075e-8	36	5	4	0.8	0.1111111111111111	GO:0030261	GO:BP	chromosome condensation	16324	7112		GO:0051276;GO:0050789	0	0.14285714285714285	ENSG00000183955;ENSG00000184897;ENSG00000184357;ENSG00000189060;ENSG00000184270	1	36	16288	4	1	32	16287	16324	0.29769449959768995
592	M1	e019_M1	TRUE	0.0012742278666942736	395	5	4	0.8	0.010126582278481013	GO:0022613	GO:BP	ribonucleoprotein complex biogenesis	16324	6982		GO:0044085	0	0.5	ENSG00000171960;ENSG00000075856;ENSG00000124784;ENSG00000146223;ENSG00000067533	1	395	15929	4	1	391	15928	16324	0.08837373037443091
595	M1	e019_M1	TRUE	5.771655679604725e-4	5	5	2	0.4	0.4	GO:0016076	GO:BP	snRNA catabolic process	16324	5227		GO:0009057;GO:0016070	0	0.3333333333333333	ENSG00000140829;ENSG00000033030;ENSG00000113360;ENSG00000039123;ENSG00000143748	1	5	16319	2	3	3	16316	16324	0.3998161652062013
596	M1	e019_M1	TRUE	6.900482779474138e-5	179	5	4	0.8	0.0223463687150838	REAC:R-HSA-72163	REAC	mRNA Splicing - Major Pathway	10790	2566		NA	0	0.25	ENSG00000085872;ENSG00000163714;ENSG00000124216;ENSG00000003756;ENSG00000134453	1	179	10611	4	1	175	10610	10790	0.1320629893562604
598	M1	e019_M1	TRUE	1.678221148819389e-4	5	4	2	0.5	0.4	REAC:R-HSA-426048	REAC	Arachidonate production from DAG	10790	159		GO:0050789	0	0.2	ENSG00000148175;ENSG00000144040;ENSG00000134780;ENSG00000074416;ENSG00000135750	1	5	10785	2	2	3	10783	10790	0.44698554213248753
604	M1	e019_M1	TRUE	4.794700705949062e-7	16	3	3	1	0.1875	REAC:R-HSA-210993	REAC	Tie2 Signaling	10790	2376		GO:0050789;GO:0032502	0	0.041666666666666664	ENSG00000154188;ENSG00000091879;ENSG00000101280;ENSG00000066056	1	16	10774	3	0	13	10774	10790	0.4327516996603404
608	M1	e019_M1	TRUE	1.662596717650016e-4	9	2	2	1	0.2222222222222222	REAC:R-HSA-3785653	REAC	Myoclonic epilepsy of Lafora	10790	1422		NA	0	0.2	ENSG00000112425;ENSG00000187566;ENSG00000053438;ENSG00000152784	1	9	10781	2	0	7	10781	10790	0.4712515560566517
611	M1	e019_M1	TRUE	4.794700705949071e-8	8	3	3	1	0.375	REAC:R-HSA-444821	REAC	Relaxin receptors	10790	1937		NA	0	0.09090909090909091	ENSG00000171509;ENSG00000133105;ENSG00000107014;ENSG00000107018	1	8	10782	3	0	5	10782	10790	0.612230495533098
614	M1	e019_M1	TRUE	0.0013151115964863142	10	4	2	0.5	0.2	GO:0045657	GO:BP	positive regulation of monocyte differentiation	16324	12208		GO:0050789	0	0.1111111111111111	ENSG00000157368;ENSG00000184371;ENSG00000101082;ENSG00000160219	1	10	16314	2	2	8	16312	16324	0.3159758279267165
630	M1	e019_M1	TRUE	2.9243810329823496e-5	2	4	2	0.5	1	GO:0070488	GO:BP	neutrophil aggregation	16324	17079		GO:0007155;GO:0044419;GO:0050896	0	0.0625	ENSG00000143546;ENSG00000135655;ENSG00000124795;ENSG00000163220	1	2	16322	2	2	0	16320	16324	0.7070634575470628
632	M1	e019_M1	TRUE	2.9236643936860157e-4	5	4	2	0.5	0.4	GO:1902857	GO:BP	positive regulation of non-motile cilium assembly	16324	23624		GO:0050789	0	0.16666666666666666	ENSG00000122545;ENSG00000184640;ENSG00000162664;ENSG00000168385	1	5	16319	2	2	3	16317	16324	0.4470628757260096
634	M1	e019_M1	TRUE	9.22337159565646e-4	11	4	2	0.5	0.18181818181818182	REAC:R-HSA-9664873	REAC	Pexophagy	10790	1640		NA	0	0.14285714285714285	ENSG00000161011;ENSG00000171858;ENSG00000221983;ENSG00000183048	1	11	10779	2	2	9	10777	10790	0.30110589654130226
635	M1	e019_M1	TRUE	1.9383442630820246e-4	23	2	2	1	0.08695652173913043	KEGG:03060	KEGG	Protein export	8161	217		NA	0	0.5	ENSG00000174780;ENSG00000140319;ENSG00000131914;ENSG00000183258	1	23	8138	2	0	21	8138	8161	0.2945041750890402
642	M1	e019_M1	TRUE	7.824780312797907e-6	39	3	3	1	0.07692307692307693	REAC:R-HSA-420499	REAC	Class C/3 (Metabotropic glutamate/pheromone receptors)	10790	352		GO:0050877;GO:0051606	0	0.07692307692307693	ENSG00000173662;ENSG00000169962;ENSG00000179002	1	39	10751	3	0	36	10751	10790	0.2768869040831114
645	M1	e019_M1	TRUE	2.1939563503302555e-6	28	3	3	1	0.10714285714285714	GO:0045116	GO:BP	protein neddylation	16324	11976		GO:0036211	0	0.2	ENSG00000184182;ENSG00000188215;ENSG00000150401	1	28	16296	3	0	25	16296	16324	0.327076044747781
647	M1	e019_M1	TRUE	3.42478621853503e-9	4	3	3	1	0.75	REAC:R-HSA-1296061	REAC	HCN channels	10790	1033		GO:0065008;GO:0050789;GO:0007154;GO:0050896	0	0.02	ENSG00000099822;ENSG00000138622;ENSG00000164588	1	4	10786	3	0	1	10786	10790	0.8659852607661871
653	M1	e019_M1	TRUE	6.092420699876344e-4	12	3	2	0.6666666666666666	0.16666666666666666	REAC:R-HSA-1433617	REAC	Regulation of signaling by NODAL	10790	1934		NA	0	0.5	ENSG00000111058;ENSG00000143768;ENSG00000243709	1	12	10778	2	1	10	10777	10790	0.3330087622878821
657	M1	e019_M1	TRUE	2.2950283565548754e-4	7	3	2	0.6666666666666666	0.2857142857142857	GO:0002933	GO:BP	lipid hydroxylation	16324	1460		GO:0044255	0	0.1111111111111111	ENSG00000106258;ENSG00000168874;ENSG00000160870	1	7	16317	2	1	5	16316	16324	0.4362886915987346
659	M1	e019_M1	TRUE	2.678823382576616e-9	4	3	3	1	0.75	GO:0044278	GO:BP	cell wall disruption in another organism	16324	11588		GO:0044419	0	0.14285714285714285	ENSG00000115386;ENSG00000172023;ENSG00000172016	1	4	16320	3	0	1	16320	16324	0.8659988723626599
660	M1	e019_M1	TRUE	8.907087747067297e-7	21	3	3	1	0.14285714285714285	GO:0052695	GO:BP	cellular glucuronidation	16324	14980		GO:0006082	0	0.05	ENSG00000196620;ENSG00000135220;ENSG00000271271	1	21	16303	3	0	18	16303	16324	0.37775599199210375
662	M1	e019_M1	TRUE	0.0010418756204544088	195	3	3	1	0.015384615384615385	REAC:R-HSA-375276	REAC	Peptide ligand-binding receptors	10790	1636		GO:0008015	0	0.16666666666666666	ENSG00000188958;ENSG00000049247;ENSG00000181408	1	195	10595	3	0	192	10595	10790	0.12292591873256625
674	M1	e019_M1	TRUE	0.00711221929216954	56	2	2	1	0.03571428571428571	REAC:R-HSA-72187	REAC	mRNA 3'-end processing	10790	2560		NA	0	0.5	ENSG00000160679;ENSG00000123136;ENSG00000177311	1	56	10734	2	0	54	10734	10790	0.18850866200870475
683	M1	e019_M1	TRUE	4.081728148536891e-4	168	3	3	1	0.017857142857142856	KEGG:04141	KEGG	Protein processing in endoplasmic reticulum	8161	273		NA	0	0.5	ENSG00000069345;ENSG00000132002;ENSG00000164070	1	168	7993	3	0	165	7993	8161	0.13227234178844577
686	M1	e019_M1	TRUE	4.571679984705278e-4	161	3	3	1	0.018633540372670808	GO:0009060	GO:BP	aerobic respiration	16324	3312		GO:0045333	0	0.25	ENSG00000174840;ENSG00000155463;ENSG00000148290	1	161	16163	3	0	158	16163	16324	0.135842383590515
693	M1	e019_M1	TRUE	0.00275521866672488	43	2	2	1	0.046511627906976744	GO:0007422	GO:BP	peripheral nervous system development	16324	2988		NA	0	0.5	ENSG00000117407;ENSG00000146013	1	43	16281	2	0	41	16281	16324	0.215394505871791
702	M1	e019_M1	TRUE	0.003246681923633233	38	2	2	1	0.05263157894736842	REAC:R-HSA-8853659	REAC	RET signaling	10790	1753		NA	0	0.3333333333333333	ENSG00000125861;ENSG00000125650	1	38	10752	2	0	36	10752	10790	0.22903262912142347
704	M1	e019_M1	TRUE	0.001327264806229592	30	2	2	1	0.06666666666666667	GO:0042475	GO:BP	odontogenesis of dentin-containing tooth	16324	10783		GO:0032502	0	0.5	ENSG00000137674;ENSG00000152591	1	30	16294	2	0	28	16294	16324	0.2579773276802179
708	M1	e019_M1	TRUE	9.153550387790284e-6	3	2	2	1	0.6666666666666666	GO:0002331	GO:BP	pre-B cell allelic exclusion	16324	881		GO:0001775;GO:0002376;GO:0032502;GO:0050789	0	0.09090909090909091	ENSG00000166349;ENSG00000175097	1	3	16321	2	0	1	16321	16324	0.8164715683959474
709	M1	e019_M1	TRUE	6.407485271453196e-5	7	2	2	1	0.2857142857142857	GO:0032754	GO:BP	positive regulation of interleukin-5 production	16324	8222		GO:0050789;GO:0001816	0	0.125	ENSG00000205755;ENSG00000145777	1	7	16317	2	0	5	16317	16324	0.5344406060791936
712	M1	e019_M1	TRUE	2.5400783186319703e-4	11	2	2	1	0.18181818181818182	REAC:R-HSA-2485179	REAC	Activation of the phototransduction cascade	10790	102		NA	0	0.14285714285714285	ENSG00000132915;ENSG00000133256	1	11	10779	2	0	9	10779	10790	0.42622353070804814
720	M1	e019_M1	TRUE	0.005583665736552068	61	2	2	1	0.03278688524590164	GO:0008543	GO:BP	fibroblast growth factor receptor signaling pathway	16324	3266		GO:0050789	0	0.3333333333333333	ENSG00000105550;ENSG00000134962	1	61	16263	2	0	59	16263	16324	0.1807439314362088
721	M1	e019_M1	TRUE	3.0511834625967682e-6	2	2	2	1	1	GO:0110091	GO:BP	negative regulation of hippocampal neuron apoptotic process	16324	20481		GO:0002376;GO:0050789;GO:0007154	0	0.030303030303030304	ENSG00000006210;ENSG00000168329	1	2	16322	2	0	0	16322	16324	1.0000000000000002
722	M1	e019_M1	TRUE	3.602292888241709e-4	13	2	2	1	0.15384615384615385	REAC:R-HSA-74217	REAC	Purine salvage	10790	1732		NA	0	0.25	ENSG00000100938;ENSG00000137198	1	13	10777	2	0	11	10777	10790	0.3920322491709873
728	M1	e019_M1	TRUE	0.0018750396315719655	29	2	2	1	0.06896551724137931	REAC:R-HSA-5669034	REAC	TNFs bind their physiological receptors	10790	2316		GO:0050789	0	0.25	ENSG00000120337;ENSG00000186891	1	29	10761	2	0	27	10761	10790	0.26228402861078165
733	M1	e019_M1	TRUE	0.005220574904503062	59	2	2	1	0.03389830508474576	GO:0042267	GO:BP	natural killer cell mediated cytotoxicity	16324	10638		GO:0001906;GO:0002376;GO:0044419;GO:0050896	0	0.5	ENSG00000188393;ENSG00000256797	1	59	16265	2	0	57	16265	16324	0.18379315758913098
736	M1	e019_M1	TRUE	0.004934733359095378	114	2	2	1	0.017543859649122806	KEGG:04724	KEGG	Glutamatergic synapse	8161	348		NA	0	0.5	ENSG00000162105;ENSG00000170579	1	114	8047	2	0	112	8047	8161	0.13154099004615535
746	M1	e019_M1	TRUE	3.0511834625967682e-6	2	2	2	1	1	GO:0001581	GO:BP	detection of chemical stimulus involved in sensory perception of sour taste	16324	378		GO:0050877;GO:0051606	0	0.09090909090909091	ENSG00000277481;ENSG00000107593	1	2	16322	2	0	0	16322	16324	1.0000000000000002
747	M1	e019_M1	TRUE	0.0018154541602450746	35	2	2	1	0.05714285714285714	GO:0001580	GO:BP	detection of chemical stimulus involved in sensory perception of bitter taste	16324	377		GO:0050877;GO:0051606	0	0.2	ENSG00000136514;ENSG00000121318	1	35	16289	2	0	33	16289	16324	0.23880394695798152
753	M1	e019_M1	TRUE	0.0015009553701007116	26	2	2	1	0.07692307692307693	REAC:R-HSA-912526	REAC	Interleukin receptor SHC signaling	10790	1170		NA	0	0.25	ENSG00000091181;ENSG00000113525	1	26	10764	2	0	24	10764	10790	0.27704141677254956
755	M1	e019_M1	TRUE	3.048093982358366e-4	12	2	2	1	0.16666666666666666	REAC:R-HSA-622323	REAC	Presynaptic nicotinic acetylcholine receptors	10790	1702		NA	0	0.3333333333333333	ENSG00000138435;ENSG00000108556	1	12	10778	2	0	10	10778	10790	0.4080590325192136
757	M1	e019_M1	TRUE	3.2037426357266066e-4	15	2	2	1	0.13333333333333333	GO:0046629	GO:BP	gamma-delta T cell activation	16324	12976		GO:0001775;GO:0002376	0	0.3333333333333333	ENSG00000154639;ENSG00000160593	1	15	16309	2	0	13	16309	16324	0.3650029276557092
759	M1	e019_M1	TRUE	3.0511834625967682e-6	2	2	2	1	1	GO:0160023	GO:BP	sneeze reflex	16324	21183		GO:0050789;GO:0050896	0	0.07142857142857142	ENSG00000197696;ENSG00000135577	1	2	16322	2	0	0	16322	16324	1.0000000000000002
769	M1	e019_M1	TRUE	0.00713739729441586	137	2	2	1	0.014598540145985401	KEGG:04915	KEGG	Estrogen signaling pathway	8161	365		NA	0	0.5	ENSG00000082175;ENSG00000004478	1	137	8024	2	0	135	8024	8161	0.11982066006608481
771	M1	e019_M1	TRUE	5.217523721040468e-4	19	2	2	1	0.10526315789473684	GO:0006123	GO:BP	mitochondrial electron transport, cytochrome c to oxygen	16324	2025		NA	0	0.2	ENSG00000131174;ENSG00000198804	1	19	16305	2	0	17	16305	16324	0.3242738383028699
