module	monet_type	experiment_info	significant	p_value	term_size	query_size	intersection_size	precision	recall	term_id	source	term_name	effective_domain_size	source_order	parents	goslim_pir	perc_rank	cumelative_dist	genes	rank	P	N	tp	fp	fn	tn	tot_pop_valid	mcc
1	M1	e019_M1	TRUE	6.456696233072297e-8	249	66	15	0.22727272727272727	0.060240963855421686	KEGG:05132	KEGG	Salmonella infection	8161	422		NA	0	0.06666666666666667	55754;6259;9991;55293;23603;23118;51068;3416;3655;8826;4893;10114;9908;5781;55573;1452;7326;26092;8450;8301;5573;8545;2776;4087;8780;10640;55669;55233;9337;7319;51714;7534;5868;29766;382;8540;51164;1654;1968;56650;8030;5048;25800;51573;5782;6760;23190;55681;55916;9341;3998;10006;1635;25932;1432;387;4179;23473;9425;528;5962;10565;10048;10049;6197;7803;9802;4735;2782;9135;8773;23291;10097;164;10092;7323;102;3836;4149;10678;1810;9589;2665;81537;4074;9522;6856;3688;3799;523;51582;23062;3840;5594;5151;10672;3964	1	249	7912	15	51	234	7861	8161	0.10330106664501404
2	M1	e019_M1	TRUE	3.978960526699407e-62	193	76	47	0.618421052631579	0.24352331606217617	REAC:R-HSA-913531	REAC	Interferon Signaling	10790	1167		GO:0050896;GO:0044419;GO:0016032;GO:0001816;GO:0050789;GO:0002376	0	0.005235602094240838	9246;4615;54625;6737;5920;5696;9976;7453;103;11274;3434;3135;3627;10379;11118;3134;83666;3428;51191;4600;2643;6672;10964;4938;3133;10561;5721;6892;3105;3106;3437;2633;3433;6773;94240;3137;391020;4940;834;5371;3659;3601;10384;3107;151636;55601;5359;8519;51131;64135;10581;5698;9111;4061;837;55337;3429;54739;57674;3669;24138;3430;80833;129607;3123;9636;10346;3959;3665;6772;6890;80830;23586;4599;64108;2634;10410;8638;684;567;219285;91543;8743;58472;5610;5699;54809;2537;6373;4939;5720;51056;3431;64761	1	193	10597	47	29	146	10568	10790	0.3816102099444179
3	M1	e019_M1	TRUE	2.16974909166913e-8	32	45	7	0.15555555555555556	0.21875	KEGG:00640	KEGG	Propanoate metabolism	8161	109		NA	0	0.125	4594;23256;7485;23530;81689;55745;5825;900;10559;51138;9443;5867;25972;10477;2339;829;51510;9039;10099;25821;1738;2110;5110;26128;51727;6767;9604;594;11345;9694;10463;1429;51567;9562;27430;10857;5824;440026;23219;2631;1781;4338;128;10558;6342;56947;10175;55860;34;8723;60592;8803;23479;10768;25898;114932;9354;9581;8801;5887;178;10484;7257;51125;9419;10424;26275;10638;8799;10447;3188;23741;8050;79886;23588;64400;55884;157567;54951;83941;79624;221154;51382;80762;11034;8504;9403;55862;9166;7251;65084;10671;9412;10438	1	32	8129	7	38	25	8091	8161	0.18066873135097902
4	M1	e019_M1	TRUE	1.482072289301719e-26	757	79	38	0.4810126582278481	0.05019815059445178	GO:0045321	GO:BP	leukocyte activation	16324	12051		GO:0050896;GO:0016192;GO:0001775;GO:0044419;GO:0007155;GO:0050789;GO:0002376;GO:0008283	0	0.0040650406504065045	6503;241;4067;64092;3122;10875;4688;3310;3937;1436;5777;397;9450;5880;11151;7805;3575;474344;2123;962;199;1043;3109;4542;9535;7305;1512;1536;6039;3055;6850;1794;3113;942;445347;3119;6404;64231;963;1230;3587;3059;3936;1890;2124;5341;3689;5788;1236;2533;4689;4046;2207;3932;9473;22918;50856;9938;3108;7852;4125;7409;2213;51338;11010;4332;7940;864;6352;7133;3115;23643;972;1439;5175;958;2268;330;3683;9103;9595;11031;54440;953;1520;597;10437	1	757	15567	38	41	719	15526	16324	0.14413145951427844
5	M1	e019_M1	TRUE	2.9425802368251546e-47	813	82	54	0.6585365853658537	0.06642066420664207	GO:0000278	GO:BP	mitotic cell cycle	16324	80		GO:0006260;GO:0051276;GO:0000280;GO:0007059;GO:0007049;GO:0050789	0	0.005291005291005291	10733;9735;5983;580;9134;79733;56992;83879;55215;64785;9837;9055;81930;79682;25788;51053;9768;9787;11130;90417;64151;4001;6491;55839;55706;55165;3070;29028;1854;3832;3925;4751;55010;26271;1894;29899;2146;3148;675;1111;54443;51514;151246;11169;1062;5427;9833;6119;29127;55055;54908;7153;259266;10926;990;1063;83540;4175;10403;79075;8317;54892;7272;11339;7112;1164;1719;7443;23594;79801;699;9319;6240;57405;10592;9493;672;23310;2237;3838;5557;55388;4085;5888;5985;3161	1	813	15511	54	28	759	15483	16324	0.19882690823360474
6	M1	e019_M1	TRUE	0.0037054482449351564	27	56	4	0.07142857142857142	0.14814814814814814	REAC:R-HSA-8863795	REAC	Downregulation of ERBB2 signaling	10790	746		NA	0	0.5	10427;1998;50618;23469;51585;6093;9444;5412;11183;5980;7337;152006;23607;1407;5530;2908;25852;57826;9101;51320;648;1386;23369;10274;29978;490;6651;2060;6249;5771;51366;23411;23063;8899;8065;394;22828;9821;51430;9859;2332;9655;5903;26009;23515;2803;9107;221037;1147;55288;29761;9698;4154;80204;9202;23142;6477;23111;55914;6670;8036;5495;3298;8491;23394;6938;253943;22862;54778;23200;54665;167227;27107;10000;64844;4089;1027;23122;9748	1	27	10763	4	52	23	10711	10790	0.09964850547918216
7	M1	e019_M1	TRUE	2.804666790693581e-9	46	40	8	0.2	0.17391304347826086	KEGG:03050	KEGG	Proteasome	8161	216		GO:0044085;GO:0006396;GO:0043412;GO:0006412;GO:0065003	0	0.005747126436781609	10286;5687;9631;6950;3843;56647;7347;55699;5901;10987;6905;8624;10606;79833;7334;9521;6637;11222;7295;8872;8883;10128;5700;5701;8443;27101;10923;3376;28969;5685;1965;10969;5686;3015;51377;79017;6635;5464;4869;6636;2739;2926;9255;10576;8533;51002;6634;65008;79053;4528;55759;28985;158;3336;9352;22948;60488;5683;10213;8894;10440;52;51637;6880;51096;5684;2958;51182;5001;10575;1653;28977;28998;8487;29088;7411	1	46	8115	8	32	38	8083	8161	0.1822048814771222
8	M1	e019_M1	TRUE	8.550296716742831e-12	110	60	13	0.21666666666666667	0.11818181818181818	REAC:R-HSA-6785807	REAC	Interleukin-4 and Interleukin-13 signaling	10790	1192		GO:0050896;GO:0050789;GO:0065009	0	0.008547008547008548	467;5606;8870;10135;1647;1847;6446;2354;22822;4616;6303;5054;10397;10221;80149;2919;6648;133;5209;23645;1604;3491;9516;5743;3554;602;3727;1026;7538;6515;1390;3383;7071;8553;3576;694;10957;7050;7128;3949;678;51278;7832;9592;2353;2355;604;4929;5329;7422;5997;1848;4170;4783;1052;5292;1958;7130;9314;3726;9766;5366;1843;4792;1839;2114;84981;3569;2669;1316;23764;3725;5328;3553;64332;2920	1	110	10680	13	47	97	10633	10790	0.15370092916947348
9	M1	e019_M1	TRUE	1.137318593599339e-12	395	74	20	0.2702702702702703	0.05063291139240506	GO:0022613	GO:BP	ribonucleoprotein complex biogenesis	16324	6982		GO:0042254;GO:0006396	0	0.03571428571428571	55651;3276;26155;7866;54998;2193;3692;57819;5425;10514;7284;6182;10105;10084;64223;22827;5496;8260;64118;11047;51073;23481;7064;10061;11331;23246;56915;10452;6183;23203;8192;191;2873;51042;3704;51690;55658;23640;54606;10280;25804;4809;5434;54555;54663;54512;10726;55621;10856;65993;5709;92856;9136;26517;2288;7407;617;5245;10572;6150;6723;10131;10469;10607;3265;9040;1978;8815;80308;353;26121;51116;10195;57418;23170;5499	1	395	15929	20	54	375	15875	16324	0.10806536304717937
10	M1	e019_M1	TRUE	4.0700164290969473e-29	168	46	25	0.5434782608695652	0.1488095238095238	KEGG:04141	KEGG	Protein processing in endoplasmic reticulum	8161	273		GO:0050896;GO:0009057;GO:0016192;GO:0007030;GO:0015031;GO:0006508;GO:0061024;GO:0016050	0	0.01694915254237288	7494;64924;9709;11196;378;58505;7009;26003;81567;9554;27230;9019;2673;54499;10130;51397;55062;10972;51014;6745;9451;23471;79139;1314;11231;55002;55829;813;10959;7184;4247;55312;56889;1315;4189;55069;11014;54431;10282;22872;51726;400;51026;10802;6400;3703;64746;3309;6675;51569;51465;2923;4925;29880;51128;387263;84888;9871;90411;8615;9197;821;50999;81555;6782;60559;9276;116150;9950;26286;5861;10483;54928;488;6747;372	1	168	7993	25	21	143	7972	8161	0.2772559896171582
11	M1	e019_M1	TRUE	1.1341382242905519e-14	394	61	20	0.32786885245901637	0.050761421319796954	GO:0008380	GO:BP	RNA splicing	16324	3261		GO:0000375	0	0.05555555555555555	9988;54482;10902;23398;51747;23360;91746;81669;400322;57337;10181;4848;8473;55729;9406;140890;10724;8481;51455;23126;23015;55023;57018;6430;79609;55082;29896;9924;1195;79048;10443;22889;55900;57466;151613;51631;7637;55000;1655;10142;23347;64848;65117;94104;54520;26118;8881;130872;55037;8451;55269;57035;8675;7072;9584;55705;9736;64766;51592;55608;196441;55769;79848;55119;27332;84901;10180;9044;58517;56339;23230;9295;25957;9877;10521;65110	1	394	15930	20	41	374	15889	16324	0.12120669179624519
12	M1	e019_M1	TRUE	2.5766117462999353e-135	94	66	63	0.9545454545454546	0.6702127659574468	REAC:R-HSA-156842	REAC	Eukaryotic Translation Elongation	10790	827		GO:0042254;GO:0006412	0	0.01694915254237288	6157;6748;1936;6166;5204;6230;442216;6159;25873;6204;6168;6227;6208;6224;9045;6228;6189;6144;6156;9349;6202;6135;6130;6234;6158;6235;6173;6187;114915;6128;6176;6164;6170;11224;6193;6218;29997;4666;441951;128668;3921;2197;6229;6210;6223;6147;6232;6205;641638;1933;6133;6141;6201;6160;6136;6169;6134;6165;6171;6203;6143;6209;51372;6233;6181;54543;6142;6129;6167;6191;6206;6155;6161;207032;60674;6207	1	94	10696	63	3	31	10693	10790	0.7984636736174006
13	M1	e019_M1	TRUE	0.003145881111309779	121	28	5	0.17857142857142858	0.04132231404958678	KEGG:04919	KEGG	Thyroid hormone signaling pathway	8161	369		NA	0	0.5	4820;3516;253461;23077;22878;23405;51111;9969;57730;54800;23137;7559;5927;5469;7707;5930;23099;23215;23049;4090;9169;57187;23512;9140;64710;3842;55186;10927;80205;51773;4659;9043;7750;5295;79982;23325;23451;22902;7572;114882;546;9728;65125;10725;5586;23036;285527;56987;10087;26043;9910;2186;54556;7716;9931;26512;9693;10299;23389;6738;4750;51663;1385;9857;66008;1105;9975;9360;23637;10735;8202;7644;7175;23429;7267	1	121	8040	5	23	116	8017	8161	0.07949573929964612
14	M1	e019_M1	TRUE	1.6921349075691206e-14	395	70	21	0.3	0.053164556962025315	GO:0022613	GO:BP	ribonucleoprotein complex biogenesis	16324	6982		GO:0051179;GO:0000375;GO:0065003;GO:0044085	0	0.015625	246243;79084;6749;1019;10419;5725;3329;23212;79902;50628;55226;29960;328;1503;6472;51491;5437;7283;6631;10963;22984;5036;8607;5631;1736;4830;10921;3609;6597;10197;10212;5433;5198;5902;10946;7372;203068;51155;10528;6626;5982;6427;4953;27338;705;8662;9221;7203;3182;471;9688;9775;6627;4609;3735;80324;51154;10598;9416;4691;8480;4172;6628;9533;51593;10985;23404;10574;9128;9898;5707;2618;7371;79080	1	395	15929	21	49	374	15880	16324	0.1177879523519306
15	M1	e019_M1	TRUE	1.94689239402246e-28	157	69	24	0.34782608695652173	0.15286624203821655	GO:0002181	GO:BP	cytoplasmic translation	16324	746		GO:0006412	0	0.019230769230769232	10983;5018;1725;25875;10399;738;3476;51545;9960;6139;57820;5250;8664;140465;4904;468;6138;4048;28987;3326;4736;2091;293;6746;26978;3646;8667;2483;1975;8665;6194;6146;689;819;517;6125;1974;5859;10541;3615;3178;11179;8761;8531;5042;57570;51611;26986;84273;51614;27044;6122;1459;51082;25796;55850;8666;1938;1939;84320;728689;4673;10412;23478;6152;51386;7570;6132;3945;6124;26520;26156;54930;805	1	157	16167	24	45	133	16122	16324	0.22577581568594773
17	M1	e019_M1	TRUE	1.9071279546701021e-4	132	39	7	0.1794871794871795	0.05303030303030303	KEGG:04142	KEGG	Lysosome	8161	274		NA	0	0.3333333333333333	3920;3295;6451;9236;801;6744;1362;8804;5264;7844;9741;8031;9488;9528;10159;81533;55032;8895;140609;10313;10955;427;5862;8417;51170;11342;847;9375;55788;1389;2589;259230;1486;310;2744;10133;51669;1203;2230;51646;7905;9867;831;10550;10140;5621;90;9445;4942;51439;2746;665;8724;8763;950;56674;175;6643;27020;57515;23167;26234;2180;6302;57142;8887;6990	1	132	8029	7	32	125	7997	8161	0.08971115113734192
18	M1	e019_M1	TRUE	6.714560311434427e-39	672	62	41	0.6612903225806451	0.06101190476190476	GO:1903047	GO:BP	mitotic cell cycle process	16324	23794		GO:0051276;GO:0000280;GO:0007059;GO:0007049;GO:0050789	0	0.0055248618784530384	10024;6502;3833;3014;79019;9928;8318;9156;81620;83461;332;9232;10535;7298;1163;55635;55723;1869;4174;4288;4171;9700;1033;55355;890;9918;10112;24137;3978;9133;51203;23397;22974;11065;2305;1786;10036;4173;641;10615;55143;146909;6790;899;4605;10460;991;701;4176;51512;1058;2189;7468;11004;3149;1841;54478;55872;7083;9212;5347;891;51659;6241	1	672	15652	41	21	631	15631	16324	0.1927278139150856
19	M1	e019_M1	TRUE	2.879451834503186e-12	476	50	20	0.4	0.04201680672268908	REAC:R-HSA-6798695	REAC	Neutrophil degranulation	10790	1511		GO:0006996	0	0.05263157894736842	4000;83442;832;2316;5552;23406;3460;5476;6678;10577;10493;87;7791;10095;308;6281;7076;9948;8682;3956;3916;967;6282;301;2495;8407;2512;307;1200;10109;2876;53827;1476;822;4245;2896;6277;4627;2280;1075;1535;5216;2014;960;7171;706;6275;302;2934;1508;5660;7431;10487;1192;3958;4267;4478;9123;84617;5355	1	476	10314	20	30	456	10284	10790	0.11824888271463706
20	M1	e019_M1	TRUE	1.1450732139794937e-4	111	54	7	0.12962962962962962	0.06306306306306306	GO:0006413	GO:BP	translational initiation	16324	2222		NA	0	0.5	81034;5965;7341;5706;10988;9801;55726;80145;29080;51001;60496;5876;6921;51444;9318;6996;7884;8669;81929;5955;58478;3066;10434;23658;80218;10944;64431;11260;1964;26135;10527;3093;5440;11335;10480;8467;1977;7336;908;1070;8813;6059;6731;10393;51184;79657;10190;8520;5718;54529;86;51187;10054;55156;55832;10605;5612	1	111	16213	7	47	104	16166	16324	0.08610737387896855
21	M1	e019_M1	TRUE	2.4982459483768732e-6	552	53	14	0.2641509433962264	0.025362318840579712	GO:0051276	GO:BP	chromosome organization	16324	14382		GO:0006281;GO:0050789;GO:0051276	0	0.030303030303030304	9994;8726;10772;4436;23350;5378;5431;11177;10198;5501;9972;10664;10042;9987;2956;9984;9879;545;23306;7913;9126;5885;11340;9184;10951;7013;8880;55746;7705;8697;10051;55656;10915;25842;4678;3189;7398;23244;220988;10236;11168;5411;1479;22976;3930;26065;11073;54906;9774;22823;8930;7514;4683;9702;55035;55120	1	552	15772	14	39	538	15733	16324	0.0727286848184806
23	M1	e019_M1	TRUE	2.6975062902144076e-22	297	39	22	0.5641025641025641	0.07407407407407407	REAC:R-HSA-1474244	REAC	Extracellular matrix organization	10790	844		GO:0043062;GO:0045229	0	0.025	1009;10186;10979;1281;1282;1289;1290;2200;2202;23213;25937;29995;3624;4015;4907;7414;7145;11259;4811;633;1634;5764;4060;10580;3339;10631;1278;10826;56893;8933;23002;1277;3910;4638;7837;8614;11098;3371;285761;6196;558;3912;23452;80781;8406;7412;150771;1805;7373;2006;3075;3078;7041	1	297	10493	22	17	275	10476	10790	0.1975301401811717
24	M1	e019_M1	TRUE	1.1103100266141996e-62	128	52	36	0.6923076923076923	0.28125	GO:0006119	GO:BP	oxidative phosphorylation	16324	2021		GO:0022900;GO:0009117;GO:0006119	0	0.014492753623188406	4710;93974;1350;1349;9551;4701;514;4708;4259;1327;3094;4695;51079;1347;4724;1345;7388;4714;51650;11315;29796;4725;516;26521;1340;7381;4696;4707;54539;6647;6633;521;4700;4717;1351;59286;27335;9556;1329;1337;4726;51642;10975;4694;27089;1622;64976;78988;4697;10632;10063;10476	1	128	16196	36	16	92	16180	16324	0.43868330205409933
25	M1	e019_M1	TRUE	7.814550382728659e-7	120	21	7	0.3333333333333333	0.058333333333333334	KEGG:04935	KEGG	Growth hormone synthesis, secretion and action	8161	385		NA	0	0.05555555555555555	4238;9919;7465;64770;10057;23503;7529;7532;31;4013;6416;8660;57614;9497;25914;4214;23164;10260;22921;3480;1487;23304;375484;51490;5168;57147;51092;91833;64769;5894;93210;9759;7248;55835;162681;23317;23677;5534;26031;26064;2690;5774;27342;3667;404734;5599;4301;8496;55177;7345;7249	1	120	8041	7	14	113	8027	8161	0.13445619410437082
26	M1	e019_M1	TRUE	3.328828016418601e-4	70	30	5	0.16666666666666666	0.07142857142857142	KEGG:05230	KEGG	Central carbon metabolism in cancer	8161	471		NA	0	0.5	7094;79095;5589;5315;10120;5605;1201;8079;5518;2319;23193;9526;11316;10994;166;207;10945;439;5127;6576;2783;23558;8733;1209;5585;56904;6510;10362;22913;2907;823;10554;10093;55643;377;10908;92579;80700;7317;5211;4924;23770;396;57175;10211;55611;5524;64755;682;826;23646	1	70	8091	5	25	65	8066	8161	0.10413203203509198
27	M1	e019_M1	TRUE	2.0956155521463945e-43	161	49	29	0.5918367346938775	0.18012422360248448	GO:0009060	GO:BP	aerobic respiration	16324	3312		GO:0009117;GO:0006119	0	0.014285714285714285	506;27068;7385;27258;2108;4722;515;4704;51021;2271;79135;4712;6392;518;4718;25874;509;7386;54205;7417;498;2971;5160;81892;29093;55967;8802;4719;4706;6390;29074;27069;10542;522;4729;9377;4190;23788;28957;4711;64960;539;6391;7419;4709;55847;55856;3033;5162;4702	1	161	16163	29	20	132	16143	16324	0.32314225617872355
28	M1	e019_M1	TRUE	0.0017356930149482915	121	25	5	0.2	0.04132231404958678	KEGG:04152	KEGG	AMPK signaling pathway	8161	280		NA	0	0.125	55629;25836;115426;51552;5926;55284;54014;8087;253260;57532;10771;55196;55031;51496;8731;868;6885;55596;905;51742;80267;80315;64786;25831;54407;51701;5562;26122;659;149041;4780;5290;79718;571;57534;23683;65056;3845;10150;6198;81573;56204;1456;29066;114885;26091;54882;54464;51322	1	121	8040	5	20	116	8020	8161	0.0849309085063811
30	M1	e019_M1	TRUE	1.414384577978773e-28	249	41	23	0.5609756097560976	0.09236947791164658	GO:0042254	GO:BP	ribosome biogenesis	16324	10632		GO:0042254;GO:0006396	0	0.045454545454545456	9669;10492;9188;6741;23160;26354;55127;29889;51388;5471;84365;27000;54433;55720;10199;10153;51575;80155;27292;84128;55131;11137;8886;51018;84549;27042;10799;55646;25926;83732;1662;79101;55299;6632;54962;10885;55003;56902;54517;23560;64318;9933;55854;7019	1	249	16075	23	18	226	16057	16324	0.2234331442508531
31	M1	e019_M1	TRUE	3.1291215236057697e-6	11	27	4	0.14814814814814814	0.36363636363636365	REAC:R-HSA-389359	REAC	CD28 dependent Vav1 pathway	10790	257		GO:0022607;GO:0050789;GO:0006996	0	0.025	5062;1024;9270;5147;5910;10071;998;5879;7114;5878;10245;892;402;134510;53981;57695;7982;80006;23568;389;153830;10962;55255;57691;51107;25923;29123;114799;117177;392;9191;6780;403;203259;57630;5058;89781;8976;27185;4130;4512	1	11	10779	4	23	7	10756	10790	0.2309130265006635
32	M1	e019_M1	TRUE	2.3116115364741347e-5	617	40	12	0.3	0.019448946515397084	GO:0016071	GO:BP	mRNA metabolic process	16324	5222		GO:0006396	0	0.14285714285714285	23265;23381;7343;7917;8175;1107;6830;10992;6602;23523;81;1639;58509;29882;10262;5339;7919;23399;11100;23396;4650;4150;7916;55700;25792;6829;3297;10155;8241;22904;3159;9146;4849;6878;9968;79171;29888;51586;55201;8289;9112	1	617	15707	12	28	605	15679	16324	0.0681434798335276
33	M1	e019_M1	TRUE	6.648140444366109e-4	4	12	2	0.16666666666666666	0.5	KEGG:00785	KEGG	Lipoic acid metabolism	8161	124		NA	0	0.5	7159;51292;64172;54851;51015;57002;57325;119559;152579;55622;125228;80135;10961;54865;83989;8772;55830;10775;112487;64282;10557;7024;25938;11019;51562;84437;9678;116092;51124;54925;55888;7259;222068;283232;22954;585;51601;283459;84881;7164	1	4	8157	2	10	2	8147	8161	0.2881086536121658
34	M1	e019_M1	TRUE	3.725279069620678e-5	43	14	4	0.2857142857142857	0.09302325581395349	KEGG:03022	KEGG	Basal transcription factors	8161	213		NA	0	0.1111111111111111	10171;196294;10973;64062;55170;79102;55236;115209;4216;55857;57703;51321;9946;2960;55585;57037;25934;729852;89890;51633;10564;134218;63939;51000;6874;151525;6908;116064;55783;221143;79736;81545;148423;8091;84078;79686;23283;4534;55266;6883	1	43	8118	4	10	39	8108	8161	0.16058241641367327
36	M1	e019_M1	TRUE	3.878093753317869e-15	394	37	17	0.4594594594594595	0.04314720812182741	GO:0008380	GO:BP	RNA splicing	16324	3261		GO:0050789;GO:0000375;GO:0051276	0	0.019230769230769232	6426;3183;10657;3190;27316;23028;11198;142;10146;5928;6434;6421;7027;6117;4670;3181;7520;1665;3608;3065;3184;1457;3185;3192;51031;4144;9410;6428;47;5591;9555;22919;8683;7150;1660;23435;4841;8125;6599	1	394	15930	17	20	377	15910	16324	0.1351956544309696
37	M1	e019_M1	TRUE	8.161728852340614e-13	168	19	11	0.5789473684210527	0.06547619047619048	KEGG:04141	KEGG	Protein processing in endoplasmic reticulum	8161	273		GO:0051641;GO:0016192;GO:0019538;GO:0009059	0	0.07692307692307693	6184;6734;10226;7264;10113;9601;2286;10960;51150;10525;6836;7873;22820;79174;1650;10652;1798;10954;977;10237;29927;2132;1611;53838;811;23753;5479;23423;10548;56005;64834;54480;5034;10263;8985;54867;6185;6238	1	168	7993	11	8	157	7985	8161	0.18995934722060476
39	M1	e019_M1	TRUE	7.317838204641694e-6	36	27	5	0.18518518518518517	0.1388888888888889	REAC:R-HSA-6804757	REAC	Regulation of TP53 Degradation	10790	1906		GO:0006281	0	0.07692307692307693	7874;26130;10075;2547;55848;6945;7157;5607;23172;6603;2969;4193;54880;1399;10301;6470;23008;752;79892;29855;8453;9820;56252;1616;2033;5598;51621;6904;23113;3064;7158;85015;4194;6598;84148	1	36	10754	5	22	31	10732	10790	0.15794676682912823
42	M1	e019_M1	TRUE	8.420806503208808e-7	24	27	5	0.18518518518518517	0.20833333333333334	REAC:R-HSA-379716	REAC	Cytosolic tRNA aminoacylation	10790	409		GO:0006865;GO:0006520;GO:0016070	0	0.034482758620689655	6509;7296;57099;56888;16;90956;7533;22809;8140;8565;26227;4141;833;6520;23654;83667;9518;440;5106;29789;6301;57761;23344;1649;6541;29968;10626;23657;11072;4482;6396;9780;23596;84649	1	24	10766	5	22	19	10744	10790	0.19451905190792468
44	M1	e019_M1	TRUE	1.5201804700058203e-6	132	21	7	0.3333333333333333	0.05303030303030303	KEGG:04142	KEGG	Lysosome	8161	274		GO:0065008	0	0.038461538461538464	51094;2771;527;381;553115;162;4758;5226;535;1212;537;1845;10121;334;9784;5306;6050;54472;10043;51117;4947;10567;1173;1312;10956;11337;9114;7165;8775;10066;440400;3611;375	1	132	8029	7	14	125	8015	8161	0.1277026635734624
47	M1	e019_M1	TRUE	9.569319662126024e-5	32	20	4	0.2	0.125	REAC:R-HSA-418990	REAC	Adherens junctions interactions	10790	117		GO:0019538	0	0.047619047619047616	1001;999;55654;124583;28991;55909;10904;65264;8502;255488;64114;55739;63916;115992;5663;5664;1500;10653;29916;64207;57217;9414;121665;51547;79720;1499;9322;1525;23385;55851;8273	1	32	10758	4	16	28	10742	10790	0.15614556275478403
48	M1	e019_M1	TRUE	3.948037241565839e-14	177	28	13	0.4642857142857143	0.07344632768361582	REAC:R-HSA-1428517	REAC	The citric acid (TCA) cycle and respiratory electron transport	10790	2365		GO:0022900;GO:0009117;GO:0006119	0	0.014285714285714285	8402;513;2109;1891;8574;7384;374291;4720;26073;95;2639;4728;1892;3421;5096;10591;9380;1537;1632;51181;25828;25813;4191;65003;3418;8209;79004;4713;4723;3420;7001	1	177	10613	13	15	164	10598	10790	0.17985044119565569
49	M1	e019_M1	TRUE	4.050524776369002e-5	295	28	8	0.2857142857142857	0.02711864406779661	GO:0016236	GO:BP	macroautophagy	16324	5303		GO:0016032;GO:0044419;GO:0006914	0	0.2	7879;6729;26225;5604;9218;6009;285381;9550;6049;9367;7360;55207;23585;9943;55973;9685;81631;9559;7320;25996;84640;6788;5805;79868;84085;55041;25978;10730;22931;10289	1	295	16029	8	20	287	16009	16324	0.08328299407627611
51	M1	e019_M1	TRUE	4.631239022138331e-11	94	23	9	0.391304347826087	0.09574468085106383	REAC:R-HSA-156842	REAC	Eukaryotic Translation Elongation	10790	827		GO:0006412	0	0.006622516556291391	2778;1915;9168;3020;1973;2597;6188;5478;10376;7311;6137;6217;6222;7314;7316;5757;4946;10209;2509;1072;71;60;3146;6175;7178;3151;1937;23521;84790	1	94	10696	9	14	85	10682	10790	0.19028297054526583
52	M1	e019_M1	TRUE	4.0405149851617283e-7	8	24	4	0.16666666666666666	0.5	GO:0070537	GO:BP	histone H2A K63-linked deubiquitination	16324	17102		GO:0050896;GO:0006508;GO:0036211;GO:0050789	0	0.05263157894736842	83939;57621;10165;9577;79184;5935;120534;57587;152137;55109;221830;6443;26258;26503;222658;51193;26061;4898;149371;84991;84190;92689;221035;5325;60558;51720;25979;84142	1	8	16316	4	20	4	16296	16324	0.2881087230806942
57	M1	e019_M1	TRUE	1.5278952043071445e-8	87	18	7	0.3888888888888889	0.08045977011494253	REAC:R-HSA-3371556	REAC	Cellular response to heat stress	10790	322		GO:0050896	0	0.125	140809;79109;2992;573;7280;9531;28232;56940;9643;29928;10381;10490;25912;9616;6642;9482;79038;3303;9124;93621;3304;10933;4097;83640;57521;2475;26353;84337	1	87	10703	7	11	80	10692	10790	0.1740698583786359
58	M1	e019_M1	TRUE	6.485443584487552e-39	46	24	19	0.7916666666666666	0.41304347826086957	KEGG:03050	KEGG	Proteasome	8161	216		GO:0009057;GO:0006508	0	0.006993006993006993	5694;5690;8896;5704;7415;51399;55505;5691;8668;5713;5714;51371;7353;83460;10436;5688;5710;5702;5682;5689;5719;9861;5695;5708;55969;5705;5692;5693	1	46	8115	19	5	27	8110	8161	0.5702073896488173
62	M1	e019_M1	TRUE	2.681188693404622e-6	53	7	4	0.5714285714285714	0.07547169811320754	KEGG:03460	KEGG	Fanconi anemia pathway	8161	237		GO:0050896	0	0.0625	11266;64222;221908;79008;79714;54973;81875;10283;339229;79447;28955;4832;23511;55794;57473;114785;128710;2072;23224;84464;146956;80198;6415;222229;26151;285367;318	1	53	8108	4	3	49	8105	8161	0.20606781188548684
64	M1	e019_M1	TRUE	1.157849762362942e-5	5	18	3	0.16666666666666666	0.6	REAC:R-HSA-9754119	REAC	Drug-mediated inhibition of CDK4/CDK6 activity	10790	766		NA	0	0.1	894;55320;51765;23531;64859;595;1021;57522;79832;84959;91687;2099;9862;10551;4582;139818;79745;586;5577;54509;283464;29035;84925;2317;2100;23362;284129	1	5	10785	3	15	2	10770	10790	0.31568505646043094
65	M1	e019_M1	TRUE	1.5598098947915127e-9	158	25	9	0.36	0.056962025316455694	GO:0140053	GO:BP	mitochondrial gene expression	16324	20737		GO:0006412	0	0.07142857142857142	708;201254;51218;51287;51121;51367;79590;56954;26589;79622;3145;54948;3028;3396;65265;10248;51373;26519;7965;57019;51081;51728;79081;79077;30968;10328;63875	1	158	16166	9	16	149	16150	16324	0.14013688234988297
69	M1	e019_M1	TRUE	3.090728318465756e-5	58	24	5	0.20833333333333334	0.08620689655172414	GO:0006939	GO:BP	smooth muscle contraction	16324	2634		GO:0006936	0	0.14285714285714285	59;153222;4323;3488;6876;7169;6840;6654;64224;50862;25897;6525;4256;4629;114907;1291;1264;4016;1293;5159;55959;388403;6095;171024;6453	1	58	16266	5	19	53	16247	16324	0.13206026426733694
71	M1	e019_M1	TRUE	3.2237957118884145e-5	297	16	7	0.4375	0.02356902356902357	REAC:R-HSA-1474244	REAC	Extracellular matrix organization	10790	844		GO:0043062;GO:0045229	0	0.25	4053;2621;4681;59307;85450;55701;11078;7084;115908;64743;81603;5654;27352;1303;221184;79654;9902;3913;649;4054;5396;4313;3092;6604	1	297	10493	7	9	290	10484	10790	0.0965654455005377
73	M1	e019_M1	TRUE	6.764005213759381e-9	32	21	6	0.2857142857142857	0.1875	REAC:R-HSA-70263	REAC	Gluconeogenesis	10790	998		GO:0006091;GO:0009117;GO:0006082;GO:0005975	0	0.034482758620689655	2950;1175;4831;81037;10383;5052;4282;5223;2821;10430;533;7086;6888;3939;7167;5230;11332;2023;51142;1460;664;10134;292;226	1	32	10758	6	15	26	10743	10790	0.22961648896759476
74	M1	e019_M1	TRUE	0.0027851526227876235	142	24	5	0.20833333333333334	0.035211267605633804	GO:2000045	GO:BP	regulation of G1/S transition of mitotic cell cycle	16324	26652		GO:0050789	0	0.14285714285714285	5311;55837;5494;1112;25949;27250;64750;51247;5934;5921;54741;5527;51185;22863;57181;6595;120;56034;472;5567;214;11215;10464;4781	1	142	16182	5	19	137	16163	16324	0.08249235421568184
77	M1	e019_M1	TRUE	6.977148940950978e-14	135	19	11	0.5789473684210527	0.08148148148148149	KEGG:04210	KEGG	Apoptosis	8161	281		GO:0065009;GO:0007005;GO:0050789	0	0.011904761904761904	10018;596;598;841;8797;572;843;10327;5872;824;83985;84876;2990;11035;3305;8737;581;1174;6461;92714;356;56834;638	1	135	8026	11	8	124	8018	8161	0.2130038999367925
79	M1	e019_M1	TRUE	2.55547540943132e-9	128	11	7	0.6363636363636364	0.0546875	REAC:R-HSA-6809371	REAC	Formation of the cornified envelope	10790	919		GO:0006996	0	0.14285714285714285	79005;10919;11007;7004;80764;84726;9203;9502;84260;148223;3872;84310;84445;94121;150483;3866;4103;3856;2261;3853;3854;3880;3875	1	128	10662	7	4	121	10658	10790	0.18426261350079778
80	M1	e019_M1	TRUE	6.102270774708651e-29	63	19	15	0.7894736842105263	0.23809523809523808	REAC:R-HSA-73728	REAC	RNA Polymerase I Promoter Opening	10790	1791		GO:0065003	0	0.00909090909090909	85236;55741;23387;3017;8334;128869;55245;4815;2017;399979;8349;3006;3012;8337;8343;8344;8345;8346;8347;8365;3013;8331;8357	1	63	10727	15	4	48	10723	10790	0.43199091297164494
82	M1	e019_M1	TRUE	3.0705882563626596e-23	47	21	12	0.5714285714285714	0.2553191489361702	GO:0032968	GO:BP	positive regulation of transcription elongation by RNA polymerase II	16324	8380		GO:0050789	0	0.05	10001;55588;84246;9440;112950;10179;10363;55145;9442;51003;51780;54888;84146;91408;90390;59349;5195;80306;219771;219541;81857;9477	1	47	16277	12	9	35	16268	16324	0.3808329747097541
83	M1	e019_M1	TRUE	0.005260991250472241	86	20	4	0.2	0.046511627906976744	GO:0006400	GO:BP	tRNA modification	16324	2211		GO:0006396;GO:0043412	0	0.5	91283;79707;8518;55006;84950;57470;5082;23119;9673;55833;55703;23466;11176;9903;54802;9686;7988;51759;359845;55182;57095;55140	1	86	16238	4	16	82	16222	16324	0.0942140394529641
85	M1	e019_M1	TRUE	0.002347007281646391	31	14	3	0.21428571428571427	0.0967741935483871	REAC:R-HSA-917729	REAC	Endosomal Sorting Complex Required For Transport (ESCRT)	10790	803		GO:0006811	0	0.25	84641;10617;153339;57103;51527;2182;27032;28962;51528;57552;9525;8027;55858;10254;3685;51030;663;6646;26750;51136;8754;55500	1	31	10759	3	11	28	10748	10790	0.1423707948646659
87	M1	e019_M1	TRUE	2.780091024084643e-6	3	21	3	0.14285714285714285	1	GO:0018916	GO:BP	nitrobenzene metabolic process	16324	5765		GO:0006805;GO:0006725;GO:0006807	0	0.05263157894736842	55556;6652;27102;51312;51260;493856;137682;11160;23587;94081;25879;154743;84513;286148;56898;144245;54495;2944;2946;2947;2948	1	3	16321	3	18	0	16303	16324	0.37775599199210375
88	M1	e019_M1	TRUE	1.3595549877010559e-6	67	12	5	0.4166666666666667	0.07462686567164178	KEGG:00010	KEGG	Glycolysis / Gluconeogenesis	8161	2		GO:0006091;GO:0009117;GO:0006082;GO:0005975	0	0.043478260869565216	3098;53335;2026;10253;4651;5217;84058;5213;4628;5214;22927;23321;254863;84153;2824;230;55689;89927;23301;384;64919	1	67	8094	5	7	62	8087	8161	0.17370369838180813
90	M1	e019_M1	TRUE	1.6198871349521298e-4	58	13	4	0.3076923076923077	0.06896551724137931	REAC:R-HSA-8866654	REAC	E3 ubiquitin ligases ubiquitinate target proteins	10790	773		GO:0036211	0	0.125	8548;64089;79577;51616;25871;56254;84693;23774;583;5000;54826;8790;57120;1080;729082;123169;122786;23168;11228;9667;49854	1	58	10732	4	9	54	10723	10790	0.14359931315356
94	M1	e019_M1	TRUE	3.041179169963804e-10	202	14	9	0.6428571428571429	0.04455445544554455	KEGG:04510	KEGG	Focal adhesion	8161	307		NA	0	0.07692307692307693	5937;4837;800;4071;7168;3693;3490;1292;55752;1490;2335;284119;7057;11030;64778;3915;857;2012;7045;858;1284	1	202	7959	9	5	193	7954	8161	0.16491723691283314
97	M1	e019_M1	TRUE	1.1448276062847776e-5	158	17	6	0.35294117647058826	0.0379746835443038	GO:0140053	GO:BP	mitochondrial gene expression	16324	20737		GO:0006412	0	0.1	84319;11218;51602;30836;57129;494143;129401;84154;55173;64983;55660;84955;29979;54534;51645;87178;84916;91298;54931;113174	1	158	16166	6	11	152	16155	16324	0.1132035723378891
98	M1	e019_M1	TRUE	5.912213419896603e-4	472	18	7	0.3888888888888889	0.014830508474576272	GO:0007005	GO:BP	mitochondrion organization	16324	2676		NA	0	0.14285714285714285	51253;51078;83443;51499;4716;140823;4715;154791;56655;26355;91582;27166;84316;4731;79763;219927;128240;64951;84279;51264	1	472	15852	7	11	465	15841	16324	0.07137526170371418
99	M1	e019_M1	TRUE	1.9549124513567047e-10	502	14	11	0.7857142857142857	0.021912350597609563	REAC:R-HSA-9006934	REAC	Signaling by Receptor Tyrosine Kinases	10790	2177		GO:0050789	0	0.013513513513513514	30011;143384;2064;5747;9529;1039;8853;1956;79647;867;4354;3909;2887;2065;23650;4233;2886;9564;3082	1	502	10288	11	3	491	10285	10790	0.12650137811094356
102	M1	e019_M1	TRUE	2.0216294338790357e-8	183	19	8	0.42105263157894735	0.04371584699453552	GO:0006457	GO:BP	protein folding	16324	2254		GO:0006457;GO:0050896	0	0.09090909090909091	10808;10728;5481;3308;113251;3320;5917;81542;26973;10914;865;10269;3312;6432;55161;3301;2107;2935;262	1	183	16141	8	11	175	16130	16324	0.1328828200356036
103	M1	e019_M1	TRUE	0.005686198898754479	7	11	2	0.18181818181818182	0.2857142857142857	REAC:R-HSA-426496	REAC	Post-transcriptional silencing by small RNAs	10790	1684		NA	0	0.3333333333333333	196528;23112;51105;26523;54165;23592;29072;23528;57798;8452;57708;80314;7586;11278;27086;23253;143684;255967;22841	1	7	10783	2	9	5	10774	10790	0.22729749724310414
104	M1	e019_M1	TRUE	6.463962071892483e-4	179	14	5	0.35714285714285715	0.027932960893854747	REAC:R-HSA-72163	REAC	mRNA Splicing - Major Pathway	10790	2566		NA	0	0.3333333333333333	29894;55738;8558;89941;256364;22937;10594;8106;23524;57680;26168;22985;8971;65980;578;30827;3661;6625;10494	1	179	10611	5	9	174	10602	10790	0.09610306695377553
106	M1	e019_M1	TRUE	0.00578926479092162	72	11	3	0.2727272727272727	0.041666666666666664	KEGG:04137	KEGG	Mitophagy - animal	8161	269		NA	0	0.5	5601;58497;285362;4802;23039;4800;9927;79735;51495;10277;57658;64426;64854;200933;223;8543;55290;79567	1	72	8089	3	8	69	8081	8161	0.10367990243822549
111	M1	e019_M1	TRUE	1.7975477747189364e-30	26	17	13	0.7647058823529411	0.5	REAC:R-HSA-191273	REAC	Cholesterol biosynthesis	10790	334		GO:0006066;GO:0006629	0	0.03571428571428571	6307;3156;3157;3422;50814;2222;39;4047;3992;10682;6319;2224;1718;1717;3638;1595;6713	1	26	10764	13	4	13	10760	10790	0.6176292234930262
114	M1	e019_M1	TRUE	6.139682837213973e-5	682	15	8	0.5333333333333333	0.011730205278592375	GO:0032446	GO:BP	protein modification by small protein conjugation	16324	7988		GO:0036211	0	0.5	7329;6612;26578;2752;55819;7325;7324;23259;9666;6048;128866;51493;22806;9189;4540;91445	1	682	15642	8	7	674	15635	16324	0.07450608981456823
117	M1	e019_M1	TRUE	8.283175639021576e-10	260	16	9	0.5625	0.03461538461538462	GO:0007249	GO:BP	I-kappaB kinase/NF-kappaB signaling	16324	2852		GO:0050789	0	0.013888888888888888	4794;9020;10318;5970;9641;7185;5966;4790;7127;79155;4814;51561;4791;8837;6776;5971	1	260	16064	9	7	251	16057	16324	0.1367478497593161
118	M1	e019_M1	TRUE	9.937942057466454e-11	132	12	8	0.6666666666666666	0.06060606060606061	KEGG:04142	KEGG	Lysosome	8161	274		GO:0008152	0	0.2	2760;1992;1514;3074;5641;2799;7077;966;8992;1318;2517;3597;64747;3482;3459;3988	1	132	8029	8	4	124	8025	8161	0.19788197042370986
120	M1	e019_M1	TRUE	8.180001006013874e-8	23	7	4	0.5714285714285714	0.17391304347826086	KEGG:03060	KEGG	Protein export	8161	217		GO:0015031	0	0.16666666666666666	28972;746;51506;58477;51065;1603;10952;51374;29100;23480;10549;10330;24140;10897;79001	1	23	8138	4	3	19	8135	8161	0.3142671577614873
126	M1	e019_M1	TRUE	1.872053518852944e-5	125	11	5	0.45454545454545453	0.04	KEGG:04380	KEGG	Osteoclast differentiation	8161	303		NA	0	0.3333333333333333	653361;56833;968;83937;10859;51296;80896;54;29992;5724;409;10288;11025	1	125	8036	5	6	120	8030	8161	0.13139434054886892
131	M1	e019_M1	TRUE	1.1037366414422763e-6	68	11	5	0.45454545454545453	0.07352941176470588	REAC:R-HSA-5685942	REAC	HDR through Homologous Recombination (HRR)	10790	1039		GO:0050896	0	0.03333333333333333	1477;8089;5889;5111;3251;7374;54148;5810;4116;6118;54107;996	1	68	10722	5	6	63	10716	10790	0.18094643143132966
133	M1	e019_M1	TRUE	8.469986508400321e-5	628	8	6	0.75	0.009554140127388535	GO:0046649	GO:BP	lymphocyte activation	16324	12996		GO:0032502;GO:0001775;GO:0002376	0	0.08333333333333333	9214;4068;915;3702;3507;5551;914;3514;3535;931;3500;939	1	628	15696	6	2	622	15694	16324	0.08191869825075003
135	M1	e019_M1	TRUE	0.0019849156803126125	37	11	3	0.2727272727272727	0.08108108108108109	GO:0045324	GO:BP	late endosome to vacuole transport	16324	12052		GO:0051641;GO:0016192	0	0.25	5537;81847;57132;51652;5828;26175;8634;9204;7328;1176;757;10479	1	37	16287	3	8	34	16279	16324	0.14768579398222154
138	M1	e019_M1	TRUE	1.0883915691297306e-6	24	10	4	0.4	0.16666666666666666	REAC:R-HSA-379716	REAC	Cytosolic tRNA aminoacylation	10790	409		GO:0006520;GO:0016070	0	0.125	6732;6897;10797;2617;79572;3313;8661;4677;9804;2058;1054	1	24	10766	4	6	20	10760	10790	0.25716835346146905
139	M1	e019_M1	TRUE	3.096106844582773e-5	10	11	3	0.2727272727272727	0.3	GO:0031442	GO:BP	positive regulation of mRNA 3'-end processing	16324	7568		GO:0050789;GO:0016070	0	0.03333333333333333	11051;9793;51729;22916;3796;4686;10059;8539;9100;23165;4076	1	10	16314	3	8	7	16306	16324	0.2855799739945463
140	M1	e019_M1	TRUE	1.6296507983416678e-7	516	11	8	0.7272727272727273	0.015503875968992248	GO:0006281	GO:BP	DNA repair	16324	2140		GO:0006281	0	0.025	25913;4292;6596;57122;80010;5981;10714;23595;5984;79677;10038	1	516	15808	8	3	508	15805	16324	0.10325034082161441
144	M1	e019_M1	TRUE	1.4679333101832147e-4	25	8	3	0.375	0.12	REAC:R-HSA-69273	REAC	Cyclin A/B1/B2 associated events during G2/M transition	10790	397		NA	0	0.058823529411764705	5520;6879;10015;25843;5516;7871;8428;54918;23011;55791;5519	1	25	10765	3	5	22	10760	10790	0.2111443099338758
148	M1	e019_M1	TRUE	3.244499646083744e-4	6	6	2	0.3333333333333333	0.3333333333333333	KEGG:00232	KEGG	Caffeine metabolism	8161	23		GO:0050896	0	0.16666666666666666	56;84687;1548;1549;1813;4635;2916;29974;5030;60676	1	6	8155	2	4	4	8151	8161	0.33284283670549764
149	M1	e019_M1	TRUE	0.0011701452741383028	179	8	4	0.5	0.0223463687150838	REAC:R-HSA-72163	REAC	mRNA Splicing - Major Pathway	10790	2566		NA	0	0.3333333333333333	1984;5094;3191;7458;5093;10204;6431;1629;54841;83852	1	179	10611	4	4	175	10607	10790	0.10309277732915115
164	M1	e019_M1	TRUE	8.358693729073095e-4	6	6	2	0.3333333333333333	0.3333333333333333	REAC:R-HSA-9022537	REAC	Loss of MECP2 binding ability to the NCoR/SMRT complex	10790	1268		NA	0	0.2	7421;79039;84872;9612;56965;8841;83746;90933	1	6	10784	2	4	4	10780	10790	0.33296241345202765
166	M1	e019_M1	TRUE	1.459482756275451e-4	2	7	2	0.2857142857142857	1	GO:0045004	GO:BP	DNA replication proofreading	16324	11911		GO:0006281	0	0.5	6929;5424;994;5426;790;3835;84823;55038	1	2	16322	2	5	0	16317	16324	0.5344406060791936
169	M1	e019_M1	TRUE	6.479570571597898e-4	313	5	4	0.8	0.012779552715654952	REAC:R-HSA-418594	REAC	G alpha (i) signalling events	10790	933		GO:0040011;GO:0050789;GO:0002376	0	0.06666666666666667	9770;5142;6351;1880;6348;969;9308;5996	1	313	10477	4	1	309	10476	10790	0.09891346392576071
177	M1	e019_M1	TRUE	0.0016714469962941154	100	6	3	0.5	0.03	KEGG:04914	KEGG	Progesterone-mediated oocyte maturation	8161	364		NA	0	0.5	81876;51343;8379;8498;8751;10459;28952;10555	1	100	8061	3	3	97	8058	8161	0.1202560155335159
179	M1	e019_M1	TRUE	0.003061785303907354	7	7	2	0.2857142857142857	0.2857142857142857	GO:0140507	GO:BP	granzyme-mediated programmed cell death signaling pathway	16324	20892		NA	0	0.5	1154;10578;3001;3002;3560;2057;8320	1	7	16317	2	5	5	16312	16324	0.2854078568364282
184	M1	e019_M1	TRUE	0.0021022166432344705	113	5	3	0.6	0.02654867256637168	REAC:R-HSA-9020702	REAC	Interleukin-1 signaling	10790	1173		NA	0	0.16666666666666666	10971;5716;23204;5717;55148;5931;9097	1	113	10677	3	2	110	10675	10790	0.12469139391886577
185	M1	e019_M1	TRUE	9.774597903588425e-6	88	6	4	0.6666666666666666	0.045454545454545456	GO:0006405	GO:BP	RNA export from nucleus	16324	2216		GO:0015931;GO:0051641	0	0.08333333333333333	23636;2130;29107;10432;26528;11052;26097	1	88	16236	4	2	84	16234	16324	0.1731691556941054
187	M1	e019_M1	TRUE	1.459482756275451e-4	2	7	2	0.2857142857142857	1	GO:0070488	GO:BP	neutrophil aggregation	16324	17079		GO:0050789;GO:0007155	0	0.1	1475;2219;6279;11027;6280;4318;366	1	2	16322	2	5	0	16317	16324	0.5344406060791936
190	M1	e019_M1	TRUE	2.647171209849274e-4	45	7	3	0.42857142857142855	0.06666666666666667	KEGG:03420	KEGG	Nucleotide excision repair	8161	233		NA	0	0.125	6500;1069;404672;9978;83658;63931;90701	1	45	8116	3	4	42	8112	8161	0.1673898278158461
191	M1	e019_M1	TRUE	1.2678108459637378e-6	199	6	5	0.8333333333333334	0.02512562814070352	GO:0044242	GO:BP	cellular lipid catabolic process	16324	11574		GO:0044255;GO:0006082	0	0.07692307692307693	1528;10247;10449;4258;9588;38;1666	1	199	16125	5	1	194	16124	16324	0.14348647948644852
192	M1	e019_M1	TRUE	4.781969227371244e-7	43	6	4	0.6666666666666666	0.09302325581395349	KEGG:00071	KEGG	Fatty acid degradation	8161	11		GO:0044255;GO:0006082	0	0.037037037037037035	10455;4285;51660;3032;1376;3030;10667	1	43	8118	4	2	39	8116	8161	0.24780550635874635
194	M1	e019_M1	TRUE	1.4491359130245555e-4	6	4	2	0.5	0.3333333333333333	KEGG:00400	KEGG	Phenylalanine, tyrosine and tryptophan biosynthesis	8161	49		GO:0006520	0	0.1111111111111111	2805;2806;327;5827;10300;10953;211	1	6	8155	2	2	4	8153	8161	0.4078979087783254
196	M1	e019_M1	TRUE	0.0016485062620029212	19	4	2	0.5	0.10526315789473684	KEGG:01210	KEGG	2-Oxocarboxylic acid metabolism	8161	185		NA	0	0.3333333333333333	9791;25994;54968;3052;1431;3419;80273	1	19	8142	2	2	17	8140	8161	0.22866983194067225
200	M1	e019_M1	TRUE	0.0031695795714286007	39	3	2	0.6666666666666666	0.05128205128205128	KEGG:00513	KEGG	Various types of N-glycan biosynthesis	8161	66		NA	0	0.5	11282;2590;9130;11253;58986;83986;1186	1	39	8122	2	1	37	8121	8161	0.18404870305428178
205	M1	e019_M1	TRUE	1.678150904428219e-4	11	2	2	1	0.18181818181818182	GO:0061314	GO:BP	Notch signaling involved in heart development	16324	16285		GO:0032502;GO:0050789	0	0.058823529411764705	182;4853;200030;440675;25832;55672	1	11	16313	2	0	9	16313	16324	0.42628385698342613
212	M1	e019_M1	TRUE	2.090617662251986e-5	25	5	3	0.6	0.12	REAC:R-HSA-69273	REAC	Cyclin A/B1/B2 associated events during G2/M transition	10790	397		GO:0050789	0	0.024390243902439025	993;8438;983;995;1104;898	1	25	10765	3	2	22	10763	10790	0.26766419669983604
221	M1	e019_M1	TRUE	0.0010663150374331828	231	3	3	1	0.012987012987012988	KEGG:05171	KEGG	Coronavirus disease - COVID-19	8161	445		GO:0050789	0	0.2	7097;55332;6347;9332;1193;719	1	231	7930	3	0	228	7930	8161	0.11235680488601389
224	M1	e019_M1	TRUE	0.0014064388329387081	6	6	2	0.3333333333333333	0.3333333333333333	GO:0002583	GO:BP	regulation of antigen processing and presentation of peptide antigen	16324	1122		NA	0	0.2	3337;55080;29108;3398;23210;3162	1	6	16318	2	4	4	16314	16324	0.33308820525391186
234	M1	e019_M1	TRUE	1.0612261861745883e-8	3	5	3	0.6	1	GO:0048014	GO:BP	Tie signaling pathway	16324	13202		GO:0032502;GO:0050789	0	0.05263157894736842	2983;285;2982;284;7010	1	3	16321	3	2	0	16319	16324	0.7745492076643277
237	M1	e019_M1	TRUE	0.003806025974048819	12	5	2	0.4	0.16666666666666666	GO:0006264	GO:BP	mitochondrial DNA replication	16324	2124		GO:0006260	0	0.5	11232;29945;5428;7748;196513	1	12	16312	2	3	10	16309	16324	0.25785865013900466
242	M1	e019_M1	TRUE	5.771655679604725e-4	5	5	2	0.4	0.4	GO:0061312	GO:BP	BMP signaling pathway involved in heart development	16324	16283		GO:0050789	0	0.5	390;657;10769;650;55214	1	5	16319	2	3	3	16316	16324	0.3998161652062013
246	M1	e019_M1	TRUE	0.0012742278666942736	395	5	4	0.8	0.010126582278481013	GO:0022613	GO:BP	ribonucleoprotein complex biogenesis	16324	6982		GO:0044085	0	0.5	9790;51202;23279;23076;9733	1	395	15929	4	1	391	15928	16324	0.08837373037443091
248	M1	e019_M1	TRUE	3.343509034449457e-4	13	3	2	0.6666666666666666	0.15384615384615385	KEGG:03450	KEGG	Non-homologous end-joining	8161	236		GO:0006259;GO:0050789	0	0.041666666666666664	23173;29929;4361;10111;9656	1	13	8148	2	1	11	8147	8161	0.3198046386269725
250	M1	e019_M1	TRUE	0.0011245285548559805	200	3	3	1	0.015	REAC:R-HSA-68877	REAC	Mitotic Prometaphase	10790	1404		NA	0	0.5	79441;55319;151188;55166;115106	1	200	10590	3	0	197	10590	10790	0.12135097504868862
261	M1	e019_M1	TRUE	7.280348263143238e-4	108	4	3	0.75	0.027777777777777776	GO:0030183	GO:BP	B cell differentiation	16324	7063		GO:0032502;GO:0001775;GO:0002376	0	0.3333333333333333	4242;10866;3384;3071;3635	1	108	16216	3	1	105	16215	16324	0.14355752210921618
289	M1	e019_M1	TRUE	1.7543419574842214e-4	4	4	2	0.5	0.5	GO:2001199	GO:BP	negative regulation of dendritic cell differentiation	16324	27689		GO:0050789	0	0.5	3176;28959;6414;55365	1	4	16320	2	2	2	16318	16324	0.4998774509803922
297	M1	e019_M1	TRUE	6.410176517881189e-4	516	4	4	1	0.007751937984496124	GO:0006281	GO:BP	DNA repair	16324	2140		GO:0006281	0	0.3333333333333333	56852;113130;2175;116028	1	516	15808	4	0	512	15808	16324	0.08665298569628492
298	M1	e019_M1	TRUE	3.583031815255001e-8	5	4	3	0.75	0.6	GO:0006269	GO:BP	DNA replication, synthesis of RNA primer	16324	2129		GO:0009059;GO:0016070	0	0.034482758620689655	5558;10635;5422;23649	1	5	16319	3	1	2	16318	16324	0.6707313317561487
299	M1	e019_M1	TRUE	1.6945985872890745e-5	33	4	3	0.75	0.09090909090909091	REAC:R-HSA-68962	REAC	Activation of the pre-replicative complex	10790	103		GO:0050789;GO:0006260	0	0.047619047619047616	1017;4999;8914;4998	1	33	10757	3	1	30	10756	10790	0.2604985636819362
312	M1	e019_M1	TRUE	0.0028604775096130477	170	4	3	0.75	0.01764705882352941	GO:0071674	GO:BP	mononuclear cell migration	16324	17797		GO:0002376	0	0.5	6362;7941;219972;1234	1	170	16154	3	1	167	16153	16324	0.11405665197304879
316	M1	e019_M1	TRUE	3.726742248204495e-7	76	4	4	1	0.05263157894736842	KEGG:05133	KEGG	Pertussis	8161	423		NA	0	0.14285714285714285	715;718;716;710	1	76	8085	4	0	72	8085	8161	0.22840098919623253
320	M1	e019_M1	TRUE	2.005483471312465e-6	16	4	3	0.75	0.1875	GO:0034375	GO:BP	high-density lipoprotein particle remodeling	16324	9049		GO:0016043;GO:0032501;GO:0006869	0	0.03333333333333333	348;717;341;5360	1	16	16308	3	1	13	16307	16324	0.37473951290104596
322	M1	e019_M1	TRUE	0.0019582640064970958	72	2	2	1	0.027777777777777776	KEGG:05140	KEGG	Leishmaniasis	8161	426		NA	0	0.16666666666666666	2215;55303;2212;8477	1	72	8089	2	0	70	8089	8161	0.1659501696644916
333	M1	e019_M1	TRUE	6.555739734996714e-4	18	3	2	0.6666666666666666	0.1111111111111111	KEGG:00061	KEGG	Fatty acid biosynthesis	8161	9		NA	0	0.3333333333333333	60314;51102;4913;27349	1	18	8143	2	1	16	8142	8161	0.2716146658101083
338	M1	e019_M1	TRUE	0.003567166359252922	97	2	2	1	0.020618556701030927	KEGG:03015	KEGG	mRNA surveillance pathway	8161	210		NA	0	0.5	26019;65109;56890;6787	1	97	8064	2	0	95	8064	8161	0.14275322346207808
342	M1	e019_M1	TRUE	2.3439704597545525e-8	7	3	3	1	0.42857142857142855	GO:0060602	GO:BP	branch elongation of an epithelium	16324	15624		GO:0040007;GO:0032501;GO:0032502;GO:0050789	0	0.0125	2246;2255;2263	1	7	16317	3	0	4	16317	16324	0.6545734435421479
343	M1	e019_M1	TRUE	3.750352735607291e-8	8	3	3	1	0.375	GO:1901750	GO:BP	leukotriene D4 biosynthetic process	16324	22705		GO:0006790;GO:0006082;GO:0006629;GO:0006518	0	0.08333333333333333	728226;92086;2678	1	8	16316	3	0	5	16316	16324	0.6122786272061902
357	M1	e019_M1	TRUE	1.732941826578732e-6	24	3	3	1	0.125	REAC:R-HSA-166208	REAC	mTORC1-mediated signalling	10790	2570		GO:0050896;GO:0050789;GO:0007154	0	0.02702702702702703	64121;10670;58528	1	24	10766	3	0	21	10766	10790	0.3532090762211297
362	M1	e019_M1	TRUE	7.211472910597762e-4	12	3	2	0.6666666666666666	0.16666666666666666	GO:0070914	GO:BP	UV-damage excision repair	16324	17305		NA	0	0.25	1643;2232;7508	1	12	16312	2	1	10	16311	16324	0.3331188392146641
363	M1	e019_M1	TRUE	6.120441723341945e-6	39	3	3	1	0.07692307692307693	GO:0036297	GO:BP	interstrand cross-link repair	16324	10071		NA	0	0.25	2177;2178;2176	1	39	16285	3	0	36	16285	16324	0.27704404715095354
370	M1	e019_M1	TRUE	0.0032983293230670952	47	2	2	1	0.0425531914893617	GO:0032968	GO:BP	positive regulation of transcription elongation by RNA polymerase II	16324	8380		GO:0050789	0	0.1111111111111111	51280;6837;55090	1	47	16277	2	0	45	16277	16324	0.20599968858975817
374	M1	e019_M1	TRUE	3.12873176968038e-4	142	3	3	1	0.02112676056338028	GO:0006941	GO:BP	striated muscle contraction	16324	2636		GO:0006936;GO:0050789	0	0.1111111111111111	1837;1756;287	1	142	16182	3	0	139	16182	16324	0.14473020298029016
394	M1	e019_M1	TRUE	7.199688332190912e-4	13	3	2	0.6666666666666666	0.15384615384615385	REAC:R-HSA-5357786	REAC	TNFR1-induced proapoptotic signaling	10790	2313		NA	0	0.08333333333333333	7132;10106;8717	1	13	10777	2	1	11	10776	10790	0.3199147590433374
407	M1	e019_M1	TRUE	0.002181994724869983	293	3	3	1	0.010238907849829351	KEGG:04060	KEGG	Cytokine-cytokine receptor interaction	8161	248		NA	0	0.5	6364;58191;3557	1	293	7868	3	0	290	7868	8161	0.09937271198144815
409	M1	e019_M1	TRUE	1.093093881260395e-5	2	3	2	0.6666666666666666	1	GO:0003366	GO:BP	cell-matrix adhesion involved in ameboidal cell migration	16324	1816		GO:0002376;GO:0007155	0	0.07142857142857142	101;3676;3695	1	2	16322	2	1	0	16321	16324	0.8164715683959474
410	M1	e019_M1	TRUE	1.4035765179986937e-4	118	3	3	1	0.025423728813559324	KEGG:04722	KEGG	Neurotrophin signaling pathway	8161	346		NA	0	0.16666666666666666	5580;6464;9261	1	118	8043	3	0	115	8043	8161	0.15832037415846728
418	M1	e019_M1	TRUE	0.0014856968785640606	17	3	2	0.6666666666666666	0.11764705882352941	GO:0032042	GO:BP	mitochondrial DNA metabolic process	16324	7733		GO:0006259	0	0.5	9361;51025;2021	1	17	16307	2	1	15	16306	16324	0.2797899601623404
437	M1	e019_M1	TRUE	4.8492404264792325e-4	15	2	2	1	0.13333333333333333	REAC:R-HSA-2214320	REAC	Anchoring fibril formation	10790	140		NA	0	0.07692307692307693	1287;1288	1	15	10775	2	0	13	10775	10790	0.36492829567099516
441	M1	e019_M1	TRUE	2.0137810853138635e-4	12	2	2	1	0.16666666666666666	GO:1904953	GO:BP	Wnt signaling pathway involved in midbrain dopaminergic neuron differentiation	16324	25411		GO:0032502;GO:0050789	0	0.06666666666666667	8321;7474	1	12	16312	2	0	10	16312	16324	0.4081232105594401
445	M1	e019_M1	TRUE	6.407485271453199e-4	21	2	2	1	0.09523809523809523	GO:0036010	GO:BP	protein localization to endosome	16324	9902		GO:0051641;GO:0050789	0	0.2	387680;253725	1	21	16303	2	0	19	16303	16324	0.3084270272527599
447	M1	e019_M1	TRUE	1.0984260465348315e-4	9	2	2	1	0.2222222222222222	GO:0000301	GO:BP	retrograde transport, vesicle recycling within Golgi	16324	92		GO:0016192	0	0.25	9382;25839	1	9	16315	2	0	7	16315	16324	0.47130342455526686
452	M1	e019_M1	TRUE	0.002032088186089442	37	2	2	1	0.05405405405405406	GO:0048704	GO:BP	embryonic skeletal system morphogenesis	16324	13701		GO:0032502	0	0.5	3214;3213	1	37	16287	2	0	35	16287	16324	0.2322458686618555
461	M1	e019_M1	TRUE	0.003641482325070705	98	2	2	1	0.02040816326530612	KEGG:04061	KEGG	Viral protein interaction with cytokine and cytokine receptor	8161	249		GO:0050789	0	0.16666666666666666	5473;5196	1	98	8063	2	0	96	8063	8161	0.1420142168930645
464	M1	e019_M1	TRUE	2.078245897062526e-4	10	2	2	1	0.2	REAC:R-HSA-1462054	REAC	Alpha-defensins	10790	127		NA	0	0.25	5646;5645	1	10	10780	2	0	8	10780	10790	0.4470477458389606
467	M1	e019_M1	TRUE	2.078245897062526e-4	10	2	2	1	0.2	REAC:R-HSA-111932	REAC	CaMK IV-mediated phosphorylation of CREB	10790	287		GO:0050789	0	0.019230769230769232	816;815	1	10	10780	2	0	8	10780	10790	0.4470477458389606
472	M1	e019_M1	TRUE	0.002482306487108999	81	2	2	1	0.024691358024691357	KEGG:04662	KEGG	B cell receptor signaling pathway	8161	333		NA	0	0.5	973;974	1	81	8080	2	0	79	8080	8161	0.1563722561404061
475	M1	e019_M1	TRUE	4.2026750362819963e-4	14	2	2	1	0.14285714285714285	REAC:R-HSA-354194	REAC	GRB2:SOS provides linkage to MAPK signaling for Integrins 	10790	970		NA	0	0.047619047619047616	3674;3690	1	14	10776	2	0	12	10776	10790	0.3777542006852982
481	M1	e019_M1	TRUE	4.1496095091316025e-4	17	2	2	1	0.11764705882352941	GO:0035720	GO:BP	intraciliary anterograde transport	16324	9697		GO:0051641;GO:0006810	0	0.3333333333333333	8100;23059	1	17	16307	2	0	15	16307	16324	0.3428395259963825
489	M1	e019_M1	TRUE	4.618324215694508e-6	2	2	2	1	1	REAC:R-HSA-176034	REAC	Interactions of Tat with host cellular proteins	10790	1162		GO:0050789;GO:0044419	0	0.047619047619047616	1025;904	1	2	10788	2	0	0	10788	10790	1
498	M1	e019_M1	TRUE	0.002008971033827106	30	2	2	1	0.06666666666666667	REAC:R-HSA-420029	REAC	Tight junction interactions	10790	2377		GO:0008150	0	0.16666666666666666	5584;56288	1	30	10760	2	0	28	10760	10790	0.25786359747544557
504	M1	e019_M1	TRUE	4.618324215694496e-5	5	2	2	1	0.4	REAC:R-HSA-446205	REAC	Synthesis of GDP-mannose	10790	2247		NA	0	0.16666666666666666	29926;29925	1	5	10785	2	0	3	10785	10790	0.6323675871633301
528	M1	e019_M1	TRUE	9.698480852958448e-5	7	2	2	1	0.2857142857142857	REAC:R-HSA-3371599	REAC	Defective HLCS causes multiple carboxylase deficiency	10790	546		NA	0	0.16666666666666666	56922;5095	1	7	10783	2	0	5	10783	10790	0.5343985997793754
538	M1	e019_M1	TRUE	1.678150904428219e-4	11	2	2	1	0.18181818181818182	GO:0034616	GO:BP	response to laminar fluid shear stress	16324	9152		GO:0050896;GO:0050789	0	0.07692307692307693	4092;4091	1	11	16313	2	0	9	16313	16324	0.42628385698342613
588	M1	e019_M1	TRUE	4.618324215694508e-6	2	2	2	1	1	REAC:R-HSA-191650	REAC	Regulation of gap junction activity	10790	1917		NA	0	0.2	7082;2697	1	2	10788	2	0	0	10788	10790	1
590	M1	e019_M1	TRUE	1.1722002855792488e-4	18	2	2	1	0.1111111111111111	KEGG:00511	KEGG	Other glycan degradation	8161	64		GO:0044255;GO:0006807	0	0.1	2629;3073	1	18	8143	2	0	16	8143	8161	0.33300633550273284
603	M1	e019_M1	TRUE	7.89733440883759e-4	19	2	2	1	0.10526315789473684	REAC:R-HSA-9694614	REAC	Attachment and Entry	10790	180		NA	0	0.5	10082;8829	1	19	10771	2	0	17	10771	10790	0.3241871089046003
623	M1	e019_M1	TRUE	0.0016110248682510936	33	2	2	1	0.06060606060606061	GO:0033260	GO:BP	nuclear DNA replication	16324	8538		GO:0006260	0	0.5	1763;29980	1	33	16291	2	0	31	16291	16324	0.2459490860037868
633	M1	e019_M1	TRUE	9.916346253439475e-4	26	2	2	1	0.07692307692307693	GO:0032743	GO:BP	positive regulation of interleukin-2 production	16324	8211		GO:0001816;GO:0050789	0	0.125	64581;729230	1	26	16298	2	0	24	16298	16324	0.2771461141932966
