module	monet_type	experiment_info	significant	p_value	term_size	query_size	intersection_size	precision	recall	term_id	source	term_name	effective_domain_size	source_order	parents	goslim_pir	perc_rank	cumelative_dist	genes	rank	P	N	tp	fp	fn	tn	tot_pop_valid	mcc
1	R1	e019_R1	TRUE	2.236291956613911e-21	163	25	15	0.6	0.0920245398773006	GO:0016482	GO:BP	cytosolic transport	16324	5359	NA	GO:0051641;GO:0016192	0	0.03846153846153846	-	1	163	16161	15	10	148	16151	16324	0.2324079751753559
2	R1	e019_R1	TRUE	4.490486697529842e-6	57	16	5	0.3125	0.08771929824561403	REAC:R-HSA-3371497	REAC	HSP90 chaperone cycle for steroid hormone receptors (SHR) in the presence of ligand	10790	1053	NA	GO:0051641;GO:0009057;GO:0016070;GO:0015931;GO:0050789	0	0.05	-	1	57	10733	5	11	52	10722	10790	0.1633204882280268
3	R1	e019_R1	TRUE	1.1650114865691452e-17	122	29	13	0.4482758620689655	0.10655737704918032	GO:0001936	GO:BP	regulation of endothelial cell proliferation	16324	565	NA	GO:0032502;GO:0050789;GO:0040011;GO:0008283	0	0.0099009900990099	-	1	122	16202	13	16	109	16186	16324	0.21591257175602369
4	R1	e019_R1	TRUE	9.333388865927246e-7	77	22	6	0.2727272727272727	0.07792207792207792	GO:0051453	GO:BP	regulation of intracellular pH	16324	14493	NA	GO:0050789;GO:0050896;GO:0065009	0	0.02222222222222222	-	1	77	16247	6	16	71	16231	16324	0.14369345942049083
5	R1	e019_R1	TRUE	2.190377735181657e-12	12	20	6	0.3	0.5	GO:1905907	GO:BP	negative regulation of amyloid fibril formation	16324	26232	NA	GO:0050789;GO:0019538;GO:0016043	0	0.07692307692307693	-	1	12	16312	6	14	6	16298	16324	0.3867283707797637
6	R1	e019_R1	TRUE	2.400118132595371e-23	100	17	13	0.7647058823529411	0.13	GO:0007605	GO:BP	sensory perception of sound	16324	3136	NA	GO:0032502;GO:0050877	0	0.02702702702702703	-	1	100	16224	13	4	87	16220	16324	0.31389644142740497
7	R1	e019_R1	TRUE	3.340171302127511e-23	9	27	9	0.3333333333333333	1	GO:0090522	GO:BP	vesicle tethering involved in exocytosis	16324	19367	NA	GO:0046903;GO:0061024;GO:0051640;GO:0016192;GO:0022406	0	0.02439024390243902	-	1	9	16315	9	18	0	16297	16324	0.5770316920265505
8	R1	e019_R1	TRUE	5.366648142069978e-26	35	22	13	0.5909090909090909	0.37142857142857144	REAC:R-HSA-5663213	REAC	RHO GTPases Activate WASPs and WAVEs	10790	1760	NA	GO:0006996	0	0.0217391304347826	-	1	35	10755	13	9	22	10746	10790	0.46714974295998385
9	R1	e019_R1	TRUE	7.783990727442596e-34	77	24	19	0.7916666666666666	0.24675324675324675	KEGG:05412	KEGG	Arrhythmogenic right ventricular cardiomyopathy	8161	483	NA	GO:0006811;GO:0015031;GO:0016192;GO:0007154;GO:0050789;GO:0065009	0	0.00775193798449612	-	1	77	8084	19	5	58	8079	8161	0.43943399707724096
10	R1	e019_R1	TRUE	5.199230561119847e-25	342	18	17	0.9444444444444444	0.04970760233918128	GO:0016055	GO:BP	Wnt signaling pathway	16324	5210	NA	GO:0032502;GO:0050789;GO:0007154	0	0.01219512195121951	-	1	342	15982	17	1	325	15981	16324	0.21423698073701536
11	R1	e019_R1	TRUE	1.3304066090331396e-30	15	23	12	0.5217391304347826	0.8	GO:1904507	GO:BP	positive regulation of telomere maintenance in response to DNA damage	16324	25027	NA	GO:0050789;GO:0051276;GO:0050896;GO:0006259	0	0.02083333333333333	-	1	15	16309	12	11	3	16298	16324	0.6456719744994194
12	R1	e019_R1	TRUE	3.302267651524557e-13	81	23	10	0.43478260869565216	0.12345679012345678	KEGG:04662	KEGG	B cell receptor signaling pathway	8161	333	NA	GO:0002376;GO:0050789	0	0.025	-	1	81	8080	10	13	71	8067	8161	0.2278470466998364
13	R1	e019_R1	TRUE	2.672824275493901e-23	19	32	11	0.34375	0.5789473684210527	GO:0042659	GO:BP	regulation of cell fate specification	16324	10850	NA	GO:0032502;GO:0050789;GO:0016043	0	0.02564102564102564	-	1	19	16305	11	21	8	16284	16324	0.44529402933575774
14	R1	e019_R1	TRUE	4.263875239333776e-32	31	21	14	0.6666666666666666	0.4516129032258064	GO:0099022	GO:BP	vesicle tethering	16324	20073	NA	GO:0016050;GO:0061024	0	0.04545454545454545	-	1	31	16293	14	7	17	16286	16324	0.548013115350418
15	R1	e019_R1	TRUE	6.680594300142552e-24	84	25	15	0.6	0.17857142857142858	REAC:R-HSA-216083	REAC	Integrin cell surface interactions	10790	1156	NA	GO:0050789;GO:0007155	0	0.03225806451612903	-	1	84	10706	15	10	69	10696	10790	0.32472115485562264
16	R1	e019_R1	TRUE	2.247003032853033e-23	34	14	11	0.7857142857142857	0.3235294117647059	KEGG:04710	KEGG	Circadian rhythm	8161	339	NA	GO:0050789;GO:0050896;GO:0048511	0	0.02631578947368421	-	1	34	8127	11	3	23	8124	8161	0.5029903779486863
17	R1	e019_R1	TRUE	2.361346102649246e-15	183	22	12	0.5454545454545454	0.06557377049180328	GO:0006457	GO:BP	protein folding	16324	2254	NA	GO:0050896;GO:0006457	0	0.06666666666666667	-	1	183	16141	12	10	171	16131	16324	0.1864088035075016
18	R1	e019_R1	TRUE	3.9188234697265685e-35	37	24	17	0.7083333333333334	0.4594594594594595	KEGG:05332	KEGG	Graft-versus-host disease	8161	480	NA	GO:0002376;GO:0050789;GO:0065003;GO:0001775	0	0.00775193798449612	-	1	37	8124	17	7	20	8117	8161	0.5689577554946946
19	R1	e019_R1	TRUE	6.261657973076754e-11	8	16	5	0.3125	0.625	REAC:R-HSA-8851805	REAC	MET activates RAS signaling	10790	1298	NA	NA	0	0.02777777777777777	-	1	8	10782	5	11	3	10771	10790	0.4413841134483552
20	R1	e019_R1	TRUE	3.683986619897366e-13	115	33	11	0.3333333333333333	0.09565217391304348	GO:0050852	GO:BP	T cell receptor signaling pathway	16324	14053	NA	GO:0002376;GO:0050789	0	0.02222222222222222	-	1	115	16209	11	22	104	16187	16324	0.17558378584722517
21	R1	e019_R1	TRUE	5.26464854143614e-23	10	19	9	0.47368421052631576	0.9	REAC:R-HSA-390450	REAC	Folding of actin by CCT/TriC	10790	897	NA	GO:0050789;GO:0051641;GO:0051234;GO:0006457	0	0.01388888888888888	-	1	10	10780	9	10	1	10770	10790	0.6525280895737788
22	R1	e019_R1	TRUE	3.2691779823006803e-34	516	28	26	0.9285714285714286	0.0503875968992248	GO:0006281	GO:BP	DNA repair	16324	2140	NA	GO:0002376;GO:0006266;GO:0006281	0	0.015625	-	1	516	15808	26	2	490	15806	16324	0.21250815255396704
23	R1	e019_R1	TRUE	2.1939563503302555e-6	28	3	3	1	0.10714285714285714	GO:0008535	GO:BP	respiratory chain complex IV assembly	16324	3264	NA	GO:0065003	0	0.07692307692307693	-	1	28	16296	3	0	25	16296	16324	0.327076044747781
24	R1	e019_R1	TRUE	9.011678225819052e-6	459	7	6	0.8571428571428571	0.0130718954248366	REAC:R-HSA-500792	REAC	GPCR ligand binding	10790	965	NA	GO:0050789	0	0.1	-	1	459	10331	6	1	453	10330	10790	0.10284173472001824
25	R1	e019_R1	TRUE	8.11050218812945e-20	32	11	9	0.8181818181818182	0.28125	REAC:R-HSA-352230	REAC	Amino acid transport across the plasma membrane	10790	135	NA	GO:0006865	0	0.02272727272727272	-	1	32	10758	9	2	23	10756	10790	0.4789173218098177
26	R1	e019_R1	TRUE	7.181089830253857e-23	52	29	13	0.4482758620689655	0.25	GO:1902476	GO:BP	chloride transmembrane transport	16324	23347	NA	GO:0006811;GO:0007033;GO:0065008;GO:0007154;GO:0022607	0	0.01724137931034482	-	1	52	16272	13	16	39	16256	16324	0.333214935550086
27	R1	e019_R1	TRUE	6.147248636034955e-19	31	15	9	0.6	0.2903225806451613	GO:0006506	GO:BP	GPI anchor biosynthetic process	16324	2284	NA	GO:0036211;GO:0044255;GO:0009059;GO:0006793	0	0.02702702702702703	-	1	31	16293	9	6	22	16287	16324	0.41663108522011955
28	R1	e019_R1	TRUE	4.9389685120239787e-14	8	17	6	0.35294117647058826	0.75	REAC:R-HSA-9017802	REAC	Noncanonical activation of NOTCH3	10790	1518	NA	GO:0006518;GO:0006508	0	0.0175438596491228	-	1	8	10782	6	11	2	10771	10790	0.5140104644086453
29	R1	e019_R1	TRUE	5.263132662500475e-23	295	22	17	0.7727272727272727	0.0576271186440678	GO:0016236	GO:BP	macroautophagy	16324	5303	NA	GO:0022411;GO:0007005;GO:0006914	0	0.025	-	1	295	16029	17	5	278	16024	16324	0.2081143988150931
30	R1	e019_R1	TRUE	2.7855053595766205e-15	10	23	7	0.30434782608695654	0.7	REAC:R-HSA-193697	REAC	p75NTR regulates axonogenesis	10790	2583	NA	GO:0050789;GO:0050896	0	0.01612903225806451	-	1	10	10780	7	16	3	10764	10790	0.46086563032899486
31	R1	e019_R1	TRUE	4.3403741185237365e-95	49	57	42	0.7368421052631579	0.8571428571428571	REAC:R-HSA-1236978	REAC	Cross-presentation of soluble exogenous antigens (endosomes)	10790	395	NA	GO:0006508;GO:0009057	0	0.00609756097560975	-	1	49	10741	42	15	7	10726	10790	0.7937202412203518
32	R1	e019_R1	TRUE	2.1274878774135098e-13	16	10	6	0.6	0.375	REAC:R-HSA-180292	REAC	GAB1 signalosome	10790	955	NA	GO:0050789;GO:0065009	0	0.01123595505617977	-	1	16	10774	6	4	10	10770	10790	0.47374013919967006
33	R1	e019_R1	TRUE	3.1211410335277176e-16	91	18	11	0.6111111111111112	0.12087912087912088	KEGG:04657	KEGG	IL-17 signaling pathway	8161	329	NA	GO:0050789;GO:0050896	0	0.09090909090909093	-	1	91	8070	11	7	80	8063	8161	0.26862882970205215
34	R1	e019_R1	TRUE	1.1264007233348115e-205	93	88	87	0.9886363636363636	0.935483870967742	REAC:R-HSA-5368287	REAC	Mitochondrial translation	10790	1394	NA	GO:0006412	0	0.07692307692307693	-	1	93	10697	87	1	6	10696	10790	0.9613722123340288
35	R1	e019_R1	TRUE	2.485510367163237e-34	33	17	15	0.8823529411764706	0.4545454545454546	KEGG:04130	KEGG	SNARE interactions in vesicular transport	8161	267	NA	GO:0006836;GO:0046903;GO:0016050;GO:0048284;GO:0061024;GO:0065008;GO:0051640;GO:0016192;GO:0022406	0	0.0108695652173913	-	1	33	8128	15	2	18	8126	8161	0.6323355948211181
36	R1	e019_R1	TRUE	0.0010418756204544	195	3	3	1	0.01538461538461538	REAC:R-HSA-375276	REAC	Peptide ligand-binding receptors	10790	1636	NA	GO:0008015	0	0.16666666666666666	-	1	195	10595	3	0	192	10595	10790	0.12292591873256624
37	R1	e019_R1	TRUE	5.495992295191477e-32	132	30	21	0.7	0.1590909090909091	REAC:R-HSA-5693567	REAC	HDR through Homologous Recombination (HRR) or Single Strand Annealing (SSA)	10790	1040	NA	GO:0050789;GO:0006260;GO:0006281;GO:0065009	0	0.00819672131147541	-	1	132	10658	21	9	111	10649	10790	0.33036353132326807
38	R1	e019_R1	TRUE	1.2081208296393006e-16	116	26	12	0.4615384615384616	0.10344827586206896	GO:0001508	GO:BP	action potential	16324	337	NA	GO:0006811;GO:0065008;GO:0006936;GO:0007154;GO:0050789;GO:0008015	0	0.01149425287356321	-	1	116	16208	12	14	104	16194	16324	0.21608351936222817
40	R1	e019_R1	TRUE	1.7618904089363015e-24	212	20	17	0.85	0.08018867924528301	REAC:R-HSA-416476	REAC	G alpha (q) signalling events	10790	934	NA	GO:0065008;GO:0050789;GO:0006936;GO:0065009	0	0.008	-	1	212	10578	17	3	195	10575	10790	0.2578227332572414
41	R1	e019_R1	TRUE	6.352834718297533e-41	41	39	21	0.5384615384615384	0.5121951219512195	REAC:R-HSA-383280	REAC	Nuclear Receptor transcription pathway	10790	1530	NA	GO:0006351;GO:0007154;GO:0048511;GO:0050789;GO:0050896	0	0.00862068965517241	-	1	41	10749	21	18	20	10731	10790	0.5233984735723384
42	R1	e019_R1	TRUE	6.099389160212e-6	6	12	3	0.25	0.5	REAC:R-HSA-8937144	REAC	Aryl hydrocarbon receptor signalling	10790	162	NA	GO:0050789;GO:0050896	0	0.14285714285714285	-	1	6	10784	3	9	3	10775	10790	0.3530614924863559
43	R1	e019_R1	TRUE	5.404985131148763e-7	14	14	4	0.2857142857142857	0.2857142857142857	REAC:R-HSA-1170546	REAC	Prolactin receptor signaling	10790	1715	NA	GO:0050789	0	0.03703703703703703	-	1	14	10776	4	10	10	10766	10790	0.28478629759253365
44	R1	e019_R1	TRUE	9.043480166319929e-20	76	34	14	0.4117647058823529	0.18421052631578944	REAC:R-HSA-438064	REAC	Post NMDA receptor activation events	10790	1682	NA	GO:0006811;GO:0065008;GO:0051276;GO:0050789;GO:0032501;GO:0065009	0	0.00510204081632653	-	1	76	10714	14	20	62	10694	10790	0.272087622950133
45	R1	e019_R1	TRUE	5.2904171424897216e-20	297	23	17	0.7391304347826086	0.05723905723905724	REAC:R-HSA-5688426	REAC	Deubiquitination	10790	702	NA	GO:0036211;GO:0006508;GO:0009057	0	0.00392156862745098	-	1	297	10493	17	6	280	10487	10790	0.2010244601112987
46	R1	e019_R1	TRUE	2.0409706648453377e-123	291	85	76	0.8941176470588236	0.2611683848797251	GO:0000375	GO:BP	RNA splicing, via transesterification reactions	16324	112	NA	GO:0000375	0	0.03571428571428571	-	1	291	16033	76	9	215	16024	16324	0.479127319723094
47	R1	e019_R1	TRUE	2.842980687344629e-7	28	19	5	0.2631578947368421	0.17857142857142858	REAC:R-HSA-525793	REAC	Myogenesis	10790	1423	NA	GO:0032502;GO:0050789;GO:0009059	0	0.03571428571428571	-	1	28	10762	5	14	23	10748	10790	0.215108365754289
48	R1	e019_R1	TRUE	1.2694955934863775e-16	10	16	7	0.4375	0.7	REAC:R-HSA-111932	REAC	CaMK IV-mediated phosphorylation of CREB	10790	287	NA	GO:0036211;GO:0050789;GO:0006793	0	0.01204819277108433	-	1	10	10780	7	9	3	10771	10790	0.5528924479944121
49	R1	e019_R1	TRUE	1.19873827527704e-8	250	16	9	0.5625	0.036	KEGG:04144	KEGG	Endocytosis	8161	275	NA	GO:0065008;GO:0051641;GO:0050789;GO:0016192	0	0.0588235294117647	-	1	250	7911	9	7	241	7904	8161	0.13679643024300284
50	R1	e019_R1	TRUE	1.525916318262086e-34	107	25	19	0.76	0.17757009345794392	GO:0036503	GO:BP	ERAD pathway	16324	10171	NA	GO:0050896;GO:0006508;GO:0015031;GO:0009057	0	0.01587301587301587	-	1	107	16217	19	6	88	16211	16324	0.3656711128135933
51	R1	e019_R1	TRUE	2.1000539284543574e-25	33	21	12	0.5714285714285714	0.3636363636363637	GO:0042554	GO:BP	superoxide anion generation	16324	10820	NA	GO:0008152	0	0.02631578947368421	-	1	33	16291	12	9	21	16282	16324	0.4549822304640864
52	R1	e019_R1	TRUE	6.443357112434327e-8	35	31	6	0.1935483870967742	0.17142857142857143	GO:0032355	GO:BP	response to estradiol	16324	7934	NA	GO:0050789;GO:0050896	0	0.05263157894736842	-	1	35	16289	6	25	29	16264	16324	0.18050006866516227
53	R1	e019_R1	TRUE	6.77350168129352e-16	84	22	11	0.5	0.13095238095238096	REAC:R-HSA-216083	REAC	Integrin cell surface interactions	10790	1156	NA	GO:0050789;GO:0007155	0	0.02857142857142857	-	1	84	10706	11	11	73	10695	10790	0.25314354395413113
54	R1	e019_R1	TRUE	1.4653650227686512e-35	27	45	17	0.37777777777777777	0.6296296296296297	GO:2000819	GO:BP	regulation of nucleotide-excision repair	16324	27358	NA	GO:0032502;GO:0050789;GO:0006281;GO:0016043	0	0.00892857142857142	-	1	27	16297	17	28	10	16269	16324	0.4866469980306767
55	R1	e019_R1	TRUE	1.1594384605309847e-9	28	21	6	0.2857142857142857	0.21428571428571427	GO:0050901	GO:BP	leukocyte tethering or rolling	16324	14096	NA	GO:0002376;GO:0007155	0	0.05555555555555555	-	1	28	16296	6	15	22	16281	16324	0.2463200628550825
56	R1	e019_R1	TRUE	1.7200794272930186e-32	15	49	14	0.2857142857142857	0.9333333333333332	GO:0099116	GO:BP	tRNA 5'-end processing	16324	20109	NA	GO:0050789;GO:0006396;GO:0009057	0	0.00952380952380952	-	1	15	16309	14	35	1	16274	16324	0.515748284029742
57	R1	e019_R1	TRUE	6.423146315250954e-30	42	23	15	0.6521739130434783	0.35714285714285715	REAC:R-HSA-75893	REAC	TNF signaling	10790	2311	NA	GO:0036211;GO:0006508;GO:0002376;GO:0050789;GO:0050896	0	0.01388888888888888	-	1	42	10748	15	8	27	10740	10790	0.4811861370150577
58	R1	e019_R1	TRUE	4.9095216847677965e-29	9	10	9	0.9	1	GO:0000301	GO:BP	retrograde transport, vesicle recycling within Golgi	16324	92	NA	GO:0016192	0	0.07142857142857142	-	1	9	16315	9	1	0	16314	16324	0.9486542236455038
59	R1	e019_R1	TRUE	2.427378970854913e-26	208	25	18	0.72	0.08653846153846154	GO:0006470	GO:BP	protein dephosphorylation	16324	2260	NA	GO:0036211;GO:0050789;GO:0006793	0	0.00787401574803149	-	1	208	16116	18	7	190	16109	16324	0.2469640267215749
60	R1	e019_R1	TRUE	9.718323507372413e-9	17	17	5	0.29411764705882354	0.29411764705882354	REAC:R-HSA-1810476	REAC	RIP-mediated NFkB activation via ZBP1	10790	1784	NA	GO:0050789	0	0.01388888888888888	-	1	17	10773	5	12	12	10761	10790	0.2930037512080856
61	R1	e019_R1	TRUE	9.498781523220776e-60	294	45	39	0.8666666666666667	0.1326530612244898	GO:0007178	GO:BP	transmembrane receptor protein serine/threonine kinase signaling pathway	16324	2803	NA	GO:0036211;GO:0006793;GO:0032502;GO:0050789;GO:0032501;GO:0050896	0	0.00490196078431372	-	1	294	16030	39	6	255	16024	16324	0.3355138349021767
62	R1	e019_R1	TRUE	8.515935440597529e-34	28	22	15	0.6818181818181818	0.5357142857142857	REAC:R-HSA-3928663	REAC	EPHA-mediated growth cone collapse	10790	782	NA	GO:0032989;GO:0050789	0	0.01694915254237288	-	1	28	10762	15	7	13	10755	10790	0.6034652337524175
63	R1	e019_R1	TRUE	1.8621211030434822e-38	24	54	18	0.3333333333333333	0.75	GO:0031145	GO:BP	anaphase-promoting complex-dependent catabolic process	16324	7447	NA	GO:0000280;GO:0007049;GO:0009057;GO:0036211;GO:0051276;GO:0006508;GO:0050789;GO:0007059	0	0.0062111801242236	-	1	24	16300	18	36	6	16264	16324	0.4989870093399849
65	R1	e019_R1	TRUE	3.35629781603026e-5	68	3	3	1	0.04411764705882353	GO:0045109	GO:BP	intermediate filament organization	16324	11970	NA	GO:0006996	0	0.08333333333333333	-	1	68	16256	3	0	65	16256	16324	0.20962333877007264
66	R1	e019_R1	TRUE	4.9345657652627085e-31	61	25	16	0.64	0.26229508196721313	GO:0008543	GO:BP	fibroblast growth factor receptor signaling pathway	16324	3266	NA	GO:0032502;GO:0050789;GO:0050896	0	0.0079365079365079309	-	1	61	16263	16	9	45	16254	16324	0.4084017999508575
67	R1	e019_R1	TRUE	2.147108800983141e-46	65	24	22	0.9166666666666666	0.3384615384615385	REAC:R-HSA-1268020	REAC	Mitochondrial protein import	10790	1390	NA	GO:0007005;GO:0015031	0	0.03846153846153846	-	1	65	10725	22	2	43	10723	10790	0.5556387142523397
68	R1	e019_R1	TRUE	5.0401780836350315e-62	55	28	27	0.9642857142857144	0.4909090909090909	REAC:R-HSA-9639288	REAC	Amino acids regulate mTORC1	10790	136	NA	GO:0050789;GO:0050896;GO:0007154	0	0.01923076923076923	-	1	55	10735	27	1	28	10734	10790	0.6870297069289277
69	R1	e019_R1	TRUE	2.893624987109099e-10	11	16	5	0.3125	0.4545454545454546	GO:0051256	GO:BP	mitotic spindle midzone assembly	16324	14372	NA	GO:0050789;GO:0022607	0	0.01063829787234042	-	1	11	16313	5	11	6	16302	16324	0.37638775997434915
70	R1	e019_R1	TRUE	6.015069914815543e-7	293	26	9	0.34615384615384615	0.03071672354948805	GO:0031589	GO:BP	cell-substrate adhesion	16324	7637	NA	GO:0022607;GO:0007155	0	0.0303030303030303	-	1	293	16031	9	17	284	16014	16324	0.09873631919053089
71	R1	e019_R1	TRUE	1.4789177623320483e-16	49	21	10	0.47619047619047616	0.20408163265306123	REAC:R-HSA-373752	REAC	Netrin-1 signaling	10790	1500	NA	GO:0032989	0	0.04545454545454545	-	1	49	10741	10	11	39	10730	10790	0.30977198520295046
72	R1	e019_R1	TRUE	2.037300665041971e-28	292	30	23	0.7666666666666667	0.07876712328767123	REAC:R-HSA-72766	REAC	Translation	10790	2429	NA	GO:0016070;GO:0006412;GO:0006520;GO:0015031	0	0.02941176470588235	-	1	292	10498	23	7	269	10491	10790	0.24067490756081827
73	R1	e019_R1	TRUE	3.339282896480899e-20	11	14	8	0.5714285714285714	0.7272727272727273	REAC:R-HSA-8847993	REAC	ERBB2 Activates PTK6 Signaling	10790	787	NA	GO:0036211;GO:0050789;GO:0006793	0	0.01587301587301587	-	1	11	10779	8	6	3	10773	10790	0.64425462482682
74	R1	e019_R1	TRUE	7.009460826079889e-8	36	12	5	0.4166666666666667	0.1388888888888889	REAC:R-HSA-8939243	REAC	RUNX1 interacts with co-factors whose precise effect on RUNX1 targets is not known	10790	1823	NA	GO:0036211;GO:0050789	0	0.07692307692307693	-	1	36	10754	5	7	31	10747	10790	0.2391684539321159
75	R1	e019_R1	TRUE	6.70886025800106e-15	23	21	8	0.380952380952381	0.34782608695652173	REAC:R-HSA-8949215	REAC	Mitochondrial calcium ion transport	10790	1388	NA	GO:0006793;GO:0002376;GO:0007005;GO:0050789;GO:0050896	0	0.02127659574468085	-	1	23	10767	8	13	15	10754	10790	0.36271533754596247
76	R1	e019_R1	TRUE	3.853194543811094e-9	27	4	4	1	0.14814814814814814	GO:0046856	GO:BP	phosphatidylinositol dephosphorylation	16324	13124	NA	GO:0044255;GO:0006793	0	0.06666666666666667	-	1	27	16297	4	0	23	16297	16324	0.3846288612800098
77	R1	e019_R1	TRUE	4.99813673559817e-35	39	26	17	0.6538461538461539	0.4358974358974359	REAC:R-HSA-140877	REAC	Formation of Fibrin Clot (Clotting Cascade)	10790	899	NA	GO:0050789;GO:0050896;GO:0050878;GO:0050817	0	0.0196078431372549	-	1	39	10751	17	9	22	10742	10790	0.5325160174311262
78	R1	e019_R1	TRUE	3.055100199122017e-39	43	17	17	1	0.3953488372093023	KEGG:03022	KEGG	Basal transcription factors	8161	213	NA	GO:0006354	0	0.01515151515151515	-	1	43	8118	17	0	26	8118	8161	0.6277632296128597
79	R1	e019_R1	TRUE	6.806678891300902e-150	103	72	70	0.9722222222222222	0.6796116504854369	REAC:R-HSA-611105	REAC	Respiratory electron transport	10790	1963	NA	GO:0065003;GO:0022900;GO:0006119	0	0.01470588235294117	-	1	103	10687	70	2	33	10685	10790	0.8114552988053446
80	R1	e019_R1	TRUE	6.153324280363093e-5	83	3	3	1	0.03614457831325301	GO:0006821	GO:BP	chloride transport	16324	2554	NA	GO:0006811	0	0.3333333333333333	-	1	83	16241	3	0	80	16241	16324	0.1896507576143733
81	R1	e019_R1	TRUE	5.117746206707755e-54	44	29	23	0.7931034482758621	0.5227272727272727	GO:0042073	GO:BP	intraciliary transport	16324	10523	NA	GO:0051641;GO:0006810	0	0.04545454545454545	-	1	44	16280	23	6	21	16274	16324	0.6431262084120468
82	R1	e019_R1	TRUE	2.7507495013062286e-75	34	38	31	0.8157894736842105	0.9117647058823528	KEGG:03020	KEGG	RNA polymerase	8161	212	NA	GO:0006351;GO:0050789;GO:0032502;GO:0006354	0	0.00854700854700854	-	1	34	8127	31	7	3	8120	8161	0.8618404563053172
83	R1	e019_R1	TRUE	2.6149047822458476e-18	23	22	9	0.4090909090909091	0.391304347826087	GO:0042744	GO:BP	hydrogen peroxide catabolic process	16324	10914	NA	GO:0065003;GO:0008152;GO:0006869;GO:0015669;GO:0050789;GO:0032501	0	0.01818181818181818	-	1	23	16301	9	13	14	16288	16324	0.399271134778463
84	R1	e019_R1	TRUE	7.727837143554942e-20	35	16	10	0.625	0.2857142857142857	REAC:R-HSA-5663213	REAC	RHO GTPases Activate WASPs and WAVEs	10790	1760	NA	GO:0050789;GO:0016043	0	0.01492537313432835	-	1	35	10755	10	6	25	10749	10790	0.4213799667018039
85	R1	e019_R1	TRUE	3.786345803512217e-36	33	19	16	0.8421052631578947	0.48484848484848486	KEGG:04130	KEGG	SNARE interactions in vesicular transport	8161	267	NA	GO:0016192;GO:0061024;GO:0048284;GO:0016050	0	0.02857142857142857	-	1	33	8128	16	3	17	8125	8161	0.6379428509362829
86	R1	e019_R1	TRUE	5.023110723287713e-11	11	11	5	0.4545454545454546	0.4545454545454546	REAC:R-HSA-446107	REAC	Type I hemidesmosome assembly	10790	2474	NA	GO:0050789;GO:0022607	0	0.03846153846153846	-	1	11	10779	5	6	6	10773	10790	0.45398881663841306
87	R1	e019_R1	TRUE	4.7546191680020124e-20	174	34	16	0.4705882352941176	0.09195402298850576	GO:0007179	GO:BP	transforming growth factor beta receptor signaling pathway	16324	2804	NA	GO:0051641;GO:0016050;GO:0048284;GO:0065003;GO:0061024;GO:0036211;GO:0006793;GO:0016192;GO:0050789;GO:0050896	0	0.008	-	1	174	16150	16	18	158	16132	16324	0.20461406695151357
88	R1	e019_R1	TRUE	6.045326063214911e-13	210	16	11	0.6875	0.05238095238095238	KEGG:04015	KEGG	Rap1 signaling pathway	8161	243	NA	GO:0050789	0	0.01052631578947368	-	1	210	7951	11	5	199	7946	8161	0.18524349716512736
89	R1	e019_R1	TRUE	3.414813288232755e-5	89	17	5	0.29411764705882354	0.05617977528089887	GO:0010717	GO:BP	regulation of epithelial to mesenchymal transition	16324	4442	NA	GO:0032502;GO:0050789;GO:0050896	0	0.1111111111111111	-	1	89	16235	5	12	84	16223	16324	0.12657205219529533
90	R1	e019_R1	TRUE	1.1304788313226641e-13	160	14	10	0.7142857142857143	0.0625	REAC:R-HSA-5633007	REAC	Regulation of TP53 Activity	10790	1901	NA	GO:0050789	0	0.05555555555555555	-	1	160	10630	10	4	150	10626	10790	0.20858889025904823
91	R1	e019_R1	TRUE	1.4758456025087048e-97	59	42	41	0.9761904761904762	0.6949152542372882	REAC:R-HSA-6790901	REAC	rRNA modification in the nucleus and cytosol	10790	2590	NA	GO:0042254;GO:0006396	0	0.02857142857142857	-	1	59	10731	41	1	18	10730	10790	0.8228700044727599
92	R1	e019_R1	TRUE	4.952473788334902e-13	20	23	7	0.30434782608695654	0.35	GO:0043567	GO:BP	regulation of insulin-like growth factor receptor signaling pathway	16324	11367	NA	GO:0050789;GO:0050896	0	0.015625	-	1	20	16304	7	16	13	16288	16324	0.3254915125454465
93	R1	e019_R1	TRUE	3.7503527356072867e-7	16	3	3	1	0.1875	GO:0080009	GO:BP	mRNA methylation	16324	18762	NA	GO:0006396;GO:0043412	0	0.07692307692307693	-	1	16	16308	3	0	13	16308	16324	0.4328402159383365
94	R1	e019_R1	TRUE	3.2169059940979296e-33	39	39	17	0.4358974358974359	0.4358974358974359	GO:0000387	GO:BP	spliceosomal snRNP assembly	16324	119	NA	GO:0000375;GO:0065003	0	0.0303030303030303	-	1	39	16285	17	22	22	16263	16324	0.434546499452855
95	R1	e019_R1	TRUE	1.0730347089911549e-8	70	13	6	0.4615384615384616	0.08571428571428572	GO:0007260	GO:BP	tyrosine phosphorylation of STAT protein	16324	2859	NA	GO:0036211;GO:0006793;GO:0032502;GO:0050789;GO:0050896	0	0.02	-	1	70	16254	6	7	64	16247	16324	0.1975526304627208
96	R1	e019_R1	TRUE	9.3227675801503e-27	144	25	18	0.72	0.125	REAC:R-HSA-8856828	REAC	Clathrin-mediated endocytosis	10790	357	NA	GO:0016192	0	0.04347826086956521	-	1	144	10646	18	7	126	10639	10790	0.29676792958202913
97	R1	e019_R1	TRUE	6.878996244827388e-18	109	31	13	0.41935483870967744	0.11926605504587157	GO:0007219	GO:BP	Notch signaling pathway	16324	2840	NA	GO:0050789;GO:0048771;GO:0007154	0	0.01515151515151515	-	1	109	16215	13	18	96	16197	16324	0.22102735483292352
98	R1	e019_R1	TRUE	1.1830857863381263e-34	30	23	16	0.6956521739130435	0.5333333333333333	KEGG:00020	KEGG	Citrate cycle (TCA cycle)	8161	3	NA	GO:0006082;GO:0045333;GO:0006790;GO:0043603;GO:0009117	0	0.0144927536231884	-	1	30	8131	16	7	14	8124	8161	0.607864769985449
99	R1	e019_R1	TRUE	3.421632997643195e-20	51	22	12	0.5454545454545454	0.2352941176470588	KEGG:04979	KEGG	Cholesterol metabolism	8161	403	NA	GO:0006869;GO:0044255;GO:0016043;GO:0050789;GO:0032501	0	0.01098901098901099	-	1	51	8110	12	10	39	8100	8161	0.35573601875428024
101	R1	e019_R1	TRUE	6.827323665727093e-13	18	5	5	1	0.2777777777777778	GO:0070525	GO:BP	tRNA threonylcarbamoyladenosine metabolic process	16324	17096	NA	GO:0006396;GO:0043412	0	0.125	-	1	18	16306	5	0	13	16306	16324	0.5268363077423696
102	R1	e019_R1	TRUE	2.922849550346544e-4	128	3	3	1	0.0234375	REAC:R-HSA-6809371	REAC	Formation of the cornified envelope	10790	919	NA	NA	0	0.3333333333333333	-	1	128	10662	3	0	125	10662	10790	0.15220350101048255
103	R1	e019_R1	TRUE	1.8585517581919639e-10	268	14	9	0.6428571428571429	0.0335820895522388	GO:0006887	GO:BP	exocytosis	16324	2599	NA	GO:0050789;GO:0046903;GO:0016192	0	0.04761904761904761	-	1	268	16056	9	5	259	16051	16324	0.14442977974666962
104	R1	e019_R1	TRUE	3.058462557262793e-56	145	37	31	0.8378378378378378	0.21379310344827587	GO:0006261	GO:BP	DNA-templated DNA replication	16324	2123	NA	GO:0032392;GO:0050789;GO:0006260;GO:0006281	0	0.01515151515151515	-	1	145	16179	31	6	114	16173	16324	0.4210931020800052
105	R1	e019_R1	TRUE	1.9372156863286907e-54	108	35	31	0.8857142857142857	0.28703703703703703	KEGG:03013	KEGG	Nucleocytoplasmic transport	8161	209	NA	GO:0015931;GO:0051641;GO:0006997	0	0.00980392156862745	-	1	108	8053	31	4	77	8049	8161	0.5010765163541097
106	R1	e019_R1	TRUE	1.3797546905016195e-11	65	18	8	0.4444444444444444	0.12307692307692308	REAC:R-HSA-5334118	REAC	DNA methylation	10790	426	NA	GO:0065003;GO:0006304	0	0.01724137931034482	-	1	65	10725	8	10	57	10715	10790	0.23160338291659607
107	R1	e019_R1	TRUE	6.672881496846604e-19	610	30	20	0.6666666666666666	0.03278688524590164	GO:0016567	GO:BP	protein ubiquitination	16324	5381	NA	GO:0036211;GO:0006508;GO:0009057	0	0.05263157894736842	-	1	610	15714	20	10	590	15704	16324	0.1423710459214014
108	R1	e019_R1	TRUE	3.4247862185350303e-9	4	3	3	1	0.75	REAC:R-HSA-204626	REAC	Hypusine synthesis from eIF5A-lysine	10790	1081	NA	NA	0	0.5	-	1	4	10786	3	0	1	10786	10790	0.8659852607661871
109	R1	e019_R1	TRUE	3.8840904054960975e-9	93	17	7	0.4117647058823529	0.07526881720430108	GO:0006497	GO:BP	protein lipidation	16324	2278	NA	GO:0036211;GO:0009059;GO:0006914	0	0.03448275862068965	-	1	93	16231	7	10	86	16221	16324	0.17420002284847275
110	R1	e019_R1	TRUE	1.0088334166578875e-30	277	33	23	0.696969696969697	0.08303249097472924	GO:0006310	GO:BP	DNA recombination	16324	2162	NA	GO:0000003;GO:0000280;GO:0007049;GO:0006281	0	0.01098901098901099	-	1	277	16047	23	10	254	16037	16324	0.23696396481211257
111	R1	e019_R1	TRUE	6.252360642728414e-75	134	41	41	1	0.30597014925373134	KEGG:00190	KEGG	Oxidative phosphorylation	8161	18	NA	GO:1902600;GO:0009117;GO:0065007	0	0.00943396226415094	-	1	134	8027	41	0	93	8027	8161	0.5499689185194029
112	R1	e019_R1	TRUE	1.0231439325788767e-7	49	11	5	0.4545454545454546	0.1020408163265306	GO:0031146	GO:BP	SCF-dependent proteasomal ubiquitin-dependent protein catabolic process	16324	7448	NA	GO:0006508;GO:0009057	0	0.04347826086956521	-	1	49	16275	5	6	44	16269	16324	0.2143370736839492
113	R1	e019_R1	TRUE	1.878428154158982e-21	196	27	16	0.5925925925925926	0.08163265306122448	GO:0051403	GO:BP	stress-activated MAPK cascade	16324	14472	NA	GO:0050789;GO:0050896;GO:0065009	0	0.01052631578947368	-	1	196	16128	16	11	180	16117	16324	0.21697150466033716
115	R1	e019_R1	TRUE	5.535896369035385e-36	166	28	24	0.8571428571428571	0.14457831325301204	KEGG:04630	KEGG	JAK-STAT signaling pathway	8161	326	NA	GO:0050789;GO:0036211;GO:0001816;GO:0006793;GO:0002376;GO:0008283;GO:0050896;GO:0001775	0	0.00429184549356223	-	1	166	7995	24	4	142	7991	8161	0.34782160050639105
116	R1	e019_R1	TRUE	1.6929006899689335e-40	24	15	15	1	0.625	REAC:R-HSA-912694	REAC	Regulation of IFNA/IFNB signaling	10790	1879	NA	GO:0036211;GO:0006793;GO:0002376;GO:0001775;GO:0050789;GO:0050896;GO:0044419	0	0.01162790697674418	-	1	24	10766	15	0	9	10766	10790	0.7902391778674724
117	R1	e019_R1	TRUE	7.018619357472081e-18	42	19	10	0.5263157894736842	0.23809523809523808	REAC:R-HSA-5675221	REAC	Negative regulation of MAPK pathway	10790	1488	NA	GO:0065008;GO:0050789;GO:0051258;GO:0051261	0	0.00602409638554216	-	1	42	10748	10	9	32	10739	10790	0.3523743545122019
118	R1	e019_R1	TRUE	1.388042651574436e-17	234	21	15	0.7142857142857143	0.0641025641025641	KEGG:04014	KEGG	Ras signaling pathway	8161	242	NA	GO:0006351;GO:0050789;GO:0044255;GO:0006793	0	0.0040650406504065	-	1	234	7927	15	6	219	7921	8161	0.20866872147194335
119	R1	e019_R1	TRUE	2.341698072060925e-17	23	22	9	0.4090909090909091	0.391304347826087	REAC:R-HSA-5620922	REAC	BBSome-mediated cargo-targeting to cilium	10790	192	NA	GO:0022607;GO:0051641;GO:0016192;GO:0006996	0	0.02702702702702703	-	1	23	10767	9	13	14	10754	10790	0.3988457520076687
121	R1	e019_R1	TRUE	4.810472510202634e-17	11	15	7	0.4666666666666667	0.6363636363636364	GO:0044571	GO:BP	[2Fe-2S] cluster assembly	16324	11743	NA	GO:0022607;GO:0006790	0	0.05	-	1	11	16313	7	8	4	16305	16324	0.5445960743880061
122	R1	e019_R1	TRUE	1.154449708750919e-41	100	24	21	0.875	0.21	GO:0007006	GO:BP	mitochondrial membrane organization	16324	2677	NA	GO:0061024;GO:0007005;GO:0015031	0	0.02631578947368421	-	1	100	16224	21	3	79	16221	16324	0.427283638169392
123	R1	e019_R1	TRUE	1.0560289831040249e-19	12	8	7	0.875	0.5833333333333334	GO:0006388	GO:BP	tRNA splicing, via endonucleolytic cleavage and ligation	16324	2202	NA	GO:0006396	0	0.1111111111111111	-	1	12	16312	7	1	5	16311	16324	0.714271854988081
124	R1	e019_R1	TRUE	1.7109973786200983e-10	53	19	7	0.3684210526315789	0.1320754716981132	GO:0006879	GO:BP	intracellular iron ion homeostasis	16324	2591	NA	GO:0002376;GO:0006811;GO:0050789	0	0.01694915254237288	-	1	53	16271	7	12	46	16259	16324	0.2191281299099268
125	R1	e019_R1	TRUE	6.43900437579601e-22	456	33	21	0.6363636363636364	0.04605263157894736	GO:0097190	GO:BP	apoptotic signaling pathway	16324	19569	NA	GO:0061024;GO:0065008;GO:0007005;GO:0050789;GO:0050896	0	0.0091743119266055	-	1	456	15868	21	12	435	15856	16324	0.1661790575957611
126	R1	e019_R1	TRUE	2.379071856680018e-21	17	30	10	0.3333333333333333	0.5882352941176471	GO:0006474	GO:BP	N-terminal protein amino acid acetylation	16324	2262	NA	GO:0036211;GO:0051604	0	0.04545454545454545	-	1	17	16307	10	20	7	16287	16324	0.4420604330600399
127	R1	e019_R1	TRUE	2.2407546746596652e-20	16	21	9	0.42857142857142855	0.5625	GO:0033275	GO:BP	actin-myosin filament sliding	16324	8544	NA	GO:0032502;GO:0006936	0	0.01785714285714285	-	1	16	16308	9	12	7	16296	16324	0.49042315057428904
128	R1	e019_R1	TRUE	1.2846171208862668e-48	111	33	26	0.7878787878787878	0.23423423423423423	GO:0006413	GO:BP	translational initiation	16324	2222	NA	GO:0065003;GO:0006412	0	0.01886792452830188	-	1	111	16213	26	7	85	16206	16324	0.427771115336712
129	R1	e019_R1	TRUE	4.820768522161321e-28	166	17	17	1	0.10240963855421686	KEGG:04630	KEGG	JAK-STAT signaling pathway	8161	326	NA	GO:0050789;GO:0050896	0	0.0131578947368421	-	1	166	7995	17	0	149	7995	8161	0.3170740998625632
130	R1	e019_R1	TRUE	4.924445518654628e-22	166	21	16	0.7619047619047619	0.0963855421686747	KEGG:04630	KEGG	JAK-STAT signaling pathway	8161	326	NA	GO:0001816;GO:0002376;GO:0050789;GO:0050896;GO:0001775	0	0.01265822784810126	-	1	166	7995	16	5	150	7990	8161	0.26682483640588606
131	R1	e019_R1	TRUE	6.207673479623855e-10	239	10	8	0.8	0.03347280334728033	REAC:R-HSA-8951664	REAC	Neddylation	10790	1474	NA	GO:0036211	0	0.07142857142857142	-	1	239	10551	8	2	231	10549	10790	0.16097635177222205
132	R1	e019_R1	TRUE	1.9282689472850037e-06	253	23	8	0.34782608695652173	0.03162055335968379	GO:0043414	GO:BP	macromolecule methylation	16324	11271	NA	GO:0036211;GO:0016043	0	0.02777777777777777	-	1	253	16071	8	15	245	16056	16324	0.10105734039549838
133	R1	e019_R1	TRUE	9.119992174758159e-44	141	27	25	0.925925925925926	0.1773049645390071	REAC:R-HSA-3214847	REAC	HATs acetylate histones	10790	1029	NA	GO:0036211;GO:0050789	0	0.01886792452830188	-	1	141	10649	25	2	116	10647	10790	0.4026021052139655
135	R1	e019_R1	TRUE	7.309239512140824e-49	60	26	22	0.8461538461538461	0.36666666666666664	GO:0031124	GO:BP	mRNA 3'-end processing	16324	7432	NA	GO:0006396	0	0.02777777777777777	-	1	60	16264	22	4	38	16260	16324	0.5560521273513591
136	R1	e019_R1	TRUE	1.000882843675255e-5	52	22	5	0.2272727272727273	0.09615384615384616	GO:0051568	GO:BP	histone H3-K4 methylation	16324	14578	NA	GO:0036211;GO:0050789;GO:0016043	0	0.0303030303030303	-	1	52	16272	5	17	47	16255	16324	0.14608729833960213
137	R1	e019_R1	TRUE	7.643318542679308e-6	83	14	5	0.35714285714285715	0.06024096385542168	GO:0016575	GO:BP	histone deacetylation	16324	5386	NA	GO:0036211;GO:0016043	0	0.1111111111111111	-	1	83	16241	5	9	78	16232	16324	0.14502163765643286
138	R1	e019_R1	TRUE	1.7511106931598828e-27	72	25	16	0.64	0.2222222222222222	REAC:R-HSA-199992	REAC	trans-Golgi Network Vesicle Budding	10790	2608	NA	GO:0051641;GO:0048753;GO:0051640;GO:0006810;GO:0022607;GO:0043473	0	0.01162790697674418	-	1	72	10718	16	9	56	10709	10790	0.3748775360378066
139	R1	e019_R1	TRUE	1.4659612441853305e-37	39	27	18	0.6666666666666666	0.4615384615384616	REAC:R-HSA-110313	REAC	Translesion synthesis by Y family DNA polymerases bypasses lesions on DNA template	10790	2440	NA	GO:0009059;GO:0006260;GO:0006281	0	0.01162790697674418	-	1	39	10751	18	9	21	10742	10790	0.55338533808560475
140	R1	e019_R1	TRUE	1.5000236884398057e-15	183	16	11	0.6875	0.06010928961748633	GO:0006457	GO:BP	protein folding	16324	2254	NA	GO:0006457	0	0.09090909090909093	-	1	183	16141	11	5	172	16136	16324	0.20120006423244047
142	R1	e019_R1	TRUE	7.497769980027266e-5	643	16	8	0.5	0.01244167962674961	GO:0030036	GO:BP	actin cytoskeleton organization	16324	7022	NA	GO:0006996	0	0.25	-	1	643	15681	8	8	635	15673	16324	0.07416984320127677
143	R1	e019_R1	TRUE	3.720186040739811e-15	86	22	11	0.5	0.12790697674418605	KEGG:04610	KEGG	Complement and coagulation cascades	8161	314	NA	GO:0006811;GO:0050878;GO:0002376;GO:0050789;GO:0050896	0	0.02439024390243902	-	1	86	8075	11	11	75	8064	8161	0.24921131140343947
144	R1	e019_R1	TRUE	4.755520208318613e-17	36	25	10	0.4	0.2777777777777778	REAC:R-HSA-73933	REAC	Resolution of Abasic Sites (AP sites)	10790	1958	NA	GO:0006260;GO:0006281	0	0.02439024390243902	-	1	36	10754	10	15	26	10739	10790	0.33149004439366875
145	R1	e019_R1	TRUE	1.361142518229662e-22	23	29	11	0.3793103448275862	0.4782608695652174	GO:1902455	GO:BP	negative regulation of stem cell population maintenance	16324	23330	NA	GO:0032502;GO:0050789;GO:0032501	0	0.02083333333333333	-	1	23	16301	11	18	12	16283	16324	0.4250165431802198
146	R1	e019_R1	TRUE	1.4544160630606457e-7	174	24	8	0.3333333333333333	0.04597701149425287	GO:0007051	GO:BP	spindle organization	16324	2709	NA	GO:0050789;GO:0006996	0	0.03333333333333333	-	1	174	16150	8	16	166	16134	16324	0.12057068656507622
147	R1	e019_R1	TRUE	5.310879205327038e-26	15	22	11	0.5	0.7333333333333333	REAC:R-HSA-1362300	REAC	Transcription of E2F targets under negative control by p107 (RBL1) and p130 (RBL2) in complex with HDAC1	10790	2404	NA	GO:0050789	0	0.01666666666666666	-	1	15	10775	11	11	4	10764	10790	0.6048836193634027
148	R1	e019_R1	TRUE	3.108406637252542e-11	22	14	6	0.42857142857142855	0.2727272727272727	REAC:R-HSA-452723	REAC	Transcriptional regulation of pluripotent stem cells	10790	2424	NA	GO:0032502	0	0.04347826086956521	-	1	22	10768	6	8	16	10760	10790	0.3408238195638717
149	R1	e019_R1	TRUE	3.6498825769843016e-43	60	25	21	0.84	0.35	REAC:R-HSA-983189	REAC	Kinesins	10790	1230	NA	GO:0006810;GO:0051641;GO:0007049;GO:0006996;GO:0051640;GO:0051261	0	0.00934579439252336	-	1	60	10730	21	4	39	10726	10790	0.5407589219619802
151	R1	e019_R1	TRUE	2.8252783997706497e-10	22	19	6	0.3157894736842105	0.2727272727272727	REAC:R-HSA-389357	REAC	CD28 dependent PI3K/Akt signaling	10790	256	NA	GO:0050789;GO:0050896;GO:0008643;GO:0044255	0	0.0078125	-	1	22	10768	6	13	16	10755	10790	0.2921298007164975
152	R1	e019_R1	TRUE	8.265998606535042e-10	459	16	11	0.6875	0.02396514161220043	REAC:R-HSA-500792	REAC	GPCR ligand binding	10790	965	NA	GO:0046903;GO:0015833;GO:0009914;GO:0050886;GO:0050789	0	0.0303030303030303	-	1	459	10331	11	5	448	10326	10790	0.1231540276243811
153	R1	e019_R1	TRUE	9.973767658455678e-76	32	40	29	0.725	0.90625	GO:0036258	GO:BP	multivesicular body assembly	16324	10041	NA	GO:0061024;GO:0009057;GO:0007032;GO:0015031;GO:0006508;GO:0006914;GO:0016192;GO:0016032;GO:0022607;GO:0044419	0	0.00555555555555555	-	1	32	16292	29	11	3	16281	16324	0.8101696809760793
154	R1	e019_R1	TRUE	2.0758450243417352e-11	15	22	6	0.2727272727272727	0.4	GO:0006620	GO:BP	post-translational protein targeting to endoplasmic reticulum membrane	16324	2388	NA	GO:0015031	0	0.02857142857142857	-	1	15	16309	6	16	9	16293	16324	0.32954978211305075
155	R1	e019_R1	TRUE	4.781038981601547e-16	6	5	5	1	0.8333333333333334	GO:0016255	GO:BP	attachment of GPI anchor to protein	16324	5311	NA	GO:0036211;GO:0044255;GO:0009059;GO:0006793	0	0.04	-	1	6	16318	5	0	1	16318	16324	0.9128429591736104
156	R1	e019_R1	TRUE	6.83116050907112e-10	12	17	5	0.29411764705882354	0.4166666666666667	GO:0032933	GO:BP	SREBP signaling pathway	16324	8351	NA	GO:0015031;GO:0009057;GO:0006508;GO:0050789;GO:0050896	0	0.02702702702702703	-	1	12	16312	5	12	7	16300	16324	0.34950551721564843
157	R1	e019_R1	TRUE	1.1108728059650098e-8	6	15	4	0.26666666666666666	0.6666666666666666	REAC:R-HSA-9022537	REAC	Loss of MECP2 binding ability to the NCoR/SMRT complex	10790	1268	NA	GO:0050789	0	0.04347826086956521	-	1	6	10784	4	11	2	10773	10790	0.42116768152920087
158	R1	e019_R1	TRUE	4.849609207488571e-49	71	27	24	0.8888888888888888	0.3380281690140845	REAC:R-HSA-159236	REAC	Transport of Mature mRNA derived from an Intron-Containing Transcript	10790	2449	NA	GO:0015931;GO:0051641	0	0.0196078431372549	-	1	71	10719	24	3	47	10716	10790	0.5465764546431325
159	R1	e019_R1	TRUE	6.899109892017033e-9	29	4	4	1	0.13793103448275862	KEGG:04744	KEGG	Phototransduction	8161	356	NA	GO:0050877;GO:0050789	0	0.05263157894736842	-	1	29	8132	4	0	25	8132	8161	0.37082111083115576
160	R1	e019_R1	TRUE	3.40523810701239e-41	53	25	19	0.76	0.3584905660377358	GO:0007062	GO:BP	sister chromatid cohesion	16324	2719	NA	GO:0036211;GO:0050789;GO:0051276;GO:0006281	0	0.01612903225806451	-	1	53	16271	19	6	34	16265	16324	0.5209851519899665
161	R1	e019_R1	TRUE	1.0398083678232548e-20	37	16	10	0.625	0.2702702702702703	GO:0007031	GO:BP	peroxisome organization	16324	2695	NA	GO:0006082;GO:0015031;GO:0006869;GO:0007031;GO:0015849;GO:0044255;GO:0050789	0	0.0131578947368421	-	1	37	16287	10	6	27	16281	16324	0.41017291051927535
162	R1	e019_R1	TRUE	2.1522681539339807e-10	77	12	7	0.5833333333333334	0.09090909090909093	KEGG:05100	KEGG	Bacterial invasion of epithelial cells	8161	416	NA	GO:0006457	0	0.05555555555555555	-	1	77	8084	7	5	70	8079	8161	0.2278023505587604
163	R1	e019_R1	TRUE	3.8497596248766866e-15	6	19	6	0.3157894736842105	1	REAC:R-HSA-433692	REAC	Proton-coupled monocarboxylate transport	10790	1727	NA	GO:0022411;GO:0045229;GO:0043062;GO:0015849;GO:0050896	0	0.03571428571428571	-	1	6	10784	6	13	0	10771	10790	0.5616126714679761
164	R1	e019_R1	TRUE	2.403797872721379e-26	15	9	9	1	0.6	GO:0036376	GO:BP	sodium ion export across plasma membrane	16324	10121	NA	GO:0050789;GO:0006811	0	0.00909090909090909	-	1	15	16309	9	0	6	16309	16324	0.7744542234127296
165	R1	e019_R1	TRUE	1.0019208524644326e-15	30	24	9	0.375	0.3	REAC:R-HSA-3000157	REAC	Laminin interactions	10790	1241	NA	GO:0032502;GO:0006936;GO:0007155;GO:0016043	0	0.0175438596491228	-	1	30	10760	9	15	21	10745	10790	0.33375855666612914
166	R1	e019_R1	TRUE	9.596165137869837e-8	190	17	8	0.4705882352941176	0.04210526315789473	KEGG:04062	KEGG	Chemokine signaling pathway	8161	250	NA	GO:0040011;GO:0002376;GO:0050789	0	0.06666666666666667	-	1	190	7971	8	9	182	7962	8161	0.13552556510304076
167	R1	e019_R1	TRUE	9.511907073925577e-13	40	25	8	0.32	0.2	GO:0045197	GO:BP	establishment or maintenance of epithelial cell apical/basal polarity	16324	12011	NA	GO:0016070;GO:0043412	0	0.03846153846153846	-	1	40	16284	8	17	32	16267	16324	0.251545855177499
168	R1	e019_R1	TRUE	1.7599769291582732e-8	16	20	5	0.25	0.3125	REAC:R-HSA-210744	REAC	Regulation of gene expression in late stage (branching morphogenesis) pancreatic bud precursor cells	10790	1922	NA	GO:0050789	0	0.03225806451612903	-	1	16	10774	5	15	11	10759	10790	0.27831490832775807
169	R1	e019_R1	TRUE	1.2584229075422575e-17	26	31	10	0.3225806451612903	0.38461538461538464	REAC:R-HSA-5674400	REAC	Constitutive Signaling by AKT1 E17K in Cancer	10790	378	NA	GO:0050789	0	0.01298701298701298	-	1	26	10764	10	21	16	10743	10790	0.3505296996459614
170	R1	e019_R1	TRUE	3.35189826445196e-33	52	30	17	0.5666666666666667	0.3269230769230769	GO:0051568	GO:BP	histone H3-K4 methylation	16324	14578	NA	GO:0036211	0	0.02127659574468085	-	1	52	16272	17	13	35	16259	16324	0.42907244770205016
171	R1	e019_R1	TRUE	2.9625848295361493e-18	182	28	16	0.5714285714285714	0.08791208791208792	KEGG:04621	KEGG	NOD-like receptor signaling pathway	8161	320	NA	GO:0065003;GO:0001816;GO:0050789;GO:0050896;GO:0065009	0	0.01136363636363636	-	1	182	7979	16	12	166	7967	8161	0.2182027309044814
172	R1	e019_R1	TRUE	8.685348992057519e-106	130	58	57	0.9827586206896552	0.43846153846153846	KEGG:05322	KEGG	Systemic lupus erythematosus	8161	477	NA	GO:0050789;GO:0051641;GO:0065003	0	0.0072463768115942	-	1	130	8031	57	1	73	8030	8161	0.6533226645017778
173	R1	e019_R1	TRUE	1.6469139116806085e-22	73	23	13	0.5652173913043478	0.1780821917808219	GO:0072384	GO:BP	organelle transport along microtubule	16324	18352	NA	GO:0006810;GO:0051641;GO:0065008;GO:0051640;GO:0016043	0	0.01265822784810126	-	1	73	16251	13	10	60	16241	16324	0.31568043188734884
175	R1	e019_R1	TRUE	1.872012490331375e-28	179	36	22	0.6111111111111112	0.12290502793296088	REAC:R-HSA-72163	REAC	mRNA Splicing - Major Pathway	10790	2566	NA	GO:0006351;GO:0065008;GO:0000375;GO:0050789	0	0.01219512195121951	-	1	179	10611	22	14	157	10597	10790	0.2693088962662202
176	R1	e019_R1	TRUE	4.1378889344419e-9	36	8	5	0.625	0.1388888888888889	REAC:R-HSA-168638	REAC	NOD1/2 Signaling Pathway	10790	1444	NA	GO:0002376;GO:0050789;GO:0050896;GO:0065009	0	0.02941176470588235	-	1	36	10754	5	3	31	10751	10790	0.29365400695524435
177	R1	e019_R1	TRUE	1.3651926762102534e-34	253	28	23	0.8214285714285714	0.09090909090909093	GO:0060070	GO:BP	canonical Wnt signaling pathway	16324	15163	NA	GO:0032502;GO:0007154;GO:0050789;GO:0032501;GO:0050896	0	0.01219512195121951	-	1	253	16071	23	5	230	16066	16324	0.27044606159233936
178	R1	e019_R1	TRUE	8.314608349015481e-23	13	26	10	0.38461538461538464	0.7692307692307693	REAC:R-HSA-75205	REAC	Dissolution of Fibrin Clot	10790	742	NA	GO:0050878;GO:0006508;GO:0051604;GO:0050789;GO:0050896	0	0.01428571428571428	-	1	13	10777	10	16	3	10761	10790	0.5432062181857129
179	R1	e019_R1	TRUE	3.009207284565007e-33	10	10	10	1	1	GO:0045050	GO:BP	protein insertion into ER membrane by stop-transfer membrane-anchor sequence	16324	11938	NA	GO:0051641;GO:0051234	0	0.09090909090909093	-	1	10	16314	10	0	0	16314	16324	1
180	R1	e019_R1	TRUE	4.8754934074452975e-21	123	16	13	0.8125	0.10569105691056913	REAC:R-HSA-2132295	REAC	MHC class II antigen presentation	10790	1304	NA	GO:0006996	0	0.02083333333333333	-	1	123	10667	13	3	110	10664	10790	0.29080795361903317
181	R1	e019_R1	TRUE	6.697058456441566e-10	3	3	3	1	1	GO:0033693	GO:BP	neurofilament bundle assembly	16324	8795	NA	GO:0022607;GO:0006996	0	0.16666666666666666	-	1	3	16321	3	0	0	16321	16324	1
182	R1	e019_R1	TRUE	3.4174934530090367e-42	79	24	22	0.9166666666666666	0.27848101265822783	KEGG:03018	KEGG	RNA degradation	8161	211	NA	GO:0050789;GO:0006396;GO:0009057	0	0.00980392156862745	-	1	79	8082	22	2	57	8080	8161	0.5030888423326944
183	R1	e019_R1	TRUE	2.8490388400864917e-10	40	26	7	0.2692307692307692	0.175	GO:0045197	GO:BP	establishment or maintenance of epithelial cell apical/basal polarity	16324	12011	NA	GO:0008150	0	0.03846153846153846	-	1	40	16284	7	19	33	16265	16324	0.21552093524880064
184	R1	e019_R1	TRUE	3.0103277761704914e-6	31	3	3	1	0.0967741935483871	GO:0006298	GO:BP	mismatch repair	16324	2152	NA	GO:0016070;GO:0006281;GO:0009057	0	0.125	-	1	31	16293	3	0	28	16293	16324	0.3108185476541378
185	R1	e019_R1	TRUE	2.0946422011362152e-25	23	24	12	0.5	0.5217391304347826	REAC:R-HSA-171319	REAC	Telomere Extension By Telomerase	10790	2353	NA	GO:0051641;GO:0009059;GO:0006396;GO:0051276;GO:0006259;GO:0043412;GO:0050789;GO:0044085;GO:0065009	0	0.01136363636363636	-	1	23	10767	12	12	11	10755	10790	0.5096865374820696
187	R1	e019_R1	TRUE	8.464284852140638e-23	42	20	12	0.6	0.2857142857142857	REAC:R-HSA-3769402	REAC	Deactivation of the beta-catenin transactivating complex	10790	431	NA	GO:0050789;GO:0007154	0	0.02777777777777777	-	1	42	10748	12	8	30	10740	10790	0.4125387115417765
188	R1	e019_R1	TRUE	7.344560896170581e-16	13	17	7	0.4117647058823529	0.5384615384615384	GO:0048791	GO:BP	calcium ion-regulated exocytosis of neurotransmitter	16324	13777	NA	GO:0006836;GO:0046903;GO:0016049;GO:0065008;GO:0016192;GO:0050789	0	0.01063829787234042	-	1	13	16311	7	10	6	16301	16324	0.47039251158101464
189	R1	e019_R1	TRUE	9.688251647562508e-6	49	3	3	1	0.06122448979591836	KEGG:05144	KEGG	Malaria	8161	429	NA	NA	0	0.16666666666666666	-	1	49	8112	3	0	46	8112	8161	0.24673724308927727
190	R1	e019_R1	TRUE	5.967779571187632e-15	39	22	9	0.4090909090909091	0.2307692307692308	REAC:R-HSA-9031628	REAC	NGF-stimulated transcription	10790	1442	NA	GO:0050789;GO:0050896	0	0.01639344262295082	-	1	39	10751	9	13	30	10738	10790	0.30540360845170955
191	R1	e019_R1	TRUE	5.474185929435183e-13	253	24	12	0.5	0.04743083003952569	GO:0060070	GO:BP	canonical Wnt signaling pathway	16324	15163	NA	GO:0050789;GO:0007154	0	0.01612903225806451	-	1	253	16071	12	12	241	16059	16324	0.15050526163983077
192	R1	e019_R1	TRUE	4.1233795871592715e-24	38	26	13	0.5	0.34210526315789475	REAC:R-HSA-8853659	REAC	RET signaling	10790	1753	NA	GO:0032502;GO:0050877	0	0.0588235294117647	-	1	38	10752	13	13	25	10739	10790	0.41189360541077463
193	R1	e019_R1	TRUE	6.783472501532068e-12	11	23	6	0.2608695652173913	0.5454545454545454	REAC:R-HSA-430116	REAC	GP1b-IX-V activation signalling	10790	963	NA	GO:0051604;GO:0032502;GO:0050789;GO:0050896;GO:0001775	0	0.0175438596491228	-	1	11	10779	6	17	5	10762	10790	0.3763356152074656
194	R1	e019_R1	TRUE	1.0732908232883927e-18	100	18	12	0.6666666666666666	0.12	REAC:R-HSA-5668541	REAC	TNFR2 non-canonical NF-kB pathway	10790	2315	NA	GO:0002376;GO:0050789;GO:0050896	0	0.01587301587301587	-	1	100	10690	12	6	88	10684	10790	0.28044622370840405
195	R1	e019_R1	TRUE	1.2931307803944607e-4	8	2	2	1	0.25	REAC:R-HSA-444821	REAC	Relaxin receptors	10790	1937	NA	NA	0	0.3333333333333333	-	1	8	10782	2	0	6	10782	10790	0.4998609372800248
196	R1	e019_R1	TRUE	1.8613288893386297e-56	48	48	27	0.5625	0.5625	GO:0043966	GO:BP	histone H3 acetylation	16324	11488	NA	GO:0009059;GO:0065003;GO:0036211;GO:0016070;GO:0006508	0	0.01234567901234567	-	1	48	16276	27	21	21	16255	16324	0.561209756696977
197	R1	e019_R1	TRUE	3.4648476842620007e-26	49	20	13	0.65	0.2653061224489796	GO:0031146	GO:BP	SCF-dependent proteasomal ubiquitin-dependent protein catabolic process	16324	7448	NA	GO:0006508;GO:0009057	0	0.05555555555555555	-	1	49	16275	13	7	36	16268	16324	0.41422765598331274
198	R1	e019_R1	TRUE	2.9259128525056083e-32	68	27	18	0.6666666666666666	0.2647058823529412	REAC:R-HSA-5693571	REAC	Nonhomologous End-Joining (NHEJ)	10790	1519	NA	GO:0050789;GO:0006281	0	0.00680272108843537	-	1	68	10722	18	9	50	10713	10790	0.41795357101911507
199	R1	e019_R1	TRUE	8.036470147729857e-8	10	3	3	1	0.3	GO:0010524	GO:BP	positive regulation of calcium ion transport into cytosol	16324	4288	NA	GO:0065008;GO:0006811;GO:0050789	0	0.03448275862068965	-	1	10	16314	3	0	7	16314	16324	0.54760508709609
200	R1	e019_R1	TRUE	2.1742836332797448e-18	47	24	11	0.4583333333333333	0.23404255319148937	REAC:R-HSA-512988	REAC	Interleukin-3, Interleukin-5 and GM-CSF signaling	10790	1186	NA	GO:0050789;GO:0050896	0	0.0125	-	1	47	10743	11	13	36	10730	10790	0.3254786008323217
201	R1	e019_R1	TRUE	5.096581419091911e-6	16	5	3	0.6	0.1875	REAC:R-HSA-139853	REAC	Elevation of cytosolic Ca2+ levels	10790	801	NA	GO:0065008;GO:0050789	0	0.07142857142857142	-	1	16	10774	3	2	13	10772	10790	0.3349072053054919
202	R1	e019_R1	TRUE	2.8683527931889472e-11	722	15	12	0.8	0.01662049861495845	GO:0030029	GO:BP	actin filament-based process	16324	7015	NA	GO:0050789;GO:0006996	0	0.02222222222222222	-	1	722	15602	12	3	710	15599	16324	0.11147817050638296
203	R1	e019_R1	TRUE	1.2865715023476603e-68	82	35	33	0.9428571428571428	0.4024390243902439	REAC:R-HSA-381340	REAC	Transcriptional regulation of white adipocyte differentiation	10790	2426	NA	GO:0050789	0	0.05	-	1	82	10708	33	2	49	10706	10790	0.6143563590669362
204	R1	e019_R1	TRUE	5.348219755718875e-6	157	4	4	1	0.02547770700636942	GO:0002181	GO:BP	cytoplasmic translation	16324	746	NA	GO:0006412	0	0.2	-	1	157	16167	4	0	153	16167	16324	0.15886740856193482
205	R1	e019_R1	TRUE	4.832269261500435e-7	33	18	5	0.2777777777777778	0.15151515151515152	REAC:R-HSA-5357905	REAC	Regulation of TNFR1 signaling	10790	1900	NA	GO:0050789;GO:0065009	0	0.01851851851851851	-	1	33	10757	5	13	28	10744	10790	0.20337440001225773
206	R1	e019_R1	TRUE	1.0794511585847616e-30	67	24	16	0.6666666666666666	0.23880597014925373	GO:0002548	GO:BP	monocyte chemotaxis	16324	1087	NA	GO:0040011;GO:0002376;GO:0050789;GO:0050896	0	0.01041666666666666	-	1	67	16257	16	8	51	16249	16324	0.39765597147947346
207	R1	e019_R1	TRUE	2.640957003169365e-33	297	29	25	0.8620689655172413	0.08417508417508418	REAC:R-HSA-1474244	REAC	Extracellular matrix organization	10790	844	NA	GO:0045229;GO:0043062	0	0.0196078431372549	-	1	297	10493	25	4	272	10489	10790	0.2647982037752524
208	R1	e019_R1	TRUE	4.068705219215547e-30	108	25	19	0.76	0.17592592592592593	KEGG:03013	KEGG	Nucleocytoplasmic transport	8161	209	NA	GO:0036211;GO:0015031	0	0.0136986301369863	-	1	108	8053	19	6	89	8047	8161	0.3622445931662934
209	R1	e019_R1	TRUE	6.772096940170303e-20	29	17	10	0.5882352941176471	0.3448275862068966	KEGG:04744	KEGG	Phototransduction	8161	356	NA	GO:0050877;GO:0051606;GO:0050789	0	0.03225806451612903	-	1	29	8132	10	7	19	8125	8161	0.44892196310276417
210	R1	e019_R1	TRUE	5.858964169283203e-15	88	16	10	0.625	0.11363636363636365	KEGG:04512	KEGG	ECM-receptor interaction	8161	308	NA	GO:0032502;GO:0045229;GO:0043062	0	0.025	-	1	88	8073	10	6	78	8067	8161	0.2635850962081373
211	R1	e019_R1	TRUE	1.1341065443697236e-35	57	16	16	1	0.2807017543859649	REAC:R-HSA-380108	REAC	Chemokine receptors bind chemokines	10790	332	NA	GO:0002376;GO:0040011;GO:0050789;GO:0050896;GO:0044419	0	0.01492537313432835	-	1	57	10733	16	0	41	10733	10790	0.5288038915951315
212	R1	e019_R1	TRUE	1.8836324201942629e-7	12	3	3	1	0.25	REAC:R-HSA-375281	REAC	Hormone ligand-binding receptors	10790	1072	NA	NA	0	0.16666666666666666	-	1	12	10778	3	0	9	10778	10790	0.4997913720672289
214	R1	e019_R1	TRUE	3.1957840047773434e-11	168	17	9	0.5294117647058824	0.05357142857142857	GO:0002221	GO:BP	pattern recognition receptor signaling pathway	16324	773	NA	GO:0002376;GO:0050789	0	0.01162790697674418	-	1	168	16156	9	8	159	16148	16324	0.16607732881499912
215	R1	e019_R1	TRUE	6.234188063049426e-39	81	39	22	0.5641025641025641	0.2716049382716049	GO:0000079	GO:BP	regulation of cyclin-dependent protein serine/threonine kinase activity	16324	30	NA	GO:0050789;GO:0007049;GO:0065009	0	0.00689655172413793	-	1	81	16243	22	17	59	16226	16324	0.38941292491413304
216	R1	e019_R1	TRUE	1.365995852988074e-31	25	22	14	0.6363636363636364	0.56	REAC:R-HSA-8854691	REAC	Interleukin-20 family signaling	10790	1182	NA	GO:0050789;GO:0050896	0	0.05	-	1	25	10765	14	8	11	10757	10790	0.5960867529858502
217	R1	e019_R1	TRUE	2.5853026206477324e-4	8	3	2	0.6666666666666666	0.25	REAC:R-HSA-804914	REAC	Transport of fatty acids	10790	2456	NA	GO:0051179	0	0.14285714285714285	-	1	8	10782	2	1	6	10781	10790	0.4080022432978254
218	R1	e019_R1	TRUE	1.0884619174715176e-26	169	18	17	0.9444444444444444	0.10059171597633136	KEGG:04530	KEGG	Tight junction	8161	311	NA	GO:0032502;GO:0022607;GO:0032501;GO:0007155	0	0.01818181818181818	-	1	169	7992	17	1	152	7991	8161	0.30497503196147285
219	R1	e019_R1	TRUE	1.3112432084907665e-19	313	23	17	0.7391304347826086	0.05431309904153354	REAC:R-HSA-418594	REAC	G alpha (i) signalling events	10790	933	NA	GO:0050789	0	0.02272727272727272	-	1	313	10477	17	6	296	10471	10790	0.1955601628815586
220	R1	e019_R1	TRUE	1.325629388769343e-9	130	16	8	0.5	0.06153846153846154	REAC:R-HSA-8939236	REAC	RUNX1 regulates transcription of genes involved in differentiation of HSCs	10790	1829	NA	GO:0032502	0	0.07692307692307693	-	1	130	10660	8	8	122	10652	10790	0.17235329984456532
221	R1	e019_R1	TRUE	2.1452070357178053e-8	44	21	6	0.2857142857142857	0.13636363636363635	GO:0048709	GO:BP	oligodendrocyte differentiation	16324	13706	NA	GO:0032502;GO:0050789	0	0.01204819277108433	-	1	44	16280	6	15	38	16265	16324	0.19591348049205523
222	R1	e019_R1	TRUE	4.2154118824038196e-33	56	21	17	0.8095238095238095	0.30357142857142855	KEGG:04340	KEGG	Hedgehog signaling pathway	8161	296	NA	GO:0051641;GO:0032502;GO:0051640;GO:0006810;GO:0050789;GO:0065009	0	0.02272727272727272	-	1	56	8105	17	4	39	8101	8161	0.4938589757511984
223	R1	e019_R1	TRUE	2.277193628355256e-37	154	24	21	0.875	0.13636363636363635	GO:0043488	GO:BP	regulation of mRNA stability	16324	11323	NA	GO:0016070;GO:0065008;GO:0050789;GO:0009057	0	0.0175438596491228	-	1	154	16170	21	3	133	16167	16324	0.34357633450756575
224	R1	e019_R1	TRUE	2.2796766247768844e-41	38	21	18	0.8571428571428571	0.47368421052631576	REAC:R-HSA-6814122	REAC	Cooperation of PDCL (PhLP1) and TRiC/CCT in G-protein beta folding	10790	388	NA	GO:0050789	0	0.01234567901234567	-	1	38	10752	18	3	20	10749	10790	0.6363149216532813
225	R1	e019_R1	TRUE	1.848254977029102e-6	78	5	4	0.8	0.05128205128205128	GO:0032456	GO:BP	endocytic recycling	16324	7991	NA	GO:0051641;GO:0016192	0	0.16666666666666666	-	1	78	16246	4	1	74	16245	16324	0.2018517626814588
226	R1	e019_R1	TRUE	2.7271609563379153e-17	124	10	10	1	0.08064516129032258	KEGG:04650	KEGG	Natural killer cell mediated cytotoxicity	8161	328	NA	GO:0001906;GO:0050896;GO:0044419;GO:0002376	0	0.06666666666666667	-	1	124	8037	10	0	114	8037	8161	0.2819880439603987
227	R1	e019_R1	TRUE	2.428134803004833e-17	43	25	10	0.4	0.23255813953488372	GO:0035329	GO:BP	hippo signaling	16324	9458	NA	GO:0050789	0	0.1	-	1	43	16281	10	15	33	16266	16324	0.30362104889235025
228	R1	e019_R1	TRUE	1.412724315145702e-7	11	3	3	1	0.2727272727272727	REAC:R-HSA-1660517	REAC	Synthesis of PIPs at the late endosome membrane	10790	2264	NA	GO:0044255;GO:0006793	0	0.07692307692307693	-	1	11	10779	3	0	8	10779	10790	0.5220392792307172
229	R1	e019_R1	TRUE	2.4574818534972912e-8	42	4	4	1	0.09523809523809525	GO:0045332	GO:BP	phospholipid translocation	16324	12058	NA	GO:0065008;GO:0006869;GO:0061024	0	0.08333333333333333	-	1	42	16282	4	0	38	16282	16324	0.30824720577692355
230	R1	e019_R1	TRUE	5.931499608180506e-25	297	17	17	1	0.05723905723905724	REAC:R-HSA-1474244	REAC	Extracellular matrix organization	10790	844	NA	GO:0045229;GO:0022607;GO:0043062	0	0.04166666666666666	-	1	297	10493	17	0	280	10493	10790	0.23611726418036444
231	R1	e019_R1	TRUE	3.211972561400135e-18	107	30	13	0.43333333333333335	0.12149532710280374	GO:0061640	GO:BP	cytoskeleton-dependent cytokinesis	16324	16508	NA	GO:0008150	0	0.1111111111111111	-	1	107	16217	13	17	94	16200	16324	0.22693360458990955
232	R1	e019_R1	TRUE	1.1454046339332795e-10	23	7	5	0.7142857142857143	0.21739130434782608	KEGG:03430	KEGG	Mismatch repair	8161	234	NA	GO:0006281	0	0.07142857142857142	-	1	23	8138	5	2	18	8136	8161	0.393223358681707
233	R1	e019_R1	TRUE	1.595345040649353e-17	239	28	16	0.5714285714285714	0.06694560669456066	REAC:R-HSA-8951664	REAC	Neddylation	10790	1474	NA	GO:0006508;GO:0009057	0	0.08333333333333333	-	1	239	10551	16	12	223	10539	10790	0.19037098243890457
234	R1	e019_R1	TRUE	6.697058456441587e-9	5	3	3	1	0.6	GO:0006003	GO:BP	fructose 2,6-bisphosphate metabolic process	16324	1915	NA	NA	0	0.14285714285714285	-	1	5	16319	3	0	2	16319	16324	0.7745492076643277
235	R1	e019_R1	TRUE	2.432239578045201e-31	36	17	14	0.8235294117647058	0.3888888888888889	REAC:R-HSA-390522	REAC	Striated Muscle Contraction	10790	2225	NA	GO:0006996;GO:0050877;GO:0050879;GO:0032502;GO:0006936;GO:0022607	0	0.01886792452830188	-	1	36	10754	14	3	22	10751	10790	0.5650115967239437
236	R1	e019_R1	TRUE	1.7573986805140248e-10	23	17	6	0.35294117647058826	0.2608695652173913	REAC:R-HSA-373753	REAC	Nephrin family interactions	10790	1497	NA	GO:0006811;GO:0065003	0	0.0303030303030303	-	1	23	10767	6	11	17	10756	10790	0.30216053244212965
237	R1	e019_R1	TRUE	3.312517073345554e-9	26	23	6	0.2608695652173913	0.2307692307692308	REAC:R-HSA-5621480	REAC	Dectin-2 family	10790	436	NA	GO:0050789;GO:0001816;GO:0002376;GO:0040011;GO:0022607;GO:0050896;GO:0044419	0	0.00689655172413793	-	1	26	10764	6	17	20	10747	10790	0.24364511278011325
238	R1	e019_R1	TRUE	6.92258477538355e-20	151	20	14	0.7	0.09271523178807949	REAC:R-HSA-446652	REAC	Interleukin-1 family signaling	10790	1171	NA	GO:0002376;GO:0050789;GO:0050896	0	0.01694915254237288	-	1	151	10639	14	6	137	10633	10790	0.25166182914716373
239	R1	e019_R1	TRUE	2.5546402929220572e-26	208	35	20	0.5714285714285714	0.09615384615384616	GO:0006470	GO:BP	protein dephosphorylation	16324	2260	NA	GO:0050789;GO:0009059;GO:0006112;GO:0036211;GO:0006793;GO:0005976	0	0.01428571428571428	-	1	208	16116	20	15	188	16101	16324	0.2308986278230309
240	R1	e019_R1	TRUE	2.2192528806536639e-23	196	16	15	0.9375	0.07653061224489796	REAC:R-HSA-112314	REAC	Neurotransmitter receptors and postsynaptic signal transmission	10790	1508	NA	GO:0050789;GO:0007154	0	0.01492537313432835	-	1	196	10594	15	1	181	10593	10790	0.2652825846389199
241	R1	e019_R1	TRUE	1.2024721002534753e-12	102	23	10	0.43478260869565216	0.09803921568627452	REAC:R-HSA-6807878	REAC	COPI-mediated anterograde transport	10790	267	NA	GO:0007030;GO:0051641;GO:0016192	0	0.03225806451612903	-	1	102	10688	10	13	92	10675	10790	0.2031491982569896
242	R1	e019_R1	TRUE	4.9696272788669485e-14	168	16	11	0.6875	0.06547619047619048	KEGG:04141	KEGG	Protein processing in endoplasmic reticulum	8161	273	NA	GO:0050789;GO:0006457;GO:0050896	0	0.04347826086956521	-	1	168	7993	11	5	157	7988	8161	0.2081700751669726
243	R1	e019_R1	TRUE	2.6146870475751455e-4	300	9	5	0.5555555555555556	0.01666666666666666	GO:0007409	GO:BP	axonogenesis	16324	2976	NA	GO:0032989;GO:0065008;GO:0050789	0	0.05555555555555555	-	1	300	16024	5	4	295	16020	16324	0.09393472911220428
245	R1	e019_R1	TRUE	5.210252116038631e-11	86	10	7	0.7	0.08139534883720931	REAC:R-HSA-6794362	REAC	Protein-protein interactions at synapses	10790	1726	NA	GO:0050789;GO:0007154;GO:0016043	0	0.05263157894736842	-	1	86	10704	7	3	79	10701	10790	0.2370361011287631
246	R1	e019_R1	TRUE	6.311668292145681e-9	101	5	5	1	0.04950495049504951	GO:0009952	GO:BP	anterior/posterior pattern specification	16324	3868	NA	GO:0032501	0	0.3333333333333333	-	1	101	16223	5	0	96	16223	16324	0.221841671151587
247	R1	e019_R1	TRUE	6.214481435725043e-11	7	19	5	0.2631578947368421	0.7142857142857143	REAC:R-HSA-420597	REAC	Nectin/Necl  trans heterodimerization	10790	1473	NA	GO:0002376;GO:0001906;GO:0050789;GO:0050896;GO:0044419;GO:0007155	0	0.0303030303030303	-	1	7	10783	5	14	2	10769	10790	0.4330079285708533
248	R1	e019_R1	TRUE	3.4621569845039346e-39	128	24	21	0.875	0.1640625	GO:0006888	GO:BP	endoplasmic reticulum to Golgi vesicle-mediated transport	16324	2600	NA	GO:0051641;GO:0016050;GO:0016192;GO:0061024	0	0.02439024390243902	-	1	128	16196	21	3	107	16193	16324	0.37724905789640656
249	R1	e019_R1	TRUE	1.4411318814446322e-7	200	12	7	0.5833333333333334	0.035	REAC:R-HSA-68877	REAC	Mitotic Prometaphase	10790	1404	NA	GO:0051640;GO:0051234;GO:0006996	0	0.02631578947368421	-	1	200	10590	7	5	193	10585	10790	0.139724602535883
250	R1	e019_R1	TRUE	2.215133230388691e-28	81	16	15	0.9375	0.18518518518518515	KEGG:04146	KEGG	Peroxisome	8161	277	NA	GO:0044255;GO:0006082;GO:0007031;GO:0015031	0	0.01639344262295082	-	1	81	8080	15	1	66	8079	8161	0.4147234102105272
251	R1	e019_R1	TRUE	1.5693017583649905e-15	38	20	9	0.45	0.23684210526315788	REAC:R-HSA-190861	REAC	Gap junction assembly	10790	979	NA	GO:0036211;GO:0022607;GO:0006810	0	0.07142857142857142	-	1	38	10752	9	11	29	10741	10790	0.32478236755441936
252	R1	e019_R1	TRUE	1.4071786922971718e-14	120	10	9	0.9	0.075	KEGG:04935	KEGG	Growth hormone synthesis, secretion and action	8161	385	NA	GO:0040007;GO:0046903;GO:0015833;GO:0009914;GO:0050789;GO:0032501;GO:0050896	0	0.02040816326530612	-	1	120	8041	9	1	111	8040	8161	0.25762069038472957
253	R1	e019_R1	TRUE	1.338110269121381e-8	34	4	4	1	0.1176470588235294	REAC:R-HSA-156590	REAC	Glutathione conjugation	10790	1004	NA	GO:0006725;GO:0006807;GO:0006805	0	0.04347826086956521	-	1	34	10756	4	0	30	10756	10790	0.3425198348443633
254	R1	e019_R1	TRUE	1.9386332129854416e-12	32	15	7	0.4666666666666667	0.21875	REAC:R-HSA-418990	REAC	Adherens junctions interactions	10790	117	NA	GO:0007155;GO:0016043	0	0.05	-	1	32	10758	7	8	25	10750	10790	0.3181673923078296
255	R1	e019_R1	TRUE	5.552760477086812e-16	10	19	7	0.3684210526315789	0.7	REAC:R-HSA-419812	REAC	Calcitonin-like ligand receptors	10790	289	NA	GO:0002376;GO:0016192;GO:0050789;GO:0050896;GO:0044419	0	0.01538461538461538	-	1	10	10780	7	12	3	10768	10790	0.5072375801536164
256	R1	e019_R1	TRUE	1.8209897171769014e-14	43	27	9	0.3333333333333333	0.20930232558139536	GO:0035329	GO:BP	hippo signaling	16324	9458	NA	GO:0050789;GO:0050896	0	0.04	-	1	43	16281	9	18	34	16263	16324	0.2626110408426943
257	R1	e019_R1	TRUE	6.18911629119089e-18	330	22	15	0.6818181818181818	0.04545454545454545	GO:0009615	GO:BP	response to virus	16324	3618	NA	GO:0001816;GO:0002376;GO:0050789;GO:0050896;GO:0044419	0	0.01052631578947368	-	1	330	15994	15	7	315	15987	16324	0.17269475027914988
258	R1	e019_R1	TRUE	1.8707536295574752e-22	64	21	13	0.6190476190476191	0.203125	REAC:R-HSA-8873719	REAC	RAB geranylgeranylation	10790	1743	NA	GO:0036211;GO:0015031	0	0.05	-	1	64	10726	13	8	51	10718	10790	0.35259594416836104
259	R1	e019_R1	TRUE	2.6012621738303918e-27	97	14	14	1	0.14432989690721648	REAC:R-HSA-5620912	REAC	Anchoring of the basal body to the plasma membrane	10790	141	NA	GO:0022607;GO:0006996	0	0.07692307692307693	-	1	97	10693	14	0	83	10693	10790	0.37844183772237006
260	R1	e019_R1	TRUE	2.43772927814474e-7	14	3	3	1	0.21428571428571427	GO:0030206	GO:BP	chondroitin sulfate biosynthetic process	16324	7078	NA	GO:0019538;GO:0009059;GO:0006790	0	0.05	-	1	14	16310	3	0	11	16310	16324	0.46275402792640297
261	R1	e019_R1	TRUE	1.5450542504534845e-15	195	17	12	0.7058823529411765	0.06153846153846154	REAC:R-HSA-375276	REAC	Peptide ligand-binding receptors	10790	1636	NA	GO:0050789	0	0.03703703703703703	-	1	195	10595	12	5	183	10590	10790	0.20510597646729464
262	R1	e019_R1	TRUE	1.3942786373542676e-6	49	15	5	0.3333333333333333	0.1020408163265306	REAC:R-HSA-6811440	REAC	Retrograde transport at the Trans-Golgi-Network	10790	1974	NA	GO:0050789;GO:0032501	0	0.02564102564102564	-	1	49	10741	5	10	44	10731	10790	0.18245652501826332
263	R1	e019_R1	TRUE	1.7751521424750012e-22	11	22	9	0.4090909090909091	0.8181818181818182	GO:0000338	GO:BP	protein deneddylation	16324	100	NA	GO:0036211;GO:0050789;GO:0006508	0	0.04761904761904761	-	1	11	16313	9	13	2	16300	16324	0.5781733776844971
264	R1	e019_R1	TRUE	1.47462332371389e-10	58	8	6	0.75	0.10344827586206896	KEGG:04923	KEGG	Regulation of lipolysis in adipocytes	8161	373	NA	GO:0050789;GO:0051179;GO:0044255	0	0.03225806451612903	-	1	58	8103	6	2	52	8101	8161	0.2770250337066179
265	R1	e019_R1	TRUE	1.1714052536087533e-25	33	12	11	0.9166666666666666	0.3333333333333333	REAC:R-HSA-2172127	REAC	DAP12 interactions	10790	411	NA	GO:0002376;GO:0001906;GO:0050789;GO:0050896;GO:0044419	0	0.01333333333333333	-	1	33	10757	11	1	22	10756	10790	0.5520780118242767
266	R1	e019_R1	TRUE	2.3536633401646427e-25	23	30	12	0.4	0.5217391304347826	GO:0034587	GO:BP	piRNA processing	16324	9142	NA	GO:0050789;GO:0006396;GO:0006304	0	0.02083333333333333	-	1	23	16301	12	18	11	16283	16324	0.4559632478540735
267	R1	e019_R1	TRUE	1.60673904826706e-29	111	20	17	0.85	0.15315315315315314	REAC:R-HSA-166658	REAC	Complement cascade	10790	370	NA	GO:0002376;GO:0050789;GO:0050896;GO:0044419	0	0.02777777777777777	-	1	111	10679	17	3	94	10676	10790	0.3586183666796774
269	R1	e019_R1	TRUE	3.846768138978122e-17	18	16	8	0.5	0.4444444444444444	REAC:R-HSA-446353	REAC	Cell-extracellular matrix interactions	10790	318	NA	GO:0050789;GO:0007155	0	0.04545454545454545	-	1	18	10772	8	8	10	10764	10790	0.4705731215471223
270	R1	e019_R1	TRUE	2.763316173184239e-12	29	17	7	0.4117647058823529	0.2413793103448276	REAC:R-HSA-983170	REAC	Antigen Presentation: Folding, assembly and peptide loading of class I MHC	10790	145	NA	GO:0036211;GO:0002376;GO:0006457;GO:0050896	0	0.02777777777777777	-	1	29	10761	7	10	22	10751	10790	0.31387545641810055
271	R1	e019_R1	TRUE	6.09184527561886e-31	36	21	14	0.6666666666666666	0.3888888888888889	GO:0016180	GO:BP	snRNA processing	16324	5285	NA	GO:0050789;GO:0006396;GO:0006354	0	0.03225806451612903	-	1	36	16288	14	7	22	16281	16324	0.5083783488542588
272	R1	e019_R1	TRUE	1.7388616462743892e-10	88	11	7	0.6363636363636364	0.07954545454545454	REAC:R-HSA-8876198	REAC	RAB GEFs exchange GTP for GDP on RABs	10790	1742	NA	GO:0006914	0	0.09090909090909093	-	1	88	10702	7	4	81	10698	10790	0.2231301003650227
273	R1	e019_R1	TRUE	1.0355409549772782e-18	138	13	11	0.8461538461538461	0.07971014492753623	GO:0007189	GO:BP	adenylate cyclase-activating G protein-coupled receptor signaling pathway	16324	2812	NA	GO:0050789;GO:0050896;GO:0009117	0	0.00714285714285714	-	1	138	16186	11	2	127	16184	16324	0.2583076040901309
274	R1	e019_R1	TRUE	2.005483471312465e-6	16	4	3	0.75	0.1875	GO:0099560	GO:BP	synaptic membrane adhesion	16324	20200	NA	GO:0045229;GO:0022607;GO:0043062;GO:0007155	0	0.125	-	1	16	16308	3	1	13	16307	16324	0.3747395129010459
275	R1	e019_R1	TRUE	3.588655339730638e-12	57	6	6	1	0.10526315789473684	REAC:R-HSA-380108	REAC	Chemokine receptors bind chemokines	10790	332	NA	GO:0040011	0	0.06666666666666667	-	1	57	10733	6	0	51	10733	10790	0.3236747508994587
276	R1	e019_R1	TRUE	1.0291823339503103e-24	291	27	19	0.7037037037037037	0.06529209621993128	GO:0048193	GO:BP	Golgi vesicle transport	16324	13306	NA	GO:0051641;GO:0016050;GO:0016192;GO:0061024	0	0.03571428571428571	-	1	291	16033	19	8	272	16025	16324	0.21098282587407707
277	R1	e019_R1	TRUE	1.4749416445776338e-22	28	15	10	0.6666666666666666	0.35714285714285715	GO:0045116	GO:BP	protein neddylation	16324	11976	NA	GO:0036211;GO:0050789	0	0.07692307692307693	-	1	28	16296	10	5	18	16291	16324	0.4873364898249501
278	R1	e019_R1	TRUE	4.13434841496126e-6	21	4	3	0.75	0.14285714285714285	REAC:R-HSA-5620916	REAC	VxPx cargo-targeting to cilium	10790	2528	NA	GO:0006811	0	0.09090909090909093	-	1	21	10769	3	1	18	10768	10790	0.3268561816437884
279	R1	e019_R1	TRUE	1.605026061316442e-4	105	3	3	1	0.02857142857142857	REAC:R-HSA-2672351	REAC	Stimuli-sensing channels	10790	2224	NA	NA	0	0.5	-	1	105	10685	3	0	102	10685	10790	0.168229789577252
280	R1	e019_R1	TRUE	1.7140994328682425e-15	239	12	11	0.9166666666666666	0.04602510460251046	REAC:R-HSA-8951664	REAC	Neddylation	10790	1474	NA	GO:0050789;GO:0051641;GO:0016192;GO:0065009	0	0.1111111111111111	-	1	239	10551	11	1	228	10550	10790	0.2028082349408964
281	R1	e019_R1	TRUE	1.459304628138863e-20	155	12	12	1	0.07741935483870968	REAC:R-HSA-9013148	REAC	CDC42 GTPase cycle	10790	258	NA	GO:0065009	0	0.1	-	1	155	10635	12	0	143	10635	10790	0.2763913399966967
282	R1	e019_R1	TRUE	1.056632168073526e-5	43	3	3	1	0.06976744186046512	REAC:R-HSA-1660662	REAC	Glycosphingolipid metabolism	10790	1023	NA	NA	0	0.5	-	1	43	10747	3	0	40	10747	10790	0.26364508817396004
283	R1	e019_R1	TRUE	9.747639622105744e-20	812	24	20	0.8333333333333334	0.02463054187192118	GO:0007017	GO:BP	microtubule-based process	16324	2684	NA	GO:0051641;GO:0016192;GO:0006996	0	0.0303030303030303	-	1	812	15512	20	4	792	15508	16324	0.13829794360435074
285	R1	e019_R1	TRUE	6.231938103264174e-21	43	12	10	0.8333333333333334	0.23255813953488372	REAC:R-HSA-1296072	REAC	Voltage gated Potassium channels	10790	2524	NA	GO:0006811	0	0.06666666666666667	-	1	43	10747	10	2	33	10745	10790	0.4392401308988181
286	R1	e019_R1	TRUE	8.378506048936831e-16	56	14	9	0.6428571428571429	0.16071428571428573	REAC:R-HSA-6794361	REAC	Neurexins and neuroligins	10790	1501	NA	GO:0050877;GO:0050789	0	0.04166666666666666	-	1	56	10734	9	5	47	10729	10790	0.31987176604006773
287	R1	e019_R1	TRUE	7.04749090709957e-27	148	30	18	0.6	0.12162162162162164	GO:0097553	GO:BP	calcium ion transmembrane import into cytosol	16324	19746	NA	GO:0050789;GO:0006811;GO:0007154;GO:0065009	0	0.00689655172413793	-	1	148	16176	18	12	130	16164	16324	0.26751344308611524
288	R1	e019_R1	TRUE	1.014273040429561e-52	74	35	26	0.7428571428571429	0.35135135135135137	GO:0042273	GO:BP	ribosomal large subunit biogenesis	16324	10643	NA	GO:0042254;GO:0006396	0	0.04347826086956521	-	1	74	16250	26	9	48	16241	16324	0.5094690486194043
290	R1	e019_R1	TRUE	2.5917781105664112e-20	19	15	9	0.6	0.47368421052631576	REAC:R-HSA-388844	REAC	Receptor-type tyrosine-protein phosphatases	10790	1852	NA	GO:0022607;GO:0050789;GO:0007155	0	0.02702702702702703	-	1	19	10771	9	6	10	10765	10790	0.5323882027049024
291	R1	e019_R1	TRUE	9.00259957550751e-16	25	19	8	0.42105263157894735	0.32	GO:0042026	GO:BP	protein refolding	16324	10497	NA	GO:0050789;GO:0006457;GO:0022607	0	0.02777777777777777	-	1	25	16299	8	11	17	16288	16324	0.3662236234756137
292	R1	e019_R1	TRUE	8.50883010806706e-18	58	22	11	0.5	0.1896551724137931	REAC:R-HSA-8866654	REAC	E3 ubiquitin ligases ubiquitinate target proteins	10790	773	NA	GO:0036211;GO:0006281	0	0.02702702702702703	-	1	58	10732	11	11	47	10721	10790	0.30576423924351076
293	R1	e019_R1	TRUE	5.994684584358027e-7	20	3	3	1	0.15	KEGG:00100	KEGG	Steroid biosynthesis	8161	13	NA	GO:0006629;GO:0006066	0	0.06666666666666667	-	1	20	8141	3	0	17	8141	8161	0.3868945895047969
295	R1	e019_R1	TRUE	4.7947007059490715e-8	8	3	3	1	0.375	REAC:R-HSA-5358493	REAC	Synthesis of diphthamide-EEF2	10790	2275	NA	GO:0036211;GO:0050789	0	0.1	-	1	8	10782	3	0	5	10782	10790	0.612230495533098
296	R1	e019_R1	TRUE	1.6853195300683645e-5	195	4	4	1	0.02051282051282051	REAC:R-HSA-375276	REAC	Peptide ligand-binding receptors	10790	1636	NA	GO:0006936;GO:0050789	0	0.09090909090909093	-	1	195	10595	4	0	191	10595	10790	0.14194920433611835
297	R1	e019_R1	TRUE	3.7326893649666753e-11	83	6	6	1	0.07228915662650602	REAC:R-HSA-1483255	REAC	PI Metabolism	10790	1577	NA	GO:0044255;GO:0006793	0	0.0625	-	1	83	10707	6	0	77	10707	10790	0.2679048283115497
298	R1	e019_R1	TRUE	1.120789039040333e-18	317	21	15	0.7142857142857143	0.0473186119873817	GO:0006816	GO:BP	calcium ion transport	16324	2551	NA	GO:0006811	0	0.01219512195121951	-	1	317	16007	15	6	302	16001	16324	0.1807254070536496
299	R1	e019_R1	TRUE	2.541645128074907e-16	16	6	6	1	0.375	GO:0002098	GO:BP	tRNA wobble uridine modification	16324	698	NA	GO:0006396;GO:0043412	0	0.05263157894736842	-	1	16	16308	6	0	10	16308	16324	0.6121847698412158
300	R1	e019_R1	TRUE	5.159418459661675e-16	239	18	13	0.7222222222222222	0.05439330543933055	REAC:R-HSA-8951664	REAC	Neddylation	10790	1474	NA	GO:0036211;GO:0044255;GO:0006793	0	0.02439024390243902	-	1	239	10551	13	5	226	10546	10790	0.19444936198031895
301	R1	e019_R1	TRUE	1.8194817962320642e-34	40	19	15	0.7894736842105263	0.375	GO:0071526	GO:BP	semaphorin-plexin signaling pathway	16324	17694	NA	GO:0032989;GO:0050789;GO:0040011;GO:0016049	0	0.01020408163265306	-	1	40	16284	15	4	25	16280	16324	0.5434005014538857
302	R1	e019_R1	TRUE	4.748924364005039e-4	67	15	4	0.26666666666666666	0.05970149253731343	GO:0042982	GO:BP	amyloid precursor protein metabolic process	16324	11047	NA	GO:0019538	0	0.5	-	1	67	16257	4	11	63	16246	16324	0.12454700281692832
304	R1	e019_R1	TRUE	7.192051058923587e-8	9	3	3	1	0.3333333333333333	REAC:R-HSA-1296052	REAC	Ca2+ activated K+ channels	10790	284	NA	GO:0050896	0	0.0625	-	1	9	10781	3	0	6	10781	10790	0.5771896785038834
305	R1	e019_R1	TRUE	6.852996593475476e-9	29	4	4	1	0.13793103448275862	REAC:R-HSA-5669034	REAC	TNFs bind their physiological receptors	10790	2316	NA	NA	0	0.25	-	1	29	10761	4	0	25	10761	10790	0.37096001840601545
306	R1	e019_R1	TRUE	1.0309536913431444e-11	26	5	5	1	0.19230769230769232	REAC:R-HSA-5223345	REAC	Miscellaneous transport and binding events	10790	1380	NA	GO:0015931;GO:0006811	0	0.04347826086956521	-	1	26	10764	5	0	21	10764	10790	0.43810186100033977
307	R1	e019_R1	TRUE	1.20922614722714e-15	722	20	16	0.8	0.0221606648199446	GO:0030029	GO:BP	actin filament-based process	16324	7015	NA	GO:0032502;GO:0022607;GO:0006996	0	0.02083333333333333	-	1	722	15602	16	4	706	15598	16324	0.12874364007448355
308	R1	e019_R1	TRUE	2.392910010291601e-13	15	5	5	1	0.3333333333333333	GO:0007210	GO:BP	serotonin receptor signaling pathway	16324	2831	NA	GO:0050789;GO:0050896	0	0.03703703703703703	-	1	15	16309	5	0	10	16309	16324	0.5771733469689455
309	R1	e019_R1	TRUE	5.3313707823022945e-12	15	18	6	0.3333333333333333	0.4	GO:0007158	GO:BP	neuron cell-cell adhesion	16324	2785	NA	GO:0051641;GO:0061024;GO:0050789;GO:0006996;GO:0065008;GO:0050896;GO:0022607;GO:0032501;GO:0044085;GO:0007155	0	0.01098901098901099	-	1	15	16309	6	12	9	16297	16324	0.3645102172352645
310	R1	e019_R1	TRUE	1.6376732242169638e-19	149	21	14	0.6666666666666666	0.09395973154362416	REAC:R-HSA-8980692	REAC	RHOA GTPase cycle	10790	1767	NA	GO:0050789;GO:0051301	0	0.01851851851851851	-	1	149	10641	14	7	135	10634	10790	0.24704581507961992
311	R1	e019_R1	TRUE	9.502588855825572e-11	9	15	5	0.3333333333333333	0.5555555555555556	REAC:R-HSA-428542	REAC	Regulation of commissural axon pathfinding by SLIT and ROBO	10790	1913	NA	GO:0008037;GO:0048511;GO:0032502;GO:0016043;GO:0040011;GO:0050789	0	0.01538461538461538	-	1	9	10781	5	10	4	10771	10790	0.42973259695693977
312	R1	e019_R1	TRUE	4.3279562054695327e-8	45	4	4	1	0.08888888888888889	KEGG:02010	KEGG	ABC transporters	8161	199	NA	GO:0050789	0	0.125	-	1	45	8116	4	0	41	8116	8161	0.2973921679115818
313	R1	e019_R1	TRUE	5.793088748324286e-7	41	6	4	0.6666666666666666	0.0975609756097561	REAC:R-HSA-6782315	REAC	tRNA modification in the nucleus and cytosol	10790	2601	NA	GO:0016070;GO:0043412	0	0.07692307692307693	-	1	41	10749	4	2	37	10747	10790	0.25413089869341066
314	R1	e019_R1	TRUE	1.3185426941359922e-6	22	3	3	1	0.13636363636363635	REAC:R-HSA-8935690	REAC	Digestion	10790	704	NA	NA	0	0.5	-	1	22	10768	3	0	19	10768	10790	0.3689491133725971
316	R1	e019_R1	TRUE	8.727037315314161e-24	11	8	8	1	0.7272727272727273	REAC:R-HSA-629594	REAC	Highly calcium permeable postsynaptic nicotinic acetylcholine receptors	10790	1066	NA	GO:0065008;GO:0032501;GO:0050896;GO:0007154	0	0.02439024390243902	-	1	11	10779	8	0	3	10779	10790	0.8526842145884175
317	R1	e019_R1	TRUE	2.885350761431304e-13	4	4	4	1	1	REAC:R-HSA-112126	REAC	ALKBH3 mediated reversal of alkylation damage	10790	16	NA	GO:0006508;GO:0006304;GO:0009057	0	0.0625	-	1	4	10786	4	0	0	10786	10790	0.9999999999999998
318	R1	e019_R1	TRUE	8.509961283083633e-10	19	4	4	1	0.21052631578947367	GO:0044804	GO:BP	autophagy of nucleus	16324	11850	NA	GO:0022411;GO:0007033;GO:0022607;GO:0006914;GO:0007005;GO:0050789	0	0.03125	-	1	19	16305	4	0	15	16305	16324	0.458620559218033
319	R1	e019_R1	TRUE	5.1788847405006575e-19	207	27	15	0.5555555555555556	0.07246376811594203	GO:0071559	GO:BP	response to transforming growth factor beta	16324	17709	NA	GO:0050789;GO:0050896	0	0.01515151515151515	-	1	207	16117	15	12	192	16105	16324	0.19748179866890803
320	R1	e019_R1	TRUE	1.3851547860864964e-4	6	3	2	0.6666666666666666	0.3333333333333333	REAC:R-HSA-2142700	REAC	Synthesis of Lipoxins (LX)	10790	2255	NA	GO:0006082	0	0.14285714285714285	-	1	6	10784	2	1	4	10783	10790	0.4712078427331372
321	R1	e019_R1	TRUE	2.309603745482753e-17	214	12	11	0.9166666666666666	0.0514018691588785	GO:0007188	GO:BP	adenylate cyclase-modulating G protein-coupled receptor signaling pathway	16324	2811	NA	GO:0050789	0	0.0625	-	1	214	16110	11	1	203	16109	16324	0.2154589630644146
322	R1	e019_R1	TRUE	5.771655679604725e-4	5	5	2	0.4	0.4	GO:1990116	GO:BP	ribosome-associated ubiquitin-dependent protein catabolic process	16324	26316	NA	GO:0006508;GO:0009057	0	0.5	-	1	5	16319	2	3	3	16316	16324	0.3998161652062013
323	R1	e019_R1	TRUE	1.0938609966116439e-27	32	34	14	0.4117647058823529	0.4375	GO:0000184	GO:BP	nuclear-transcribed mRNA catabolic process, nonsense-mediated decay	16324	61	NA	GO:0016070;GO:0050789;GO:0009057	0	0.0175438596491228	-	1	32	16292	14	20	18	16272	16324	0.423272381584861
324	R1	e019_R1	TRUE	4.843994547546717e-6	403	12	7	0.5833333333333334	0.0173697270471464	GO:1903530	GO:BP	regulation of secretion by cell	16324	24181	NA	GO:0006836;GO:0065008;GO:0046903;GO:0050789	0	0.02941176470588235	-	1	403	15921	7	5	396	15916	16324	0.09764778871014908
325	R1	e019_R1	TRUE	1.452454006172952e-9	628	20	12	0.6	0.01910828025477707	GO:0046649	GO:BP	lymphocyte activation	16324	12996	NA	GO:0002376;GO:0008283;GO:0050789;GO:0006949;GO:0001775	0	0.02272727272727272	-	1	628	15696	12	8	616	15688	16324	0.10225684817997964
327	R1	e019_R1	TRUE	1.025532861553547e-13	13	5	5	1	0.38461538461538464	GO:0006465	GO:BP	signal peptide processing	16324	2257	NA	GO:0006518;GO:0006508;GO:0051604	0	0.06666666666666667	-	1	13	16311	5	0	8	16311	16324	0.6200216416456159
328	R1	e019_R1	TRUE	2.3799231008254785e-4	13	2	2	1	0.15384615384615383	GO:1990253	GO:BP	cellular response to leucine starvation	16324	26357	NA	GO:0050896;GO:0007154	0	0.3333333333333333	-	1	13	16311	2	0	11	16311	16324	0.3921000780771072
329	R1	e019_R1	TRUE	2.678823382576616e-9	4	3	3	1	0.75	GO:0070681	GO:BP	glutaminyl-tRNAGln biosynthesis via transamidation	16324	17192	NA	GO:0016070;GO:0006520	0	0.125	-	1	4	16320	3	0	1	16320	16324	0.8659988723626599
333	R1	e019_R1	TRUE	1.0098727665009536e-11	7	4	4	1	0.5714285714285714	REAC:R-HSA-3371599	REAC	Defective HLCS causes multiple carboxylase deficiency	10790	546	NA	GO:0006520	0	0.04166666666666666	-	1	7	10783	4	0	3	10783	10790	0.7558238123011543
334	R1	e019_R1	TRUE	6.489449644291878e-7	19	3	3	1	0.15789473684210523	GO:1903232	GO:BP	melanosome assembly	16324	23932	NA	GO:0022607;GO:0048753	0	0.125	-	1	19	16305	3	0	16	16305	16324	0.39716488712514914
335	R1	e019_R1	TRUE	1.9148327014011882e-10	45	5	5	1	0.1111111111111111	REAC:R-HSA-8955332	REAC	Carboxyterminal post-translational modifications of tubulin	10790	294	NA	GO:0036211	0	0.3333333333333333	-	1	45	10745	5	0	40	10745	10790	0.3327146166359638
338	R1	e019_R1	TRUE	1.0703909629942333e-13	328	19	13	0.6842105263157895	0.03963414634146341	REAC:R-HSA-373076	REAC	Class A/1 (Rhodopsin-like receptors)	10790	350	NA	GO:0008015;GO:0065008;GO:0050789;GO:0050886	0	0.02325581395348837	-	1	328	10462	13	6	315	10456	10790	0.1599480117525157
339	R1	e019_R1	TRUE	2.3890338748334942e-17	49	12	9	0.75	0.1836734693877551	REAC:R-HSA-6811440	REAC	Retrograde transport at the Trans-Golgi-Network	10790	1974	NA	GO:0051641;GO:0016192	0	0.0625	-	1	49	10741	9	3	40	10738	10790	0.3699526999914772
340	R1	e019_R1	TRUE	3.705688422985404e-16	493	17	14	0.8235294117647058	0.02839756592292089	GO:0010498	GO:BP	proteasomal protein catabolic process	16324	4267	NA	GO:0050896;GO:0006508;GO:0009057	0	0.05263157894736842	-	1	493	15831	14	3	479	15828	16324	0.14967160744011188
342	R1	e019_R1	TRUE	9.521657512723284e-11	11	4	4	1	0.3636363636363637	REAC:R-HSA-2534343	REAC	Interaction With Cumulus Cells And The Zona Pellucida	10790	1158	NA	GO:0050789;GO:0008037	0	0.04545454545454545	-	1	11	10779	4	0	7	10779	10790	0.6028269797211547
345	R1	e019_R1	TRUE	5.822136571509578e-7	17	3	3	1	0.17647058823529413	REAC:R-HSA-162710	REAC	Synthesis of glycosylphosphatidylinositol (GPI)	10790	2279	NA	GO:0036211;GO:0044255;GO:0009059;GO:0006793	0	0.04761904761904761	-	1	17	10773	3	0	14	10773	10790	0.41981133188190056
346	R1	e019_R1	TRUE	3.32174099439503e-6	32	3	3	1	0.09375	GO:0050982	GO:BP	detection of mechanical stimulus	16324	14177	NA	GO:0051606	0	0.07692307692307693	-	1	32	16292	3	0	29	16292	16324	0.3059140731211466
347	R1	e019_R1	TRUE	7.793719113186276e-10	752	14	11	0.7857142857142857	0.01462765957446808	GO:0007186	GO:BP	G protein-coupled receptor signaling pathway	16324	2809	NA	GO:0050789;GO:0048511	0	0.05	-	1	752	15572	11	3	741	15569	16324	0.1033729930615322
348	R1	e019_R1	TRUE	3.65282842753292e-7	81	4	4	1	0.04938271604938271	GO:0015914	GO:BP	phospholipid transport	16324	5133	NA	GO:0006869	0	0.1	-	1	81	16243	4	0	77	16243	16324	0.2216973649303074
349	R1	e019_R1	TRUE	2.7690049526898937e-18	8	6	6	1	0.75	REAC:R-HSA-444821	REAC	Relaxin receptors	10790	1937	NA	NA	0	0.125	-	1	8	10782	6	0	2	10782	10790	0.8659450935506884
350	R1	e019_R1	TRUE	1.6393729395523346e-4	6	3	2	0.6666666666666666	0.3333333333333333	GO:0072679	GO:BP	thymocyte migration	16324	18472	NA	GO:0002376	0	0.2	-	1	6	16318	2	1	4	16317	16324	0.4712745359351349
351	R1	e019_R1	TRUE	8.561965546337587e-10	3	3	3	1	1	REAC:R-HSA-4341670	REAC	Defective NEU1 causes sialidosis	10790	576	NA	NA	0	0.07692307692307693	-	1	3	10787	3	0	0	10787	10790	1
352	R1	e019_R1	TRUE	4.553999750380284e-7	17	3	3	1	0.17647058823529413	GO:0035269	GO:BP	protein O-linked mannosylation	16324	9415	NA	GO:0036211	0	0.07692307692307693	-	1	17	16307	3	0	14	16307	16324	0.4199038144952559
353	R1	e019_R1	TRUE	2.5052311188583843e-5	57	3	3	1	0.05263157894736842	REAC:R-HSA-380108	REAC	Chemokine receptors bind chemokines	10790	332	NA	GO:0050789	0	0.0625	-	1	57	10733	3	0	54	10733	10790	0.2288407828747956
354	R1	e019_R1	TRUE	3.1376851475660913e-13	14	5	5	1	0.35714285714285715	REAC:R-HSA-70221	REAC	Glycogen breakdown (glycogenolysis)	10790	1009	NA	GO:0005976;GO:0006112	0	0.08333333333333333	-	1	14	10776	5	0	9	10776	10790	0.5973649003419437
355	R1	e019_R1	TRUE	3.6616132912820656e-4	160	7	4	0.5714285714285714	0.025	REAC:R-HSA-5633007	REAC	Regulation of TP53 Activity	10790	1901	NA	GO:0050789;GO:0032501;GO:0050896	0	0.1111111111111111	-	1	160	10630	4	3	156	10627	10790	0.11733221278064436
356	R1	e019_R1	TRUE	1.2354204728458554e-12	20	5	5	1	0.25	GO:0051923	GO:BP	sulfation	16324	14785	NA	GO:0006790	0	0.08333333333333333	-	1	20	16304	5	0	15	16304	16324	0.49977015367842015
357	R1	e019_R1	TRUE	1.198131901569237e-20	12	7	7	1	0.5833333333333334	GO:0036444	GO:BP	calcium import into the mitochondrion	16324	10135	NA	GO:0006811	0	0.04166666666666666	-	1	12	16312	7	0	5	16312	16324	0.7636455873994056
358	R1	e019_R1	TRUE	3.051183462596768e-6	2	2	2	1	1	GO:0006183	GO:BP	GTP biosynthetic process	16324	2060	NA	GO:0009117	0	0.125	-	1	2	16322	2	0	0	16322	16324	1.0000000000000002
359	R1	e019_R1	TRUE	4.522382370526861e-6	196	7	5	0.7142857142857143	0.02551020408163265	GO:0098742	GO:BP	cell-cell adhesion via plasma-membrane adhesion molecules	16324	19918	NA	GO:0007155	0	0.25	-	1	196	16128	5	2	191	16126	16324	0.13355087800939738
360	R1	e019_R1	TRUE	1.027435865560509e-7	10	3	3	1	0.3	REAC:R-HSA-1462054	REAC	Alpha-defensins	10790	127	NA	GO:0002376;GO:0031640;GO:0050789;GO:0050896	0	0.02702702702702703	-	1	10	10780	3	0	7	10780	10790	0.5475448120656309
361	R1	e019_R1	TRUE	8.56196554633762e-9	5	3	3	1	0.6	REAC:R-HSA-9013425	REAC	RHOT1 GTPase cycle	10790	1780	NA	GO:0051640;GO:0051641;GO:0006810	0	0.05555555555555555	-	1	5	10785	3	0	2	10785	10790	0.7745248575629122
364	R1	e019_R1	TRUE	7.824780312797907e-6	39	3	3	1	0.07692307692307693	REAC:R-HSA-420499	REAC	Class C/3 (Metabotropic glutamate/pheromone receptors)	10790	352	NA	GO:0051606;GO:0050877	0	0.07692307692307693	-	1	39	10751	3	0	36	10751	10790	0.2768869040831114
366	R1	e019_R1	TRUE	1.473352860417147e-7	12	3	3	1	0.25	GO:0033539	GO:BP	fatty acid beta-oxidation using acyl-CoA dehydrogenase	16324	8714	NA	GO:0006082;GO:0044255	0	0.07692307692307693	-	1	12	16312	3	0	9	16312	16324	0.4998621217897952
367	R1	e019_R1	TRUE	1.3394116912883184e-8	6	3	3	1	0.5	GO:0071569	GO:BP	protein ufmylation	16324	17712	NA	GO:0036211;GO:0050789;GO:0050896	0	0.05	-	1	6	16318	3	0	3	16318	16324	0.7070417907498803
370	R1	e019_R1	TRUE	1.473352860417147e-7	12	3	3	1	0.25	GO:0034454	GO:BP	microtubule anchoring at centrosome	16324	9101	NA	GO:0006996	0	0.3333333333333333	-	1	12	16312	3	0	9	16312	16324	0.4998621217897952
371	R1	e019_R1	TRUE	9.760640722824867e-7	20	3	3	1	0.15	REAC:R-HSA-3781860	REAC	Diseases associated with N-glycosylation of proteins	10790	711	NA	GO:0044255	0	0.07692307692307693	-	1	20	10770	3	0	17	10770	10790	0.3869930287983954
372	R1	e019_R1	TRUE	1.3730325581685454e-4	10	2	2	1	0.2	GO:0006089	GO:BP	lactate metabolic process	16324	1996	NA	NA	0	0.1	-	1	10	16314	2	0	8	16314	16324	0.4471039843229439
373	R1	e019_R1	TRUE	6.697058456441566e-10	3	3	3	1	1	GO:0060183	GO:BP	apelin receptor signaling pathway	16324	15249	NA	GO:0032502;GO:0050789	0	0.03846153846153846	-	1	3	16321	3	0	0	16321	16324	1
