network_method	network_db	network_cutoff	experiment_info	func_module_number	significant	p_value	term_size	query_size	intersection_size	precision	recall	term_id	source	term_name	effective_domain_size	source_order	parents	perc_rank	cumelative_dist	P	N	tp	fp	fn	tn	tot_pop_valid	MCC
M1	string	0	network_modules	1	TRUE	2.978029672382265e-78	158	84	50	0.5952380952380952	0.31645569620253167	GO:0140053	GO:BP	mitochondrial gene expression	16175	19653		0	0.045454545454545456	158	16017	50	34	108	15983	16175	0.43010835746552173
M1	string	0	network_modules	1	TRUE	4.777886981530429e-65	127	84	42	0.5	0.33070866141732286	GO:0032543	GO:BP	mitochondrial translation	16175	7635		0.047619047619047616	0.09090909090909091	127	16048	42	42	85	16006	16175	0.4028804133245303
M1	string	0	network_modules	1	TRUE	3.329178170165147e-53	93	72	35	0.4861111111111111	0.3763440860215054	REAC:R-HSA-5368287	REAC	Mitochondrial translation	10916	1473		0	0.1111111111111111	93	10823	35	37	58	10786	10916	0.4234248206754861
M1	string	0	network_modules	1	TRUE	1.4365108956796477e-45	87	72	31	0.4305555555555556	0.3563218390804598	REAC:R-HSA-5419276	REAC	Mitochondrial translation termination	10916	1476		0.125	0.3333333333333333	87	10829	31	41	56	10788	10916	0.38725400223717077
M1	string	0	network_modules	1	TRUE	1.4365108956796477e-45	87	72	31	0.4305555555555556	0.3563218390804598	REAC:R-HSA-5368286	REAC	Mitochondrial translation initiation	10916	1475		0.125	0.3333333333333333	87	10829	31	41	56	10788	10916	0.38725400223717077
M1	string	0	network_modules	1	TRUE	2.606601067835045e-41	87	72	29	0.4027777777777778	0.3333333333333333	REAC:R-HSA-5389840	REAC	Mitochondrial translation elongation	10916	1474		0.375	0.4444444444444444	87	10829	29	43	58	10786	10916	0.3617986731004363
M1	string	0	network_modules	1	TRUE	3.8131636158267e-40	566	84	45	0.5357142857142857	0.07950530035335689	GO:0006412	GO:BP	translation	16175	2170		0.09523809523809523	0.13636363636363635	566	15609	45	39	521	15570	16175	0.19687625706996
M1	string	0	network_modules	1	TRUE	4.718033284065653e-37	292	72	37	0.5138888888888888	0.1267123287671233	REAC:R-HSA-72766	REAC	Translation	10916	2565		0.5	0.5555555555555556	292	10624	37	35	255	10589	10916	0.24600991460957883
M1	string	0	network_modules	1	TRUE	2.615095597939476e-13	42	84	11	0.13095238095238096	0.2619047619047619	GO:0000959	GO:BP	mitochondrial RNA metabolic process	16175	267		0.14285714285714285	0.18181818181818182	42	16133	11	73	31	16060	16175	0.1822324178131352
M1	string	0	network_modules	1	TRUE	4.017256941345332e-12	24	84	9	0.10714285714285714	0.375	GO:0070129	GO:BP	regulation of mitochondrial translation	16175	15928		0.19047619047619047	0.22727272727272727	24	16151	9	75	15	16076	16175	0.19833252208597574
M1	string	0	network_modules	1	TRUE	1.4220427232947641e-11	27	84	9	0.10714285714285714	0.3333333333333333	GO:0062125	GO:BP	regulation of mitochondrial gene expression	16175	15832		0.23809523809523808	0.2727272727272727	27	16148	9	75	18	16073	16175	0.1866787961891938
M1	string	0	network_modules	1	TRUE	3.381341619086519e-11	153	35	12	0.34285714285714286	0.0784313725490196	KEGG:03010	KEGG	Ribosome	8484	208		0	0.5	153	8331	12	23	141	8308	8484	0.15710310923849558
M1	string	0	network_modules	1	TRUE	2.134144323443649e-9	9	72	6	0.08333333333333333	0.6666666666666666	REAC:R-HSA-9836573	REAC	Mitochondrial RNA degradation	10916	1462		0.625	0.6666666666666666	9	10907	6	66	3	10841	10916	0.23424033065985744
M1	string	0	network_modules	1	TRUE	1.6026736960531167e-8	21	84	7	0.08333333333333333	0.3333333333333333	GO:0000963	GO:BP	mitochondrial RNA processing	16175	271		0.2857142857142857	0.3181818181818182	21	16154	7	77	14	16077	16175	0.1646046455938806
M1	string	0	network_modules	1	TRUE	2.327279160623073e-7	16	84	6	0.07142857142857142	0.375	GO:0070131	GO:BP	positive regulation of mitochondrial translation	16175	15930		0.3333333333333333	0.36363636363636365	16	16159	6	78	10	16081	16175	0.1618977351063706
M1	string	0	network_modules	1	TRUE	2.7951984834623627e-6	11	84	5	0.05952380952380952	0.45454545454545453	GO:0061668	GO:BP	mitochondrial ribosome assembly	16175	15605		0.38095238095238093	0.4090909090909091	11	16164	5	79	6	16085	16175	0.1630879884872507
M1	string	0	network_modules	1	TRUE	7.776689613400304e-6	47	84	7	0.08333333333333333	0.14893617021276595	GO:0042255	GO:BP	ribosome assembly	16175	10061		0.42857142857142855	0.45454545454545453	47	16128	7	77	40	16051	16175	0.10795889156984455
M1	string	0	network_modules	1	TRUE	2.5893994644286518e-5	16	84	5	0.05952380952380952	0.3125	GO:0006390	GO:BP	mitochondrial transcription	16175	2153		0.47619047619047616	0.5	16	16159	5	79	11	16080	16175	0.13453585742528953
M1	string	0	network_modules	1	TRUE	4.334593969795483e-5	7	84	4	0.047619047619047616	0.5714285714285714	GO:0000965	GO:BP	mitochondrial RNA 3'-end processing	16175	273		0.5238095238095238	0.5454545454545454	7	16168	4	80	3	16088	16175	0.16391964104949192
M1	string	0	network_modules	1	TRUE	8.401705359912148e-5	364	84	13	0.15476190476190477	0.03571428571428571	GO:0007005	GO:BP	mitochondrion organization	16175	2617		0.5714285714285714	0.5909090909090909	364	15811	13	71	351	15740	16175	0.06442940767407437
M1	string	0	network_modules	1	TRUE	2.502218071555414e-4	3	84	3	0.03571428571428571	1	GO:0000960	GO:BP	regulation of mitochondrial RNA catabolic process	16175	268		0.6190476190476191	0.6818181818181818	3	16172	3	81	0	16091	16175	0.18850836880457084
M1	string	0	network_modules	1	TRUE	2.502218071555414e-4	3	84	3	0.03571428571428571	1	GO:0000962	GO:BP	positive regulation of mitochondrial RNA catabolic process	16175	270		0.6190476190476191	0.6818181818181818	3	16172	3	81	0	16091	16175	0.18850836880457084
M1	string	0	network_modules	1	TRUE	5.485449646258313e-4	290	84	11	0.13095238095238096	0.03793103448275862	GO:0006417	GO:BP	regulation of translation	16175	2174		0.7142857142857143	0.7272727272727273	290	15885	11	73	279	15812	16175	0.0615415563504171
M1	string	0	network_modules	1	TRUE	9.971274030508813e-4	4	84	3	0.03571428571428571	0.75	GO:0070126	GO:BP	mitochondrial translational termination	16175	15926		0.7619047619047619	0.8181818181818182	4	16171	3	81	1	16090	16175	0.16297399793454923
M1	string	0	network_modules	1	TRUE	9.971274030508813e-4	4	84	3	0.03571428571428571	0.75	GO:0000957	GO:BP	mitochondrial RNA catabolic process	16175	265		0.7619047619047619	0.8181818181818182	4	16171	3	81	1	16090	16175	0.16297399793454923
M1	string	0	network_modules	1	TRUE	0.001872899867885871	103	72	7	0.09722222222222222	0.06796116504854369	REAC:R-HSA-611105	REAC	Respiratory electron transport	10916	2081		0.75	0.7777777777777778	103	10813	7	65	96	10748	10916	0.07398968817160041
M1	string	0	network_modules	1	TRUE	0.002483456144372514	5	84	3	0.03571428571428571	0.6	GO:1902775	GO:BP	mitochondrial large ribosomal subunit assembly	16175	22496		0.8571428571428571	0.8636363636363636	5	16170	3	81	2	16089	16175	0.145518780462203
M1	string	0	network_modules	1	TRUE	0.004360057654187937	434	84	12	0.14285714285714285	0.027649769585253458	GO:0010608	GO:BP	post-transcriptional regulation of gene expression	16175	4255		0.9047619047619048	0.9090909090909091	434	15741	12	72	422	15669	16175	0.051878243264646996
M1	string	0	network_modules	1	TRUE	0.004848076995583192	118	84	7	0.08333333333333333	0.059322033898305086	GO:0045727	GO:BP	positive regulation of translation	16175	11569		0.9523809523809523	0.9545454545454546	118	16057	7	77	111	15980	16175	0.06455807989140129
M1	string	0	network_modules	1	TRUE	0.00709057669917238	22	35	3	0.08571428571428572	0.13636363636363635	KEGG:00220	KEGG	Arginine biosynthesis	8484	21		1	1	22	8462	3	32	19	8430	8484	0.10519517485506276
M1	string	0	network_modules	1	TRUE	0.007815201971119205	177	72	8	0.1111111111111111	0.04519774011299435	REAC:R-HSA-1428517	REAC	Aerobic respiration and respiratory electron transport	10916	127		0.875	0.8888888888888888	177	10739	8	64	169	10675	10916	0.061223212506326986
M1	string	0	network_modules	1	TRUE	0.009431377857097235	53	72	5	0.06944444444444445	0.09433962264150944	REAC:R-HSA-2151201	REAC	Transcriptional activation of mitochondrial biogenesis	10916	2548		1	1	53	10863	5	67	48	10796	10916	0.0757150142112019
M1	string	0	network_modules	1	TRUE	0.009821226452205763	247	84	9	0.10714285714285714	0.03643724696356275	GO:0006520	GO:BP	amino acid metabolic process	16175	2241		1	1	247	15928	9	75	238	15853	16175	0.05413127699631876
M1	string	0	network_modules	3	TRUE	9.683251637867058e-7	774	78	20	0.2564102564102564	0.025839793281653745	GO:0007186	GO:BP	G protein-coupled receptor signaling pathway	16175	2744		0	0.25	774	15401	20	58	754	15343	16175	0.06801463168302031
M1	string	0	network_modules	3	TRUE	1.2346739980500962e-6	365	43	13	0.3023255813953488	0.03561643835616438	KEGG:04080	KEGG	Neuroactive ligand-receptor interaction	8484	263		0	0.5	365	8119	13	30	352	8089	8484	0.09121126580223766
M1	string	0	network_modules	3	TRUE	1.764316894150836e-6	96	78	9	0.11538461538461539	0.09375	GO:0007200	GO:BP	phospholipase C-activating G protein-coupled receptor signaling pathway	16175	2758		0.3333333333333333	0.5	96	16079	9	69	87	16010	16175	0.09918999925127671
M1	string	0	network_modules	3	TRUE	2.5220633271534837e-5	460	57	14	0.24561403508771928	0.030434782608695653	REAC:R-HSA-500792	REAC	GPCR ligand binding	10916	1019		0	0.25	460	10456	14	43	446	10413	10916	0.0733758896174126
M1	string	0	network_modules	3	TRUE	3.096026727574127e-4	328	57	11	0.19298245614035087	0.03353658536585366	REAC:R-HSA-373076	REAC	Class A/1 (Rhodopsin-like receptors)	10916	365		0.3333333333333333	0.5	328	10588	11	46	317	10542	10916	0.06914743174798776
M1	string	0	network_modules	3	TRUE	0.00242000710819232	251	43	8	0.18604651162790697	0.03187250996015936	KEGG:04020	KEGG	Calcium signaling pathway	8484	250		1	1	251	8233	8	35	243	8198	8484	0.06590665337486536
M1	string	0	network_modules	3	TRUE	0.0032363044690502628	625	78	14	0.1794871794871795	0.0224	GO:0008610	GO:BP	lipid biosynthetic process	16175	3206		0.6666666666666666	0.75	625	15550	14	64	611	15486	16175	0.05087008333379675
M1	string	0	network_modules	3	TRUE	0.003504800190985821	55	57	5	0.08771929824561403	0.09090909090909091	REAC:R-HSA-936837	REAC	Ion transport by P-type ATPases	10916	1275		0.6666666666666666	0.75	55	10861	5	52	50	10809	10916	0.08460471669974169
M1	string	0	network_modules	3	TRUE	0.0050711347446517506	213	57	8	0.14035087719298245	0.03755868544600939	REAC:R-HSA-416476	REAC	G alpha (q) signalling events	10916	988		1	1	213	10703	8	49	205	10654	10916	0.06329477316214488
M1	string	0	network_modules	3	TRUE	0.006253840994217908	129	78	7	0.08974358974358974	0.05426356589147287	GO:0007204	GO:BP	positive regulation of cytosolic calcium ion concentration	16175	2759		1	1	129	16046	7	71	122	15975	16175	0.0639920378360278
M1	string	0	network_modules	4	TRUE	1.113929142422275e-70	290	81	53	0.654320987654321	0.18275862068965518	GO:0007178	GO:BP	cell surface receptor protein serine/threonine kinase signaling pathway	16175	2740		0	0.006329113924050633	290	15885	53	28	237	15857	16175	0.3402412469297614
M1	string	0	network_modules	4	TRUE	8.141235962686733e-68	275	81	51	0.6296296296296297	0.18545454545454546	GO:0141091	GO:BP	transforming growth factor beta receptor superfamily signaling pathway	16175	20020		0.006369426751592357	0.012658227848101266	275	15900	51	30	224	15870	16175	0.336191549648087
M1	string	0	network_modules	4	TRUE	1.2266670382939515e-60	107	50	37	0.74	0.34579439252336447	KEGG:04350	KEGG	TGF-beta signaling pathway	8484	304		0	0.2	107	8377	37	13	70	8364	8484	0.5018788148895768
M1	string	0	network_modules	4	TRUE	9.214312224832573e-55	217	81	42	0.5185185185185185	0.1935483870967742	GO:0090092	GO:BP	regulation of transmembrane receptor protein serine/threonine kinase signaling pathway	16175	18013		0.012738853503184714	0.0189873417721519	217	15958	42	39	175	15919	16175	0.3114694377966696
M1	string	0	network_modules	4	TRUE	4.510364572404359e-54	117	81	36	0.4444444444444444	0.3076923076923077	GO:0030509	GO:BP	BMP signaling pathway	16175	6825		0.01910828025477707	0.02531645569620253	117	16058	36	45	81	16013	16175	0.3660220776299493
M1	string	0	network_modules	4	TRUE	3.733797743804134e-53	123	81	36	0.4444444444444444	0.2926829268292683	GO:0071773	GO:BP	cellular response to BMP stimulus	16175	16902		0.025477707006369428	0.0379746835443038	123	16052	36	45	87	16007	16175	0.35674687997457544
M1	string	0	network_modules	4	TRUE	3.733797743804134e-53	123	81	36	0.4444444444444444	0.2926829268292683	GO:0071772	GO:BP	response to BMP	16175	16901		0.025477707006369428	0.0379746835443038	123	16052	36	45	87	16007	16175	0.35674687997457544
M1	string	0	network_modules	4	TRUE	1.8278184681636768e-48	502	81	48	0.5925925925925926	0.09561752988047809	GO:0071363	GO:BP	cellular response to growth factor stimulus	16175	16615		0.03821656050955414	0.04430379746835443	502	15673	48	33	454	15640	16175	0.22973160889458913
M1	string	0	network_modules	4	TRUE	9.441684037481734e-48	519	81	48	0.5925925925925926	0.09248554913294797	GO:0070848	GO:BP	response to growth factor	16175	16340		0.044585987261146494	0.05063291139240506	519	15656	48	33	471	15623	16175	0.22563736084049635
M1	string	0	network_modules	4	TRUE	1.4395992896148272e-46	790	81	53	0.654320987654321	0.0670886075949367	GO:0007167	GO:BP	enzyme-linked receptor protein signaling pathway	16175	2731		0.050955414012738856	0.056962025316455694	790	15385	53	28	737	15357	16175	0.19929318071228613
M1	string	0	network_modules	4	TRUE	1.5880430000399487e-44	71	81	28	0.345679012345679	0.39436619718309857	GO:0060395	GO:BP	SMAD protein signal transduction	16175	14598		0.05732484076433121	0.06329113924050633	71	16104	28	53	43	16051	16175	0.36625343000845906
M1	string	0	network_modules	4	TRUE	8.219055836358419e-42	53	81	25	0.30864197530864196	0.4716981132075472	GO:0060390	GO:BP	regulation of SMAD protein signal transduction	16175	14595		0.06369426751592357	0.06962025316455696	53	16122	25	56	28	16066	16175	0.3790767175883689
M1	string	0	network_modules	4	TRUE	2.146326268087689e-39	122	53	28	0.5283018867924528	0.22950819672131148	REAC:R-HSA-9006936	REAC	Signaling by TGFB family members	10916	2310		0	0.09090909090909091	122	10794	28	25	94	10769	10916	0.34359870180197805
M1	string	0	network_modules	4	TRUE	2.5796395108273104e-38	31	53	20	0.37735849056603776	0.6451612903225806	REAC:R-HSA-201451	REAC	Signaling by BMP	10916	2224		0.1	0.18181818181818182	31	10885	20	33	11	10852	10916	0.49159213475521746
M1	string	0	network_modules	4	TRUE	1.2819079346744264e-37	35	81	21	0.25925925925925924	0.6	GO:0060391	GO:BP	positive regulation of SMAD protein signal transduction	16175	14596		0.07006369426751592	0.0759493670886076	35	16140	21	60	14	16080	16175	0.3925214218834454
M1	string	0	network_modules	4	TRUE	3.0188136786993307e-36	80	81	25	0.30864197530864196	0.3125	GO:0090100	GO:BP	positive regulation of transmembrane receptor protein serine/threonine kinase signaling pathway	16175	18018		0.07643312101910828	0.08227848101265822	80	16095	25	56	55	16039	16175	0.30711674047953785
M1	string	0	network_modules	4	TRUE	9.047964886793045e-31	41	81	19	0.2345679012345679	0.4634146341463415	GO:0032924	GO:BP	activin receptor signaling pathway	16175	7915		0.08280254777070063	0.08860759493670886	41	16134	19	62	22	16072	16175	0.3273722289659839
M1	string	0	network_modules	4	TRUE	2.324900550713063e-28	291	50	29	0.58	0.09965635738831616	KEGG:04060	KEGG	Cytokine-cytokine receptor interaction	8484	253		0.25	0.4	291	8193	29	21	262	8172	8484	0.2308633312851543
M1	string	0	network_modules	4	TRUE	1.7155219149100644e-23	126	81	21	0.25925925925925924	0.16666666666666666	GO:0090101	GO:BP	negative regulation of transmembrane receptor protein serine/threonine kinase signaling pathway	16175	18019		0.08917197452229299	0.0949367088607595	126	16049	21	60	105	15989	16175	0.20292277312660112
M1	string	0	network_modules	4	TRUE	1.4174668408928795e-22	256	81	25	0.30864197530864196	0.09765625	GO:0090287	GO:BP	regulation of cellular response to growth factor stimulus	16175	18171		0.09554140127388536	0.10126582278481013	256	15919	25	56	231	15863	16175	0.16644485237742657
M1	string	0	network_modules	4	TRUE	7.154596948787631e-22	176	81	22	0.2716049382716049	0.125	GO:0007179	GO:BP	transforming growth factor beta receptor signaling pathway	16175	2741		0.10191082802547771	0.10759493670886076	176	15999	22	59	154	15940	16175	0.1782924581782424
M1	string	0	network_modules	4	TRUE	1.2945983440145898e-20	78	81	17	0.20987654320987653	0.21794871794871795	GO:0030510	GO:BP	regulation of BMP signaling pathway	16175	6826		0.10828025477707007	0.11392405063291139	78	16097	17	64	61	16033	16175	0.2099925462142001
M1	string	0	network_modules	4	TRUE	1.624257815822203e-20	202	81	22	0.2716049382716049	0.10891089108910891	GO:0071560	GO:BP	cellular response to transforming growth factor beta stimulus	16175	16762		0.11464968152866242	0.12025316455696203	202	15973	22	59	180	15914	16175	0.16553162910200578
M1	string	0	network_modules	4	TRUE	3.137070129078097e-20	208	81	22	0.2716049382716049	0.10576923076923077	GO:0071559	GO:BP	response to transforming growth factor beta	16175	16761		0.12101910828025478	0.12658227848101267	208	15967	22	59	186	15908	16175	0.1629237592663512
M1	string	0	network_modules	4	TRUE	2.0322683170205613e-17	17	53	10	0.18867924528301888	0.5882352941176471	REAC:R-HSA-1502540	REAC	Signaling by Activin	10916	2223		0.2	0.2727272727272727	17	10899	10	43	7	10856	10916	0.3314617352332283
M1	string	0	network_modules	4	TRUE	2.878102272278787e-17	283	81	22	0.2716049382716049	0.07773851590106007	GO:0001501	GO:BP	skeletal system development	16175	318		0.12738853503184713	0.13291139240506328	283	15892	22	59	261	15833	16175	0.1374966172128095
M1	string	0	network_modules	4	TRUE	7.69797792739129e-16	92	81	15	0.18518518518518517	0.16304347826086957	GO:0045667	GO:BP	regulation of osteoblast differentiation	16175	11518		0.1337579617834395	0.13924050632911392	92	16083	15	66	77	16017	16175	0.1693306231934528
M1	string	0	network_modules	4	TRUE	1.287180420617674e-13	143	50	15	0.3	0.1048951048951049	KEGG:04550	KEGG	Signaling pathways regulating pluripotency of stem cells	8484	319		0.5	0.6	143	8341	15	35	128	8306	8484	0.1693558828383264
M1	string	0	network_modules	4	TRUE	1.3679413063735702e-13	159	81	16	0.19753086419753085	0.10062893081761007	GO:0001649	GO:BP	osteoblast differentiation	16175	367		0.14012738853503184	0.14556962025316456	159	16016	16	65	143	15951	16175	0.1349725695848411
M1	string	0	network_modules	4	TRUE	1.3733934672944744e-13	41	81	11	0.13580246913580246	0.2682926829268293	GO:0003197	GO:BP	endocardial cushion development	16175	1627		0.1464968152866242	0.1518987341772152	41	16134	11	70	30	16064	16175	0.18802548869875613
M1	string	0	network_modules	4	TRUE	3.2942210689801854e-13	44	81	11	0.13580246913580246	0.25	GO:0030514	GO:BP	negative regulation of BMP signaling pathway	16175	6830		0.15286624203821655	0.15822784810126583	44	16131	11	70	33	16061	16175	0.18126662944552846
M1	string	0	network_modules	4	TRUE	5.263863823696868e-13	250	81	18	0.2222222222222222	0.072	GO:0007389	GO:BP	pattern specification process	16175	2889		0.1592356687898089	0.16455696202531644	250	15925	18	63	232	15862	16175	0.11891175045908256
M1	string	0	network_modules	4	TRUE	6.970751109627136e-13	254	81	18	0.2222222222222222	0.07086614173228346	GO:0001503	GO:BP	ossification	16175	320		0.16560509554140126	0.17088607594936708	254	15921	18	63	236	15858	16175	0.11784542711309201
M1	string	0	network_modules	4	TRUE	7.013344705433708e-13	21	81	9	0.1111111111111111	0.42857142857142855	GO:0032925	GO:BP	regulation of activin receptor signaling pathway	16175	7916		0.17197452229299362	0.17721518987341772	21	16154	9	72	12	16082	16175	0.21635060973602627
M1	string	0	network_modules	4	TRUE	9.551998319745098e-13	48	81	11	0.13580246913580246	0.22916666666666666	GO:0060411	GO:BP	cardiac septum morphogenesis	16175	14612		0.17834394904458598	0.18354430379746836	48	16127	11	70	37	16057	16175	0.17324857408006372
M1	string	0	network_modules	4	TRUE	1.7409572909171143e-12	225	81	17	0.20987654320987653	0.07555555555555556	GO:0003002	GO:BP	regionalization	16175	1453		0.18471337579617833	0.189873417721519	225	15950	17	64	208	15886	16175	0.11870372335208089
M1	string	0	network_modules	4	TRUE	3.230923753597294e-12	615	81	24	0.2962962962962963	0.03902439024390244	GO:0045597	GO:BP	positive regulation of cell differentiation	16175	11448		0.1910828025477707	0.1962025316455696	615	15560	24	57	591	15503	16175	0.09580633814962573
M1	string	0	network_modules	4	TRUE	4.781683729945012e-12	239	81	17	0.20987654320987653	0.07112970711297072	GO:0060485	GO:BP	mesenchyme development	16175	14679		0.19745222929936307	0.20253164556962025	239	15936	17	64	222	15872	16175	0.1147162430846578
M1	string	0	network_modules	4	TRUE	6.312803397182593e-12	39	81	10	0.12345679012345678	0.2564102564102564	GO:0030501	GO:BP	positive regulation of bone mineralization	16175	6822		0.20382165605095542	0.2088607594936709	39	16136	10	71	29	16065	16175	0.17509501570232386
M1	string	0	network_modules	4	TRUE	1.2866944132946958e-11	157	50	14	0.28	0.08917197452229299	KEGG:04390	KEGG	Hippo signaling pathway	8484	310		0.75	0.8	157	8327	14	36	143	8291	8484	0.14939547503098788
M1	string	0	network_modules	4	TRUE	1.5516324074925628e-11	83	81	12	0.14814814814814814	0.14457831325301204	GO:0003206	GO:BP	cardiac chamber morphogenesis	16175	1636		0.21019108280254778	0.21518987341772153	83	16092	12	69	71	16023	16175	0.14200306402228555
M1	string	0	network_modules	4	TRUE	1.8736213685841825e-11	43	81	10	0.12345679012345678	0.23255813953488372	GO:0045778	GO:BP	positive regulation of ossification	16175	11612		0.21656050955414013	0.22151898734177214	43	16132	10	71	33	16061	16175	0.16643226663361216
M1	string	0	network_modules	4	TRUE	2.0321640797033967e-11	62	81	11	0.13580246913580246	0.1774193548387097	GO:0003279	GO:BP	cardiac septum development	16175	1703		0.2229299363057325	0.22784810126582278	62	16113	11	70	51	16043	16175	0.1515109329563995
M1	string	0	network_modules	4	TRUE	6.264902720914529e-11	48	81	10	0.12345679012345678	0.20833333333333334	GO:0070169	GO:BP	positive regulation of biomineral tissue development	16175	15962		0.22929936305732485	0.23417721518987342	48	16127	10	71	38	16056	16175	0.15714685039058948
M1	string	0	network_modules	4	TRUE	7.223757778763879e-11	123	81	13	0.16049382716049382	0.10569105691056911	GO:0017015	GO:BP	regulation of transforming growth factor beta receptor signaling pathway	16175	5276		0.2356687898089172	0.24050632911392406	123	16052	13	68	110	15984	16175	0.12485769926016868
M1	string	0	network_modules	4	TRUE	7.839831360046304e-11	49	81	10	0.12345679012345678	0.20408163265306123	GO:0045669	GO:BP	positive regulation of osteoblast differentiation	16175	11520		0.24203821656050956	0.2468354430379747	49	16126	10	71	39	16055	16175	0.15546005913402694
M1	string	0	network_modules	4	TRUE	8.93593068342988e-11	125	81	13	0.16049382716049382	0.104	GO:1903844	GO:BP	regulation of cellular response to transforming growth factor beta stimulus	16175	23323		0.2484076433121019	0.25316455696202533	125	16050	13	68	112	15982	16175	0.12376235412552594
M1	string	0	network_modules	4	TRUE	1.1878309074073035e-10	34	81	9	0.1111111111111111	0.2647058823529412	GO:0003203	GO:BP	endocardial cushion morphogenesis	16175	1633		0.25477707006369427	0.25949367088607594	34	16141	9	72	25	16069	16175	0.16885459534325006
M1	string	0	network_modules	4	TRUE	1.2263824796136935e-10	98	81	12	0.14814814814814814	0.12244897959183673	GO:0003205	GO:BP	cardiac chamber development	16175	1635		0.2611464968152866	0.26582278481012656	98	16077	12	69	86	16008	16175	0.1298975573267977
M1	string	0	network_modules	4	TRUE	3.8241962359640017e-10	24	81	8	0.09876543209876543	0.3333333333333333	GO:0003272	GO:BP	endocardial cushion formation	16175	1696		0.267515923566879	0.2721518987341772	24	16151	8	73	16	16078	16175	0.1793000651522408
M1	string	0	network_modules	4	TRUE	3.89924599282542e-10	80	81	11	0.13580246913580246	0.1375	GO:0030278	GO:BP	regulation of ossification	16175	6755		0.27388535031847133	0.27848101265822783	80	16095	11	70	69	16025	16175	0.13233046299027224
M1	string	0	network_modules	4	TRUE	5.698072045994849e-10	144	81	13	0.16049382716049382	0.09027777777777778	GO:0001837	GO:BP	epithelial to mesenchymal transition	16175	494		0.2802547770700637	0.2848101265822785	144	16031	13	68	131	15963	16175	0.11448991607859571
M1	string	0	network_modules	4	TRUE	6.044893402086187e-10	40	81	9	0.1111111111111111	0.225	GO:0072132	GO:BP	mesenchyme morphogenesis	16175	17163		0.28662420382165604	0.2911392405063291	40	16135	9	72	31	16063	16175	0.1551753441427066
M1	string	0	network_modules	4	TRUE	6.803013337686866e-10	84	81	11	0.13580246913580246	0.13095238095238096	GO:0090288	GO:BP	negative regulation of cellular response to growth factor stimulus	16175	18172		0.2929936305732484	0.2974683544303797	84	16091	11	70	73	16021	16175	0.128913274842633
M1	string	0	network_modules	4	TRUE	7.713959904448203e-10	41	81	9	0.1111111111111111	0.21951219512195122	GO:0009953	GO:BP	dorsal/ventral pattern formation	16175	3791		0.29936305732484075	0.3037974683544304	41	16134	9	72	32	16062	16175	0.15318880363194917
M1	string	0	network_modules	4	TRUE	1.105416732790972e-9	512	81	20	0.24691358024691357	0.0390625	GO:0009790	GO:BP	embryo development	16175	3677		0.3057324840764331	0.310126582278481	512	15663	20	61	492	15602	16175	0.08722586103993615
M1	string	0	network_modules	4	TRUE	1.1527850567093298e-9	63	81	10	0.12345679012345678	0.15873015873015872	GO:0030500	GO:BP	regulation of bone mineralization	16175	6821		0.31210191082802546	0.31645569620253167	63	16112	10	71	53	16041	16175	0.13617662697028862
M1	string	0	network_modules	4	TRUE	2.15415049092751e-9	93	81	11	0.13580246913580246	0.11827956989247312	GO:0051216	GO:BP	cartilage development	16175	13573		0.3184713375796178	0.3227848101265823	93	16082	11	70	82	16012	16175	0.12202903852171668
M1	string	0	network_modules	4	TRUE	3.4929169103266363e-9	129	81	12	0.14814814814814814	0.09302325581395349	GO:0061448	GO:BP	connective tissue development	16175	15483		0.3248407643312102	0.3291139240506329	129	16046	12	69	117	15977	16175	0.1117996748421851
M1	string	0	network_modules	4	TRUE	3.6891931067141654e-9	18	81	7	0.08641975308641975	0.3888888888888889	GO:0061036	GO:BP	positive regulation of cartilage development	16175	15153		0.33121019108280253	0.33544303797468356	18	16157	7	74	11	16083	16175	0.18151915909609426
M1	string	0	network_modules	4	TRUE	4.857805711416915e-9	170	81	13	0.16049382716049382	0.07647058823529412	GO:0003007	GO:BP	heart morphogenesis	16175	1458		0.3375796178343949	0.34177215189873417	170	16005	13	68	157	15937	16175	0.10433903060575625
M1	string	0	network_modules	4	TRUE	7.076764905831657e-9	434	81	18	0.2222222222222222	0.041474654377880185	GO:0045596	GO:BP	negative regulation of cell differentiation	16175	11447		0.34394904458598724	0.34810126582278483	434	15741	18	63	416	15678	16175	0.08578229227090738
M1	string	0	network_modules	4	TRUE	7.778457335800755e-9	501	81	19	0.2345679012345679	0.03792415169660679	GO:0008285	GO:BP	negative regulation of cell population proliferation	16175	3152		0.3503184713375796	0.35443037974683544	501	15674	19	62	482	15612	16175	0.08337030058787562
M1	string	0	network_modules	4	TRUE	1.3318457462370254e-8	21	81	7	0.08641975308641975	0.3333333333333333	GO:0061384	GO:BP	heart trabecula morphogenesis	16175	15455		0.35668789808917195	0.36075949367088606	21	16154	7	74	14	16080	16175	0.16770427874529514
M1	string	0	network_modules	4	TRUE	1.499294016102859e-8	36	81	8	0.09876543209876543	0.2222222222222222	GO:0061035	GO:BP	regulation of cartilage development	16175	15152		0.3630573248407643	0.3670886075949367	36	16139	8	73	28	16066	16175	0.14533543752855993
M1	string	0	network_modules	4	TRUE	2.0249815986254598e-8	83	81	10	0.12345679012345678	0.12048192771084337	GO:0070167	GO:BP	regulation of biomineral tissue development	16175	15960		0.36942675159235666	0.37341772151898733	83	16092	10	71	73	16021	16175	0.11748671932084974
M1	string	0	network_modules	4	TRUE	2.5736646161067375e-8	59	81	9	0.1111111111111111	0.15254237288135594	GO:0002062	GO:BP	chondrocyte differentiation	16175	653		0.37579617834394907	0.379746835443038	59	16116	9	72	50	16044	16175	0.12646232837330698
M1	string	0	network_modules	4	TRUE	2.584314850194589e-8	85	81	10	0.12345679012345678	0.11764705882352941	GO:0030282	GO:BP	bone mineralization	16175	6757		0.3821656050955414	0.3860759493670886	85	16090	10	71	75	16019	16175	0.11598218441721961
M1	string	0	network_modules	4	TRUE	3.1522771973585566e-8	543	81	19	0.2345679012345679	0.034990791896869246	GO:0009887	GO:BP	animal organ morphogenesis	16175	3747		0.3885350318471338	0.3924050632911392	543	15632	19	62	524	15570	16175	0.07916595108271539
M1	string	0	network_modules	4	TRUE	4.086152334990506e-8	201	81	13	0.16049382716049382	0.06467661691542288	GO:0048762	GO:BP	mesenchymal cell differentiation	16175	13013		0.39490445859872614	0.3987341772151899	201	15974	13	68	188	15906	16175	0.09482195850673505
M1	string	0	network_modules	4	TRUE	5.418174302207176e-8	25	81	7	0.08641975308641975	0.28	GO:0061383	GO:BP	trabecula morphogenesis	16175	15454		0.4012738853503185	0.4050632911392405	25	16150	7	74	18	16076	16175	0.15327594826680757
M1	string	0	network_modules	4	TRUE	6.46208220852934e-8	93	81	10	0.12345679012345678	0.10752688172043011	GO:0010717	GO:BP	regulation of epithelial to mesenchymal transition	16175	4343		0.40764331210191085	0.41139240506329117	93	16082	10	71	83	16011	16175	0.11044504573984447
M1	string	0	network_modules	4	TRUE	1.2549077974701806e-7	744	81	21	0.25925925925925924	0.028225806451612902	GO:0072359	GO:BP	circulatory system development	16175	17370		0.4140127388535032	0.4177215189873418	744	15431	21	60	723	15371	16175	0.0722246570474212
M1	string	0	network_modules	4	TRUE	1.6203225334625767e-7	331	81	15	0.18518518518518517	0.045317220543806644	GO:0048729	GO:BP	tissue morphogenesis	16175	12986		0.42038216560509556	0.4240506329113924	331	15844	15	66	316	15778	16175	0.08253890300901096
M1	string	0	network_modules	4	TRUE	1.7312140245808964e-7	29	81	7	0.08641975308641975	0.2413793103448276	GO:0060412	GO:BP	ventricular septum morphogenesis	16175	14613		0.4267515923566879	0.43037974683544306	29	16146	7	74	22	16072	16175	0.14191606766385145
M1	string	0	network_modules	4	TRUE	1.7942995156994665e-7	4	53	4	0.07547169811320754	1	REAC:R-HSA-2473224	REAC	Antagonism of Activin by Follistatin	10916	149		0.3	0.36363636363636365	4	10912	4	49	0	10863	10916	0.27410362051008885
M1	string	0	network_modules	4	TRUE	1.9860147344592292e-7	140	81	11	0.13580246913580246	0.07857142857142857	GO:0048738	GO:BP	cardiac muscle tissue development	16175	12995		0.43312101910828027	0.43670886075949367	140	16035	11	70	129	15965	16175	0.09737845622927947
M1	string	0	network_modules	4	TRUE	2.0099860885620673e-7	16	81	6	0.07407407407407407	0.375	GO:0032926	GO:BP	negative regulation of activin receptor signaling pathway	16175	7917		0.4394904458598726	0.4430379746835443	16	16159	6	75	10	16084	16175	0.1649358964937593
M1	string	0	network_modules	4	TRUE	2.120600393784717e-7	49	81	8	0.09876543209876543	0.16326530612244897	GO:0060840	GO:BP	artery development	16175	14985		0.445859872611465	0.44936708860759494	49	16126	8	73	41	16053	16175	0.12358592401645403
M1	string	0	network_modules	4	TRUE	2.8115245794537185e-7	617	81	19	0.2345679012345679	0.03079416531604538	GO:0051093	GO:BP	negative regulation of developmental process	16175	13488		0.45222929936305734	0.45569620253164556	617	15558	19	62	598	15496	16175	0.07274896582525424
M1	string	0	network_modules	4	TRUE	3.1379099738076007e-7	347	81	15	0.18518518518518517	0.043227665706051875	GO:0007507	GO:BP	heart development	16175	2993		0.4585987261146497	0.4620253164556962	347	15828	15	66	332	15762	16175	0.08016992423339699
M1	string	0	network_modules	4	TRUE	3.593325737546624e-7	626	81	19	0.2345679012345679	0.03035143769968051	GO:0035295	GO:BP	tube development	16175	8953		0.46496815286624205	0.46835443037974683	626	15549	19	62	607	15487	16175	0.0720403645690805
M1	string	0	network_modules	4	TRUE	4.261197937561841e-7	795	81	21	0.25925925925925924	0.026415094339622643	GO:0051241	GO:BP	negative regulation of multicellular organismal process	16175	13591		0.4713375796178344	0.47468354430379744	795	15380	21	60	774	15320	16175	0.06895065872855154
M1	string	0	network_modules	4	TRUE	4.6225471111460656e-7	18	81	6	0.07407407407407407	0.3333333333333333	GO:0060037	GO:BP	pharyngeal system development	16175	14300		0.47770700636942676	0.4810126582278481	18	16157	6	75	12	16082	16175	0.15524957685465157
M1	string	0	network_modules	4	TRUE	5.353517126410395e-7	247	81	13	0.16049382716049382	0.05263157894736842	GO:0030336	GO:BP	negative regulation of cell migration	16175	6782		0.4840764331210191	0.4873417721518987	247	15928	13	68	234	15860	16175	0.084016027877522
M1	string	0	network_modules	4	TRUE	6.113020490714749e-7	83	81	9	0.1111111111111111	0.10843373493975904	GO:0030512	GO:BP	negative regulation of transforming growth factor beta receptor signaling pathway	16175	6828		0.49044585987261147	0.4936708860759494	83	16092	9	72	74	16020	16175	0.10522854697013183
M1	string	0	network_modules	4	TRUE	6.219383303722243e-7	12	53	5	0.09433962264150944	0.4166666666666667	REAC:R-HSA-1433617	REAC	Regulation of signaling by NODAL	10916	2050		0.4	0.45454545454545453	12	10904	5	48	7	10856	10916	0.19653811104095864
M1	string	0	network_modules	4	TRUE	6.479609375100083e-7	117	81	10	0.12345679012345678	0.08547008547008547	GO:0031214	GO:BP	biomineral tissue development	16175	7090		0.4968152866242038	0.5	117	16058	10	71	107	15987	16175	0.09729930506796212
M1	string	0	network_modules	4	TRUE	7.659382937067056e-7	504	81	17	0.20987654320987653	0.03373015873015873	GO:0001944	GO:BP	vasculature development	16175	555		0.5031847133757962	0.5063291139240507	504	15671	17	64	487	15607	16175	0.07297227488157468
M1	string	0	network_modules	4	TRUE	9.147890669013434e-7	207	81	12	0.14814814814814814	0.057971014492753624	GO:0014706	GO:BP	striated muscle tissue development	16175	4643		0.5095541401273885	0.5126582278481012	207	15968	12	69	195	15899	16175	0.08542886149698649
M1	string	0	network_modules	4	TRUE	9.60435977118493e-7	259	81	13	0.16049382716049382	0.05019305019305019	GO:2000146	GO:BP	negative regulation of cell motility	16175	25494		0.5159235668789809	0.5189873417721519	259	15916	13	68	246	15848	16175	0.0816582525168861
M1	string	0	network_modules	4	TRUE	1.6849509508599095e-6	770	81	20	0.24691358024691357	0.025974025974025976	GO:0048646	GO:BP	anatomical structure formation involved in morphogenesis	16175	12904		0.5222929936305732	0.5253164556962026	770	15405	20	61	750	15344	16175	0.06640580517179012
M1	string	0	network_modules	4	TRUE	1.9378461769767443e-6	221	81	12	0.14814814814814814	0.05429864253393665	GO:0060537	GO:BP	muscle tissue development	16175	14726		0.5286624203821656	0.5316455696202531	221	15954	12	69	209	15885	16175	0.0821860296808805
M1	string	0	network_modules	4	TRUE	1.9786660075141624e-6	40	81	7	0.08641975308641975	0.175	GO:0003281	GO:BP	ventricular septum development	16175	1704		0.535031847133758	0.5379746835443038	40	16135	7	74	33	16061	16175	0.11990698159648425
M1	string	0	network_modules	4	TRUE	2.155016466603544e-6	781	81	20	0.24691358024691357	0.02560819462227913	GO:0030334	GO:BP	regulation of cell migration	16175	6780		0.5414012738853503	0.5443037974683544	781	15394	20	61	761	15333	16175	0.06573499215849614
M1	string	0	network_modules	4	TRUE	2.8382928254381487e-6	283	81	13	0.16049382716049382	0.045936395759717315	GO:0040013	GO:BP	negative regulation of locomotion	16175	9901		0.5477707006369427	0.5506329113924051	283	15892	13	68	270	15824	16175	0.07737511895416799
M1	string	0	network_modules	4	TRUE	3.212306847364776e-6	480	81	16	0.19753086419753085	0.03333333333333333	GO:0001568	GO:BP	blood vessel development	16175	353		0.554140127388535	0.5569620253164557	480	15695	16	65	464	15630	16175	0.07017605335536171
M1	string	0	network_modules	4	TRUE	3.2723940020796307e-6	24	81	6	0.07407407407407407	0.25	GO:0060317	GO:BP	cardiac epithelial to mesenchymal transition	16175	14529		0.5605095541401274	0.5632911392405063	24	16151	6	75	18	16076	16175	0.13379136326551133
M1	string	0	network_modules	4	TRUE	6.4915120404114785e-6	194	81	11	0.13580246913580246	0.05670103092783505	GO:0009792	GO:BP	embryo development ending in birth or egg hatching	16175	3679		0.5668789808917197	0.569620253164557	194	15981	11	70	183	15911	16175	0.0806868856666747
M1	string	0	network_modules	4	TRUE	7.95391689525443e-6	76	81	8	0.09876543209876543	0.10526315789473684	GO:0003231	GO:BP	cardiac ventricle development	16175	1661		0.5732484076433121	0.5759493670886076	76	16099	8	73	68	16026	16175	0.09758544143882408
M1	string	0	network_modules	4	TRUE	8.09783407138978e-6	512	81	16	0.19753086419753085	0.03125	GO:0040007	GO:BP	growth	16175	9895		0.5796178343949044	0.5822784810126582	512	15663	16	65	496	15598	16175	0.06721538970629598
M1	string	0	network_modules	4	TRUE	1.0184041606004469e-5	50	81	7	0.08641975308641975	0.14	GO:0010718	GO:BP	positive regulation of epithelial to mesenchymal transition	16175	4344		0.5859872611464968	0.5886075949367089	50	16125	7	74	43	16051	16175	0.10649122646019707
M1	string	0	network_modules	4	TRUE	1.7373489761589487e-5	6	81	4	0.04938271604938271	0.6666666666666666	GO:0003223	GO:BP	ventricular compact myocardium morphogenesis	16175	1653		0.5923566878980892	0.5949367088607594	6	16169	4	77	2	16092	16175	0.18056684511241167
M1	string	0	network_modules	4	TRUE	1.8032296770460233e-5	121	81	9	0.1111111111111111	0.0743801652892562	GO:0033002	GO:BP	muscle cell proliferation	16175	7971		0.5987261146496815	0.6012658227848101	121	16054	9	72	112	15982	16175	0.08532136413226796
M1	string	0	network_modules	4	TRUE	2.0250440465512517e-5	272	81	12	0.14814814814814814	0.04411764705882353	GO:0050673	GO:BP	epithelial cell proliferation	16175	13207		0.6050955414012739	0.6075949367088608	272	15903	12	69	260	15834	16175	0.07246054920200189
M1	string	0	network_modules	4	TRUE	2.3083629016852384e-5	56	81	7	0.08641975308641975	0.125	GO:0003151	GO:BP	outflow tract morphogenesis	16175	1583		0.6114649681528662	0.6139240506329114	56	16119	7	74	49	16045	16175	0.10019545549323793
M1	string	0	network_modules	4	TRUE	2.350697073783786e-5	552	81	16	0.19753086419753085	0.028985507246376812	GO:0035239	GO:BP	tube morphogenesis	16175	8921		0.6178343949044586	0.620253164556962	552	15623	16	65	536	15558	16175	0.06385075866391113
M1	string	0	network_modules	4	TRUE	2.537782479135632e-5	23	53	5	0.09433962264150944	0.21739130434782608	REAC:R-HSA-1181150	REAC	Signaling by NODAL	10916	2273		0.5	0.5454545454545454	23	10893	5	48	18	10845	10916	0.14049907512711726
M1	string	0	network_modules	4	TRUE	4.080893781842269e-5	179	81	10	0.12345679012345678	0.055865921787709494	GO:0043009	GO:BP	chordate embryonic development	16175	10479		0.6242038216560509	0.6265822784810127	179	15996	10	71	169	15925	16175	0.07621694406652846
M1	string	0	network_modules	4	TRUE	6.116710572497236e-5	19	81	5	0.06172839506172839	0.2631578947368421	GO:0060392	GO:BP	negative regulation of SMAD protein signal transduction	16175	14597		0.6305732484076433	0.6329113924050633	19	16156	5	76	14	16080	16175	0.1254157470948448
M1	string	0	network_modules	4	TRUE	8.318803412448417e-5	309	81	12	0.14814814814814814	0.038834951456310676	GO:0048598	GO:BP	embryonic morphogenesis	16175	12865		0.6369426751592356	0.6392405063291139	309	15866	12	69	297	15797	16175	0.06687774926905317
M1	string	0	network_modules	4	TRUE	8.629780131209477e-5	12	53	4	0.07547169811320754	0.3333333333333333	REAC:R-HSA-209822	REAC	Glycoprotein hormones	10916	1075		0.6	0.6363636363636364	12	10904	4	49	8	10855	10916	0.15676705179205044
M1	string	0	network_modules	4	TRUE	1.0216637147886676e-4	41	81	6	0.07407407407407407	0.14634146341463414	GO:0048844	GO:BP	artery morphogenesis	16175	13088		0.643312101910828	0.6455696202531646	41	16134	6	75	35	16059	16175	0.10093377603173874
M1	string	0	network_modules	4	TRUE	1.0620629546899482e-4	21	81	5	0.06172839506172839	0.23809523809523808	GO:0003209	GO:BP	cardiac atrium morphogenesis	16175	1639		0.6496815286624203	0.6582278481012658	21	16154	5	76	16	16078	16175	0.11905794775456402
M1	string	0	network_modules	4	TRUE	1.0620629546899482e-4	21	81	5	0.06172839506172839	0.23809523809523808	GO:0003181	GO:BP	atrioventricular valve morphogenesis	16175	1611		0.6496815286624203	0.6582278481012658	21	16154	5	76	16	16078	16175	0.11905794775456402
M1	string	0	network_modules	4	TRUE	1.4427644337543452e-4	9	81	4	0.04938271604938271	0.4444444444444444	GO:0062042	GO:BP	regulation of cardiac epithelial to mesenchymal transition	16175	15800		0.6624203821656051	0.6645569620253164	9	16166	4	77	5	16089	16175	0.14688792295838665
M1	string	0	network_modules	4	TRUE	1.584914608371442e-4	44	81	6	0.07407407407407407	0.13636363636363635	GO:0055008	GO:BP	cardiac muscle tissue morphogenesis	16175	14197		0.6687898089171974	0.6708860759493671	44	16131	6	75	38	16056	16175	0.09718854629386545
M1	string	0	network_modules	4	TRUE	1.7326254033985167e-4	14	53	4	0.07547169811320754	0.2857142857142857	REAC:R-HSA-209952	REAC	Peptide hormone biosynthesis	10916	1724		0.7	0.7272727272727273	14	10902	4	49	10	10853	10916	0.1447938176641975
M1	string	0	network_modules	4	TRUE	1.7425050648904903e-4	23	81	5	0.06172839506172839	0.21739130434782608	GO:0001541	GO:BP	ovarian follicle development	16175	332		0.6751592356687898	0.6772151898734177	23	16152	5	76	18	16076	16175	0.11353806180214385
M1	string	0	network_modules	4	TRUE	1.7461871918336897e-4	157	81	9	0.1111111111111111	0.05732484076433121	GO:0060562	GO:BP	epithelial tube morphogenesis	16175	14746		0.6815286624203821	0.6835443037974683	157	16018	9	72	148	15946	16175	0.07337687832827716
M1	string	0	network_modules	4	TRUE	2.1265166389626333e-4	272	81	11	0.13580246913580246	0.04044117647058824	GO:0048589	GO:BP	developmental growth	16175	12860		0.6878980891719745	0.689873417721519	272	15903	11	70	261	15833	16175	0.06564900153862241
M1	string	0	network_modules	4	TRUE	2.1924474661719876e-4	24	81	5	0.06172839506172839	0.20833333333333334	GO:0003171	GO:BP	atrioventricular valve development	16175	1601		0.6942675159235668	0.6962025316455697	24	16151	5	76	19	16075	16175	0.1110370123221466
M1	string	0	network_modules	4	TRUE	2.3954525013108313e-4	10	81	4	0.04938271604938271	0.4	GO:0003183	GO:BP	mitral valve morphogenesis	16175	1613		0.7006369426751592	0.7025316455696202	10	16165	4	77	6	16088	16175	0.13917797896738765
M1	string	0	network_modules	4	TRUE	2.4198017036891476e-4	3	81	3	0.037037037037037035	1	GO:0046881	GO:BP	positive regulation of follicle-stimulating hormone secretion	16175	12416		0.7070063694267515	0.7278481012658228	3	16172	3	78	0	16094	16175	0.19198542082713027
M1	string	0	network_modules	4	TRUE	2.4198017036891476e-4	3	81	3	0.037037037037037035	1	GO:0046880	GO:BP	regulation of follicle-stimulating hormone secretion	16175	12415		0.7070063694267515	0.7278481012658228	3	16172	3	78	0	16094	16175	0.19198542082713027
M1	string	0	network_modules	4	TRUE	2.4198017036891476e-4	3	81	3	0.037037037037037035	1	GO:0046882	GO:BP	negative regulation of follicle-stimulating hormone secretion	16175	12417		0.7070063694267515	0.7278481012658228	3	16172	3	78	0	16094	16175	0.19198542082713027
M1	string	0	network_modules	4	TRUE	2.4198017036891476e-4	3	81	3	0.037037037037037035	1	GO:0032278	GO:BP	positive regulation of gonadotropin secretion	16175	7459		0.7070063694267515	0.7278481012658228	3	16172	3	78	0	16094	16175	0.19198542082713027
M1	string	0	network_modules	4	TRUE	3.077833569975497e-4	49	81	6	0.07407407407407407	0.12244897959183673	GO:0048644	GO:BP	muscle organ morphogenesis	16175	12902		0.732484076433121	0.740506329113924	49	16126	6	75	43	16051	16175	0.09171178889888111
M1	string	0	network_modules	4	TRUE	3.077833569975497e-4	49	81	6	0.07407407407407407	0.12244897959183673	GO:0060415	GO:BP	muscle tissue morphogenesis	16175	14616		0.732484076433121	0.740506329113924	49	16126	6	75	43	16051	16175	0.09171178889888111
M1	string	0	network_modules	4	TRUE	3.122846132736717e-4	37	53	5	0.09433962264150944	0.13513513513513514	REAC:R-HSA-2129379	REAC	Molecules associated with elastic fibres	10916	1490		0.8	0.8181818181818182	37	10879	5	48	32	10831	10916	0.10930358723096248
M1	string	0	network_modules	4	TRUE	3.3665772879262464e-4	26	81	5	0.06172839506172839	0.19230769230769232	GO:0003230	GO:BP	cardiac atrium development	16175	1660		0.7452229299363057	0.7468354430379747	26	16149	5	76	21	16073	16175	0.10646854837335876
M1	string	0	network_modules	4	TRUE	3.7499525791552806e-4	11	81	4	0.04938271604938271	0.36363636363636365	GO:0003174	GO:BP	mitral valve development	16175	1604		0.7515923566878981	0.7658227848101266	11	16164	4	77	7	16087	16175	0.1325368568974498
M1	string	0	network_modules	4	TRUE	3.7499525791552806e-4	11	81	4	0.04938271604938271	0.36363636363636365	GO:0060841	GO:BP	venous blood vessel development	16175	14986		0.7515923566878981	0.7658227848101266	11	16164	4	77	7	16087	16175	0.1325368568974498
M1	string	0	network_modules	4	TRUE	3.7499525791552806e-4	11	81	4	0.04938271604938271	0.36363636363636365	GO:0032332	GO:BP	positive regulation of chondrocyte differentiation	16175	7491		0.7515923566878981	0.7658227848101266	11	16164	4	77	7	16087	16175	0.1325368568974498
M1	string	0	network_modules	4	TRUE	4.4277416783362823e-4	52	81	6	0.07407407407407407	0.11538461538461539	GO:0001701	GO:BP	in utero embryonic development	16175	393		0.7707006369426752	0.7721518987341772	52	16123	6	75	46	16048	16175	0.08880280197190837
M1	string	0	network_modules	4	TRUE	4.990632795328485e-4	28	81	5	0.06172839506172839	0.17857142857142858	GO:0032330	GO:BP	regulation of chondrocyte differentiation	16175	7489		0.7770700636942676	0.7784810126582279	28	16147	5	76	23	16071	16175	0.10239099791354402
M1	string	0	network_modules	4	TRUE	5.484225591236777e-4	236	81	10	0.12345679012345678	0.0423728813559322	GO:0050678	GO:BP	regulation of epithelial cell proliferation	16175	13212		0.7834394904458599	0.7848101265822784	236	15939	10	71	226	15868	16175	0.06441129293918117
M1	string	0	network_modules	4	TRUE	5.55777605712154e-4	88	81	7	0.08641975308641975	0.07954545454545454	GO:0048705	GO:BP	skeletal system morphogenesis	16175	12962		0.7898089171974523	0.7911392405063291	88	16087	7	74	81	16013	16175	0.07809976534915555
M1	string	0	network_modules	4	TRUE	6.167289233739086e-4	182	81	9	0.1111111111111111	0.04945054945054945	GO:0007517	GO:BP	muscle organ development	16175	2999		0.7961783439490446	0.7974683544303798	182	15993	9	72	173	15921	16175	0.06716486239629138
M1	string	0	network_modules	4	TRUE	6.230122284523797e-4	55	81	6	0.07407407407407407	0.10909090909090909	GO:0003179	GO:BP	heart valve morphogenesis	16175	1609		0.802547770700637	0.8037974683544303	55	16120	6	75	49	16045	16175	0.08612895235045274
M1	string	0	network_modules	4	TRUE	6.309726796175802e-4	701	81	16	0.19753086419753085	0.02282453637660485	GO:0060429	GO:BP	epithelium development	16175	14627		0.8089171974522293	0.810126582278481	701	15474	16	65	685	15409	16175	0.053722647114555065
M1	string	0	network_modules	4	TRUE	7.369025152001991e-4	135	81	8	0.09876543209876543	0.05925925925925926	GO:0001935	GO:BP	endothelial cell proliferation	16175	549		0.8152866242038217	0.8164556962025317	135	16040	8	73	127	15967	16175	0.070509313229813
M1	string	0	network_modules	4	TRUE	7.583076973553401e-4	44	53	5	0.09433962264150944	0.11363636363636363	REAC:R-HSA-1566948	REAC	Elastic fibre formation	10916	836		0.9	0.9090909090909091	44	10872	5	48	39	10824	10916	0.09955791346306592
M1	string	0	network_modules	4	TRUE	9.501353338709189e-4	46	53	5	0.09433962264150944	0.10869565217391304	REAC:R-HSA-2173789	REAC	TGF-beta receptor signaling activates SMADs	10916	2428		1	1	46	10870	5	48	41	10822	10916	0.09718095729839486
M1	string	0	network_modules	4	TRUE	9.644193606825392e-4	4	81	3	0.037037037037037035	0.75	GO:0046884	GO:BP	follicle-stimulating hormone secretion	16175	12419		0.821656050955414	0.8227848101265823	4	16171	3	78	1	16093	16175	0.16599045150624148
M1	string	0	network_modules	4	TRUE	0.0011183019226663057	255	81	10	0.12345679012345678	0.0392156862745098	GO:0002009	GO:BP	morphogenesis of an epithelium	16175	612		0.8280254777070064	0.8291139240506329	255	15920	10	71	245	15849	16175	0.0613331816209548
M1	string	0	network_modules	4	TRUE	0.00114034908567896	138	50	7	0.14	0.050724637681159424	KEGG:05418	KEGG	Fluid shear stress and atherosclerosis	8484	495		1	1	138	8346	7	43	131	8303	8484	0.07531465497000153
M1	string	0	network_modules	4	TRUE	0.0012470891952654612	99	81	7	0.08641975308641975	0.0707070707070707	GO:0009952	GO:BP	anterior/posterior pattern specification	16175	3790		0.8343949044585988	0.8354430379746836	99	16076	7	74	92	16002	16175	0.07303977131461702
M1	string	0	network_modules	4	TRUE	0.0013801452487603675	34	81	5	0.06172839506172839	0.14705882352941177	GO:0014855	GO:BP	striated muscle cell proliferation	16175	4732		0.8407643312101911	0.8417721518987342	34	16141	5	76	29	16065	16175	0.0923609962317169
M1	string	0	network_modules	4	TRUE	0.0016038740303492805	35	81	5	0.06172839506172839	0.14285714285714285	GO:0055010	GO:BP	ventricular cardiac muscle tissue morphogenesis	16175	14199		0.8471337579617835	0.8544303797468354	35	16140	5	76	30	16064	16175	0.0909404220513718
M1	string	0	network_modules	4	TRUE	0.0016038740303492805	35	81	5	0.06172839506172839	0.14285714285714285	GO:0045668	GO:BP	negative regulation of osteoblast differentiation	16175	11519		0.8471337579617835	0.8544303797468354	35	16140	5	76	30	16064	16175	0.0909404220513718
M1	string	0	network_modules	4	TRUE	0.001855281613513841	36	81	5	0.06172839506172839	0.1388888888888889	GO:0008585	GO:BP	female gonad development	16175	3196		0.8598726114649682	0.8607594936708861	36	16139	5	76	31	16063	16175	0.08957817094880777
M1	string	0	network_modules	4	TRUE	0.0018690491645907221	66	81	6	0.07407407407407407	0.09090909090909091	GO:0003170	GO:BP	heart valve development	16175	1600		0.8662420382165605	0.8670886075949367	66	16109	6	75	60	16034	16175	0.0778946289567082
M1	string	0	network_modules	4	TRUE	0.0021367832560826873	37	81	5	0.06172839506172839	0.13513513513513514	GO:0046545	GO:BP	development of primary female sexual characteristics	16175	12230		0.8726114649681529	0.8734177215189873	37	16138	5	76	32	16062	16175	0.08827029220566332
M1	string	0	network_modules	4	TRUE	0.0024023284435737784	5	81	3	0.037037037037037035	0.6	GO:0032276	GO:BP	regulation of gonadotropin secretion	16175	7457		0.8789808917197452	0.8924050632911392	5	16170	3	78	2	16092	16175	0.14822146402888547
M1	string	0	network_modules	4	TRUE	0.0024023284435737784	5	81	3	0.037037037037037035	0.6	GO:0032927	GO:BP	positive regulation of activin receptor signaling pathway	16175	7918		0.8789808917197452	0.8924050632911392	5	16170	3	78	2	16092	16175	0.14822146402888547
M1	string	0	network_modules	4	TRUE	0.0024023284435737784	5	81	3	0.037037037037037035	0.6	GO:0032277	GO:BP	negative regulation of gonadotropin secretion	16175	7458		0.8789808917197452	0.8924050632911392	5	16170	3	78	2	16092	16175	0.14822146402888547
M1	string	0	network_modules	4	TRUE	0.002643345915705268	17	81	4	0.04938271604938271	0.23529411764705882	GO:0038092	GO:BP	nodal signaling pathway	16175	9692		0.8980891719745223	0.8987341772151899	17	16158	4	77	13	16081	16175	0.10582023249071469
M1	string	0	network_modules	4	TRUE	0.003385659725161203	18	81	4	0.04938271604938271	0.2222222222222222	GO:0022602	GO:BP	ovulation cycle process	16175	6610		0.9044585987261147	0.9050632911392406	18	16157	4	77	14	16080	16175	0.1027104123717662
M1	string	0	network_modules	4	TRUE	0.0036164772780666495	41	81	5	0.06172839506172839	0.12195121951219512	GO:0003229	GO:BP	ventricular cardiac muscle tissue development	16175	1659		0.910828025477707	0.9113924050632911	41	16134	5	76	36	16058	16175	0.08351543349833528
M1	string	0	network_modules	4	TRUE	0.0036914814830733863	74	81	6	0.07407407407407407	0.08108108108108109	GO:0001763	GO:BP	morphogenesis of a branching structure	16175	429		0.9171974522292994	0.9177215189873418	74	16101	6	75	68	16026	16175	0.07306203684943571
M1	string	0	network_modules	4	TRUE	0.004089147085138386	42	81	5	0.06172839506172839	0.11904761904761904	GO:0046660	GO:BP	female sex differentiation	16175	12293		0.9235668789808917	0.9240506329113924	42	16133	5	76	37	16057	16175	0.08243158555932982
M1	string	0	network_modules	4	TRUE	0.00409271010636628	118	81	7	0.08641975308641975	0.059322033898305086	GO:0007548	GO:BP	sex differentiation	16175	3029		0.9299363057324841	0.930379746835443	118	16057	7	74	111	15983	16175	0.06596184816018583
M1	string	0	network_modules	4	TRUE	0.004306830267336982	447	81	12	0.14814814814814814	0.026845637583892617	GO:0048514	GO:BP	blood vessel morphogenesis	16175	12799		0.9363057324840764	0.9367088607594937	447	15728	12	69	435	15659	16175	0.052155229016765385
M1	string	0	network_modules	4	TRUE	0.004787283397385974	6	81	3	0.037037037037037035	0.5	GO:0061626	GO:BP	pharyngeal arch artery morphogenesis	16175	15595		0.9426751592356688	0.9430379746835443	6	16169	3	78	3	16091	16175	0.1350834813647358
M1	string	0	network_modules	4	TRUE	0.007971084139717519	22	81	4	0.04938271604938271	0.18181818181818182	GO:0060043	GO:BP	regulation of cardiac muscle cell proliferation	16175	14306		0.9490445859872612	0.9556962025316456	22	16153	4	77	18	16076	16175	0.09244053795820256
M1	string	0	network_modules	4	TRUE	0.007971084139717519	22	81	4	0.04938271604938271	0.18181818181818182	GO:0042698	GO:BP	ovulation cycle	16175	10308		0.9490445859872612	0.9556962025316456	22	16153	4	77	18	16076	16175	0.09244053795820256
M1	string	0	network_modules	4	TRUE	0.008347458129446586	7	81	3	0.037037037037037035	0.42857142857142855	GO:0032344	GO:BP	regulation of aldosterone metabolic process	16175	7503		0.9617834394904459	0.9873417721518988	7	16168	3	78	4	16090	16175	0.12485599074034415
M1	string	0	network_modules	4	TRUE	0.008347458129446586	7	81	3	0.037037037037037035	0.42857142857142855	GO:0032347	GO:BP	regulation of aldosterone biosynthetic process	16175	7506		0.9617834394904459	0.9873417721518988	7	16168	3	78	4	16090	16175	0.12485599074034415
M1	string	0	network_modules	4	TRUE	0.008347458129446586	7	81	3	0.037037037037037035	0.42857142857142855	GO:0035912	GO:BP	dorsal aorta morphogenesis	16175	9335		0.9617834394904459	0.9873417721518988	7	16168	3	78	4	16090	16175	0.12485599074034415
M1	string	0	network_modules	4	TRUE	0.008347458129446586	7	81	3	0.037037037037037035	0.42857142857142855	GO:0060426	GO:BP	lung vasculature development	16175	14624		0.9617834394904459	0.9873417721518988	7	16168	3	78	4	16090	16175	0.12485599074034415
M1	string	0	network_modules	4	TRUE	0.008347458129446586	7	81	3	0.037037037037037035	0.42857142857142855	GO:0035907	GO:BP	dorsal aorta development	16175	9330		0.9617834394904459	0.9873417721518988	7	16168	3	78	4	16090	16175	0.12485599074034415
M1	string	0	network_modules	4	TRUE	0.00945810260572588	400	81	11	0.13580246913580246	0.0275	GO:0001525	GO:BP	angiogenesis	16175	330		0.9936305732484076	0.9936708860759493	400	15775	11	70	389	15705	16175	0.0507397613704924
M1	string	0	network_modules	4	TRUE	0.009612522799344573	23	81	4	0.04938271604938271	0.17391304347826086	GO:0003148	GO:BP	outflow tract septum morphogenesis	16175	1580		1	1	23	16152	4	77	19	16075	16175	0.09029503353239145
M1	string	0	network_modules	5	TRUE	6.177688805097397e-14	215	38	15	0.39473684210526316	0.06976744186046512	REAC:R-HSA-6805567	REAC	Keratinization	10916	1288		NA	1	215	10701	15	23	200	10678	10916	0.15952476523950024
M1	string	0	network_modules	6	TRUE	7.287475099068558e-38	162	75	30	0.4	0.18518518518518517	GO:0009060	GO:BP	aerobic respiration	16175	3236		0	0.018867924528301886	162	16013	30	45	132	15968	16175	0.2673101928577918
M1	string	0	network_modules	6	TRUE	3.585579268527865e-37	134	61	30	0.4918032786885246	0.22388059701492538	KEGG:00190	KEGG	Oxidative phosphorylation	8484	18		0	0.058823529411764705	134	8350	30	31	104	8319	8484	0.3249013830840603
M1	string	0	network_modules	6	TRUE	8.980509211304057e-36	188	75	30	0.4	0.1595744680851064	GO:0045333	GO:BP	cellular respiration	16175	11360		0.019230769230769232	0.03773584905660377	188	15987	30	45	158	15942	16175	0.24731656939238153
M1	string	0	network_modules	6	TRUE	2.2674205206306448e-35	127	75	27	0.36	0.2125984251968504	GO:0006119	GO:BP	oxidative phosphorylation	16175	1977		0.038461538461538464	0.05660377358490566	127	16048	27	48	100	16000	16175	0.2723173774731734
M1	string	0	network_modules	6	TRUE	1.2204500153001158e-33	177	69	30	0.43478260869565216	0.1694915254237288	REAC:R-HSA-1428517	REAC	Aerobic respiration and respiratory electron transport	10916	127		0	0.1	177	10739	30	39	147	10700	10916	0.2643203461124622
M1	string	0	network_modules	6	TRUE	9.460538718732143e-32	252	75	30	0.4	0.11904761904761904	GO:0015980	GO:BP	energy derivation by oxidation of organic compounds	16175	5060		0.057692307692307696	0.07547169811320754	252	15923	30	45	222	15878	16175	0.2118632808958129
M1	string	0	network_modules	6	TRUE	2.174596027550504e-31	202	61	30	0.4918032786885246	0.1485148514851485	KEGG:05415	KEGG	Diabetic cardiomyopathy	8484	492		0.0625	0.11764705882352941	202	8282	30	31	172	8251	8484	0.26123354075854727
M1	string	0	network_modules	6	TRUE	3.8420773185789784e-31	372	75	33	0.44	0.08870967741935484	GO:0006091	GO:BP	generation of precursor metabolites and energy	16175	1954		0.07692307692307693	0.09433962264150944	372	15803	33	42	339	15761	16175	0.18987089943709642
M1	string	0	network_modules	6	TRUE	1.4683273986146156e-28	82	75	21	0.28	0.25609756097560976	GO:0019646	GO:BP	aerobic electron transport chain	16175	5967		0.09615384615384616	0.11320754716981132	82	16093	21	54	61	16039	16175	0.26421616904469153
M1	string	0	network_modules	6	TRUE	7.821668295647683e-28	88	75	21	0.28	0.23863636363636365	GO:0042773	GO:BP	ATP synthesis coupled electron transport	16175	10358		0.11538461538461539	0.1509433962264151	88	16087	21	54	67	16033	16175	0.254753171789467
M1	string	0	network_modules	6	TRUE	7.821668295647683e-28	88	75	21	0.28	0.23863636363636365	GO:0042775	GO:BP	mitochondrial ATP synthesis coupled electron transport	16175	10360		0.11538461538461539	0.1509433962264151	88	16087	21	54	67	16033	16175	0.254753171789467
M1	string	0	network_modules	6	TRUE	9.646411542542443e-28	107	75	22	0.29333333333333333	0.205607476635514	GO:0022900	GO:BP	electron transport chain	16175	6630		0.15384615384615385	0.16981132075471697	107	16068	22	53	85	16015	16175	0.24140397874022843
M1	string	0	network_modules	6	TRUE	5.584102931289569e-27	221	61	28	0.45901639344262296	0.12669683257918551	KEGG:05208	KEGG	Chemical carcinogenesis - reactive oxygen species	8484	460		0.125	0.17647058823529413	221	8263	28	33	193	8230	8484	0.23132486707920374
M1	string	0	network_modules	6	TRUE	1.2235230260472772e-26	99	75	21	0.28	0.21212121212121213	GO:0022904	GO:BP	respiratory electron transport chain	16175	6631		0.17307692307692307	0.18867924528301888	99	16076	21	54	78	16022	16175	0.23967063351798273
M1	string	0	network_modules	6	TRUE	2.2780241722830068e-26	232	61	28	0.45901639344262296	0.1206896551724138	KEGG:04714	KEGG	Thermogenesis	8484	349		0.1875	0.23529411764705882	232	8252	28	33	204	8219	8484	0.2252481583495325
M1	string	0	network_modules	6	TRUE	4.52242333879878e-26	103	69	22	0.3188405797101449	0.21359223300970873	REAC:R-HSA-611105	REAC	Respiratory electron transport	10916	2081		0.1111111111111111	0.2	103	10813	22	47	81	10766	10916	0.2552517394015124
M1	string	0	network_modules	6	TRUE	2.9363790125534105e-23	265	61	27	0.4426229508196721	0.1018867924528302	KEGG:05012	KEGG	Parkinson disease	8484	412		0.25	0.29411764705882354	265	8219	27	34	238	8185	8484	0.20125701917433
M1	string	0	network_modules	6	TRUE	5.414934340271609e-23	271	61	27	0.4426229508196721	0.0996309963099631	KEGG:05020	KEGG	Prion disease	8484	416		0.3125	0.35294117647058826	271	8213	27	34	244	8179	8484	0.19874704097843662
M1	string	0	network_modules	6	TRUE	1.028907643547692e-21	154	61	22	0.36065573770491804	0.14285714285714285	KEGG:04932	KEGG	Non-alcoholic fatty liver disease	8484	389		0.375	0.4117647058823529	154	8330	22	39	132	8291	8484	0.21833072931315772
M1	string	0	network_modules	6	TRUE	1.3407223333196964e-21	305	61	27	0.4426229508196721	0.08852459016393442	KEGG:05016	KEGG	Huntington disease	8484	414		0.4375	0.47058823529411764	305	8179	27	34	278	8145	8484	0.18589915471881968
M1	string	0	network_modules	6	TRUE	1.4509394460591534e-21	382	61	29	0.47540983606557374	0.07591623036649214	KEGG:05010	KEGG	Alzheimer disease	8484	411		0.5	0.5294117647058824	382	8102	29	32	353	8070	8484	0.176628344231136
M1	string	0	network_modules	6	TRUE	8.37126388112177e-19	65	75	15	0.2	0.23076923076923078	GO:0042776	GO:BP	proton motive force-driven mitochondrial ATP synthesis	16175	10361		0.19230769230769232	0.20754716981132076	65	16110	15	60	50	16050	16175	0.21143287116811543
M1	string	0	network_modules	6	TRUE	2.6361025200578787e-18	363	61	26	0.4262295081967213	0.07162534435261708	KEGG:05014	KEGG	Amyotrophic lateral sclerosis	8484	413		0.5625	0.5882352941176471	363	8121	26	35	337	8086	8484	0.16124082860224823
M1	string	0	network_modules	6	TRUE	4.551583963386528e-18	72	75	15	0.2	0.20833333333333334	GO:0015986	GO:BP	proton motive force-driven ATP synthesis	16175	5062		0.21153846153846154	0.22641509433962265	72	16103	15	60	57	16043	16175	0.2004920889886801
M1	string	0	network_modules	6	TRUE	1.6939351985030332e-16	90	75	15	0.2	0.16666666666666666	GO:0006754	GO:BP	ATP biosynthetic process	16175	2451		0.23076923076923078	0.24528301886792453	90	16085	15	60	75	16025	16175	0.17840480870317688
M1	string	0	network_modules	6	TRUE	2.406483257085744e-16	92	75	15	0.2	0.16304347826086957	GO:0009145	GO:BP	purine nucleoside triphosphate biosynthetic process	16175	3312		0.25	0.2830188679245283	92	16083	15	60	77	16023	16175	0.17635372201310334
M1	string	0	network_modules	6	TRUE	2.406483257085744e-16	92	75	15	0.2	0.16304347826086957	GO:0009206	GO:BP	purine ribonucleoside triphosphate biosynthetic process	16175	3372		0.25	0.2830188679245283	92	16083	15	60	77	16023	16175	0.17635372201310334
M1	string	0	network_modules	6	TRUE	5.585362506259334e-16	97	75	15	0.2	0.15463917525773196	GO:0009201	GO:BP	ribonucleoside triphosphate biosynthetic process	16175	3367		0.28846153846153844	0.3018867924528302	97	16078	15	60	82	16018	16175	0.17150182807203615
M1	string	0	network_modules	6	TRUE	1.443027296336022e-15	103	75	15	0.2	0.14563106796116504	GO:0009142	GO:BP	nucleoside triphosphate biosynthetic process	16175	3309		0.3076923076923077	0.32075471698113206	103	16072	15	60	88	16012	16175	0.1661444631787148
M1	string	0	network_modules	6	TRUE	2.9313741330692773e-15	46	75	12	0.16	0.2608695652173913	GO:0006120	GO:BP	mitochondrial electron transport, NADH to ubiquinone	16175	1978		0.3269230769230769	0.33962264150943394	46	16129	12	63	34	16066	16175	0.20142371564719497
M1	string	0	network_modules	6	TRUE	4.279683334998714e-14	128	75	15	0.2	0.1171875	GO:0009152	GO:BP	purine ribonucleotide biosynthetic process	16175	3319		0.34615384615384615	0.3584905660377358	128	16047	15	60	113	15987	16175	0.14796433131620143
M1	string	0	network_modules	6	TRUE	1.217973259033603e-13	137	75	15	0.2	0.10948905109489052	GO:0009260	GO:BP	ribonucleotide biosynthetic process	16175	3425		0.36538461538461536	0.37735849056603776	137	16038	15	60	122	15978	16175	0.14264735357943314
M1	string	0	network_modules	6	TRUE	2.3482581874822834e-13	143	75	15	0.2	0.1048951048951049	GO:0046390	GO:BP	ribose phosphate biosynthetic process	16175	12117		0.38461538461538464	0.39622641509433965	143	16032	15	60	128	15972	16175	0.13937834652935546
M1	string	0	network_modules	6	TRUE	3.219636369251538e-13	220	75	17	0.22666666666666666	0.07727272727272727	GO:0072522	GO:BP	purine-containing compound biosynthetic process	16175	17424		0.40384615384615385	0.41509433962264153	220	15955	17	58	203	15897	16175	0.12554956999784353
M1	string	0	network_modules	6	TRUE	3.731803390437694e-13	364	75	20	0.26666666666666666	0.054945054945054944	GO:0007005	GO:BP	mitochondrion organization	16175	2617		0.4230769230769231	0.4339622641509434	364	15811	20	55	344	15756	16175	0.11235984290218418
M1	string	0	network_modules	6	TRUE	4.2105135934297657e-13	184	75	16	0.21333333333333335	0.08695652173913043	GO:0046034	GO:BP	ATP metabolic process	16175	11811		0.4423076923076923	0.4528301886792453	184	15991	16	59	168	15932	16175	0.12997977818985895
M1	string	0	network_modules	6	TRUE	1.3613689609262575e-12	198	75	16	0.21333333333333335	0.08080808080808081	GO:0009205	GO:BP	purine ribonucleoside triphosphate metabolic process	16175	3371		0.46153846153846156	0.4716981132075472	198	15977	16	59	182	15918	16175	0.12481794842600363
M1	string	0	network_modules	6	TRUE	1.7301798615707514e-12	201	75	16	0.21333333333333335	0.07960199004975124	GO:0009144	GO:BP	purine nucleoside triphosphate metabolic process	16175	3311		0.4807692307692308	0.49056603773584906	201	15974	16	59	185	15915	16175	0.12378033125376499
M1	string	0	network_modules	6	TRUE	1.8835750589423316e-12	164	75	15	0.2	0.09146341463414634	GO:0006164	GO:BP	purine nucleotide biosynthetic process	16175	1999		0.5	0.5094339622641509	164	16011	15	60	149	15951	16175	0.12934997744908067
M1	string	0	network_modules	6	TRUE	2.19044687760668e-12	204	75	16	0.21333333333333335	0.0784313725490196	GO:0009199	GO:BP	ribonucleoside triphosphate metabolic process	16175	3365		0.5192307692307693	0.5283018867924528	204	15971	16	59	188	15912	16175	0.12276491212247354
M1	string	0	network_modules	6	TRUE	5.042277868636756e-12	215	75	16	0.21333333333333335	0.07441860465116279	GO:0009141	GO:BP	nucleoside triphosphate metabolic process	16175	3308		0.5384615384615384	0.5471698113207547	215	15960	16	59	199	15901	16175	0.11921908796460148
M1	string	0	network_modules	6	TRUE	5.307113280203956e-12	260	75	17	0.22666666666666666	0.06538461538461539	GO:1901293	GO:BP	nucleoside phosphate biosynthetic process	16175	21368		0.5576923076923077	0.5660377358490566	260	15915	17	58	243	15857	16175	0.11429173949935122
M1	string	0	network_modules	6	TRUE	1.2482517186590967e-11	186	75	15	0.2	0.08064516129032258	GO:0009165	GO:BP	nucleotide biosynthetic process	16175	3331		0.5769230769230769	0.5849056603773585	186	15989	15	60	171	15929	16175	0.1206724123281209
M1	string	0	network_modules	6	TRUE	1.7417428378607153e-11	57	69	11	0.15942028985507245	0.19298245614035087	REAC:R-HSA-6799198	REAC	Complex I biogenesis	10916	391		0.2222222222222222	0.3	57	10859	11	58	46	10801	10916	0.17064019153681095
M1	string	0	network_modules	6	TRUE	4.7272696626523276e-11	469	75	20	0.26666666666666666	0.042643923240938165	GO:0072521	GO:BP	purine-containing compound metabolic process	16175	17423		0.5961538461538461	0.6037735849056604	469	15706	20	55	449	15651	16175	0.09667618699627178
M1	string	0	network_modules	6	TRUE	5.673276472558097e-11	87	61	12	0.19672131147540983	0.13793103448275862	KEGG:04260	KEGG	Cardiac muscle contraction	8484	296		0.625	0.6470588235294118	87	8397	12	49	75	8348	8484	0.15751132796811865
M1	string	0	network_modules	6	TRUE	1.423244305706596e-10	266	75	16	0.21333333333333335	0.06015037593984962	GO:0009150	GO:BP	purine ribonucleotide metabolic process	16175	3317		0.6153846153846154	0.6226415094339622	266	15909	16	59	250	15850	16175	0.10566214349504083
M1	string	0	network_modules	6	TRUE	1.8801843204827515e-10	109	75	12	0.16	0.11009174311926606	GO:0097250	GO:BP	mitochondrial respirasome assembly	16175	18559		0.6346153846153846	0.6415094339622641	109	16066	12	63	97	16003	16175	0.12785775959011608
M1	string	0	network_modules	6	TRUE	2.523328930277353e-10	276	75	16	0.21333333333333335	0.057971014492753624	GO:0009259	GO:BP	ribonucleotide metabolic process	16175	3424		0.6538461538461539	0.660377358490566	276	15899	16	59	260	15840	16175	0.10343711047562498
M1	string	0	network_modules	6	TRUE	3.394546614615809e-10	521	75	20	0.26666666666666666	0.03838771593090211	GO:0006753	GO:BP	nucleoside phosphate metabolic process	16175	2450		0.6730769230769231	0.6792452830188679	521	15654	20	55	501	15599	16175	0.09063431789820915
M1	string	0	network_modules	6	TRUE	3.717661034568522e-10	283	75	16	0.21333333333333335	0.05653710247349823	GO:0019693	GO:BP	ribose phosphate metabolic process	16175	6010		0.6923076923076923	0.6981132075471698	283	15892	16	59	267	15833	16175	0.10194705210718029
M1	string	0	network_modules	6	TRUE	4.0014708084880247e-10	61	75	10	0.13333333333333333	0.16393442622950818	GO:0010257	GO:BP	NADH dehydrogenase complex assembly	16175	4030		0.7115384615384616	0.7358490566037735	61	16114	10	65	51	16049	16175	0.144269093232149
M1	string	0	network_modules	6	TRUE	4.0014708084880247e-10	61	75	10	0.13333333333333333	0.16393442622950818	GO:0032981	GO:BP	mitochondrial respiratory chain complex I assembly	16175	7963		0.7115384615384616	0.7358490566037735	61	16114	10	65	51	16049	16175	0.144269093232149
M1	string	0	network_modules	6	TRUE	6.690146281230359e-10	349	75	17	0.22666666666666666	0.04871060171919771	GO:0006163	GO:BP	purine nucleotide metabolic process	16175	1998		0.75	0.7547169811320755	349	15826	17	58	332	15768	16175	0.09634041485894962
M1	string	0	network_modules	6	TRUE	9.191837177944792e-10	66	75	10	0.13333333333333333	0.15151515151515152	GO:1902600	GO:BP	proton transmembrane transport	16175	22372		0.7692307692307693	0.7735849056603774	66	16109	10	65	56	16044	16175	0.1383872980828719
M1	string	0	network_modules	6	TRUE	1.2130247168129086e-9	558	75	20	0.26666666666666666	0.035842293906810034	GO:0055086	GO:BP	nucleobase-containing small molecule metabolic process	16175	14237		0.7884615384615384	0.7924528301886793	558	15617	20	55	538	15562	16175	0.08682609743029426
M1	string	0	network_modules	6	TRUE	1.5643249185029311e-9	97	75	11	0.14666666666666667	0.1134020618556701	GO:0033108	GO:BP	mitochondrial respiratory chain complex assembly	16175	8042		0.8076923076923077	0.8113207547169812	97	16078	11	64	86	16014	16175	0.1243543104333672
M1	string	0	network_modules	6	TRUE	3.6863101173009063e-9	388	75	17	0.22666666666666666	0.04381443298969072	GO:0009117	GO:BP	nucleotide metabolic process	16175	3286		0.8269230769230769	0.8301886792452831	388	15787	17	58	371	15729	16175	0.09040764069976809
M1	string	0	network_modules	6	TRUE	2.9595285040287226e-8	512	75	18	0.24	0.03515625	GO:0090407	GO:BP	organophosphate biosynthetic process	16175	18274		0.8461538461538461	0.8490566037735849	512	15663	18	57	494	15606	16175	0.08122227320037334
M1	string	0	network_modules	6	TRUE	3.356707213204322e-8	148	61	12	0.19672131147540983	0.08108108108108109	KEGG:04723	KEGG	Retrograde endocannabinoid signaling	8484	353		0.6875	0.7058823529411765	148	8336	12	49	136	8287	8484	0.11653230575294743
M1	string	0	network_modules	6	TRUE	2.8238696373517855e-6	514	75	16	0.21333333333333335	0.0311284046692607	GO:1901137	GO:BP	carbohydrate derivative biosynthetic process	16175	21245		0.8653846153846154	0.8679245283018868	514	15661	16	59	498	15602	16175	0.07064493715053134
M1	string	0	network_modules	6	TRUE	5.087685959109331e-6	13	75	5	0.06666666666666667	0.38461538461538464	GO:0006122	GO:BP	mitochondrial electron transport, ubiquinol to cytochrome c	16175	1980		0.8846153846153846	0.8867924528301887	13	16162	5	70	8	16092	16175	0.15862950982362614
M1	string	0	network_modules	6	TRUE	1.3847109311377024e-5	19	61	5	0.08196721311475409	0.2631578947368421	KEGG:00785	KEGG	Lipoic acid metabolism	8484	124		0.75	0.7647058823529411	19	8465	5	56	14	8409	8484	0.14353279759459717
M1	string	0	network_modules	6	TRUE	4.498155964717388e-5	19	75	5	0.06666666666666667	0.2631578947368421	GO:0006123	GO:BP	mitochondrial electron transport, cytochrome c to oxygen	16175	1981		0.9038461538461539	0.9056603773584906	19	16156	5	70	14	16086	16175	0.13049882733291435
M1	string	0	network_modules	6	TRUE	2.6163909598953927e-4	33	61	5	0.08196721311475409	0.15151515151515152	KEGG:01210	KEGG	2-Oxocarboxylic acid metabolism	8484	185		0.8125	0.8235294117647058	33	8451	5	56	28	8395	8484	0.10674493300632054
M1	string	0	network_modules	6	TRUE	5.520703714476661e-4	31	69	5	0.07246376811594203	0.16129032258064516	REAC:R-HSA-8949613	REAC	Cristae formation	10916	414		0.3333333333333333	0.5	31	10885	5	64	26	10821	10916	0.10435098086035918
M1	string	0	network_modules	6	TRUE	5.520703714476661e-4	31	69	5	0.07246376811594203	0.16129032258064516	REAC:R-HSA-389661	REAC	Glyoxylate metabolism and glycine degradation	10916	1081		0.3333333333333333	0.5	31	10885	5	64	26	10821	10916	0.10435098086035918
M1	string	0	network_modules	6	TRUE	0.0010080440223514465	62	69	6	0.08695652173913043	0.0967741935483871	REAC:R-HSA-9707564	REAC	Cytoprotection by HMOX1	10916	426		0.5555555555555556	0.6	62	10854	6	63	56	10791	10916	0.08625991348237104
M1	string	0	network_modules	6	TRUE	0.0012170425877850587	15	75	4	0.05333333333333334	0.26666666666666666	GO:0045040	GO:BP	protein insertion into mitochondrial outer membrane	16175	11243		0.9230769230769231	0.9433962264150944	15	16160	4	71	11	16089	16175	0.117510450544019
M1	string	0	network_modules	6	TRUE	0.0012170425877850587	15	75	4	0.05333333333333334	0.26666666666666666	GO:0007008	GO:BP	outer mitochondrial membrane organization	16175	2620		0.9230769230769231	0.9433962264150944	15	16160	4	71	11	16089	16175	0.117510450544019
M1	string	0	network_modules	6	TRUE	0.0013344545633793144	65	69	6	0.08695652173913043	0.09230769230769231	REAC:R-HSA-1268020	REAC	Mitochondrial protein import	10916	1468		0.6666666666666666	0.7	65	10851	6	63	59	10788	10916	0.08397252606360453
M1	string	0	network_modules	6	TRUE	0.0017379777920618928	48	61	5	0.08196721311475409	0.10416666666666667	KEGG:00280	KEGG	Valine, leucine and isoleucine degradation	8484	31		0.875	0.8823529411764706	48	8436	5	56	43	8380	8484	0.08658086218542442
M1	string	0	network_modules	6	TRUE	0.0017731720156879587	18	69	4	0.057971014492753624	0.2222222222222222	REAC:R-HSA-163210	REAC	Formation of ATP by chemiosmotic coupling	10916	944		0.7777777777777778	0.8	18	10898	4	65	14	10833	10916	0.11071389244952914
M1	string	0	network_modules	6	TRUE	0.0027038745051727697	158	69	8	0.11594202898550725	0.05063291139240506	REAC:R-HSA-9609507	REAC	Protein localization	10916	1815		0.8888888888888888	0.9	158	10758	8	61	150	10697	10916	0.06775907225584707
M1	string	0	network_modules	6	TRUE	0.0029676626188741926	27	61	4	0.06557377049180328	0.14814814814814814	KEGG:04966	KEGG	Collecting duct acid secretion	8484	400		0.9375	0.9411764705882353	27	8457	4	57	23	8400	8484	0.09426842036561836
M1	string	0	network_modules	6	TRUE	0.004559055248307243	671	75	14	0.18666666666666668	0.020864381520119227	GO:0034220	GO:BP	monoatomic ion transmembrane transport	16175	8508		0.9615384615384616	0.9622641509433962	671	15504	14	61	657	15443	16175	0.04969289476350653
M1	string	0	network_modules	6	TRUE	0.004601404228480606	575	75	13	0.17333333333333334	0.022608695652173914	GO:0098662	GO:BP	inorganic cation transmembrane transport	16175	18818		0.9807692307692307	0.9811320754716981	575	15600	13	62	562	15538	16175	0.050788640712483665
M1	string	0	network_modules	6	TRUE	0.004781202389670046	577	75	13	0.17333333333333334	0.022530329289428077	GO:0098655	GO:BP	monoatomic cation transmembrane transport	16175	18811		1	1	577	15598	13	62	564	15536	16175	0.050658291284940656
M1	string	0	network_modules	6	TRUE	0.005919531963239844	32	61	4	0.06557377049180328	0.125	KEGG:00640	KEGG	Propanoate metabolism	8484	109		1	1	32	8452	4	57	28	8395	8484	0.08579850599615974
M1	string	0	network_modules	6	TRUE	0.005977298118242465	84	69	6	0.08695652173913043	0.07142857142857142	REAC:R-HSA-5628897	REAC	TP53 Regulates Metabolic Genes	10916	2452		1	1	84	10832	6	63	78	10769	10916	0.07234374665958525
M1	string	0	network_modules	7	TRUE	1.9524391661338914e-34	41	55	20	0.36363636363636365	0.4878048780487805	REAC:R-HSA-383280	REAC	Nuclear Receptor transcription pathway	10916	1616		0	0.029411764705882353	41	10875	20	35	21	10840	10916	0.41866013503964894
M1	string	0	network_modules	7	TRUE	2.936646847702874e-22	113	55	19	0.34545454545454546	0.168141592920354	REAC:R-HSA-1989781	REAC	PPARA activates gene expression	10916	1700		0.030303030303030304	0.058823529411764705	113	10803	19	36	94	10767	10916	0.2356006968301447
M1	string	0	network_modules	7	TRUE	3.512833197479069e-22	114	55	19	0.34545454545454546	0.16666666666666666	REAC:R-HSA-400206	REAC	Regulation of lipid metabolism by PPARalpha	10916	2041		0.06060606060606061	0.08823529411764706	114	10802	19	36	95	10766	10916	0.23451181444283944
M1	string	0	network_modules	7	TRUE	5.230325701249792e-21	67	55	16	0.2909090909090909	0.23880597014925373	REAC:R-HSA-400253	REAC	Circadian Clock	10916	363		0.09090909090909091	0.11764705882352941	67	10849	16	39	51	10810	10916	0.2594621092719633
M1	string	0	network_modules	7	TRUE	1.185252805964057e-19	178	73	20	0.273972602739726	0.11235955056179775	GO:0009755	GO:BP	hormone-mediated signaling pathway	16175	3652		0	0.02564102564102564	178	15997	20	53	158	15944	16175	0.16972248497653894
M1	string	0	network_modules	7	TRUE	4.341294979848576e-19	27	55	12	0.21818181818181817	0.4444444444444444	REAC:R-HSA-1368108	REAC	BMAL1:CLOCK,NPAS2 activates circadian gene expression	10916	203		0.12121212121212122	0.14705882352941177	27	10889	12	43	15	10846	10916	0.30903033350594084
M1	string	0	network_modules	7	TRUE	2.4500233266290646e-18	539	73	27	0.3698630136986301	0.05009276437847866	GO:0009725	GO:BP	response to hormone	16175	3623		0.02631578947368421	0.05128205128205128	539	15636	27	46	512	15590	16175	0.1262540344640212
M1	string	0	network_modules	7	TRUE	9.508154583178118e-18	451	73	25	0.3424657534246575	0.05543237250554324	GO:0032870	GO:BP	cellular response to hormone stimulus	16175	7867		0.05263157894736842	0.07692307692307693	451	15724	25	48	426	15676	16175	0.12865645222923097
M1	string	0	network_modules	7	TRUE	1.2953116031829056e-17	47	55	13	0.23636363636363636	0.2765957446808511	REAC:R-HSA-9707616	REAC	Heme signaling	10916	1117		0.15151515151515152	0.17647058823529413	47	10869	13	42	34	10827	10916	0.2522103137956189
M1	string	0	network_modules	7	TRUE	3.1386862769336274e-16	152	73	17	0.2328767123287671	0.1118421052631579	GO:0141193	GO:BP	nuclear receptor-mediated signaling pathway	16175	20078		0.07894736842105263	0.10256410256410256	152	16023	17	56	135	15967	16175	0.1559587616302382
M1	string	0	network_modules	7	TRUE	1.7650693259293333e-14	18	55	9	0.16363636363636364	0.5	REAC:R-HSA-1368082	REAC	RORA activates gene expression	10916	1909		0.18181818181818182	0.20588235294117646	18	10898	9	46	9	10852	10916	0.28410675955420034
M1	string	0	network_modules	7	TRUE	3.302005792860723e-13	68	73	12	0.1643835616438356	0.17647058823529413	GO:0032922	GO:BP	circadian regulation of gene expression	16175	7913		0.10526315789473684	0.1282051282051282	68	16107	12	61	56	16046	16175	0.16669058589633473
M1	string	0	network_modules	7	TRUE	4.264159520098474e-13	53	55	11	0.2	0.20754716981132076	REAC:R-HSA-2151201	REAC	Transcriptional activation of mitochondrial biogenesis	10916	2548		0.21212121212121213	0.23529411764705882	53	10863	11	44	42	10819	10916	0.19978091307070098
M1	string	0	network_modules	7	TRUE	4.639542269295938e-13	24	55	9	0.16363636363636364	0.375	REAC:R-HSA-4090294	REAC	SUMOylation of intracellular receptors	10916	2175		0.24242424242424243	0.2647058823529412	24	10892	9	46	15	10846	10916	0.2452763304576031
M1	string	0	network_modules	7	TRUE	9.341044042055885e-13	162	73	15	0.2054794520547945	0.09259259259259259	GO:0007623	GO:BP	circadian rhythm	16175	3080		0.13157894736842105	0.15384615384615385	162	16013	15	58	147	15955	16175	0.13217177502619218
M1	string	0	network_modules	7	TRUE	1.9986670218518e-12	302	73	18	0.2465753424657534	0.059602649006622516	GO:0030522	GO:BP	intracellular receptor signaling pathway	16175	6836		0.15789473684210525	0.1794871794871795	302	15873	18	55	284	15818	16175	0.11336678548934748
M1	string	0	network_modules	7	TRUE	5.874940682722282e-12	791	73	25	0.3424657534246575	0.0316055625790139	GO:0000122	GO:BP	negative regulation of transcription by RNA polymerase II	16175	48		0.18421052631578946	0.20512820512820512	791	15384	25	48	766	15336	16175	0.09165252504940331
M1	string	0	network_modules	7	TRUE	6.355929516733112e-12	184	73	15	0.2054794520547945	0.08152173913043478	GO:0048511	GO:BP	rhythmic process	16175	12796		0.21052631578947367	0.23076923076923078	184	15991	15	58	169	15933	16175	0.12324045269948393
M1	string	0	network_modules	7	TRUE	2.601085705884012e-10	92	55	11	0.2	0.11956521739130435	REAC:R-HSA-1592230	REAC	Mitochondrial biogenesis	10916	1464		0.2727272727272727	0.29411764705882354	92	10824	11	44	81	10780	10916	0.14912628627732946
M1	string	0	network_modules	7	TRUE	6.331354312668403e-10	171	55	13	0.23636363636363636	0.07602339181286549	REAC:R-HSA-3108232	REAC	SUMO E3 ligases SUMOylate target proteins	10916	2163		0.30303030303030304	0.3235294117647059	171	10745	13	42	158	10703	10916	0.1264760211531267
M1	string	0	network_modules	7	TRUE	9.85863637892053e-10	177	55	13	0.23636363636363636	0.07344632768361582	REAC:R-HSA-2990846	REAC	SUMOylation	10916	2167		0.3333333333333333	0.35294117647058826	177	10739	13	42	164	10697	10916	0.12403891010404236
M1	string	0	network_modules	7	TRUE	2.9276516392466086e-9	83	55	10	0.18181818181818182	0.12048192771084337	REAC:R-HSA-381340	REAC	Transcriptional regulation of white adipocyte differentiation	10916	2562		0.36363636363636365	0.4117647058823529	83	10833	10	45	73	10788	10916	0.1427188228283619
M1	string	0	network_modules	7	TRUE	2.9276516392466086e-9	83	55	10	0.18181818181818182	0.12048192771084337	REAC:R-HSA-9843745	REAC	Adipogenesis	10916	122		0.36363636363636365	0.4117647058823529	83	10833	10	45	73	10788	10916	0.1427188228283619
M1	string	0	network_modules	7	TRUE	5.930021376030591e-9	40	55	8	0.14545454545454545	0.2	REAC:R-HSA-2426168	REAC	Activation of gene expression by SREBF (SREBP)	10916	101		0.42424242424242425	0.4411764705882353	40	10876	8	47	32	10829	10916	0.1669904301717973
M1	string	0	network_modules	7	TRUE	6.228549605488658e-9	62	55	9	0.16363636363636364	0.14516129032258066	REAC:R-HSA-9707564	REAC	Cytoprotection by HMOX1	10916	426		0.45454545454545453	0.47058823529411764	62	10854	9	46	53	10808	10916	0.14957432928450545
M1	string	0	network_modules	7	TRUE	6.90550053281066e-9	243	73	14	0.1917808219178082	0.05761316872427984	GO:0019216	GO:BP	regulation of lipid metabolic process	16175	5593		0.23684210526315788	0.2564102564102564	243	15932	14	59	229	15873	16175	0.09783758227526322
M1	string	0	network_modules	7	TRUE	2.1478684316065902e-8	520	73	18	0.2465753424657534	0.03461538461538462	GO:0033993	GO:BP	response to lipid	16175	8371		0.2631578947368421	0.28205128205128205	520	15655	18	55	502	15600	16175	0.08184968262677392
M1	string	0	network_modules	7	TRUE	3.7789904216528176e-8	98	73	10	0.136986301369863	0.10204081632653061	GO:0042752	GO:BP	regulation of circadian rhythm	16175	10345		0.2894736842105263	0.3076923076923077	98	16077	10	63	88	16014	16175	0.11360079427735555
M1	string	0	network_modules	7	TRUE	5.68278513300093e-8	408	73	16	0.2191780821917808	0.0392156862745098	GO:0071396	GO:BP	cellular response to lipid	16175	16648		0.3157894736842105	0.3333333333333333	408	15767	16	57	392	15710	16175	0.08328367264084635
M1	string	0	network_modules	7	TRUE	6.031818083772354e-8	345	73	15	0.2054794520547945	0.043478260869565216	GO:0071407	GO:BP	cellular response to organic cyclic compound	16175	16659		0.34210526315789475	0.358974358974359	345	15830	15	58	330	15772	16175	0.08581991759965432
M1	string	0	network_modules	7	TRUE	6.5013332108004e-8	53	55	8	0.14545454545454545	0.1509433962264151	REAC:R-HSA-1655829	REAC	Regulation of cholesterol biosynthesis by SREBP (SREBF)	10916	2023		0.48484848484848486	0.5	53	10863	8	47	45	10816	10916	0.14393958924076342
M1	string	0	network_modules	7	TRUE	1.5765776582733963e-7	437	73	16	0.2191780821917808	0.036613272311212815	GO:0014070	GO:BP	response to organic cyclic compound	16175	4635		0.3684210526315789	0.38461538461538464	437	15738	16	57	421	15681	16175	0.0798023630691818
M1	string	0	network_modules	7	TRUE	4.790922467336119e-7	290	55	13	0.23636363636363636	0.04482758620689655	REAC:R-HSA-9006931	REAC	Signaling by Nuclear Receptors	10916	2289		0.5151515151515151	0.5294117647058824	290	10626	13	42	277	10584	10916	0.09283796235670212
M1	string	0	network_modules	7	TRUE	9.405385421970729e-7	40	73	7	0.0958904109589041	0.175	GO:0042789	GO:BP	mRNA transcription by RNA polymerase II	16175	10367		0.39473684210526316	0.41025641025641024	40	16135	7	66	33	16069	16175	0.1266424714334865
M1	string	0	network_modules	7	TRUE	1.2433380644999604e-6	152	55	10	0.18181818181818182	0.06578947368421052	REAC:R-HSA-8957322	REAC	Metabolism of steroids	10916	1438		0.5454545454545454	0.5588235294117647	152	10764	10	45	142	10719	10916	0.10196136525260616
M1	string	0	network_modules	7	TRUE	2.24874002015314e-6	45	73	7	0.0958904109589041	0.15555555555555556	GO:0009299	GO:BP	mRNA transcription	16175	3446		0.42105263157894735	0.4358974358974359	45	16130	7	66	38	16064	16175	0.1190230159730117
M1	string	0	network_modules	7	TRUE	2.495946098087003e-6	34	49	6	0.12244897959183673	0.17647058823529413	KEGG:04710	KEGG	Circadian rhythm	8484	345		0	0.16666666666666666	34	8450	6	43	28	8407	8484	0.1428867662303398
M1	string	0	network_modules	7	TRUE	1.420540424569199e-5	8	55	4	0.07272727272727272	0.5	REAC:R-HSA-9029558	REAC	NR1H2 & NR1H3 regulate gene expression linked to lipogenesis	10916	1542		0.5757575757575758	0.5882352941176471	8	10908	4	51	4	10857	10916	0.18931766738165096
M1	string	0	network_modules	7	TRUE	1.5702776482376948e-5	75	49	7	0.14285714285714285	0.09333333333333334	KEGG:03320	KEGG	PPAR signaling pathway	8484	236		0.2	0.3333333333333333	75	8409	7	42	68	8367	8484	0.10912221008628648
M1	string	0	network_modules	7	TRUE	2.5474153077608244e-5	9	55	4	0.07272727272727272	0.4444444444444444	REAC:R-HSA-9623433	REAC	NR1H2 & NR1H3 regulate gene expression to control bile acid homeostasis	10916	1544		0.6060606060606061	0.6176470588235294	9	10907	4	51	5	10856	10916	0.17827146176231165
M1	string	0	network_modules	7	TRUE	3.0917172429987134e-5	45	55	6	0.10909090909090909	0.13333333333333333	REAC:R-HSA-9024446	REAC	NR1H2 and NR1H3-mediated signaling	10916	1546		0.6363636363636364	0.6470588235294118	45	10871	6	49	39	10822	10916	0.11658106913503051
M1	string	0	network_modules	7	TRUE	5.2986035655251975e-5	107	73	8	0.1095890410958904	0.07476635514018691	GO:0030518	GO:BP	nuclear receptor-mediated steroid hormone signaling pathway	16175	6833		0.4473684210526316	0.46153846153846156	107	16068	8	65	99	16003	16175	0.08553032948878049
M1	string	0	network_modules	7	TRUE	6.131655456084648e-5	109	73	8	0.1095890410958904	0.07339449541284404	GO:0043401	GO:BP	steroid hormone receptor signaling pathway	16175	10670		0.47368421052631576	0.48717948717948717	109	16066	8	65	101	16001	16175	0.08464552744909702
M1	string	0	network_modules	7	TRUE	6.234688239432276e-5	292	55	11	0.2	0.03767123287671233	REAC:R-HSA-1852241	REAC	Organelle biogenesis and maintenance	10916	1646		0.6666666666666666	0.6764705882352942	292	10624	11	44	281	10580	10916	0.07640969046512366
M1	string	0	network_modules	7	TRUE	1.1244529844752852e-4	166	73	9	0.1232876712328767	0.05421686746987952	GO:0048545	GO:BP	response to steroid hormone	16175	12826		0.5	0.5128205128205128	166	16009	9	64	157	15945	16175	0.07550989572113861
M1	string	0	network_modules	7	TRUE	1.5708581866892134e-4	10	73	4	0.0547945205479452	0.4	GO:0010887	GO:BP	negative regulation of cholesterol storage	16175	4473		0.5263157894736842	0.5384615384615384	10	16165	4	69	6	16096	16175	0.14675305641420724
M1	string	0	network_modules	7	TRUE	1.990810866250276e-4	26	73	5	0.0684931506849315	0.19230769230769232	GO:0048384	GO:BP	retinoic acid receptor signaling pathway	16175	12719		0.5526315789473685	0.5641025641025641	26	16149	5	68	21	16081	16175	0.11241902134298619
M1	string	0	network_modules	7	TRUE	2.5395555207701636e-4	242	73	10	0.136986301369863	0.04132231404958678	GO:0062012	GO:BP	regulation of small molecule metabolic process	16175	15781		0.5789473684210527	0.5897435897435898	242	15933	10	63	232	15870	16175	0.06767962666969855
M1	string	0	network_modules	7	TRUE	2.6984013644304206e-4	15	55	4	0.07272727272727272	0.26666666666666666	REAC:R-HSA-193807	REAC	Synthesis of bile acids and bile salts via 27-hydroxycholesterol	10916	2403		0.696969696969697	0.7058823529411765	15	10901	4	51	11	10850	10916	0.13707058727577448
M1	string	0	network_modules	7	TRUE	3.223843966278774e-4	36	55	5	0.09090909090909091	0.1388888888888889	REAC:R-HSA-9029569	REAC	NR1H3 & NR1H2 regulate gene expression linked to cholesterol transport and efflux	10916	1547		0.7272727272727273	0.7352941176470589	36	10880	5	50	31	10830	10916	0.1087436220593315
M1	string	0	network_modules	7	TRUE	3.337426646473944e-4	211	55	9	0.16363636363636364	0.04265402843601896	REAC:R-HSA-9711123	REAC	Cellular response to chemical stress	10916	333		0.7575757575757576	0.7647058823529411	211	10705	9	46	202	10659	10916	0.07458691006914174
M1	string	0	network_modules	7	TRUE	4.292335659971511e-4	5	55	3	0.05454545454545454	0.6	REAC:R-HSA-9632974	REAC	NR1H2 & NR1H3 regulate gene expression linked to gluconeogenesis 	10916	1541		0.7878787878787878	0.8529411764705882	5	10911	3	52	2	10859	10916	0.17988248597421802
M1	string	0	network_modules	7	TRUE	4.292335659971511e-4	5	55	3	0.05454545454545454	0.6	REAC:R-HSA-9031528	REAC	NR1H2 & NR1H3 regulate gene expression linked to triglyceride lipolysis in adipose	10916	1543		0.7878787878787878	0.8529411764705882	5	10911	3	52	2	10859	10916	0.17988248597421802
M1	string	0	network_modules	7	TRUE	4.292335659971511e-4	5	55	3	0.05454545454545454	0.6	REAC:R-HSA-9031525	REAC	NR1H2 & NR1H3 regulate gene expression to limit cholesterol uptake 	10916	1545		0.7878787878787878	0.8529411764705882	5	10911	3	52	2	10859	10916	0.17988248597421802
M1	string	0	network_modules	7	TRUE	4.80990909080044e-4	142	73	8	0.1095890410958904	0.056338028169014086	GO:0071383	GO:BP	cellular response to steroid hormone stimulus	16175	16635		0.6052631578947368	0.6153846153846154	142	16033	8	65	134	15968	16175	0.07276426018661372
M1	string	0	network_modules	7	TRUE	5.967693778735274e-4	32	73	5	0.0684931506849315	0.15625	GO:0045923	GO:BP	positive regulation of fatty acid metabolic process	16175	11717		0.631578947368421	0.6410256410256411	32	16143	5	68	27	16075	16175	0.100789876614755
M1	string	0	network_modules	7	TRUE	5.981628863520249e-4	18	55	4	0.07272727272727272	0.2222222222222222	REAC:R-HSA-159418	REAC	Recycling of bile acids and salts	10916	1952		0.8787878787878788	0.8823529411764706	18	10898	4	51	14	10847	10916	0.12466296355127754
M1	string	0	network_modules	7	TRUE	6.609675395347198e-4	148	73	8	0.1095890410958904	0.05405405405405406	GO:0120161	GO:BP	regulation of cold-induced thermogenesis	16175	19527		0.6578947368421053	0.6666666666666666	148	16027	8	65	140	15962	16175	0.07102507876840693
M1	string	0	network_modules	7	TRUE	6.959701077470742e-4	149	73	8	0.1095890410958904	0.053691275167785234	GO:0106106	GO:BP	cold-induced thermogenesis	16175	19254		0.6842105263157895	0.6923076923076923	149	16026	8	65	141	15961	16175	0.07074497394738578
M1	string	0	network_modules	7	TRUE	6.975770667072595e-4	101	73	7	0.0958904109589041	0.06930693069306931	GO:0010565	GO:BP	regulation of ketone metabolic process	16175	4218		0.7105263157894737	0.717948717948718	101	16074	7	66	94	16008	16175	0.07662580640278621
M1	string	0	network_modules	7	TRUE	7.3861108604172e-4	14	73	4	0.0547945205479452	0.2857142857142857	GO:0042753	GO:BP	positive regulation of circadian rhythm	16175	10346		0.7368421052631579	0.7435897435897436	14	16161	4	69	10	16092	16175	0.1234781006269666
M1	string	0	network_modules	7	TRUE	8.014351074384637e-4	43	55	5	0.09090909090909091	0.11627906976744186	REAC:R-HSA-5362517	REAC	Signaling by Retinoic Acid	10916	2303		0.9090909090909091	0.9117647058823529	43	10873	5	50	38	10823	10916	0.09880299487494754
M1	string	0	network_modules	7	TRUE	0.0012569360295085449	161	73	8	0.1095890410958904	0.049689440993788817	GO:1990845	GO:BP	adaptive thermogenesis	16175	25314		0.7631578947368421	0.7692307692307693	161	16014	8	65	153	15949	16175	0.06757976322382833
M1	string	0	network_modules	7	TRUE	0.0013337854836433	16	73	4	0.0547945205479452	0.25	GO:0010885	GO:BP	regulation of cholesterol storage	16175	4471		0.7894736842105263	0.7948717948717948	16	16159	4	69	12	16090	16175	0.11524549409547699
M1	string	0	network_modules	7	TRUE	0.001514396540178118	165	73	8	0.1095890410958904	0.048484848484848485	GO:0001659	GO:BP	temperature homeostasis	16175	373		0.8157894736842105	0.8205128205128205	165	16010	8	65	157	15945	16175	0.06659821950221152
M1	string	0	network_modules	7	TRUE	0.0015572735674146286	71	73	6	0.0821917808219178	0.08450704225352113	GO:0019218	GO:BP	regulation of steroid metabolic process	16175	5595		0.8421052631578947	0.8461538461538461	71	16104	6	67	65	16037	16175	0.07924322425095101
M1	string	0	network_modules	7	TRUE	0.0016988806052006989	23	55	4	0.07272727272727272	0.17391304347826086	REAC:R-HSA-193368	REAC	Synthesis of bile acids and bile salts via 7alpha-hydroxycholesterol	10916	2404		0.9393939393939394	0.9411764705882353	23	10893	4	51	19	10842	10916	0.10959776360658763
M1	string	0	network_modules	7	TRUE	0.0022272523756649756	18	73	4	0.0547945205479452	0.2222222222222222	GO:0010878	GO:BP	cholesterol storage	16175	4464		0.868421052631579	0.8717948717948718	18	16157	4	69	14	16088	16175	0.1084115091394929
M1	string	0	network_modules	7	TRUE	0.0027324289454774857	242	73	9	0.1232876712328767	0.0371900826446281	GO:0008202	GO:BP	steroid metabolic process	16175	3129		0.8947368421052632	0.8974358974358975	242	15933	9	64	233	15869	16175	0.06008185064056018
M1	string	0	network_modules	7	TRUE	0.002836239265057928	26	55	4	0.07272727272727272	0.15384615384615385	REAC:R-HSA-211976	REAC	Endogenous sterols	10916	840		0.9696969696969697	0.9705882352941176	26	10890	4	51	22	10839	10916	0.10269406618117452
M1	string	0	network_modules	7	TRUE	0.0036904757958614092	70	49	5	0.10204081632653061	0.07142857142857142	KEGG:04920	KEGG	Adipocytokine signaling pathway	8484	377		0.4	0.5	70	8414	5	44	65	8370	8484	0.07902461303226298
M1	string	0	network_modules	7	TRUE	0.004229579036157064	72	49	5	0.10204081632653061	0.06944444444444445	KEGG:05223	KEGG	Non-small cell lung cancer	8484	474		0.6	0.6666666666666666	72	8412	5	44	67	8368	8484	0.07773271081921436
M1	string	0	network_modules	7	TRUE	0.004311846643703985	21	73	4	0.0547945205479452	0.19047619047619047	GO:0010888	GO:BP	negative regulation of lipid storage	16175	4474		0.9210526315789473	0.9230769230769231	21	16154	4	69	17	16085	16175	0.10003206253838287
M1	string	0	network_modules	7	TRUE	0.00437075157856357	37	49	4	0.08163265306122448	0.10810810810810811	KEGG:05216	KEGG	Thyroid cancer	8484	467		0.8	0.8333333333333334	37	8447	4	45	33	8402	8484	0.08937651265669264
M1	string	0	network_modules	7	TRUE	0.005252073663070204	22	73	4	0.0547945205479452	0.18181818181818182	GO:0032107	GO:BP	regulation of response to nutrient levels	16175	7368		0.9473684210526315	0.9487179487179487	22	16153	4	69	18	16084	16175	0.09762224330681676
M1	string	0	network_modules	7	TRUE	0.006040383492203249	139	73	7	0.0958904109589041	0.050359712230215826	GO:0046890	GO:BP	regulation of lipid biosynthetic process	16175	12425		0.9736842105263158	0.9743589743589743	139	16036	7	66	132	15970	16175	0.0636809037636383
M1	string	0	network_modules	7	TRUE	0.007562626345506811	33	55	4	0.07272727272727272	0.12121212121212122	REAC:R-HSA-192105	REAC	Synthesis of bile acids and bile salts	10916	2401		1	1	33	10883	4	51	29	10832	10916	0.09035195387383958
M1	string	0	network_modules	7	TRUE	0.008114542162671951	192	49	7	0.14285714285714285	0.036458333333333336	KEGG:05202	KEGG	Transcriptional misregulation in cancer	8484	454		1	1	192	8292	7	42	185	8250	8484	0.06161343294369299
M1	string	0	network_modules	7	TRUE	0.008677930349938533	95	73	6	0.0821917808219178	0.06315789473684211	GO:0051147	GO:BP	regulation of muscle cell differentiation	16175	13530		1	1	95	16080	6	67	89	16013	16175	0.06724978821368703
M1	string	0	network_modules	8	TRUE	1.418890047710896e-45	86	49	29	0.5918367346938775	0.3372093023255814	KEGG:04610	KEGG	Complement and coagulation cascades	8484	320		NA	1	86	8398	29	20	57	8378	8484	0.4426067821797561
M1	string	0	network_modules	8	TRUE	9.401713230650583e-37	39	59	21	0.3559322033898305	0.5384615384615384	REAC:R-HSA-140877	REAC	Formation of Fibrin Clot (Clotting Cascade)	10916	945		0	0.03225806451612903	39	10877	21	38	18	10839	10916	0.4353451288412581
M1	string	0	network_modules	8	TRUE	4.027399681578769e-34	179	69	28	0.4057971014492754	0.1564245810055866	GO:0007596	GO:BP	blood coagulation	16175	3055		0	0.018867924528301886	179	15996	28	41	151	15955	16175	0.24696966566283016
M1	string	0	network_modules	8	TRUE	7.794878994788542e-34	183	69	28	0.4057971014492754	0.15300546448087432	GO:0050817	GO:BP	coagulation	16175	13279		0.019230769230769232	0.03773584905660377	183	15992	28	41	155	15951	16175	0.24413313311972862
M1	string	0	network_modules	8	TRUE	1.0780119404742035e-33	185	69	28	0.4057971014492754	0.15135135135135136	GO:0007599	GO:BP	hemostasis	16175	3058		0.038461538461538464	0.05660377358490566	185	15990	28	41	157	15949	16175	0.2427489816412117
M1	string	0	network_modules	8	TRUE	6.70443344525878e-30	249	69	28	0.4057971014492754	0.11244979919678715	GO:0050878	GO:BP	regulation of body fluid levels	16175	13323		0.057692307692307696	0.07547169811320754	249	15926	28	41	221	15885	16175	0.2075558966846046
M1	string	0	network_modules	8	TRUE	1.2938996377649923e-27	339	69	29	0.42028985507246375	0.0855457227138643	GO:0042060	GO:BP	wound healing	16175	9947		0.07692307692307693	0.09433962264150944	339	15836	29	40	310	15796	16175	0.18246772396696212
M1	string	0	network_modules	8	TRUE	2.7149367537926324e-25	407	69	29	0.42028985507246375	0.07125307125307126	GO:0009611	GO:BP	response to wounding	16175	3539		0.09615384615384616	0.11320754716981132	407	15768	29	40	378	15728	16175	0.16513031450163995
M1	string	0	network_modules	8	TRUE	3.964908526065589e-25	22	59	14	0.23728813559322035	0.6363636363636364	REAC:R-HSA-140875	REAC	Common Pathway of Fibrin Clot Formation	10916	388		0.03333333333333333	0.06451612903225806	22	10894	14	45	8	10849	10916	0.38672407399134134
M1	string	0	network_modules	8	TRUE	5.682916566065782e-25	24	69	14	0.2028985507246377	0.5833333333333334	GO:0042730	GO:BP	fibrinolysis	16175	10330		0.11538461538461539	0.1320754716981132	24	16151	14	55	10	16096	16175	0.34250032906192124
M1	string	0	network_modules	8	TRUE	1.7349780921260876e-22	57	69	16	0.2318840579710145	0.2807017543859649	GO:0030193	GO:BP	regulation of blood coagulation	16175	6704		0.1346153846153846	0.1509433962264151	57	16118	16	53	41	16065	16175	0.2522331773428989
M1	string	0	network_modules	8	TRUE	2.1368258762479407e-22	44	69	15	0.21739130434782608	0.3409090909090909	GO:1900047	GO:BP	negative regulation of hemostasis	16175	20349		0.15384615384615385	0.18867924528301888	44	16131	15	54	29	16077	16175	0.2697686622173878
M1	string	0	network_modules	8	TRUE	2.1368258762479407e-22	44	69	15	0.21739130434782608	0.3409090909090909	GO:0030195	GO:BP	negative regulation of blood coagulation	16175	6706		0.15384615384615385	0.18867924528301888	44	16131	15	54	29	16077	16175	0.2697686622173878
M1	string	0	network_modules	8	TRUE	2.388511526326494e-22	58	69	16	0.2318840579710145	0.27586206896551724	GO:1900046	GO:BP	regulation of hemostasis	16175	20348		0.19230769230769232	0.20754716981132076	58	16117	16	53	42	16064	16175	0.2499893585926663
M1	string	0	network_modules	8	TRUE	3.267122934828745e-22	59	69	16	0.2318840579710145	0.2711864406779661	GO:0050818	GO:BP	regulation of coagulation	16175	13280		0.21153846153846154	0.22641509433962265	59	16116	16	53	43	16063	16175	0.24780231697323848
M1	string	0	network_modules	8	TRUE	3.3342343896064833e-22	23	59	13	0.22033898305084745	0.5652173913043478	REAC:R-HSA-140837	REAC	Intrinsic Pathway of Fibrin Clot Formation	10916	1269		0.06666666666666667	0.0967741935483871	23	10893	13	46	10	10847	10916	0.350845043375096
M1	string	0	network_modules	8	TRUE	4.726367699410461e-22	46	69	15	0.21739130434782608	0.32608695652173914	GO:0050819	GO:BP	negative regulation of coagulation	16175	13281		0.23076923076923078	0.24528301886792453	46	16129	15	54	31	16075	16175	0.2637033369976348
M1	string	0	network_modules	8	TRUE	9.653346402684302e-21	124	59	19	0.3220338983050847	0.1532258064516129	REAC:R-HSA-381426	REAC	Regulation of Insulin-like Growth Factor (IGF) transport and uptake by Insulin-like Growth Factor Binding Proteins (IGFBPs)	10916	1981		0.1	0.12903225806451613	124	10792	19	40	105	10752	10916	0.21611171389106593
M1	string	0	network_modules	8	TRUE	1.0693032618432306e-19	63	69	15	0.21739130434782608	0.23809523809523808	GO:0061045	GO:BP	negative regulation of wound healing	16175	15161		0.25	0.2641509433962264	63	16112	15	54	48	16058	16175	0.2243471475491289
M1	string	0	network_modules	8	TRUE	3.6480001725178065e-18	78	69	15	0.21739130434782608	0.19230769230769232	GO:1903035	GO:BP	negative regulation of response to wounding	16175	22715		0.2692307692307692	0.2830188679245283	78	16097	15	54	63	16043	16175	0.20084232537642124
M1	string	0	network_modules	8	TRUE	1.6315353162806718e-17	24	69	11	0.15942028985507245	0.4583333333333333	GO:0031639	GO:BP	plasminogen activation	16175	7249		0.28846153846153844	0.3018867924528302	24	16151	11	58	13	16093	16175	0.2685667344476089
M1	string	0	network_modules	8	TRUE	2.4042380551119624e-17	112	69	16	0.2318840579710145	0.14285714285714285	GO:0061041	GO:BP	regulation of wound healing	16175	15157		0.3076923076923077	0.32075471698113206	112	16063	16	53	96	16010	16175	0.17756507468098012
M1	string	0	network_modules	8	TRUE	2.604887981009075e-17	126	59	17	0.288135593220339	0.1349206349206349	REAC:R-HSA-114608	REAC	Platelet degranulation 	10916	1764		0.13333333333333333	0.16129032258064516	126	10790	17	42	109	10748	10916	0.19088845039883953
M1	string	0	network_modules	8	TRUE	3.551611243972624e-17	17	69	10	0.14492753623188406	0.5882352941176471	GO:0051917	GO:BP	regulation of fibrinolysis	16175	13993		0.3269230769230769	0.33962264150943394	17	16158	10	59	7	16099	16175	0.2906341776184582
M1	string	0	network_modules	8	TRUE	5.184487686037334e-17	131	59	17	0.288135593220339	0.1297709923664122	REAC:R-HSA-76005	REAC	Response to elevated platelet cytosolic Ca2+	10916	2090		0.16666666666666666	0.1935483870967742	131	10785	17	42	114	10743	10916	0.18694339630785362
M1	string	0	network_modules	8	TRUE	8.381910611606704e-17	54	69	13	0.18840579710144928	0.24074074074074073	GO:0031638	GO:BP	zymogen activation	16175	7248		0.34615384615384615	0.3584905660377358	54	16121	13	56	41	16065	16175	0.209996392953084
M1	string	0	network_modules	8	TRUE	3.7397298669929104e-16	132	69	16	0.2318840579710145	0.12121212121212122	GO:1903034	GO:BP	regulation of response to wounding	16175	22714		0.36538461538461536	0.37735849056603776	132	16043	16	53	116	15990	16175	0.16276329677169943
M1	string	0	network_modules	8	TRUE	5.628077063037278e-15	16	69	9	0.13043478260869565	0.5625	GO:0072376	GO:BP	protein activation cascade	16175	17373		0.38461538461538464	0.39622641509433965	16	16159	9	60	7	16099	16175	0.2695225173698492
M1	string	0	network_modules	8	TRUE	8.620464799744966e-15	16	59	9	0.15254237288135594	0.5625	REAC:R-HSA-9671793	REAC	Diseases of hemostasis	10916	766		0.2	0.25806451612903225	16	10900	9	50	7	10850	10916	0.29111103962588025
M1	string	0	network_modules	8	TRUE	8.620464799744966e-15	16	59	9	0.15254237288135594	0.5625	REAC:R-HSA-9651496	REAC	Defects of contact activation system (CAS) and kallikrein/kinin system (KKS)	10916	716		0.2	0.25806451612903225	16	10900	9	50	7	10850	10916	0.29111103962588025
M1	string	0	network_modules	8	TRUE	2.398483189192798e-13	22	69	9	0.13043478260869565	0.4090909090909091	GO:0050820	GO:BP	positive regulation of coagulation	16175	13282		0.40384615384615385	0.4528301886792453	22	16153	9	60	13	16093	16175	0.22923347426194254
M1	string	0	network_modules	8	TRUE	2.398483189192798e-13	22	69	9	0.13043478260869565	0.4090909090909091	GO:0030194	GO:BP	positive regulation of blood coagulation	16175	6705		0.40384615384615385	0.4528301886792453	22	16153	9	60	13	16093	16175	0.22923347426194254
M1	string	0	network_modules	8	TRUE	2.398483189192798e-13	22	69	9	0.13043478260869565	0.4090909090909091	GO:1900048	GO:BP	positive regulation of hemostasis	16175	20350		0.40384615384615385	0.4528301886792453	22	16153	9	60	13	16093	16175	0.22923347426194254
M1	string	0	network_modules	8	TRUE	2.7665301777604967e-13	198	69	16	0.2318840579710145	0.08080808080808081	GO:0016485	GO:BP	protein processing	16175	5233		0.46153846153846156	0.4716981132075472	198	15977	16	53	182	15924	16175	0.13074106942080352
M1	string	0	network_modules	8	TRUE	3.1895211225567665e-13	259	59	18	0.3050847457627119	0.0694980694980695	REAC:R-HSA-76002	REAC	Platelet activation, signaling and aggregation	10916	1762		0.26666666666666666	0.2903225806451613	259	10657	18	41	241	10616	10916	0.13627829165256572
M1	string	0	network_modules	8	TRUE	8.389597692826461e-13	15	69	8	0.11594202898550725	0.5333333333333333	GO:0072378	GO:BP	blood coagulation, fibrin clot formation	16175	17375		0.4807692307692308	0.49056603773584906	15	16160	8	61	7	16099	16175	0.24732153008373048
M1	string	0	network_modules	8	TRUE	4.1244593038410996e-12	10	59	7	0.11864406779661017	0.7	REAC:R-HSA-159740	REAC	Gamma-carboxylation of protein precursors	10916	1031		0.3	0.3225806451612903	10	10906	7	52	3	10854	10916	0.2868676425668304
M1	string	0	network_modules	8	TRUE	1.1294953888368e-11	11	59	7	0.11864406779661017	0.6363636363636364	REAC:R-HSA-159854	REAC	Gamma-carboxylation, transport, and amino-terminal cleavage of proteins	10916	1032		0.3333333333333333	0.3548387096774194	11	10905	7	52	4	10853	10916	0.2733172616459239
M1	string	0	network_modules	8	TRUE	1.1907959781670045e-11	483	69	20	0.2898550724637681	0.041407867494824016	GO:0051604	GO:BP	protein maturation	16175	13821		0.5	0.5094339622641509	483	15692	20	49	463	15643	16175	0.09998293744054147
M1	string	0	network_modules	8	TRUE	2.7108002754878866e-11	12	69	7	0.10144927536231885	0.5833333333333334	GO:0051918	GO:BP	negative regulation of fibrinolysis	16175	13994		0.5192307692307693	0.5283018867924528	12	16163	7	62	5	16101	16175	0.24209438531989771
M1	string	0	network_modules	8	TRUE	2.9531964858877744e-11	319	69	17	0.2463768115942029	0.05329153605015674	GO:0032102	GO:BP	negative regulation of response to external stimulus	16175	7366		0.5384615384615384	0.5471698113207547	319	15856	17	52	302	15804	16175	0.10669600710631275
M1	string	0	network_modules	8	TRUE	5.94323809785734e-10	9	59	6	0.1016949152542373	0.6666666666666666	REAC:R-HSA-159763	REAC	Transport of gamma-carboxylated protein precursors from the endoplasmic reticulum to the Golgi apparatus	10916	2594		0.36666666666666664	0.3870967741935484	9	10907	6	53	3	10854	10916	0.2590744630747242
M1	string	0	network_modules	8	TRUE	1.4796228355085734e-9	10	59	6	0.1016949152542373	0.6	REAC:R-HSA-159782	REAC	Removal of aminoterminal propeptides from gamma-carboxylated proteins	10916	2057		0.4	0.41935483870967744	10	10906	6	53	4	10853	10916	0.24556766121234858
M1	string	0	network_modules	8	TRUE	2.303707969584514e-9	54	69	9	0.13043478260869565	0.16666666666666666	GO:0090303	GO:BP	positive regulation of wound healing	16175	18186		0.5576923076923077	0.5660377358490566	54	16121	9	60	45	16061	16175	0.14421652171640634
M1	string	0	network_modules	8	TRUE	3.354349000251658e-9	107	59	11	0.1864406779661017	0.102803738317757	REAC:R-HSA-8957275	REAC	Post-translational protein phosphorylation	10916	1777		0.43333333333333335	0.45161290322580644	107	10809	11	48	96	10761	10916	0.13217078340060331
M1	string	0	network_modules	8	TRUE	5.352995795900562e-9	59	69	9	0.13043478260869565	0.15254237288135594	GO:1903036	GO:BP	positive regulation of response to wounding	16175	22716		0.5769230769230769	0.5849056603773585	59	16116	9	60	50	16056	16175	0.13765617209262054
M1	string	0	network_modules	8	TRUE	1.1940231733349868e-8	13	59	6	0.1016949152542373	0.46153846153846156	REAC:R-HSA-75205	REAC	Dissolution of Fibrin Clot	10916	780		0.4666666666666667	0.4838709677419355	13	10903	6	53	7	10850	10916	0.2148192968507034
M1	string	0	network_modules	8	TRUE	1.794083325793974e-7	9	59	5	0.0847457627118644	0.5555555555555556	REAC:R-HSA-9668250	REAC	Defective factor IX causes hemophilia B	10916	692		0.5	0.5161290322580645	9	10907	5	54	4	10853	10916	0.215542456010556
M1	string	0	network_modules	8	TRUE	3.4176966826427834e-7	60	59	8	0.13559322033898305	0.13333333333333333	REAC:R-HSA-163841	REAC	Gamma carboxylation, hypusinylation, hydroxylation, and arylsulfatase activation	10916	1030		0.5333333333333333	0.5483870967741935	60	10856	8	51	52	10805	10916	0.1297150468312558
M1	string	0	network_modules	8	TRUE	5.61522204652938e-7	4	69	4	0.057971014492753624	1	GO:0051919	GO:BP	positive regulation of fibrinolysis	16175	13995		0.5961538461538461	0.6037735849056604	4	16171	4	65	0	16106	16175	0.24028732304111602
M1	string	0	network_modules	8	TRUE	1.430236966912745e-6	5	59	4	0.06779661016949153	0.8	REAC:R-HSA-140834	REAC	Extrinsic Pathway of Fibrin Clot Formation	10916	890		0.5666666666666667	0.5806451612903226	5	10911	4	55	1	10856	10916	0.2319963774301947
M1	string	0	network_modules	8	TRUE	9.93109351790396e-6	7	59	4	0.06779661016949153	0.5714285714285714	REAC:R-HSA-9662001	REAC	Defective factor VIII causes hemophilia A	10916	694		0.6	0.6129032258064516	7	10909	4	55	3	10854	10916	0.19555716720805208
M1	string	0	network_modules	8	TRUE	1.3423944075615735e-5	17	69	5	0.07246376811594203	0.29411764705882354	GO:0010755	GO:BP	regulation of plasminogen activation	16175	4376		0.6153846153846154	0.6226415094339622	17	16158	5	64	12	16094	16175	0.14425556103642712
M1	string	0	network_modules	8	TRUE	3.330209524312203e-5	20	69	5	0.07246376811594203	0.25	GO:0043567	GO:BP	regulation of insulin-like growth factor receptor signaling pathway	16175	10772		0.6346153846153846	0.6415094339622641	20	16155	5	64	15	16091	16175	0.13266395546078635
M1	string	0	network_modules	8	TRUE	4.782600133556921e-5	795	69	17	0.2463768115942029	0.021383647798742137	GO:0051241	GO:BP	negative regulation of multicellular organismal process	16175	13591		0.6538461538461539	0.660377358490566	795	15380	17	52	778	15328	16175	0.05971444212728584
M1	string	0	network_modules	8	TRUE	5.596916791411016e-5	3	59	3	0.05084745762711865	1	REAC:R-HSA-9657688	REAC	Defective factor XII causes hereditary angioedema	10916	695		0.6333333333333333	0.7741935483870968	3	10913	3	56	0	10857	10916	0.22491450414665626
M1	string	0	network_modules	8	TRUE	5.596916791411016e-5	3	59	3	0.05084745762711865	1	REAC:R-HSA-9672396	REAC	Defective cofactor function of FVIIIa variant	10916	691		0.6333333333333333	0.7741935483870968	3	10913	3	56	0	10857	10916	0.22491450414665626
M1	string	0	network_modules	8	TRUE	5.596916791411016e-5	3	59	3	0.05084745762711865	1	REAC:R-HSA-9673202	REAC	Defective F9 variant does not activate FX	10916	548		0.6333333333333333	0.7741935483870968	3	10913	3	56	0	10857	10916	0.22491450414665626
M1	string	0	network_modules	8	TRUE	5.596916791411016e-5	3	59	3	0.05084745762711865	1	REAC:R-HSA-9657689	REAC	Defective SERPING1 causes hereditary angioedema	10916	614		0.6333333333333333	0.7741935483870968	3	10913	3	56	0	10857	10916	0.22491450414665626
M1	string	0	network_modules	8	TRUE	5.596916791411016e-5	3	59	3	0.05084745762711865	1	REAC:R-HSA-9672383	REAC	Defective factor IX causes thrombophilia	10916	693		0.6333333333333333	0.7741935483870968	3	10913	3	56	0	10857	10916	0.22491450414665626
M1	string	0	network_modules	8	TRUE	8.363195720323069e-5	47	69	6	0.08695652173913043	0.1276595744680851	GO:0070613	GO:BP	regulation of protein processing	16175	16212		0.6730769230769231	0.6792452830188679	47	16128	6	63	41	16065	16175	0.10220630036645147
M1	string	0	network_modules	8	TRUE	1.0819026163527636e-4	49	69	6	0.08695652173913043	0.12244897959183673	GO:1903317	GO:BP	regulation of protein maturation	16175	22901		0.6923076923076923	0.6981132075471698	49	16126	6	63	43	16063	16175	0.09995766978270569
M1	string	0	network_modules	8	TRUE	1.3758995596435352e-4	3	69	3	0.043478260869565216	1	GO:0002541	GO:BP	activation of plasma proteins involved in acute inflammatory response	16175	1062		0.7115384615384616	0.71698113207547165	3	16172	3	66	0	16106	16175	0.20808849205844884
M1	string	0	network_modules	8	TRUE	0.00027611301401868034	14	59	4	0.06779661016949153	0.2857142857142857	REAC:R-HSA-354194	REAC	GRB2:SOS provides linkage to MAPK signaling for Integrins 	10916	1024		0.8	0.8064516129032258	14	10902	4	55	10	10847	10916	0.13700334004544462
M1	string	0	network_modules	8	TRUE	2.961589481779497e-4	30	69	5	0.07246376811594203	0.16666666666666666	GO:0048009	GO:BP	insulin-like growth factor receptor signaling pathway	16175	12465		0.7307692307692307	0.7358490566037735	30	16145	5	64	25	16081	16175	0.10741272353088648
M1	string	0	network_modules	8	TRUE	3.750009461298982e-4	15	59	4	0.06779661016949153	0.26666666666666666	REAC:R-HSA-372708	REAC	p130Cas linkage to MAPK signaling for integrins	10916	2715		0.8333333333333334	0.8387096774193549	15	10901	4	55	11	10846	10916	0.13218156947628942
M1	string	0	network_modules	8	TRUE	4.040367174244043e-4	101	59	7	0.11864406779661017	0.06930693069306931	REAC:R-HSA-977606	REAC	Regulation of Complement cascade	10916	1971		0.8666666666666667	0.8709677419354839	101	10815	7	52	94	10763	10916	0.08422569770756042
M1	string	0	network_modules	8	TRUE	6.340354221844823e-4	38	59	5	0.0847457627118644	0.13157894736842105	REAC:R-HSA-76009	REAC	Platelet Aggregation (Plug Formation)	10916	1761		0.9	0.9032258064516129	38	10878	5	54	33	10824	10916	0.10171145630259414
M1	string	0	network_modules	8	TRUE	7.651450023668361e-4	111	59	7	0.11864406779661017	0.06306306306306306	REAC:R-HSA-166658	REAC	Complement cascade	10916	390		0.9333333333333333	0.9354838709677419	111	10805	7	52	104	10753	10916	0.07970625992034655
M1	string	0	network_modules	8	TRUE	8.142561615703972e-4	224	69	9	0.13043478260869565	0.04017857142857143	GO:0006959	GO:BP	humoral immune response	16175	2590		0.75	0.7547169811320755	224	15951	9	60	215	15891	16175	0.06529867328423702
M1	string	0	network_modules	8	TRUE	0.00110651115393592	6	59	3	0.05084745762711865	0.5	REAC:R-HSA-6806942	REAC	MET Receptor Activation	10916	1360		0.9666666666666667	0.967741935483871	6	10910	3	56	3	10854	10916	0.15819605628112796
M1	string	0	network_modules	8	TRUE	0.001446549663291688	781	69	15	0.21739130434782608	0.019206145966709345	GO:0030334	GO:BP	regulation of cell migration	16175	6780		0.7692307692307693	0.7735849056603774	781	15394	15	54	766	15340	16175	0.05163391978594799
M1	string	0	network_modules	8	TRUE	0.0015019026370727603	41	69	5	0.07246376811594203	0.12195121951219512	GO:0014909	GO:BP	smooth muscle cell migration	16175	4782		0.7884615384615384	0.7924528301886793	41	16134	5	64	36	16070	16175	0.09102680556930065
M1	string	0	network_modules	8	TRUE	0.002698159237768667	510	69	12	0.17391304347826086	0.023529411764705882	GO:0007169	GO:BP	cell surface receptor protein tyrosine kinase signaling pathway	16175	2733		0.8076923076923077	0.8113207547169812	510	15665	12	57	498	15608	16175	0.053331346308717005
M1	string	0	network_modules	8	TRUE	0.002840344690768413	192	69	8	0.11594202898550725	0.041666666666666664	GO:0007160	GO:BP	cell-matrix adhesion	16175	2724		0.8269230769230769	0.8301886792452831	192	15983	8	61	184	15922	16175	0.06289679782771034
M1	string	0	network_modules	8	TRUE	0.003928872907034731	26	59	4	0.06779661016949153	0.15384615384615385	REAC:R-HSA-354192	REAC	Integrin signaling	10916	1217		1	1	26	10890	4	55	22	10835	10916	0.09892587960946497
M1	string	0	network_modules	8	TRUE	0.004122116009471799	50	69	5	0.07246376811594203	0.1	GO:0014812	GO:BP	muscle cell migration	16175	4692		0.8461538461538461	0.8490566037735849	50	16125	5	64	45	16061	16175	0.08179522614344552
M1	string	0	network_modules	8	TRUE	0.004756972392215761	7	69	3	0.043478260869565216	0.42857142857142855	GO:0010757	GO:BP	negative regulation of plasminogen activation	16175	4378		0.8653846153846154	0.8679245283018868	7	16168	3	66	4	16102	16175	0.13546450546779418
M1	string	0	network_modules	8	TRUE	0.005043668228947476	279	69	9	0.13043478260869565	0.03225806451612903	GO:0031589	GO:BP	cell-substrate adhesion	16175	7233		0.8846153846153846	0.8867924528301887	279	15896	9	60	270	15836	16175	0.05690120290069492
M1	string	0	network_modules	8	TRUE	0.00539553425733641	450	69	11	0.15942028985507245	0.024444444444444446	GO:0030335	GO:BP	positive regulation of cell migration	16175	6781		0.9038461538461539	0.9056603773584906	450	15725	11	58	439	15667	16175	0.05237546634789866
M1	string	0	network_modules	8	TRUE	0.0055947847246518795	24	69	4	0.057971014492753624	0.16666666666666666	GO:1902042	GO:BP	negative regulation of extrinsic apoptotic signaling pathway via death domain receptors	16175	21965		0.9230769230769231	0.9245283018867925	24	16151	4	65	20	16086	16175	0.09605501368088011
M1	string	0	network_modules	8	TRUE	0.00663907644047758	25	69	4	0.057971014492753624	0.16	GO:2000352	GO:BP	negative regulation of endothelial cell apoptotic process	16175	25671		0.9423076923076923	0.9433962264150944	25	16150	4	65	21	16085	16175	0.09401421318796238
M1	string	0	network_modules	8	TRUE	0.007587873746569506	8	69	3	0.043478260869565216	0.375	GO:0007597	GO:BP	blood coagulation, intrinsic pathway	16175	3056		0.9615384615384616	0.9622641509433962	8	16167	3	66	5	16101	16175	0.1265373609439334
M1	string	0	network_modules	8	TRUE	0.008185580804781255	470	69	11	0.15942028985507245	0.023404255319148935	GO:2000147	GO:BP	positive regulation of cell motility	16175	25495		0.9807692307692307	0.9811320754716981	470	15705	11	58	459	15647	16175	0.05079977360141203
M1	string	0	network_modules	8	TRUE	0.009807761330322962	479	69	11	0.15942028985507245	0.022964509394572025	GO:0040017	GO:BP	positive regulation of locomotion	16175	9905		1	1	479	15696	11	58	468	15638	16175	0.050119855102584675
M1	string	0	network_modules	9	TRUE	9.405640515843994e-56	590	69	51	0.7391304347826086	0.08644067796610169	GO:0016567	GO:BP	protein ubiquitination	16175	5254		0	0.05	590	15585	51	18	539	15567	16175	0.24532247814398098
M1	string	0	network_modules	9	TRUE	5.847132705401503e-53	667	69	51	0.7391304347826086	0.07646176911544228	GO:0032446	GO:BP	protein modification by small protein conjugation	16175	7568		0.05263157894736842	0.1	667	15508	51	18	616	15490	16175	0.2297331212425455
M1	string	0	network_modules	9	TRUE	2.454390563783698e-50	749	69	51	0.7391304347826086	0.06809078771695594	GO:0070647	GO:BP	protein modification by small protein conjugation or removal	16175	16231		0.10526315789473684	0.15	749	15426	51	18	698	15408	16175	0.21578964157595157
M1	string	0	network_modules	9	TRUE	6.55567005905494e-49	798	69	51	0.7391304347826086	0.06390977443609022	GO:0043687	GO:BP	post-translational protein modification	16175	10838		0.15789473684210525	0.2	798	15377	51	18	747	15359	16175	0.20847683353982902
M1	string	0	network_modules	9	TRUE	1.3035486452307211e-40	248	69	34	0.4927536231884058	0.13709677419354838	GO:0000209	GO:BP	protein polyubiquitination	16175	59		0.21052631578947367	0.25	248	15927	34	35	214	15892	16175	0.25432202113516067
M1	string	0	network_modules	9	TRUE	1.0513780537971102e-27	308	52	28	0.5384615384615384	0.09090909090909091	REAC:R-HSA-983168	REAC	Antigen processing: Ubiquitination & Proteasome degradation	10916	154		0	0.14285714285714285	308	10608	28	24	280	10584	10916	0.21318560637909845
M1	string	0	network_modules	9	TRUE	4.1170104508794158e-25	380	52	28	0.5384615384615384	0.07368421052631578	REAC:R-HSA-983169	REAC	Class I MHC mediated antigen processing & presentation	10916	368		0.16666666666666666	0.2857142857142857	380	10536	28	24	352	10512	10916	0.19009456358611496
M1	string	0	network_modules	9	TRUE	1.327876274368412e-21	547	69	29	0.42028985507246375	0.05301645338208409	GO:0006511	GO:BP	ubiquitin-dependent protein catabolic process	16175	2235		0.2631578947368421	0.3	547	15628	29	40	518	15588	16175	0.13994195022715894
M1	string	0	network_modules	9	TRUE	2.0056194686694896e-21	555	69	29	0.42028985507246375	0.05225225225225225	GO:0019941	GO:BP	modification-dependent protein catabolic process	16175	6072		0.3157894736842105	0.35	555	15620	29	40	526	15580	16175	0.13878742970229882
M1	string	0	network_modules	9	TRUE	2.4589732432428918e-21	559	69	29	0.42028985507246375	0.0518783542039356	GO:0043632	GO:BP	modification-dependent macromolecule catabolic process	16175	10812		0.3684210526315789	0.4	559	15616	29	40	530	15576	16175	0.13821907880364281
M1	string	0	network_modules	9	TRUE	6.238572081343982e-21	140	32	17	0.53125	0.12142857142857143	KEGG:04120	KEGG	Ubiquitin mediated proteolysis	8484	270		0	0.5	140	8344	17	15	123	8329	8484	0.24862208390442658
M1	string	0	network_modules	9	TRUE	2.5330397040312583e-20	673	69	30	0.43478260869565216	0.04457652303120357	GO:0051603	GO:BP	proteolysis involved in protein catabolic process	16175	13820		0.42105263157894735	0.45	673	15502	30	39	643	15463	16175	0.1288723340063445
M1	string	0	network_modules	9	TRUE	6.036253520511954e-20	79	69	16	0.2318840579710145	0.20253164556962025	GO:0070936	GO:BP	protein K48-linked ubiquitination	16175	16380		0.47368421052631576	0.5	79	16096	16	53	63	16043	16175	0.2131219957200129
M1	string	0	network_modules	9	TRUE	4.5326862948522997e-13	78	52	12	0.23076923076923078	0.15384615384615385	REAC:R-HSA-8852135	REAC	Protein ubiquitination	10916	1818		0.3333333333333333	0.42857142857142855	78	10838	12	40	66	10798	10916	0.18368190875132734
M1	string	0	network_modules	9	TRUE	3.0677033916363466e-10	30	52	8	0.15384615384615385	0.26666666666666666	REAC:R-HSA-8866652	REAC	Synthesis of active ubiquitin: roles of E1 and E2 enzymes	10916	2400		0.5	0.5714285714285714	30	10886	8	44	22	10842	10916	0.19967971142647584
M1	string	0	network_modules	9	TRUE	1.284714977250527e-9	470	69	18	0.2608695652173913	0.03829787234042553	GO:0010498	GO:BP	proteasomal protein catabolic process	16175	4177		0.5263157894736842	0.55	470	15705	18	51	452	15654	16175	0.09033243359673748
M1	string	0	network_modules	9	TRUE	3.582282021031189e-9	363	69	16	0.2318840579710145	0.0440771349862259	GO:0043161	GO:BP	proteasome-mediated ubiquitin-dependent protein catabolic process	16175	10561		0.5789473684210527	0.6	363	15812	16	53	347	15759	16175	0.0925533377314379
M1	string	0	network_modules	9	TRUE	1.153746769438573e-8	64	69	9	0.13043478260869565	0.140625	GO:0070534	GO:BP	protein K63-linked ubiquitination	16175	16168		0.631578947368421	0.65	64	16111	9	60	55	16051	16175	0.131867855793446
M1	string	0	network_modules	9	TRUE	8.212446579668504e-5	91	52	7	0.1346153846153846	0.07692307692307693	REAC:R-HSA-877300	REAC	Interferon gamma signaling	10916	1229		0.6666666666666666	0.7142857142857143	91	10825	7	45	84	10780	10916	0.09608747867549336
M1	string	0	network_modules	9	TRUE	9.949148861573151e-5	124	69	8	0.11594202898550725	0.06451612903225806	GO:0051092	GO:BP	positive regulation of NF-kappaB transcription factor activity	16175	13487		0.6842105263157895	0.7	124	16051	8	61	116	15990	16175	0.08125401117682103
M1	string	0	network_modules	9	TRUE	1.0935352104808458e-4	58	52	6	0.11538461538461539	0.10344827586206896	REAC:R-HSA-8866654	REAC	E3 ubiquitin ligases ubiquitinate target proteins	10916	811		0.8333333333333334	0.8571428571428571	58	10858	6	46	52	10812	10916	0.10475036746339283
M1	string	0	network_modules	9	TRUE	3.965796031509949e-4	345	69	11	0.15942028985507245	0.03188405797101449	GO:0051090	GO:BP	regulation of DNA-binding transcription factor activity	16175	13485		0.7368421052631579	0.75	345	15830	11	58	334	15772	16175	0.06255911591180477
M1	string	0	network_modules	9	TRUE	4.3544261309713705e-4	208	69	9	0.13043478260869565	0.04326923076923077	GO:0051091	GO:BP	positive regulation of DNA-binding transcription factor activity	16175	13486		0.7894736842105263	0.8	208	15967	9	60	199	15907	16175	0.06830433059050135
M1	string	0	network_modules	9	TRUE	0.002178751828667613	252	69	9	0.13043478260869565	0.03571428571428571	GO:0043122	GO:BP	regulation of canonical NF-kappaB signal transduction	16175	10541		0.8421052631578947	0.85	252	15923	9	60	243	15863	16175	0.06070337993244865
M1	string	0	network_modules	9	TRUE	0.002840344690768413	192	69	8	0.11594202898550725	0.041666666666666664	GO:0043123	GO:BP	positive regulation of canonical NF-kappaB signal transduction	16175	10542		0.8947368421052632	0.9	192	15983	8	61	184	15922	16175	0.06289679782771034
M1	string	0	network_modules	9	TRUE	0.0031604075432244503	721	69	14	0.2028985507246377	0.019417475728155338	GO:0045087	GO:BP	innate immune response	16175	11270		0.9473684210526315	0.95	721	15454	14	55	707	15399	16175	0.05021489145399537
M1	string	0	network_modules	9	TRUE	0.005162112271207163	60	32	4	0.125	0.06666666666666667	KEGG:04330	KEGG	Notch signaling pathway	8484	301		1	1	60	8424	4	28	56	8396	8484	0.08659195276161212
M1	string	0	network_modules	9	TRUE	0.005193672431200531	280	69	9	0.13043478260869565	0.03214285714285714	GO:0007249	GO:BP	canonical NF-kappaB signal transduction	16175	2783		1	1	280	15895	9	60	271	15835	16175	0.05677026371882589
M1	string	0	network_modules	9	TRUE	0.006156885730226788	11	52	3	0.057692307692307696	0.2727272727272727	REAC:R-HSA-9683610	REAC	Maturation of nucleoprotein	10916	1397		1	1	11	10905	3	49	8	10856	10916	0.12360223545772288
M1	string	0	network_modules	10	TRUE	1.9298039809191114e-6	8	34	4	0.11764705882352941	0.5	REAC:R-HSA-68952	REAC	DNA replication initiation	10916	448		0	0.06666666666666667	8	10908	4	30	4	10878	10916	0.24148952118876782
M1	string	0	network_modules	10	TRUE	8.22747292423667e-6	791	70	18	0.2571428571428571	0.022756005056890013	GO:0000122	GO:BP	negative regulation of transcription by RNA polymerase II	16175	48		NA	1	791	15384	18	52	773	15332	16175	0.06365825087314947
M1	string	0	network_modules	10	TRUE	5.290457857836397e-5	41	34	5	0.14705882352941177	0.12195121951219512	REAC:R-HSA-5696400	REAC	Dual Incision in GG-NER	10916	807		0.07142857142857142	0.13333333333333333	41	10875	5	29	36	10846	10916	0.1309474207909462
M1	string	0	network_modules	10	TRUE	7.968026699543146e-5	36	20	4	0.2	0.1111111111111111	KEGG:03030	KEGG	DNA replication	8484	214		0	0.25	36	8448	4	16	32	8432	8484	0.14639164928254725
M1	string	0	network_modules	10	TRUE	1.6034303518984414e-4	21	34	4	0.11764705882352941	0.19047619047619047	REAC:R-HSA-5651801	REAC	PCNA-Dependent Long Patch Base Excision Repair	10916	1658		0.14285714285714285	0.2	21	10895	4	30	17	10865	10916	0.14762030021075107
M1	string	0	network_modules	10	TRUE	1.8142073295091313e-4	44	20	4	0.2	0.09090909090909091	KEGG:03410	KEGG	Base excision repair	8484	237		0.3333333333333333	0.5	44	8440	4	16	40	8424	8484	0.13184082534210056
M1	string	0	network_modules	10	TRUE	3.3593297149264484e-4	25	34	4	0.11764705882352941	0.16	REAC:R-HSA-5696397	REAC	Gap-filling DNA repair synthesis and ligation in GG-NER	10916	1037		0.21428571428571427	0.3333333333333333	25	10891	4	30	21	10861	10916	0.13489259268959428
M1	string	0	network_modules	10	TRUE	3.3593297149264484e-4	25	34	4	0.11764705882352941	0.16	REAC:R-HSA-110373	REAC	Resolution of AP sites via the multiple-nucleotide patch replacement pathway	10916	2073		0.21428571428571427	0.3333333333333333	25	10891	4	30	21	10861	10916	0.13489259268959428
M1	string	0	network_modules	10	TRUE	6.797084668779058e-4	61	20	4	0.2	0.06557377049180328	KEGG:03420	KEGG	Nucleotide excision repair	8484	238		0.6666666666666666	0.75	61	8423	4	16	57	8407	8484	0.11093256539862519
M1	string	0	network_modules	10	TRUE	7.198010517471084e-4	30	34	4	0.11764705882352941	0.13333333333333333	REAC:R-HSA-110314	REAC	Recognition of DNA damage by PCNA-containing replication complex	10916	1948		0.35714285714285715	0.4	30	10886	4	30	26	10856	10916	0.12267874457871261
M1	string	0	network_modules	10	TRUE	9.403525232284065e-4	32	34	4	0.11764705882352941	0.125	REAC:R-HSA-5656169	REAC	Termination of translesion DNA synthesis	10916	2492		0.42857142857142855	0.4666666666666667	32	10884	4	30	28	10854	10916	0.11860466800445132
M1	string	0	network_modules	10	TRUE	0.0010677039058024757	33	34	4	0.11764705882352941	0.12121212121212122	REAC:R-HSA-68962	REAC	Activation of the pre-replicative complex	10916	107		0.5	0.5333333333333333	33	10883	4	30	29	10853	10916	0.116705896591625
M1	string	0	network_modules	10	TRUE	0.0015268629353621178	36	34	4	0.11764705882352941	0.1111111111111111	REAC:R-HSA-73933	REAC	Resolution of Abasic Sites (AP sites)	10916	2075		0.5714285714285714	0.6	36	10880	4	30	32	10850	10916	0.11148485102756424
M1	string	0	network_modules	10	TRUE	0.0017788839996849336	26	20	3	0.15	0.11538461538461539	KEGG:04950	KEGG	Maturity onset diabetes of the young	8484	395		1	1	26	8458	3	17	23	8441	8484	0.12922120264681522
M1	string	0	network_modules	10	TRUE	0.001981092585170318	84	34	5	0.14705882352941177	0.05952380952380952	REAC:R-HSA-5696399	REAC	Global Genome Nucleotide Excision Repair (GG-NER)	10916	1047		0.6428571428571429	0.6666666666666666	84	10832	5	29	79	10803	10916	0.08914650371789191
M1	string	0	network_modules	10	TRUE	0.002113057402608225	12	34	3	0.08823529411764706	0.25	REAC:R-HSA-2892247	REAC	POU5F1 (OCT4), SOX2, NANOG activate genes related to proliferation	10916	1697		0.7142857142857143	0.7333333333333333	12	10904	3	31	9	10873	10916	0.14698149208964004
M1	string	0	network_modules	10	TRUE	0.002117980303629961	39	34	4	0.11764705882352941	0.10256410256410256	REAC:R-HSA-110313	REAC	Translesion synthesis by Y family DNA polymerases bypasses lesions on DNA template	10916	2577		0.7857142857142857	0.8	39	10877	4	30	35	10847	10916	0.10686848469247318
M1	string	0	network_modules	10	TRUE	0.004912226368678177	48	34	4	0.11764705882352941	0.08333333333333333	REAC:R-HSA-73893	REAC	DNA Damage Bypass	10916	438		0.8571428571428571	0.8666666666666667	48	10868	4	30	44	10838	10916	0.09567331068503762
M1	string	0	network_modules	10	TRUE	0.0070922547376775094	109	34	5	0.14705882352941177	0.045871559633027525	REAC:R-HSA-5696398	REAC	Nucleotide Excision Repair	10916	1622		0.9285714285714286	0.9333333333333333	109	10807	5	29	104	10778	10916	0.07706128411688618
M1	string	0	network_modules	10	TRUE	0.008813545332599421	114	34	5	0.14705882352941177	0.043859649122807015	REAC:R-HSA-9758941	REAC	Gastrulation	10916	1040		1	1	114	10802	5	29	109	10773	10916	0.07511797820306823
M1	string	0	network_modules	11	TRUE	8.990037540289024e-55	165	54	39	0.7222222222222222	0.23636363636363636	KEGG:04140	KEGG	Autophagy - animal	8484	277		0	0.1111111111111111	165	8319	39	15	126	8304	8484	0.40730694059159583
M1	string	0	network_modules	11	TRUE	5.5072504251057844e-45	491	69	43	0.6231884057971014	0.08757637474541752	GO:0006914	GO:BP	autophagy	16175	2563		0	0.05555555555555555	491	15684	43	26	448	15658	16175	0.2261716340165871
M1	string	0	network_modules	11	TRUE	5.5072504251057844e-45	491	69	43	0.6231884057971014	0.08757637474541752	GO:0061919	GO:BP	process utilizing autophagic mechanism	16175	15723		0	0.05555555555555555	491	15684	43	26	448	15658	16175	0.2261716340165871
M1	string	0	network_modules	11	TRUE	1.431309141346868e-42	309	69	37	0.5362318840579711	0.11974110032362459	GO:0016236	GO:BP	macroautophagy	16175	5179		0.05714285714285714	0.08333333333333333	309	15866	37	32	272	15834	16175	0.24726369364036038
M1	string	0	network_modules	11	TRUE	2.0466185597945078e-41	104	69	28	0.4057971014492754	0.2692307692307692	GO:0000045	GO:BP	autophagosome assembly	16175	17		0.08571428571428572	0.1111111111111111	104	16071	28	41	76	16030	16175	0.32704650045877737
M1	string	0	network_modules	11	TRUE	6.866796369222105e-41	108	69	28	0.4057971014492754	0.25925925925925924	GO:1905037	GO:BP	autophagosome organization	16175	24312		0.11428571428571428	0.1388888888888889	108	16067	28	41	80	16026	16175	0.3207741375776454
M1	string	0	network_modules	11	TRUE	3.269359799735392e-36	202	69	30	0.43478260869565216	0.1485148514851485	GO:0007033	GO:BP	vacuole organization	16175	2638		0.14285714285714285	0.16666666666666666	202	15973	30	39	172	15934	16175	0.248897866591122
M1	string	0	network_modules	11	TRUE	3.934850323666336e-36	32	54	20	0.37037037037037035	0.625	KEGG:04136	KEGG	Autophagy - other	8484	273		0.125	0.2222222222222222	32	8452	20	34	12	8418	8484	0.47865189130182406
M1	string	0	network_modules	11	TRUE	3.777553431370269e-30	134	46	23	0.5	0.17164179104477612	REAC:R-HSA-1632852	REAC	Macroautophagy	10916	1388		0	0.1111111111111111	134	10782	23	23	111	10759	10916	0.28813772818914296
M1	string	0	network_modules	11	TRUE	5.203361463159554e-29	149	46	23	0.5	0.15436241610738255	REAC:R-HSA-9612973	REAC	Autophagy	10916	193		0.125	0.2222222222222222	149	10767	23	23	126	10744	10916	0.2726693848771746
M1	string	0	network_modules	11	TRUE	1.2056582239109181e-21	19	69	12	0.17391304347826086	0.631578947368421	GO:0044804	GO:BP	nucleophagy	16175	11165		0.17142857142857143	0.19444444444444445	19	16156	12	57	7	16099	16175	0.33008070269056045
M1	string	0	network_modules	11	TRUE	3.857252553636552e-19	324	69	23	0.3333333333333333	0.07098765432098765	GO:0010506	GO:BP	regulation of autophagy	16175	4181		0.2	0.2222222222222222	324	15851	23	46	301	15805	16175	0.14636522364789803
M1	string	0	network_modules	11	TRUE	2.6266588901954217e-13	159	69	15	0.21739130434782608	0.09433962264150944	GO:0042594	GO:BP	response to starvation	16175	10254		0.22857142857142856	0.25	159	16016	15	54	144	15962	16175	0.13770376628538458
M1	string	0	network_modules	11	TRUE	8.389597692826461e-13	15	69	8	0.11594202898550725	0.5333333333333333	GO:0016237	GO:BP	microautophagy	16175	5180		0.2571428571428571	0.2777777777777778	15	16160	8	61	7	16099	16175	0.24732153008373048
M1	string	0	network_modules	11	TRUE	4.134975671938457e-12	10	69	7	0.10144927536231885	0.7	GO:0034727	GO:BP	piecemeal microautophagy of the nucleus	16175	8722		0.2857142857142857	0.3055555555555556	10	16165	7	62	3	16103	16175	0.2655102967143741
M1	string	0	network_modules	11	TRUE	6.045199133446998e-12	156	69	14	0.2028985507246377	0.08974358974358974	GO:0016241	GO:BP	regulation of macroautophagy	16175	5183		0.3142857142857143	0.3333333333333333	156	16019	14	55	142	15964	16175	0.12942660631044078
M1	string	0	network_modules	11	TRUE	2.461605291911367e-11	363	54	19	0.35185185185185186	0.05234159779614325	KEGG:05014	KEGG	Amyotrophic lateral sclerosis	8484	413		0.25	0.3333333333333333	363	8121	19	35	344	8086	8484	0.12222952264412135
M1	string	0	network_modules	11	TRUE	3.4016067619321453e-11	138	69	13	0.18840579710144928	0.09420289855072464	GO:0009267	GO:BP	cellular response to starvation	16175	3432		0.34285714285714286	0.3611111111111111	138	16037	13	56	125	15981	16175	0.12800960086060795
M1	string	0	network_modules	11	TRUE	4.331540989200113e-11	44	46	9	0.1956521739130435	0.20454545454545456	REAC:R-HSA-8854214	REAC	TBC/RABGAPs	10916	2420		0.25	0.3333333333333333	44	10872	9	37	35	10835	10916	0.1967390656788776
M1	string	0	network_modules	11	TRUE	4.707241745009795e-11	55	69	10	0.14492753623188406	0.18181818181818182	GO:0097352	GO:BP	autophagosome maturation	16175	18619		0.37142857142857144	0.3888888888888889	55	16120	10	59	45	16061	16175	0.15912965515827038
M1	string	0	network_modules	11	TRUE	7.668041622938599e-11	187	69	14	0.2028985507246377	0.0748663101604278	GO:0031669	GO:BP	cellular response to nutrient levels	16175	7272		0.4	0.4166666666666667	187	15988	14	55	173	15933	16175	0.1171540236031516
M1	string	0	network_modules	11	TRUE	1.0201253019230918e-10	103	54	12	0.2222222222222222	0.11650485436893204	KEGG:04137	KEGG	Mitophagy - animal	8484	274		0.375	0.4444444444444444	103	8381	12	42	91	8339	8484	0.1535343268759581
M1	string	0	network_modules	11	TRUE	2.225922134368436e-10	141	54	13	0.24074074074074073	0.09219858156028368	KEGG:05017	KEGG	Spinocerebellar ataxia	8484	415		0.5	0.5555555555555556	141	8343	13	41	128	8302	8484	0.14031240071924037
M1	string	0	network_modules	11	TRUE	4.466241227207256e-10	262	69	15	0.21739130434782608	0.05725190839694656	GO:0031667	GO:BP	response to nutrient levels	16175	7271		0.42857142857142855	0.4444444444444444	262	15913	15	54	247	15859	16175	0.10431870505414366
M1	string	0	network_modules	11	TRUE	1.7904500963165329e-9	145	69	12	0.17391304347826086	0.08275862068965517	GO:0010508	GO:BP	positive regulation of autophagy	16175	4183		0.45714285714285713	0.4722222222222222	145	16030	12	57	133	15973	16175	0.11454413006931777
M1	string	0	network_modules	11	TRUE	4.058740801622934e-9	11	69	6	0.08695652173913043	0.5454545454545454	GO:0006995	GO:BP	cellular response to nitrogen starvation	16175	2610		0.4857142857142857	0.5277777777777778	11	16164	6	63	5	16101	16175	0.21661899706788806
M1	string	0	network_modules	11	TRUE	4.058740801622934e-9	11	69	6	0.08695652173913043	0.5454545454545454	GO:0043562	GO:BP	cellular response to nitrogen levels	16175	10771		0.4857142857142857	0.5277777777777778	11	16164	6	63	5	16101	16175	0.21661899706788806
M1	string	0	network_modules	11	TRUE	1.921921107939949e-8	120	46	10	0.21739130434782608	0.08333333333333333	REAC:R-HSA-9007101	REAC	Rab regulation of trafficking	10916	1939		0.375	0.4444444444444444	120	10796	10	36	110	10760	10916	0.12876909856297936
M1	string	0	network_modules	11	TRUE	5.244763248933491e-8	49	69	8	0.11594202898550725	0.16326530612244897	GO:0006497	GO:BP	protein lipidation	16175	2226		0.5428571428571428	0.5555555555555556	49	16126	8	61	41	16065	16175	0.13447955661261238
M1	string	0	network_modules	11	TRUE	6.22281375648968e-8	50	69	8	0.11594202898550725	0.16	GO:0042158	GO:BP	lipoprotein biosynthetic process	16175	9996		0.5714285714285714	0.5833333333333334	50	16125	8	61	42	16064	16175	0.13305920223141057
M1	string	0	network_modules	11	TRUE	1.0656475185067229e-7	17	69	6	0.08695652173913043	0.35294117647058826	GO:1901096	GO:BP	regulation of autophagosome maturation	16175	21208		0.6	0.6388888888888888	17	16158	6	63	11	16095	16175	0.17353128435283333
M1	string	0	network_modules	11	TRUE	1.0656475185067229e-7	17	69	6	0.08695652173913043	0.35294117647058826	GO:0061709	GO:BP	reticulophagy	16175	15625		0.6	0.6388888888888888	17	16158	6	63	11	16095	16175	0.17353128435283333
M1	string	0	network_modules	11	TRUE	1.8707242290292655e-7	57	69	8	0.11594202898550725	0.14035087719298245	GO:0000422	GO:BP	autophagy of mitochondrion	16175	126		0.6571428571428571	0.6666666666666666	57	16118	8	61	49	16057	16175	0.12417041069138607
M1	string	0	network_modules	11	TRUE	3.379500041618922e-7	305	54	14	0.25925925925925924	0.04590163934426229	KEGG:05016	KEGG	Huntington disease	8484	414		0.625	0.6666666666666666	305	8179	14	40	291	8139	8484	0.09600423996331474
M1	string	0	network_modules	11	TRUE	7.139967210879196e-7	67	69	8	0.11594202898550725	0.11940298507462686	GO:0042157	GO:BP	lipoprotein metabolic process	16175	9995		0.6857142857142857	0.6944444444444444	67	16108	8	61	59	16047	16175	0.11393520423343537
M1	string	0	network_modules	11	TRUE	9.93807627255195e-7	43	69	7	0.10144927536231885	0.16279069767441862	GO:0000423	GO:BP	mitophagy	16175	127		0.7142857142857143	0.7222222222222222	43	16132	7	62	36	16070	16175	0.12557794829213156
M1	string	0	network_modules	11	TRUE	2.1690072751536706e-06	477	69	15	0.21739130434782608	0.031446540880503145	GO:0009896	GO:BP	positive regulation of catabolic process	16175	3756		0.7428571428571429	0.75	477	15698	15	54	462	15644	16175	0.07269817983565313
M1	string	0	network_modules	11	TRUE	4.386281319757625e-6	14	69	5	0.07246376811594203	0.35714285714285715	GO:0034497	GO:BP	protein localization to phagophore assembly site	16175	8664		0.7714285714285715	0.7777777777777778	14	16161	5	64	9	16097	16175	0.15935994460637667
M1	string	0	network_modules	11	TRUE	1.277661751413679e-5	9	46	4	0.08695652173913043	0.4444444444444444	REAC:R-HSA-8934903	REAC	Receptor Mediated Mitophagy	10916	1944		0.5	0.5555555555555556	9	10907	4	42	5	10865	10916	0.19521739474024344
M1	string	0	network_modules	11	TRUE	4.4388173564868785e-5	215	69	10	0.14492753623188406	0.046511627906976744	GO:0032984	GO:BP	protein-containing complex disassembly	16175	7964		0.8	0.8055555555555556	215	15960	10	59	205	15901	16175	0.07523363976028861
M1	string	0	network_modules	11	TRUE	4.4762999146711374e-5	382	54	13	0.24074074074074073	0.034031413612565446	KEGG:05010	KEGG	Alzheimer disease	8484	411		0.75	0.7777777777777778	382	8102	13	41	369	8061	8484	0.07554046279192561
M1	string	0	network_modules	11	TRUE	1.5568009187166812e-4	182	54	9	0.16666666666666666	0.04945054945054945	KEGG:04621	KEGG	NOD-like receptor signaling pathway	8484	326		0.875	0.8888888888888888	182	8302	9	45	173	8257	8484	0.08021706020529558
M1	string	0	network_modules	11	TRUE	1.8117232070398613e-4	11	69	4	0.057971014492753624	0.36363636363636365	GO:1903059	GO:BP	regulation of protein lipidation	16175	22738		0.8285714285714286	0.8333333333333334	11	16164	4	65	7	16099	16175	0.1438435086510456
M1	string	0	network_modules	11	TRUE	2.3212123228604688e-4	246	54	10	0.18518518518518517	0.04065040650406504	KEGG:05131	KEGG	Shigellosis	8484	428		1	1	246	8238	10	44	236	8194	8484	0.07450011460071497
M1	string	0	network_modules	11	TRUE	7.398086486615677e-4	15	69	4	0.057971014492753624	0.26666666666666666	GO:0050746	GO:BP	regulation of lipoprotein metabolic process	16175	13232		0.8571428571428571	0.8611111111111112	15	16160	4	65	11	16095	16175	0.12266369503198458
M1	string	0	network_modules	11	TRUE	9.456625649225563e-4	70	69	6	0.08695652173913043	0.08571428571428572	GO:0016239	GO:BP	positive regulation of macroautophagy	16175	5181		0.8857142857142857	0.8888888888888888	70	16105	6	63	64	16042	16175	0.08239053834062485
M1	string	0	network_modules	11	TRUE	0.0011787662774894803	55	46	5	0.10869565217391304	0.09090909090909091	REAC:R-HSA-75893	REAC	TNF signaling	10916	2446		0.625	0.6666666666666666	55	10861	5	41	50	10820	10916	0.09523811572839878
M1	string	0	network_modules	11	TRUE	0.0013674902689434054	5	69	3	0.043478260869565216	0.6	GO:0051697	GO:BP	protein delipidation	16175	13900		0.9142857142857143	0.9166666666666666	5	16170	3	66	2	16104	16175	0.16073423618995655
M1	string	0	network_modules	11	TRUE	0.0016835725408332893	27	46	4	0.08695652173913043	0.14814814814814814	REAC:R-HSA-5205647	REAC	Mitophagy	10916	1478		0.75	0.7777777777777778	27	10889	4	42	23	10847	10916	0.11064239568369884
M1	string	0	network_modules	11	TRUE	0.0042113648224127885	11	46	3	0.06521739130434782	0.2727272727272727	REAC:R-HSA-1660517	REAC	Synthesis of PIPs at the late endosome membrane	10916	2394		0.875	0.8888888888888888	11	10905	3	43	8	10862	10916	0.13164946793187832
M1	string	0	network_modules	11	TRUE	0.004555127804604924	51	69	5	0.07246376811594203	0.09803921568627451	GO:0044088	GO:BP	regulation of vacuole organization	16175	10910		0.9428571428571428	0.9444444444444444	51	16124	5	64	46	16060	16175	0.08091967488090147
M1	string	0	network_modules	11	TRUE	0.006512394322773287	97	69	6	0.08695652173913043	0.061855670103092786	GO:0043244	GO:BP	regulation of protein-containing complex disassembly	16175	10582		0.9714285714285714	0.9722222222222222	97	16078	6	63	91	16015	16175	0.06863435096347181
M1	string	0	network_modules	11	TRUE	0.007243202237592179	374	69	10	0.14492753623188406	0.026737967914438502	GO:0022411	GO:BP	cellular component disassembly	16175	6602		1	1	374	15801	10	59	364	15742	16175	0.053047334191840545
M1	string	0	network_modules	11	TRUE	0.00753208074164559	80	46	5	0.10869565217391304	0.0625	REAC:R-HSA-9663891	REAC	Selective autophagy	10916	2186		1	1	80	10836	5	41	75	10795	10916	0.07731158958313555
M1	string	0	network_modules	12	TRUE	6.911548549819871e-6	131	38	8	0.21052631578947367	0.061068702290076333	KEGG:04142	KEGG	Lysosome	8484	279		0	0.3333333333333333	131	8353	8	30	123	8323	8484	0.10612922453758811
M1	string	0	network_modules	12	TRUE	1.0934146618579395e-5	8	50	4	0.08	0.5	REAC:R-HSA-8939242	REAC	RUNX1 regulates transcription of genes involved in differentiation of keratinocytes	10916	1923		0	0.125	8	10908	4	46	4	10862	10916	0.19869606175228122
M1	string	0	network_modules	12	TRUE	2.948643303014163e-5	42	66	6	0.09090909090909091	0.14285714285714285	GO:0010466	GO:BP	negative regulation of peptidase activity	16175	4159		0	0.07692307692307693	42	16133	6	60	36	16073	16175	0.1110764241673948
M1	string	0	network_modules	12	TRUE	4.142196718013031e-5	128	50	8	0.16	0.0625	REAC:R-HSA-6809371	REAC	Formation of the cornified envelope	10916	969		0.14285714285714285	0.25	128	10788	8	42	120	10746	10916	0.09343369011758536
M1	string	0	network_modules	12	TRUE	4.171248121989374e-5	22	66	5	0.07575757575757576	0.22727272727272727	GO:0018149	GO:BP	peptide cross-linking	16175	5337		0.08333333333333333	0.15384615384615385	22	16153	5	61	17	16092	16175	0.1292117748319751
M1	string	0	network_modules	12	TRUE	5.750122097813445e-5	476	50	13	0.26	0.0273109243697479	REAC:R-HSA-6798695	REAC	Neutrophil degranulation	10916	1597		0.2857142857142857	0.375	476	10440	13	37	463	10403	10916	0.07187961415338394
M1	string	0	network_modules	12	TRUE	1.0981463947565325e-4	13	50	4	0.08	0.3076923076923077	REAC:R-HSA-1679131	REAC	Trafficking and processing of endosomal TLR	10916	2531		0.42857142857142855	0.5	13	10903	4	46	9	10857	10916	0.15500485317093463
M1	string	0	network_modules	12	TRUE	2.3992310440883454e-4	59	66	6	0.09090909090909091	0.1016949152542373	GO:0022617	GO:BP	extracellular matrix disassembly	16175	6624		0.16666666666666666	0.23076923076923078	59	16116	6	60	53	16056	16175	0.09265096317807922
M1	string	0	network_modules	12	TRUE	3.187898672231224e-4	102	66	7	0.10606060606060606	0.06862745098039216	GO:0030216	GO:BP	keratinocyte differentiation	16175	6724		0.25	0.3076923076923077	102	16073	7	59	95	16014	16175	0.08066149088239757
M1	string	0	network_modules	12	TRUE	3.409425907102345e-4	103	66	7	0.10606060606060606	0.06796116504854369	GO:0052547	GO:BP	regulation of peptidase activity	16175	14133		0.3333333333333333	0.38461538461538464	103	16072	7	59	96	16013	16175	0.08022172337374428
M1	string	0	network_modules	12	TRUE	6.586281894896015e-4	37	66	5	0.07575757575757576	0.13513513513513514	GO:0030574	GO:BP	collagen catabolic process	16175	6846		0.4166666666666667	0.46153846153846156	37	16138	5	61	32	16077	16175	0.09843892234042782
M1	string	0	network_modules	12	TRUE	0.001667357977107378	130	66	7	0.10606060606060606	0.05384615384615385	GO:0045861	GO:BP	negative regulation of proteolysis	16175	11673		0.5	0.5384615384615384	130	16045	7	59	123	15986	16175	0.07027011866435658
M1	string	0	network_modules	12	TRUE	0.0021106591925019198	135	38	6	0.15789473684210525	0.044444444444444446	KEGG:04210	KEGG	Apoptosis	8484	287		0.5	0.6666666666666666	135	8349	6	32	129	8317	8484	0.0761057400975114
M1	string	0	network_modules	12	TRUE	0.0021302143254790474	215	50	8	0.16	0.037209302325581395	REAC:R-HSA-6805567	REAC	Keratinization	10916	1288		0.5714285714285714	0.625	215	10701	8	42	207	10659	10916	0.06849403559324353
M1	string	0	network_modules	12	TRUE	0.002461736431666259	41	38	4	0.10526315789473684	0.0975609756097561	KEGG:04216	KEGG	Ferroptosis	8484	293		1	1	41	8443	4	34	37	8409	8484	0.09713871606723279
M1	string	0	network_modules	12	TRUE	0.003019241913432502	142	66	7	0.10606060606060606	0.04929577464788732	GO:0009913	GO:BP	epidermal cell differentiation	16175	3769		0.5833333333333334	0.6153846153846154	142	16033	7	59	135	15974	16175	0.06675152922667632
M1	string	0	network_modules	12	TRUE	0.0032056522018085987	91	66	6	0.09090909090909091	0.06593406593406594	GO:0051346	GO:BP	negative regulation of hydrolase activity	16175	13673		0.6666666666666666	0.6923076923076923	91	16084	6	60	85	16024	16175	0.07298394645062511
M1	string	0	network_modules	12	TRUE	0.0058746726006854285	33	50	4	0.08	0.12121212121212122	REAC:R-HSA-1592389	REAC	Activation of Matrix Metalloproteinases	10916	86		0.7142857142857143	0.75	33	10883	4	46	29	10837	10916	0.09511366006418555
M1	string	0	network_modules	12	TRUE	0.00591084991775608	11	50	3	0.06	0.2727272727272727	REAC:R-HSA-1236977	REAC	Endosomal/Vacuolar pathway	10916	842		0.8571428571428571	0.875	11	10905	3	47	8	10858	10916	0.12612461861418414
M1	string	0	network_modules	12	TRUE	0.006174376822109804	8	66	3	0.045454545454545456	0.375	GO:0097067	GO:BP	cellular response to thyroid hormone stimulus	16175	18473		0.75	0.7692307692307693	8	16167	3	63	5	16104	16175	0.12943392525875771
M1	string	0	network_modules	12	TRUE	0.00744086793403549	231	66	8	0.12121212121212122	0.03463203463203463	GO:0008544	GO:BP	epidermis development	16175	3192		0.8333333333333334	0.8461538461538461	231	15944	8	58	223	15886	16175	0.05768730397564507
M1	string	0	network_modules	12	TRUE	0.007799628663150018	123	50	6	0.12	0.04878048780487805	REAC:R-HSA-2132295	REAC	MHC class II antigen presentation	10916	1371		1	1	123	10793	6	44	117	10749	10916	0.06987920500180853
M1	string	0	network_modules	12	TRUE	0.009228989992955839	168	66	7	0.10606060606060606	0.041666666666666664	GO:0043588	GO:BP	skin development	16175	10792		0.9166666666666666	0.9230769230769231	168	16007	7	59	161	15948	16175	0.06040421234464052
M1	string	0	network_modules	12	TRUE	0.009234525354808933	9	66	3	0.045454545454545456	0.3333333333333333	GO:0097066	GO:BP	response to thyroid hormone	16175	18472		1	1	9	16166	3	63	6	16103	16175	0.12186744033218935
M1	string	0	network_modules	13	TRUE	2.0519692065706916e-105	90	68	54	0.7941176470588235	0.6	REAC:R-HSA-156902	REAC	Peptide chain elongation	10916	1723		0	0.02702702702702703	90	10826	54	14	36	10812	10916	0.6880819644683612
M1	string	0	network_modules	13	TRUE	6.812299955778905e-104	94	68	54	0.7941176470588235	0.574468085106383	REAC:R-HSA-156842	REAC	Eukaryotic Translation Elongation	10916	870		0.027777777777777776	0.05405405405405406	94	10822	54	14	40	10808	10916	0.6730931955995809
M1	string	0	network_modules	13	TRUE	2.1588500230713287e-102	90	68	53	0.7794117647058824	0.5888888888888889	REAC:R-HSA-192823	REAC	Viral mRNA Translation	10916	2650		0.05555555555555555	0.08108108108108109	90	10826	53	15	37	10811	10916	0.6752060238156132
M1	string	0	network_modules	13	TRUE	6.465562640464502e-101	94	68	53	0.7794117647058824	0.5638297872340425	REAC:R-HSA-2408557	REAC	Selenocysteine synthesis	10916	2188		0.08333333333333333	0.13513513513513514	94	10822	53	15	41	10807	10916	0.6604918610762888
M1	string	0	network_modules	13	TRUE	6.465562640464502e-101	94	68	53	0.7794117647058824	0.5638297872340425	REAC:R-HSA-72764	REAC	Eukaryotic Translation Termination	10916	872		0.08333333333333333	0.13513513513513514	94	10822	53	15	41	10807	10916	0.6604918610762888
M1	string	0	network_modules	13	TRUE	3.2561247560427404e-100	96	68	53	0.7794117647058824	0.5520833333333334	REAC:R-HSA-975956	REAC	Nonsense Mediated Decay (NMD) independent of the Exon Junction Complex (EJC)	10916	1607		0.1388888888888889	0.16216216216216217	96	10820	53	15	43	10805	10916	0.6534805593772705
M1	string	0	network_modules	13	TRUE	3.109918213060955e-98	102	68	53	0.7794117647058824	0.5196078431372549	REAC:R-HSA-9633012	REAC	Response of EIF2AK4 (GCN2) to amino acid deficiency	10916	2087		0.16666666666666666	0.21621621621621623	102	10814	53	15	49	10799	10916	0.6336928024007307
M1	string	0	network_modules	13	TRUE	3.109918213060955e-98	102	68	53	0.7794117647058824	0.5196078431372549	REAC:R-HSA-72689	REAC	Formation of a pool of free 40S subunits	10916	953		0.16666666666666666	0.21621621621621623	102	10814	53	15	49	10799	10916	0.6336928024007307
M1	string	0	network_modules	13	TRUE	2.7634102873315885e-95	112	68	53	0.7794117647058824	0.4732142857142857	REAC:R-HSA-156827	REAC	L13a-mediated translational silencing of Ceruloplasmin expression	10916	1293		0.2222222222222222	0.24324324324324326	112	10804	53	15	59	10789	10916	0.6043016660949515
M1	string	0	network_modules	13	TRUE	5.1973317301371823e-95	113	68	53	0.7794117647058824	0.4690265486725664	REAC:R-HSA-72706	REAC	GTP hydrolysis and joining of the 60S ribosomal subunit	10916	1027		0.25	0.2972972972972973	113	10803	53	15	60	10788	10916	0.6015780087869145
M1	string	0	network_modules	13	TRUE	5.1973317301371823e-95	113	68	53	0.7794117647058824	0.4690265486725664	REAC:R-HSA-1799339	REAC	SRP-dependent cotranslational protein targeting to membrane	10916	2157		0.25	0.2972972972972973	113	10803	53	15	60	10788	10916	0.6015780087869145
M1	string	0	network_modules	13	TRUE	3.3037132560156e-94	116	68	53	0.7794117647058824	0.45689655172413796	REAC:R-HSA-927802	REAC	Nonsense-Mediated Decay (NMD)	10916	1608		0.3055555555555556	0.35135135135135137	116	10800	53	15	63	10785	10916	0.5936182784399033
M1	string	0	network_modules	13	TRUE	3.3037132560156e-94	116	68	53	0.7794117647058824	0.45689655172413796	REAC:R-HSA-975957	REAC	Nonsense Mediated Decay (NMD) enhanced by the Exon Junction Complex (EJC)	10916	1606		0.3055555555555556	0.35135135135135137	116	10800	53	15	63	10785	10916	0.5936182784399033
M1	string	0	network_modules	13	TRUE	6.031368919839463e-94	117	68	53	0.7794117647058824	0.452991452991453	REAC:R-HSA-2408522	REAC	Selenoamino acid metabolism	10916	2187		0.3611111111111111	0.3783783783783784	117	10799	53	15	64	10784	10916	0.5910329348160492
M1	string	0	network_modules	13	TRUE	3.521410638720817e-93	120	68	53	0.7794117647058824	0.44166666666666665	REAC:R-HSA-72737	REAC	Cap-dependent Translation Initiation	10916	304		0.3888888888888889	0.43243243243243246	120	10796	53	15	67	10781	10916	0.5834706630053093
M1	string	0	network_modules	13	TRUE	3.521410638720817e-93	120	68	53	0.7794117647058824	0.44166666666666665	REAC:R-HSA-72613	REAC	Eukaryotic Translation Initiation	10916	871		0.3888888888888889	0.43243243243243246	120	10796	53	15	67	10781	10916	0.5834706630053093
M1	string	0	network_modules	13	TRUE	3.919464398542222e-90	133	68	53	0.7794117647058824	0.39849624060150374	REAC:R-HSA-168273	REAC	Influenza Viral RNA Transcription and Replication	10916	1186		0.4444444444444444	0.4594594594594595	133	10783	53	15	80	10768	10916	0.5536966055375346
M1	string	0	network_modules	13	TRUE	3.9453984359286815e-86	153	68	53	0.7794117647058824	0.3464052287581699	REAC:R-HSA-168255	REAC	Influenza Infection	10916	1185		0.4722222222222222	0.4864864864864865	153	10763	53	15	100	10748	10916	0.515485845192017
M1	string	0	network_modules	13	TRUE	2.0787285739808878e-85	157	68	53	0.7794117647058824	0.3375796178343949	REAC:R-HSA-9711097	REAC	Cellular response to starvation	10916	337		0.5	0.5135135135135135	157	10759	53	15	104	10744	10916	0.5087276947375249
M1	string	0	network_modules	13	TRUE	1.4246998305894286e-84	153	63	53	0.8412698412698413	0.3464052287581699	KEGG:03010	KEGG	Ribosome	8484	208		0	0.5	153	8331	53	10	100	8321	8484	0.5350804907075644
M1	string	0	network_modules	13	TRUE	5.196445755006864e-84	158	71	50	0.704225352112676	0.31645569620253167	GO:0002181	GO:BP	cytoplasmic translation	16175	729		0	0.07142857142857142	158	16017	50	21	108	15996	16175	0.46884893199204064
M1	string	0	network_modules	13	TRUE	4.743461867141451e-83	171	68	53	0.7794117647058824	0.30994152046783624	REAC:R-HSA-9010553	REAC	Regulation of expression of SLITs and ROBOs	10916	2031		0.5277777777777778	0.5405405405405406	171	10745	53	15	118	10730	10916	0.48695767896402953
M1	string	0	network_modules	13	TRUE	2.346406355492768e-81	182	68	53	0.7794117647058824	0.29120879120879123	REAC:R-HSA-6791226	REAC	Major pathway of rRNA processing in the nucleolus and cytosol	10916	1389		0.5555555555555556	0.5675675675675675	182	10734	53	15	129	10719	10916	0.47163128258656556
M1	string	0	network_modules	13	TRUE	6.422626883298912e-80	192	68	53	0.7794117647058824	0.2760416666666667	REAC:R-HSA-8868773	REAC	rRNA processing in the nucleus and cytosol	10916	2734		0.5833333333333334	0.5945945945945946	192	10724	53	15	139	10709	10916	0.4588472716918091
M1	string	0	network_modules	13	TRUE	1.4425712456408041e-78	202	68	53	0.7794117647058824	0.2623762376237624	REAC:R-HSA-72312	REAC	rRNA processing	10916	2732		0.6111111111111112	0.6216216216216216	202	10714	53	15	149	10699	10916	0.4470160481082724
M1	string	0	network_modules	13	TRUE	1.1118866789708442e-76	217	68	53	0.7794117647058824	0.24423963133640553	REAC:R-HSA-376176	REAC	Signaling by ROBO receptors	10916	2301		0.6388888888888888	0.6486486486486487	217	10699	53	15	164	10684	10916	0.4308123591033095
M1	string	0	network_modules	13	TRUE	1.7368696051052992e-73	231	63	53	0.8412698412698413	0.22943722943722944	KEGG:05171	KEGG	Coronavirus disease - COVID-19	8484	452		1	1	231	8253	53	10	178	8243	8484	0.432637404247175
M1	string	0	network_modules	13	TRUE	2.865814544655256e-71	292	68	54	0.7941176470588235	0.18493150684931506	REAC:R-HSA-72766	REAC	Translation	10916	2565		0.6666666666666666	0.6756756756756757	292	10624	54	14	238	10610	10916	0.3765401825994555
M1	string	0	network_modules	13	TRUE	2.178158079058697e-65	566	71	56	0.7887323943661971	0.0989399293286219	GO:0006412	GO:BP	translation	16175	2170		0.07692307692307693	0.14285714285714285	566	15609	56	15	510	15594	16175	0.2723531864011742
M1	string	0	network_modules	13	TRUE	3.533763985345465e-63	370	68	53	0.7794117647058824	0.14324324324324325	REAC:R-HSA-71291	REAC	Metabolism of amino acids and derivatives	10916	1421		0.6944444444444444	0.7027027027027027	370	10546	53	15	317	10531	10916	0.32617877492772535
M1	string	0	network_modules	13	TRUE	2.2677652412502162e-33	37	68	20	0.29411764705882354	0.5405405405405406	REAC:R-HSA-9735869	REAC	SARS-CoV-1 modulates host translation machinery	10916	2116		0.7222222222222222	0.7297297297297297	37	10879	20	48	17	10831	10916	0.39603616390884216
M1	string	0	network_modules	13	TRUE	1.438926689910469e-27	51	68	19	0.27941176470588236	0.37254901960784315	REAC:R-HSA-9754678	REAC	SARS-CoV-2 modulates host translation machinery	10916	2125		0.75	0.7567567567567568	51	10865	19	49	32	10816	10916	0.3189808777754691
M1	string	0	network_modules	13	TRUE	2.2576899330614748e-27	52	68	19	0.27941176470588236	0.36538461538461536	REAC:R-HSA-72695	REAC	Formation of the ternary complex, and subsequently, the 43S complex	10916	973		0.7777777777777778	0.7837837837837838	52	10864	19	49	33	10815	10916	0.3158080655915476
M1	string	0	network_modules	13	TRUE	4.008941192682606e-26	59	68	19	0.27941176470588236	0.3220338983050847	REAC:R-HSA-72702	REAC	Ribosomal scanning and start codon recognition	10916	2106		0.8055555555555556	0.8378378378378378	59	10857	19	49	40	10808	10916	0.2958854758935095
M1	string	0	network_modules	13	TRUE	4.008941192682606e-26	59	68	19	0.27941176470588236	0.3220338983050847	REAC:R-HSA-72649	REAC	Translation initiation complex formation	10916	2566		0.8055555555555556	0.8378378378378378	59	10857	19	49	40	10808	10916	0.2958854758935095
M1	string	0	network_modules	13	TRUE	5.841604611545311e-26	60	68	19	0.27941176470588236	0.31666666666666665	REAC:R-HSA-72662	REAC	Activation of the mRNA upon binding of the cap-binding complex and eIFs, and subsequent binding to 43S	10916	105		0.8611111111111112	0.8648648648648649	60	10856	19	49	41	10807	10916	0.2933248166468332
M1	string	0	network_modules	13	TRUE	3.0359705579731273e-25	95	68	21	0.3088235294117647	0.22105263157894736	REAC:R-HSA-9692914	REAC	SARS-CoV-1-host interactions	10916	2119		0.8888888888888888	0.8918918918918919	95	10821	21	47	74	10774	10916	0.2558253671219175
M1	string	0	network_modules	13	TRUE	1.947092476933146e-21	140	68	21	0.3088235294117647	0.15	REAC:R-HSA-9678108	REAC	SARS-CoV-1 Infection	10916	2114		0.9166666666666666	0.918918918918919	140	10776	21	47	119	10729	10916	0.20827616871677
M1	string	0	network_modules	13	TRUE	4.949013287652009e-21	390	71	26	0.36619718309859156	0.06666666666666667	GO:0022613	GO:BP	ribonucleoprotein complex biogenesis	16175	6620		0.15384615384615385	0.21428571428571427	390	15785	26	45	364	15740	16175	0.14807684767198143
M1	string	0	network_modules	13	TRUE	7.904583201103953e-20	251	71	22	0.30985915492957744	0.08764940239043825	GO:0042254	GO:BP	ribosome biogenesis	16175	10060		0.23076923076923078	0.2857142857142857	251	15924	22	49	229	15875	16175	0.158122968944082
M1	string	0	network_modules	13	TRUE	8.501215819980061e-17	197	68	20	0.29411764705882354	0.10152284263959391	REAC:R-HSA-9705683	REAC	SARS-CoV-2-host interactions	10916	2128		0.9444444444444444	0.9459459459459459	197	10719	20	48	177	10671	10916	0.16419248707709932
M1	string	0	network_modules	13	TRUE	2.0682092779377124e-13	292	68	20	0.29411764705882354	0.0684931506849315	REAC:R-HSA-9694516	REAC	SARS-CoV-2 Infection	10916	2122		0.9722222222222222	0.972972972972973	292	10624	20	48	272	10576	10916	0.13119491088506188
M1	string	0	network_modules	13	TRUE	3.220425940305058e-13	94	71	13	0.18309859154929578	0.13829787234042554	GO:0042274	GO:BP	ribosomal small subunit biogenesis	16175	10071		0.3076923076923077	0.35714285714285715	94	16081	13	58	81	16023	16175	0.1548686093742109
M1	string	0	network_modules	13	TRUE	9.31610612551076e-12	459	68	22	0.3235294117647059	0.04793028322440087	REAC:R-HSA-9679506	REAC	SARS-CoV Infections	10916	2112		1	1	459	10457	22	46	437	10411	10916	0.11104075319880385
M1	string	0	network_modules	13	TRUE	1.7148490028233828e-8	169	71	12	0.16901408450704225	0.07100591715976332	GO:0006364	GO:BP	rRNA processing	16175	2140		0.38461538461538464	0.42857142857142855	169	16006	12	59	157	15947	16175	0.103545568488658
M1	string	0	network_modules	13	TRUE	1.6542535994873915e-7	205	71	12	0.16901408450704225	0.05853658536585366	GO:0016072	GO:BP	rRNA metabolic process	16175	5099		0.46153846153846156	0.5	205	15970	12	59	193	15911	16175	0.09279997760791876
M1	string	0	network_modules	13	TRUE	6.072801844176425e-7	178	71	11	0.15492957746478872	0.06179775280898876	GO:0022618	GO:BP	protein-RNA complex assembly	16175	6625		0.5384615384615384	0.5714285714285714	178	15997	11	60	167	15937	16175	0.09160377436261104
M1	string	0	network_modules	13	TRUE	7.596203045007894e-7	65	71	8	0.11267605633802817	0.12307692307692308	GO:0042273	GO:BP	ribosomal large subunit biogenesis	16175	10070		0.6153846153846154	0.6428571428571429	65	16110	8	63	57	16047	16175	0.1140412265193359
M1	string	0	network_modules	13	TRUE	1.0890416060884133e-6	188	71	11	0.15492957746478872	0.05851063829787234	GO:0071826	GO:BP	protein-RNA complex organization	16175	16929		0.6923076923076923	0.7142857142857143	188	15987	11	60	177	15927	16175	0.0887790869267782
M1	string	0	network_modules	13	TRUE	2.536584498578928e-6	47	71	7	0.09859154929577464	0.14893617021276595	GO:0042255	GO:BP	ribosome assembly	16175	10061		0.7692307692307693	0.7857142857142857	47	16128	7	64	40	16064	16175	0.11803614779127979
M1	string	0	network_modules	13	TRUE	8.196481898549369e-6	15	71	5	0.07042253521126761	0.3333333333333333	GO:0000028	GO:BP	ribosomal small subunit assembly	16175	13		0.8461538461538461	0.8571428571428571	15	16160	5	66	10	16094	16175	0.15159851521789086
M1	string	0	network_modules	13	TRUE	0.004725987616228639	343	71	10	0.14084507042253522	0.029154518950437316	GO:0140694	GO:BP	membraneless organelle assembly	16175	19860		0.9230769230769231	0.9285714285714286	343	15832	10	61	333	15771	16175	0.05513993429812257
M1	string	0	network_modules	13	TRUE	0.0054973226681546954	434	71	11	0.15492957746478872	0.02534562211981567	GO:0010608	GO:BP	post-transcriptional regulation of gene expression	16175	4255		1	1	434	15741	11	60	423	15681	16175	0.05263662901141876
M1	string	0	network_modules	14	TRUE	1.2170855217560877e-13	8	53	7	0.1320754716981132	0.875	REAC:R-HSA-5632681	REAC	Ligand-receptor interactions	10916	1315		0	0.07692307692307693	8	10908	7	46	1	10862	10916	0.3390116566649053
M1	string	0	network_modules	14	TRUE	6.22208364272419e-11	265	61	15	0.2459016393442623	0.05660377358490566	GO:0009101	GO:BP	glycoprotein biosynthetic process	16175	3273		0	0.045454545454545456	265	15910	15	46	250	15864	16175	0.11124151093536462
M1	string	0	network_modules	14	TRUE	1.932450250918233e-10	125	53	12	0.22641509433962265	0.096	REAC:R-HSA-1630316	REAC	Glycosaminoglycan metabolism	10916	1076		0.08333333333333333	0.15384615384615385	125	10791	12	41	113	10750	10916	0.1411258208517848
M1	string	0	network_modules	14	TRUE	4.4979772529975137e-10	56	43	9	0.20930232558139536	0.16071428571428573	KEGG:04340	KEGG	Hedgehog signaling pathway	8484	302		0	0.25	56	8428	9	34	47	8394	8484	0.17866479181702685
M1	string	0	network_modules	14	TRUE	7.274374121545687e-10	82	61	10	0.16393442622950818	0.12195121951219512	GO:0030203	GO:BP	glycosaminoglycan metabolic process	16175	6712		0.047619047619047616	0.09090909090909091	82	16093	10	51	72	16042	16175	0.13762900788907906
M1	string	0	network_modules	14	TRUE	7.751502435280453e-10	315	61	15	0.2459016393442623	0.047619047619047616	GO:0009100	GO:BP	glycoprotein metabolic process	16175	3272		0.09523809523809523	0.13636363636363635	315	15860	15	46	300	15814	16175	0.10081592588945734
M1	string	0	network_modules	14	TRUE	1.9009439571103836e-9	90	61	10	0.16393442622950818	0.1111111111111111	GO:0006022	GO:BP	aminoglycan metabolic process	16175	1895		0.14285714285714285	0.18181818181818182	90	16085	10	51	80	16034	16175	0.13099340629074693
M1	string	0	network_modules	14	TRUE	6.085595195602003e-9	514	61	17	0.2786885245901639	0.033073929961089495	GO:1901137	GO:BP	carbohydrate derivative biosynthetic process	16175	21245		0.19047619047619047	0.22727272727272727	514	15661	17	44	497	15617	16175	0.08660776275592424
M1	string	0	network_modules	14	TRUE	1.999772040836104e-8	288	53	14	0.2641509433962264	0.04861111111111111	REAC:R-HSA-71387	REAC	Metabolism of carbohydrates	10916	1422		0.16666666666666666	0.23076923076923078	288	10628	14	39	274	10589	10916	0.10362327782609666
M1	string	0	network_modules	14	TRUE	6.29441181843865e-8	18	53	6	0.11320754716981132	0.3333333333333333	REAC:R-HSA-5635838	REAC	Activation of SMO	10916	97		0.25	0.3076923076923077	18	10898	6	47	12	10851	10916	0.192052489048993
M1	string	0	network_modules	14	TRUE	2.3861635630213276e-6	56	61	7	0.11475409836065574	0.125	GO:0008589	GO:BP	regulation of smoothened signaling pathway	16175	3199		0.23809523809523808	0.2727272727272727	56	16119	7	54	49	16065	16175	0.1165757661191999
M1	string	0	network_modules	14	TRUE	4.4234918690968516e-6	61	61	7	0.11475409836065574	0.11475409836065574	GO:1903510	GO:BP	mucopolysaccharide metabolic process	16175	23060		0.2857142857142857	0.36363636363636365	61	16114	7	54	54	16060	16175	0.11140297511378965
M1	string	0	network_modules	14	TRUE	4.4234918690968516e-6	61	61	7	0.11475409836065574	0.11475409836065574	GO:0030166	GO:BP	proteoglycan biosynthetic process	16175	6693		0.2857142857142857	0.36363636363636365	61	16114	7	54	54	16060	16175	0.11140297511378965
M1	string	0	network_modules	14	TRUE	7.781640750668177e-6	66	61	7	0.11475409836065574	0.10606060606060606	GO:0006024	GO:BP	glycosaminoglycan biosynthetic process	16175	1897		0.38095238095238093	0.4090909090909091	66	16109	7	54	59	16055	16175	0.10681833533489209
M1	string	0	network_modules	14	TRUE	8.664093041105882e-6	67	61	7	0.11475409836065574	0.1044776119402985	GO:0006023	GO:BP	aminoglycan biosynthetic process	16175	1896		0.42857142857142855	0.45454545454545453	67	16108	7	54	60	16054	16175	0.10596225253509597
M1	string	0	network_modules	14	TRUE	1.13096940771167e-5	158	61	9	0.14754098360655737	0.056962025316455694	GO:0044272	GO:BP	sulfur compound biosynthetic process	16175	10944		0.47619047619047616	0.5	158	16017	9	52	149	15965	16175	0.08618902201343018
M1	string	0	network_modules	14	TRUE	1.4462932413146716e-5	72	61	7	0.11475409836065574	0.09722222222222222	GO:0006029	GO:BP	proteoglycan metabolic process	16175	1902		0.5238095238095238	0.5454545454545454	72	16103	7	54	65	16049	16175	0.10194697854529432
M1	string	0	network_modules	14	TRUE	1.4485202659244769e-5	289	61	11	0.18032786885245902	0.03806228373702422	GO:0006790	GO:BP	sulfur compound metabolic process	16175	2476		0.5714285714285714	0.5909090909090909	289	15886	11	50	278	15836	16175	0.07545706131367236
M1	string	0	network_modules	14	TRUE	3.947128589967135e-5	83	61	7	0.11475409836065574	0.08433734939759036	GO:0007224	GO:BP	smoothened signaling pathway	16175	2777		0.6190476190476191	0.6363636363636364	83	16092	7	54	76	16038	16175	0.09439827404133395
M1	string	0	network_modules	14	TRUE	5.6477860436434384e-5	85	53	7	0.1320754716981132	0.08235294117647059	REAC:R-HSA-5632684	REAC	Hedgehog 'on' state	10916	1113		0.3333333333333333	0.38461538461538464	85	10831	7	46	78	10785	10916	0.09876762365372077
M1	string	0	network_modules	14	TRUE	1.38408100911671e-4	12	61	4	0.06557377049180328	0.3333333333333333	GO:0097264	GO:BP	self proteolysis	16175	18563		0.6666666666666666	0.6818181818181818	12	16163	4	57	8	16106	16175	0.14650234145071414
M1	string	0	network_modules	14	TRUE	1.5611123506391656e-4	4	53	3	0.05660377358490566	0.75	REAC:R-HSA-5658034	REAC	HHAT G278V doesn't palmitoylate Hh-Np	10916	1101		0.4166666666666667	0.46153846153846156	4	10912	3	50	1	10862	10916	0.20524338113127705
M1	string	0	network_modules	14	TRUE	2.1966638635282393e-4	181	43	8	0.18604651162790697	0.04419889502762431	KEGG:04360	KEGG	Axon guidance	8484	305		0.3333333333333333	0.5	181	8303	8	35	173	8268	8484	0.08135926045110287
M1	string	0	network_modules	14	TRUE	2.5086531600939564e-4	21	43	4	0.09302325581395349	0.19047619047619047	KEGG:00532	KEGG	Glycosaminoglycan biosynthesis - chondroitin sulfate / dermatan sulfate	8484	76		0.6666666666666666	0.75	21	8463	4	39	17	8424	8484	0.13006038091865052
M1	string	0	network_modules	14	TRUE	5.220902483800595e-4	18	53	4	0.07547169811320754	0.2222222222222222	REAC:R-HSA-9037629	REAC	Lewis blood group biosynthesis	10916	1314		0.5	0.5384615384615384	18	10898	4	49	14	10849	10916	0.1270887454259628
M1	string	0	network_modules	14	TRUE	6.589411191378057e-4	19	53	4	0.07547169811320754	0.21052631578947367	REAC:R-HSA-416700	REAC	Other semaphorin interactions	10916	1652		0.5833333333333334	0.6153846153846154	19	10897	4	49	15	10848	10916	0.12355126843844282
M1	string	0	network_modules	14	TRUE	7.706314575870984e-4	42	61	5	0.08196721311475409	0.11904761904761904	GO:0071526	GO:BP	semaphorin-plexin signaling pathway	16175	16747		0.7142857142857143	0.7272727272727273	42	16133	5	56	37	16077	16175	0.09595885381986818
M1	string	0	network_modules	14	TRUE	0.001010193861763631	21	53	4	0.07547169811320754	0.19047619047619047	REAC:R-HSA-9033658	REAC	Blood group systems biosynthesis	10916	253		0.6666666666666666	0.6923076923076923	21	10895	4	49	17	10846	10916	0.11723942553518847
M1	string	0	network_modules	14	TRUE	0.0013072867374700446	49	53	5	0.09433962264150944	0.10204081632653061	REAC:R-HSA-1793185	REAC	Chondroitin sulfate/dermatan sulfate metabolism	10916	353		0.75	0.7692307692307693	49	10867	5	48	44	10819	10916	0.09388487695377336
M1	string	0	network_modules	14	TRUE	0.001447866224434269	204	61	8	0.13114754098360656	0.0392156862745098	GO:0070085	GO:BP	glycosylation	16175	15903		0.7619047619047619	0.7727272727272727	204	15971	8	53	196	15918	16175	0.06535439082310096
M1	string	0	network_modules	14	TRUE	0.002155682791872979	8	53	3	0.05660377358490566	0.375	REAC:R-HSA-5362798	REAC	Release of Hh-Np from the secreting cell	10916	2055		0.8333333333333334	0.8461538461538461	8	10908	3	50	5	10858	10916	0.14420978036053583
M1	string	0	network_modules	14	TRUE	0.0025310818057826864	149	53	7	0.1320754716981132	0.04697986577181208	REAC:R-HSA-5358351	REAC	Signaling by Hedgehog	10916	2258		0.9166666666666666	0.9230769230769231	149	10767	7	46	142	10721	10916	0.07129061262322223
M1	string	0	network_modules	14	TRUE	0.0027875186260061706	57	53	5	0.09433962264150944	0.08771929824561403	REAC:R-HSA-1638091	REAC	Heparan sulfate/heparin (HS-GAG) metabolism	10916	1119		1	1	57	10859	5	48	52	10811	10916	0.08636928344779034
M1	string	0	network_modules	14	TRUE	0.00287225424029237	24	61	4	0.06557377049180328	0.16666666666666666	GO:0045879	GO:BP	negative regulation of smoothened signaling pathway	16175	11683		0.8095238095238095	0.8181818181818182	24	16151	4	57	20	16094	16175	0.10244540040200391
M1	string	0	network_modules	14	TRUE	0.004341798084524992	165	61	7	0.11475409836065574	0.04242424242424243	GO:0097485	GO:BP	neuron projection guidance	16175	18673		0.8571428571428571	0.9090909090909091	165	16010	7	54	158	15956	16175	0.06401873646476126
M1	string	0	network_modules	14	TRUE	0.004341798084524992	165	61	7	0.11475409836065574	0.04242424242424243	GO:0007411	GO:BP	axon guidance	16175	2906		0.8571428571428571	0.9090909090909091	165	16010	7	54	158	15956	16175	0.06401873646476126
M1	string	0	network_modules	14	TRUE	0.008612221637527015	183	61	7	0.11475409836065574	0.03825136612021858	GO:0043413	GO:BP	macromolecule glycosylation	16175	10680		0.9523809523809523	1	183	15992	7	54	176	15938	16175	0.06017561561077725
M1	string	0	network_modules	14	TRUE	0.008612221637527015	183	61	7	0.11475409836065574	0.03825136612021858	GO:0006486	GO:BP	protein glycosylation	16175	2220		0.9523809523809523	1	183	15992	7	54	176	15938	16175	0.06017561561077725
M1	string	0	network_modules	14	TRUE	0.008663475817886282	19	43	3	0.06976744186046512	0.15789473684210525	KEGG:00531	KEGG	Glycosaminoglycan degradation	8484	75		1	1	19	8465	3	40	16	8425	8484	0.10196030055270738
M1	string	0	network_modules	15	TRUE	2.2530113238509044e-39	164	59	31	0.5254237288135594	0.18902439024390244	REAC:R-HSA-168898	REAC	Toll-like Receptor Cascades	10916	2522		0	0.019230769230769232	164	10752	31	28	133	10724	10916	0.30929909668635563
M1	string	0	network_modules	15	TRUE	1.0735397536578911e-31	143	59	26	0.4406779661016949	0.18181818181818182	REAC:R-HSA-166016	REAC	Toll Like Receptor 4 (TLR4) Cascade	10916	2516		0.0196078431372549	0.038461538461538464	143	10773	26	33	117	10740	10916	0.2772129695673657
M1	string	0	network_modules	15	TRUE	2.416652749145334e-29	59	64	19	0.296875	0.3220338983050847	GO:0002224	GO:BP	toll-like receptor signaling pathway	16175	758		0	0.006097560975609756	59	16116	19	45	40	16071	16175	0.30656525750886127
M1	string	0	network_modules	15	TRUE	3.9380634582271493e-28	106	49	22	0.4489795918367347	0.20754716981132076	KEGG:04620	KEGG	Toll-like receptor signaling pathway	8484	325		0	0.04	106	8378	22	27	84	8351	8484	0.2995041553248891
M1	string	0	network_modules	15	TRUE	8.134615763357145e-25	203	64	23	0.359375	0.11330049261083744	GO:0002237	GO:BP	response to molecule of bacterial origin	16175	770		0.006134969325153374	0.012195121951219513	203	15972	23	41	180	15931	16175	0.19636110276201993
M1	string	0	network_modules	15	TRUE	1.1546262645047625e-23	227	64	23	0.359375	0.1013215859030837	GO:0002221	GO:BP	pattern recognition receptor signaling pathway	16175	755		0.012269938650306749	0.018292682926829267	227	15948	23	41	204	15907	16175	0.18503552802857998
M1	string	0	network_modules	15	TRUE	4.3723567082227485e-23	280	64	24	0.375	0.08571428571428572	GO:0007249	GO:BP	canonical NF-kappaB signal transduction	16175	2783		0.018404907975460124	0.024390243902439025	280	15895	24	40	256	15855	16175	0.17285014071953175
M1	string	0	network_modules	15	TRUE	5.750866227504141e-23	243	64	23	0.359375	0.09465020576131687	GO:0002758	GO:BP	innate immune response-activating signaling pathway	16175	1269		0.024539877300613498	0.03048780487804878	243	15932	23	41	220	15891	16175	0.1784173643801521
M1	string	0	network_modules	15	TRUE	1.0338853883497867e-22	60	64	16	0.25	0.26666666666666666	GO:0140895	GO:BP	cell surface toll-like receptor signaling pathway	16175	19927		0.03067484662576687	0.036585365853658534	60	16115	16	48	44	16067	16175	0.2553465735626818
M1	string	0	network_modules	15	TRUE	1.4230095703984548e-22	339	64	25	0.390625	0.07374631268436578	GO:0002833	GO:BP	positive regulation of response to biotic stimulus	16175	1343		0.03680981595092025	0.042682926829268296	339	15836	25	39	314	15797	16175	0.16265252100890729
M1	string	0	network_modules	15	TRUE	1.6500179918834823e-22	443	64	27	0.421875	0.060948081264108354	GO:0009617	GO:BP	response to bacterium	16175	3543		0.04294478527607362	0.04878048780487805	443	15732	27	37	416	15695	16175	0.15233929897036042
M1	string	0	network_modules	15	TRUE	1.8302891143928942e-22	152	64	20	0.3125	0.13157894736842105	GO:0071219	GO:BP	cellular response to molecule of bacterial origin	16175	16481		0.049079754601226995	0.054878048780487805	152	16023	20	44	132	15979	16175	0.19800184624514935
M1	string	0	network_modules	15	TRUE	2.6658655481319152e-22	451	64	27	0.421875	0.0598669623059867	GO:0002831	GO:BP	regulation of response to biotic stimulus	16175	1341		0.05521472392638037	0.06097560975609756	451	15724	27	37	424	15687	16175	0.15083118927200898
M1	string	0	network_modules	15	TRUE	3.67213842703628e-22	263	64	23	0.359375	0.08745247148288973	GO:0002218	GO:BP	activation of innate immune response	16175	753		0.06134969325153374	0.06707317073170732	263	15912	23	41	240	15871	16175	0.17099086258504537
M1	string	0	network_modules	15	TRUE	6.14839355690765e-22	654	64	30	0.46875	0.045871559633027525	GO:0031347	GO:BP	regulation of defense response	16175	7138		0.06748466257668712	0.07317073170731707	654	15521	30	34	624	15487	16175	0.13705341218001094
M1	string	0	network_modules	15	TRUE	7.6150047005000265e-22	67	64	16	0.25	0.23880597014925373	GO:0002752	GO:BP	cell surface pattern recognition receptor signaling pathway	16175	1263		0.0736196319018405	0.07926829268292683	67	16108	16	48	51	16060	16175	0.24126749555233282
M1	string	0	network_modules	15	TRUE	1.0332730983839616e-21	319	64	24	0.375	0.07523510971786834	GO:0045089	GO:BP	positive regulation of innate immune response	16175	11272		0.07975460122699386	0.08536585365853659	319	15856	24	40	295	15816	16175	0.16104581217550812
M1	string	0	network_modules	15	TRUE	2.110223201229229e-21	115	59	19	0.3220338983050847	0.16521739130434782	REAC:R-HSA-168179	REAC	Toll Like Receptor TLR1:TLR2 Cascade	10916	2520		0.0392156862745098	0.07692307692307693	115	10801	19	40	96	10761	10916	0.22491076013333614
M1	string	0	network_modules	15	TRUE	2.110223201229229e-21	115	59	19	0.3220338983050847	0.16521739130434782	REAC:R-HSA-181438	REAC	Toll Like Receptor 2 (TLR2) Cascade	10916	2514		0.0392156862745098	0.07692307692307693	115	10801	19	40	96	10761	10916	0.22491076013333614
M1	string	0	network_modules	15	TRUE	2.4110498268423516e-21	172	64	20	0.3125	0.11627906976744186	GO:0071216	GO:BP	cellular response to biotic stimulus	16175	16478		0.08588957055214724	0.09146341463414634	172	16003	20	44	152	15959	16175	0.1854909569304291
M1	string	0	network_modules	15	TRUE	5.44712521903893e-21	634	64	29	0.453125	0.04574132492113565	GO:0001817	GO:BP	regulation of cytokine production	16175	474		0.09202453987730061	0.0975609756097561	634	15541	29	35	605	15506	16175	0.1344356550794443
M1	string	0	network_modules	15	TRUE	6.5072950229871745e-21	638	64	29	0.453125	0.045454545454545456	GO:0001816	GO:BP	cytokine production	16175	473		0.09815950920245399	0.10365853658536585	638	15537	29	35	609	15502	16175	0.13395073924637718
M1	string	0	network_modules	15	TRUE	3.5481193211545287e-20	423	64	25	0.390625	0.0591016548463357	GO:0031349	GO:BP	positive regulation of defense response	16175	7140		0.10429447852760736	0.10975609756097561	423	15752	25	39	398	15713	16175	0.14394645944491338
M1	string	0	network_modules	15	TRUE	5.0688890680207756e-20	85	64	16	0.25	0.18823529411764706	GO:0002220	GO:BP	innate immune response activating cell surface receptor signaling pathway	16175	754		0.11042944785276074	0.11585365853658537	85	16090	16	48	69	16042	16175	0.2133532828197199
M1	string	0	network_modules	15	TRUE	9.978988635497873e-20	386	64	24	0.375	0.06217616580310881	GO:0045088	GO:BP	regulation of innate immune response	16175	11271		0.1165644171779141	0.12195121951219512	386	15789	24	40	362	15749	16175	0.14500314960262264
M1	string	0	network_modules	15	TRUE	2.0319524391120916e-19	721	64	29	0.453125	0.04022191400832178	GO:0045087	GO:BP	innate immune response	16175	11270		0.12269938650306748	0.12804878048780488	721	15454	29	35	692	15419	16175	0.12477575232905394
M1	string	0	network_modules	15	TRUE	4.544053801917154e-19	531	64	26	0.40625	0.04896421845574388	GO:0032103	GO:BP	positive regulation of response to external stimulus	16175	7367		0.12883435582822086	0.13414634146341464	531	15644	26	38	505	15606	16175	0.13208431658725345
M1	string	0	network_modules	15	TRUE	7.643745528055773e-19	756	64	29	0.453125	0.03835978835978836	GO:0050776	GO:BP	regulation of immune response	16175	13250		0.13496932515337423	0.1402439024390244	756	15419	29	35	727	15384	16175	0.12134530659336763
M1	string	0	network_modules	15	TRUE	1.6344125325236591e-18	627	64	27	0.421875	0.0430622009569378	GO:0050778	GO:BP	positive regulation of immune response	16175	13252		0.1411042944785276	0.14634146341463414	627	15548	27	37	600	15511	16175	0.12509131342316757
M1	string	0	network_modules	15	TRUE	4.192196190893812e-18	110	64	16	0.25	0.14545454545454545	GO:0032479	GO:BP	regulation of type I interferon production	16175	7590		0.147239263803681	0.15853658536585366	110	16065	16	48	94	16017	16175	0.1865085675480017
M1	string	0	network_modules	15	TRUE	4.192196190893812e-18	110	64	16	0.25	0.14545454545454545	GO:0032606	GO:BP	type I interferon production	16175	7654		0.147239263803681	0.15853658536585366	110	16065	16	48	94	16017	16175	0.1865085675480017
M1	string	0	network_modules	15	TRUE	5.660908396256204e-18	30	59	12	0.2033898305084746	0.4	REAC:R-HSA-5260271	REAC	Diseases of Immune System	10916	759		0.0784313725490196	0.11538461538461539	30	10886	12	47	18	10839	10916	0.2825275096275032
M1	string	0	network_modules	15	TRUE	5.660908396256204e-18	30	59	12	0.2033898305084746	0.4	REAC:R-HSA-5602358	REAC	Diseases associated with the TLR signaling cascade	10916	753		0.0784313725490196	0.11538461538461539	30	10886	12	47	18	10839	10916	0.2825275096275032
M1	string	0	network_modules	15	TRUE	6.755603351831806e-18	403	64	23	0.359375	0.05707196029776675	GO:0001819	GO:BP	positive regulation of cytokine production	16175	476		0.15950920245398773	0.16463414634146342	403	15772	23	41	380	15731	16175	0.1352450303521761
M1	string	0	network_modules	15	TRUE	1.3425317992846014e-17	475	64	24	0.375	0.05052631578947368	GO:0002253	GO:BP	activation of immune response	16175	785		0.1656441717791411	0.17073170731707318	475	15700	24	40	451	15660	16175	0.12903052650338137
M1	string	0	network_modules	15	TRUE	1.3854515517766513e-17	416	64	23	0.359375	0.055288461538461536	GO:0002757	GO:BP	immune response-activating signaling pathway	16175	1268		0.17177914110429449	0.17682926829268292	416	15759	23	41	393	15718	16175	0.1328499397251477
M1	string	0	network_modules	15	TRUE	3.4580378682134616e-17	103	59	16	0.2711864406779661	0.1553398058252427	REAC:R-HSA-168181	REAC	Toll Like Receptor 7/8 (TLR7/8) Cascade	10916	2518		0.11764705882352941	0.1346153846153846	103	10813	16	43	87	10770	10916	0.1995863494396697
M1	string	0	network_modules	15	TRUE	4.2068698108246405e-17	437	64	23	0.359375	0.05263157894736842	GO:0002764	GO:BP	immune response-regulating signaling pathway	16175	1275		0.17791411042944785	0.18292682926829268	437	15738	23	41	414	15697	16175	0.12920034501829283
M1	string	0	network_modules	15	TRUE	1.413917349512256e-16	594	64	25	0.390625	0.04208754208754209	GO:0006954	GO:BP	inflammatory response	16175	2585		0.18404907975460122	0.18902439024390244	594	15581	25	39	569	15542	16175	0.11859455308334883
M1	string	0	network_modules	15	TRUE	1.4168979780039313e-16	112	59	16	0.2711864406779661	0.14285714285714285	REAC:R-HSA-168188	REAC	Toll Like Receptor TLR6:TLR2 Cascade	10916	2521		0.13725490196078433	0.17307692307692307	112	10804	16	43	96	10761	10916	0.1908759116466228
M1	string	0	network_modules	15	TRUE	1.4168979780039313e-16	112	59	16	0.2711864406779661	0.14285714285714285	REAC:R-HSA-166058	REAC	MyD88:MAL(TIRAP) cascade initiated on plasma membrane	10916	1502		0.13725490196078433	0.17307692307692307	112	10804	16	43	96	10761	10916	0.1908759116466228
M1	string	0	network_modules	15	TRUE	4.621577012606494e-16	66	64	13	0.203125	0.19696969696969696	GO:0032481	GO:BP	positive regulation of type I interferon production	16175	7592		0.1901840490797546	0.1951219512195122	66	16109	13	51	53	16058	16175	0.1967964374351774
M1	string	0	network_modules	15	TRUE	8.064882378803152e-16	187	64	17	0.265625	0.09090909090909091	GO:0032496	GO:BP	response to lipopolysaccharide	16175	7607		0.19631901840490798	0.20121951219512196	187	15988	17	47	170	15941	16175	0.1497953039793381
M1	string	0	network_modules	15	TRUE	1.1602950381872756e-15	51	64	12	0.1875	0.23529411764705882	GO:0032608	GO:BP	interferon-beta production	16175	7656		0.20245398773006135	0.21341463414634146	51	16124	12	52	39	16072	16175	0.20724668205864358
M1	string	0	network_modules	15	TRUE	1.1602950381872756e-15	51	64	12	0.1875	0.23529411764705882	GO:0032648	GO:BP	regulation of interferon-beta production	16175	7695		0.20245398773006135	0.21341463414634146	51	16124	12	52	39	16072	16175	0.20724668205864358
M1	string	0	network_modules	15	TRUE	1.270932855997962e-15	192	64	17	0.265625	0.08854166666666667	GO:0043123	GO:BP	positive regulation of canonical NF-kappaB signal transduction	16175	10542		0.2147239263803681	0.21951219512195122	192	15983	17	47	175	15936	16175	0.1476752044574521
M1	string	0	network_modules	15	TRUE	1.3226142169616131e-15	102	59	15	0.2542372881355932	0.14705882352941177	REAC:R-HSA-975155	REAC	MyD88 dependent cascade initiated on endosome	10916	1500		0.17647058823529413	0.19230769230769232	102	10814	15	44	87	10770	10916	0.18763682786962194
M1	string	0	network_modules	15	TRUE	1.9382796095116932e-15	53	64	12	0.1875	0.22641509433962265	GO:0034142	GO:BP	toll-like receptor 4 signaling pathway	16175	8450		0.22085889570552147	0.22560975609756098	53	16122	12	52	41	16070	16175	0.20317500663086563
M1	string	0	network_modules	15	TRUE	2.421110069417014e-15	106	59	15	0.2542372881355932	0.14150943396226415	REAC:R-HSA-168138	REAC	Toll Like Receptor 9 (TLR9) Cascade	10916	2519		0.19607843137254902	0.21153846153846154	106	10810	15	44	91	10766	10916	0.1838210523759704
M1	string	0	network_modules	15	TRUE	5.039071164083709e-15	252	64	18	0.28125	0.07142857142857142	GO:0043122	GO:BP	regulation of canonical NF-kappaB signal transduction	16175	10541		0.22699386503067484	0.23170731707317074	252	15923	18	46	234	15877	16175	0.13520834043603244
M1	string	0	network_modules	15	TRUE	9.618704778399629e-15	82	64	13	0.203125	0.15853658536585366	GO:0032677	GO:BP	regulation of interleukin-8 production	16175	7723		0.2331288343558282	0.24390243902439024	82	16093	13	51	69	16042	16175	0.1757658057481902
M1	string	0	network_modules	15	TRUE	9.618704778399629e-15	82	64	13	0.203125	0.15853658536585366	GO:0032637	GO:BP	interleukin-8 production	16175	7684		0.2331288343558282	0.24390243902439024	82	16093	13	51	69	16042	16175	0.1757658057481902
M1	string	0	network_modules	15	TRUE	1.2274576498704409e-14	142	64	15	0.234375	0.1056338028169014	GO:0071222	GO:BP	cellular response to lipopolysaccharide	16175	16484		0.24539877300613497	0.25	142	16033	15	49	127	15984	16175	0.15242383793907788
M1	string	0	network_modules	15	TRUE	1.28999314080021e-14	76	49	13	0.2653061224489796	0.17105263157894737	KEGG:05133	KEGG	Pertussis	8484	430		0.041666666666666664	0.08	76	8408	13	36	63	8372	8484	0.20736386748308577
M1	string	0	network_modules	15	TRUE	1.9474373273601214e-14	102	49	14	0.2857142857142857	0.13725490196078433	KEGG:04064	KEGG	NF-kappa B signaling pathway	8484	256		0.08333333333333333	0.12	102	8382	14	35	88	8347	8484	0.19140082166315958
M1	string	0	network_modules	15	TRUE	1.9712952599451704e-14	151	59	16	0.2711864406779661	0.10596026490066225	REAC:R-HSA-446652	REAC	Interleukin-1 family signaling	10916	1231		0.21568627450980393	0.23076923076923078	151	10765	16	43	135	10722	10916	0.16243112827715844
M1	string	0	network_modules	15	TRUE	4.684156169132227e-14	101	59	14	0.23728813559322035	0.13861386138613863	REAC:R-HSA-975138	REAC	TRAF6 mediated induction of NFkB and MAP kinases upon TLR7/8 or 9 activation	10916	2468		0.23529411764705882	0.25	101	10815	14	45	87	10770	10916	0.17557530685451095
M1	string	0	network_modules	15	TRUE	7.737798027492477e-14	175	49	16	0.32653061224489793	0.09142857142857143	KEGG:05152	KEGG	Tuberculosis	8484	440		0.125	0.16	175	8309	16	33	159	8276	8484	0.16403905884169404
M1	string	0	network_modules	15	TRUE	2.1695399527594422e-13	21	59	9	0.15254237288135594	0.42857142857142855	REAC:R-HSA-5686938	REAC	Regulation of TLR by endogenous ligand	10916	2010		0.2549019607843137	0.2692307692307692	21	10895	9	50	12	10845	10916	0.25339026785918495
M1	string	0	network_modules	15	TRUE	9.769077424534546e-13	27	64	9	0.140625	0.3333333333333333	GO:0070498	GO:BP	interleukin-1-mediated signaling pathway	16175	16156		0.25153374233128833	0.25609756097560976	27	16148	9	55	18	16093	16175	0.21454002190535407
M1	string	0	network_modules	15	TRUE	1.0733574877521527e-12	116	64	13	0.203125	0.11206896551724138	GO:0032635	GO:BP	interleukin-6 production	16175	7682		0.25766871165644173	0.2682926829268293	116	16059	13	51	103	16008	16175	0.1463651470880359
M1	string	0	network_modules	15	TRUE	1.0733574877521527e-12	116	64	13	0.203125	0.11206896551724138	GO:0032675	GO:BP	regulation of interleukin-6 production	16175	7721		0.25766871165644173	0.2682926829268293	116	16059	13	51	103	16008	16175	0.1463651470880359
M1	string	0	network_modules	15	TRUE	1.091175298242773e-12	62	64	11	0.171875	0.1774193548387097	GO:0032757	GO:BP	positive regulation of interleukin-8 production	16175	7801		0.26993865030674846	0.27439024390243905	62	16113	11	53	51	16060	16175	0.17139834545000512
M1	string	0	network_modules	15	TRUE	1.242520334287019e-12	9	59	7	0.11864406779661017	0.7777777777777778	REAC:R-HSA-2562578	REAC	TRIF-mediated programmed cell death	10916	2472		0.27450980392156865	0.28846153846153844	9	10907	7	52	2	10855	10916	0.30260647013889247
M1	string	0	network_modules	15	TRUE	1.435243334747743e-12	28	64	9	0.140625	0.32142857142857145	GO:0032607	GO:BP	interferon-alpha production	16175	7655		0.27607361963190186	0.2865853658536585	28	16147	9	55	19	16092	16175	0.21058690737538868
M1	string	0	network_modules	15	TRUE	1.435243334747743e-12	28	64	9	0.140625	0.32142857142857145	GO:0032647	GO:BP	regulation of interferon-alpha production	16175	7694		0.27607361963190186	0.2865853658536585	28	16147	9	55	19	16092	16175	0.21058690737538868
M1	string	0	network_modules	15	TRUE	2.6981028355646926e-12	18	64	8	0.125	0.4444444444444444	GO:0002755	GO:BP	MyD88-dependent toll-like receptor signaling pathway	16175	1266		0.2883435582822086	0.2926829268292683	18	16157	8	56	10	16101	16175	0.23419776718911034
M1	string	0	network_modules	15	TRUE	6.815721407378718e-12	50	64	10	0.15625	0.2	GO:0032655	GO:BP	regulation of interleukin-12 production	16175	7702		0.294478527607362	0.3048780487804878	50	16125	10	54	40	16071	16175	0.173892217908628
M1	string	0	network_modules	15	TRUE	6.815721407378718e-12	50	64	10	0.15625	0.2	GO:0032615	GO:BP	interleukin-12 production	16175	7663		0.294478527607362	0.3048780487804878	50	16125	10	54	40	16071	16175	0.173892217908628
M1	string	0	network_modules	15	TRUE	6.905364557928299e-12	265	64	16	0.25	0.06037735849056604	GO:0002429	GO:BP	immune response-activating cell surface receptor signaling pathway	16175	952		0.3067484662576687	0.31097560975609756	265	15910	16	48	249	15862	16175	0.11598955214692692
M1	string	0	network_modules	15	TRUE	6.963346679120064e-12	18	59	8	0.13559322033898305	0.4444444444444444	REAC:R-HSA-5603041	REAC	IRAK4 deficiency (TLR2/4)	10916	1158		0.29411764705882354	0.3076923076923077	18	10898	8	51	10	10847	10916	0.24335993570877573
M1	string	0	network_modules	15	TRUE	7.849153725506916e-12	113	59	13	0.22033898305084745	0.11504424778761062	REAC:R-HSA-9020702	REAC	Interleukin-1 signaling	10916	1233		0.3137254901960784	0.3269230769230769	113	10803	13	46	100	10757	10916	0.15293822266998647
M1	string	0	network_modules	15	TRUE	1.5912711027489526e-11	78	64	11	0.171875	0.14102564102564102	GO:0032755	GO:BP	positive regulation of interleukin-6 production	16175	7799		0.3128834355828221	0.3170731707317073	78	16097	11	53	67	16044	16175	0.15198714825813128
M1	string	0	network_modules	15	TRUE	2.4095717133655322e-11	287	64	16	0.25	0.05574912891986063	GO:0002768	GO:BP	immune response-regulating cell surface receptor signaling pathway	16175	1279		0.31901840490797545	0.3231707317073171	287	15888	16	48	271	15840	16175	0.1108831281195473
M1	string	0	network_modules	15	TRUE	2.92423883241759e-11	555	64	20	0.3125	0.036036036036036036	GO:0071345	GO:BP	cellular response to cytokine stimulus	16175	16597		0.32515337423312884	0.32926829268292684	555	15620	20	44	535	15576	16175	0.09632168808910899
M1	string	0	network_modules	15	TRUE	2.958524144818778e-11	149	64	13	0.203125	0.087248322147651	GO:0002753	GO:BP	cytoplasmic pattern recognition receptor signaling pathway	16175	1264		0.3312883435582822	0.3353658536585366	149	16026	13	51	136	15975	16175	0.1279307120441544
M1	string	0	network_modules	15	TRUE	2.976992535897864e-11	23	64	8	0.125	0.34782608695652173	GO:0032727	GO:BP	positive regulation of interferon-alpha production	16175	7772		0.3374233128834356	0.34146341463414637	23	16152	8	56	15	16096	16175	0.2066984897617755
M1	string	0	network_modules	15	TRUE	3.284995150140125e-11	38	64	9	0.140625	0.23684210526315788	GO:0032728	GO:BP	positive regulation of interferon-beta production	16175	7773		0.34355828220858897	0.3475609756097561	38	16137	9	55	29	16082	16175	0.18001789593297857
M1	string	0	network_modules	15	TRUE	3.50906802610099e-11	7	64	6	0.09375	0.8571428571428571	GO:0071220	GO:BP	cellular response to bacterial lipoprotein	16175	16482		0.3496932515337423	0.36585365853658536	7	16168	6	58	1	16110	16175	0.28278587431888497
M1	string	0	network_modules	15	TRUE	3.50906802610099e-11	7	64	6	0.09375	0.8571428571428571	GO:0071221	GO:BP	cellular response to bacterial lipopeptide	16175	16483		0.3496932515337423	0.36585365853658536	7	16168	6	58	1	16110	16175	0.28278587431888497
M1	string	0	network_modules	15	TRUE	3.50906802610099e-11	7	64	6	0.09375	0.8571428571428571	GO:0070339	GO:BP	response to bacterial lipopeptide	16175	16061		0.3496932515337423	0.36585365853658536	7	16168	6	58	1	16110	16175	0.28278587431888497
M1	string	0	network_modules	15	TRUE	3.864185401810233e-11	419	64	18	0.28125	0.04295942720763723	GO:0019221	GO:BP	cytokine-mediated signaling pathway	16175	5598		0.36809815950920244	0.3719512195121951	419	15756	18	46	401	15710	16175	0.10131454410853419
M1	string	0	network_modules	15	TRUE	6.995386925281544e-11	41	64	9	0.140625	0.21951219512195122	GO:0140894	GO:BP	endolysosomal toll-like receptor signaling pathway	16175	19926		0.37423312883435583	0.3780487804878049	41	16134	9	55	32	16079	16175	0.17309041025785585
M1	string	0	network_modules	15	TRUE	9.361482754908687e-11	124	64	12	0.1875	0.0967741935483871	GO:0051092	GO:BP	positive regulation of NF-kappaB transcription factor activity	16175	13487		0.3803680981595092	0.38414634146341464	124	16051	12	52	112	15999	16175	0.12995188277452796
M1	string	0	network_modules	15	TRUE	1.192249006475267e-10	107	59	12	0.2033898305084746	0.11214953271028037	REAC:R-HSA-166166	REAC	MyD88-independent TLR4 cascade 	10916	1501		0.3333333333333333	0.36538461538461536	107	10809	12	47	95	10762	10916	0.14485308143775938
M1	string	0	network_modules	15	TRUE	1.192249006475267e-10	107	59	12	0.2033898305084746	0.11214953271028037	REAC:R-HSA-937061	REAC	TRIF (TICAM1)-mediated TLR4 signaling 	10916	2471		0.3333333333333333	0.36538461538461536	107	10809	12	47	95	10762	10916	0.14485308143775938
M1	string	0	network_modules	15	TRUE	1.378192825057082e-10	128	64	12	0.1875	0.09375	GO:0032640	GO:BP	tumor necrosis factor production	16175	7687		0.38650306748466257	0.39634146341463417	128	16047	12	52	116	15995	16175	0.12774530036659604
M1	string	0	network_modules	15	TRUE	1.378192825057082e-10	128	64	12	0.1875	0.09375	GO:0032680	GO:BP	regulation of tumor necrosis factor production	16175	7726		0.38650306748466257	0.39634146341463417	128	16047	12	52	116	15995	16175	0.12774530036659604
M1	string	0	network_modules	15	TRUE	1.399311568465592e-10	8	64	6	0.09375	0.75	GO:0032493	GO:BP	response to bacterial lipoprotein	16175	7604		0.3987730061349693	0.4024390243902439	8	16167	6	58	2	16109	16175	0.2643548902382206
M1	string	0	network_modules	15	TRUE	2.0068996839763028e-10	16	64	7	0.109375	0.4375	GO:0034134	GO:BP	toll-like receptor 2 signaling pathway	16175	8442		0.4049079754601227	0.40853658536585363	16	16159	7	57	9	16102	16175	0.21730927355694846
M1	string	0	network_modules	15	TRUE	2.1951798414961126e-10	133	64	12	0.1875	0.09022556390977443	GO:0071706	GO:BP	tumor necrosis factor superfamily cytokine production	16175	16870		0.4110429447852761	0.42073170731707316	133	16042	12	52	121	15990	16175	0.1251248527177889
M1	string	0	network_modules	15	TRUE	2.1951798414961126e-10	133	64	12	0.1875	0.09022556390977443	GO:1903555	GO:BP	regulation of tumor necrosis factor superfamily cytokine production	16175	23102		0.4110429447852761	0.42073170731707316	133	16042	12	52	121	15990	16175	0.1251248527177889
M1	string	0	network_modules	15	TRUE	2.712588184796458e-10	625	64	20	0.3125	0.032	GO:1901652	GO:BP	response to peptide	16175	21619		0.4233128834355828	0.4329268292682927	625	15550	20	44	605	15506	16175	0.08955639889205394
M1	string	0	network_modules	15	TRUE	2.712588184796458e-10	625	64	20	0.3125	0.032	GO:0034097	GO:BP	response to cytokine	16175	8408		0.4233128834355828	0.4329268292682927	625	15550	20	44	605	15506	16175	0.08955639889205394
M1	string	0	network_modules	15	TRUE	3.3271790674879965e-10	72	64	10	0.15625	0.1388888888888889	GO:0032602	GO:BP	chemokine production	16175	7650		0.43558282208588955	0.4451219512195122	72	16103	10	54	62	16049	16175	0.14372138567550305
M1	string	0	network_modules	15	TRUE	3.3271790674879965e-10	72	64	10	0.15625	0.1388888888888889	GO:0032642	GO:BP	regulation of chemokine production	16175	7689		0.43558282208588955	0.4451219512195122	72	16103	10	54	62	16049	16175	0.14372138567550305
M1	string	0	network_modules	15	TRUE	3.834598292120035e-10	16	59	7	0.11864406779661017	0.4375	REAC:R-HSA-936964	REAC	Activation of IRF3, IRF7 mediated by TBK1, IKKε (IKBKE)	10916	85		0.37254901960784315	0.38461538461538464	16	10900	7	52	9	10848	10916	0.2257920651437403
M1	string	0	network_modules	15	TRUE	6.065201204595338e-10	101	49	11	0.22448979591836735	0.10891089108910891	KEGG:05142	KEGG	Chagas disease	8484	434		0.16666666666666666	0.2	101	8383	11	38	90	8345	8484	0.14939237215902182
M1	string	0	network_modules	15	TRUE	6.491624372252558e-10	17	59	7	0.11864406779661017	0.4117647058823529	REAC:R-HSA-5602498	REAC	MyD88 deficiency (TLR2/4)	10916	1498		0.39215686274509803	0.40384615384615385	17	10899	7	52	10	10847	10916	0.21888926851102036
M1	string	0	network_modules	15	TRUE	6.629076154373905e-10	214	49	14	0.2857142857142857	0.06542056074766354	KEGG:05417	KEGG	Lipid and atherosclerosis	8484	494		0.20833333333333334	0.24	214	8270	14	35	200	8235	8484	0.1266158657248716
M1	string	0	network_modules	15	TRUE	9.970357499585301e-10	80	64	10	0.15625	0.125	GO:0032760	GO:BP	positive regulation of tumor necrosis factor production	16175	7804		0.44785276073619634	0.45121951219512196	80	16095	10	54	70	16041	16175	0.13593560615139746
M1	string	0	network_modules	15	TRUE	1.5332852625078914e-9	520	64	18	0.28125	0.03461538461538462	GO:0033993	GO:BP	response to lipid	16175	8371		0.4539877300613497	0.4573170731707317	520	15655	18	46	502	15609	16175	0.08900642888937568
M1	string	0	network_modules	15	TRUE	1.6516813939170412e-9	84	64	10	0.15625	0.11904761904761904	GO:1903557	GO:BP	positive regulation of tumor necrosis factor superfamily cytokine production	16175	23104		0.4601226993865031	0.4634146341463415	84	16091	10	54	74	16037	16175	0.13245920652901544
M1	string	0	network_modules	15	TRUE	2.1493417773469704e-9	791	64	21	0.328125	0.02654867256637168	GO:1901701	GO:BP	cellular response to oxygen-containing compound	16175	21654		0.4662576687116564	0.4695121951219512	791	15384	21	43	770	15341	16175	0.08160191731100144
M1	string	0	network_modules	15	TRUE	2.220866182637424e-9	208	64	13	0.203125	0.0625	GO:0051091	GO:BP	positive regulation of DNA-binding transcription factor activity	16175	13486		0.4723926380368098	0.47560975609756095	208	15967	13	51	195	15916	16175	0.10643637734944573
M1	string	0	network_modules	15	TRUE	2.7845406311613075e-9	60	64	9	0.140625	0.15	GO:0032729	GO:BP	positive regulation of type II interferon production	16175	7774		0.4785276073619632	0.4817073170731707	60	16115	9	55	51	16060	16175	0.14194990039185248
M1	string	0	network_modules	15	TRUE	3.360134862967455e-9	90	64	10	0.15625	0.1111111111111111	GO:0032609	GO:BP	type II interferon production	16175	7657		0.48466257668711654	0.49390243902439024	90	16085	10	54	80	16031	16175	0.12767731318991635
M1	string	0	network_modules	15	TRUE	3.360134862967455e-9	90	64	10	0.15625	0.1111111111111111	GO:0032649	GO:BP	regulation of type II interferon production	16175	7696		0.48466257668711654	0.49390243902439024	90	16085	10	54	80	16031	16175	0.12767731318991635
M1	string	0	network_modules	15	TRUE	4.561199678842684e-9	12	64	6	0.09375	0.5	GO:0032490	GO:BP	detection of molecule of bacterial origin	16175	7601		0.49693251533742333	0.5	12	16163	6	58	6	16105	16175	0.21529912147337207
M1	string	0	network_modules	15	TRUE	5.123114556478896e-9	249	49	14	0.2857142857142857	0.05622489959839357	KEGG:05132	KEGG	Salmonella infection	8484	429		0.25	0.28	249	8235	14	35	235	8200	8484	0.11576660107908693
M1	string	0	network_modules	15	TRUE	6.559836554797976e-9	345	64	15	0.234375	0.043478260869565216	GO:0051090	GO:BP	regulation of DNA-binding transcription factor activity	16175	13485		0.5030674846625767	0.5060975609756098	345	15830	15	49	330	15781	16175	0.09293856777093498
M1	string	0	network_modules	15	TRUE	1.5981458141789255e-8	302	64	14	0.21875	0.046357615894039736	GO:0030522	GO:BP	intracellular receptor signaling pathway	16175	6836		0.50920245398773	0.5121951219512195	302	15873	14	50	288	15823	16175	0.09316268907275595
M1	string	0	network_modules	15	TRUE	1.8823767764843357e-8	138	49	11	0.22448979591836735	0.07971014492753623	KEGG:05162	KEGG	Measles	8484	443		0.2916666666666667	0.32	138	8346	11	38	127	8308	8484	0.12546077481671342
M1	string	0	network_modules	15	TRUE	2.5651510589876676e-8	142	49	11	0.22448979591836735	0.07746478873239436	KEGG:04936	KEGG	Alcoholic liver disease	8484	393		0.3333333333333333	0.36	142	8342	11	38	131	8304	8484	0.12343063336128868
M1	string	0	network_modules	15	TRUE	3.4536271472425396e-8	15	59	6	0.1016949152542373	0.4	REAC:R-HSA-937072	REAC	TRAF6-mediated induction of TAK1 complex within TLR4 complex	10916	2469		0.4117647058823529	0.46153846153846156	15	10901	6	53	9	10848	10916	0.19963962190403084
M1	string	0	network_modules	15	TRUE	3.4536271472425396e-8	15	59	6	0.1016949152542373	0.4	REAC:R-HSA-140534	REAC	Caspase activation via Death Receptors in the presence of ligand	10916	313		0.4117647058823529	0.46153846153846156	15	10901	6	53	9	10848	10916	0.19963962190403084
M1	string	0	network_modules	15	TRUE	3.4536271472425396e-8	15	59	6	0.1016949152542373	0.4	REAC:R-HSA-975163	REAC	IRAK2 mediated activation of TAK1 complex upon TLR7/8 or 9 stimulation	10916	1157		0.4117647058823529	0.46153846153846156	15	10901	6	53	9	10848	10916	0.19963962190403084
M1	string	0	network_modules	15	TRUE	3.904650096984102e-8	16	64	6	0.09375	0.375	GO:0002756	GO:BP	MyD88-independent toll-like receptor signaling pathway	16175	1267		0.5153374233128835	0.5182926829268293	16	16159	6	58	10	16101	16175	0.18598176756516907
M1	string	0	network_modules	15	TRUE	7.099909408324609e-8	408	64	15	0.234375	0.03676470588235294	GO:0071396	GO:BP	cellular response to lipid	16175	16648		0.5214723926380368	0.524390243902439	408	15767	15	49	393	15718	16175	0.08406749882020687
M1	string	0	network_modules	15	TRUE	7.789776270940494e-8	56	64	8	0.125	0.14285714285714285	GO:0032722	GO:BP	positive regulation of chemokine production	16175	7767		0.5276073619631901	0.5304878048780488	56	16119	8	56	48	16063	16175	0.1304132076028313
M1	string	0	network_modules	15	TRUE	8.926814677658284e-8	34	64	7	0.109375	0.20588235294117646	GO:0032735	GO:BP	positive regulation of interleukin-12 production	16175	7780		0.5337423312883436	0.5365853658536586	34	16141	7	57	27	16084	16175	0.14762460173395411
M1	string	0	network_modules	15	TRUE	9.35122920374693e-8	472	59	17	0.288135593220339	0.036016949152542374	REAC:R-HSA-449147	REAC	Signaling by Interleukins	10916	2261		0.47058823529411764	0.4807692307692308	472	10444	17	42	455	10402	10916	0.08875900538023715
M1	string	0	network_modules	15	TRUE	1.0573166315638934e-7	162	49	11	0.22448979591836735	0.06790123456790123	KEGG:05161	KEGG	Hepatitis B	8484	442		0.375	0.4	162	8322	11	38	151	8284	8484	0.11438648707107212
M1	string	0	network_modules	15	TRUE	1.0952266472865912e-7	89	64	9	0.140625	0.10112359550561797	GO:0071347	GO:BP	cellular response to interleukin-1	16175	16599		0.5398773006134969	0.5426829268292683	89	16086	9	55	80	16031	16175	0.1151283412695746
M1	string	0	network_modules	15	TRUE	2.5131481306907965e-7	39	64	7	0.109375	0.1794871794871795	GO:0031663	GO:BP	lipopolysaccharide-mediated signaling pathway	16175	7267		0.5460122699386503	0.5487804878048781	39	16136	7	57	32	16079	16175	0.13746112561734863
M1	string	0	network_modules	15	TRUE	2.627867218298252e-7	120	59	10	0.1694915254237288	0.08333333333333333	REAC:R-HSA-9705671	REAC	SARS-CoV-2 activates/modulates innate and adaptive immune responses	10916	2123		0.49019607843137253	0.5	120	10796	10	49	110	10747	10916	0.11205666053791798
M1	string	0	network_modules	15	TRUE	3.5684265803511313e-7	143	64	10	0.15625	0.06993006993006994	GO:0060759	GO:BP	regulation of response to cytokine stimulus	16175	14927		0.5521472392638037	0.5548780487804879	143	16032	10	54	133	15978	16175	0.09925119284368718
M1	string	0	network_modules	15	TRUE	4.929442241773963e-7	105	64	9	0.140625	0.08571428571428572	GO:0070555	GO:BP	response to interleukin-1	16175	16175		0.558282208588957	0.5609756097560976	105	16070	9	55	96	16015	16175	0.1052707456319934
M1	string	0	network_modules	15	TRUE	5.000367840134991e-7	22	59	6	0.1016949152542373	0.2727272727272727	REAC:R-HSA-937041	REAC	IKK complex recruitment mediated by RIP1	10916	1145		0.5098039215686274	0.5192307692307693	22	10894	6	53	16	10841	10916	0.1638458885082173
M1	string	0	network_modules	15	TRUE	8.39928039550976e-7	25	64	6	0.09375	0.24	GO:0098581	GO:BP	detection of external biotic stimulus	16175	18798		0.5644171779141104	0.5670731707317073	25	16150	6	58	19	16092	16175	0.14793414609917208
M1	string	0	network_modules	15	TRUE	1.068458197240426e-6	12	64	5	0.078125	0.4166666666666667	GO:0035666	GO:BP	TRIF-dependent toll-like receptor signaling pathway	16175	9146		0.5705521472392638	0.573170731707317	12	16163	5	59	7	16104	16175	0.17912970985093182
M1	string	0	network_modules	15	TRUE	1.172115130216294e-6	25	59	6	0.1016949152542373	0.24	REAC:R-HSA-5357769	REAC	Caspase activation via extrinsic apoptotic signalling pathway	10916	315		0.5294117647058824	0.5384615384615384	25	10891	6	53	19	10838	10916	0.1532984082306239
M1	string	0	network_modules	15	TRUE	1.1932885353457162e-6	276	64	12	0.1875	0.043478260869565216	GO:0002697	GO:BP	regulation of immune effector process	16175	1215		0.5766871165644172	0.5792682926829268	276	15899	12	52	264	15847	16175	0.08294620519506839
M1	string	0	network_modules	15	TRUE	1.3188687732385885e-6	103	59	9	0.15254237288135594	0.08737864077669903	REAC:R-HSA-168164	REAC	Toll Like Receptor 3 (TLR3) Cascade	10916	2515		0.5490196078431373	0.5576923076923077	103	10813	9	50	94	10763	10916	0.10911961198492125
M1	string	0	network_modules	15	TRUE	1.3326222888627845e-6	79	64	8	0.125	0.10126582278481013	GO:0002718	GO:BP	regulation of cytokine production involved in immune response	16175	1236		0.5828220858895705	0.5914634146341463	79	16096	8	56	71	16040	16175	0.10859280989028916
M1	string	0	network_modules	15	TRUE	1.3326222888627845e-6	79	64	8	0.125	0.10126582278481013	GO:0002367	GO:BP	cytokine production involved in immune response	16175	899		0.5828220858895705	0.5914634146341463	79	16096	8	56	71	16040	16175	0.10859280989028916
M1	string	0	network_modules	15	TRUE	1.8024896503703868e-6	13	59	5	0.0847457627118644	0.38461538461538464	REAC:R-HSA-975110	REAC	TRAF6 mediated IRF7 activation in TLR7/8 or 9 signaling	10916	2466		0.5686274509803921	0.5769230769230769	13	10903	5	54	8	10849	10916	0.17859183397591344
M1	string	0	network_modules	15	TRUE	2.0424505745070627e-6	123	64	9	0.140625	0.07317073170731707	GO:0002700	GO:BP	regulation of production of molecular mediator of immune response	16175	1218		0.5950920245398773	0.5975609756097561	123	16052	9	55	114	15997	16175	0.09651060427319418
M1	string	0	network_modules	15	TRUE	2.1919590833080738e-6	167	49	10	0.20408163265306123	0.059880239520958084	KEGG:05164	KEGG	Influenza A	8484	445		0.4166666666666667	0.44	167	8317	10	39	157	8278	8484	0.101174169747517
M1	string	0	network_modules	15	TRUE	3.122078323227857e-6	536	64	15	0.234375	0.027985074626865673	GO:0002252	GO:BP	immune effector process	16175	784		0.6012269938650306	0.6036585365853658	536	15639	15	49	521	15590	16175	0.07085898565798203
M1	string	0	network_modules	15	TRUE	4.20614627725083e-6	32	64	6	0.09375	0.1875	GO:0009595	GO:BP	detection of biotic stimulus	16175	3526		0.6073619631901841	0.6097560975609756	32	16143	6	58	26	16085	16175	0.1301710475593262
M1	string	0	network_modules	15	TRUE	4.273411245616425e-6	6	59	4	0.06779661016949153	0.6666666666666666	REAC:R-HSA-9013957	REAC	TLR3-mediated TICAM1-dependent programmed cell death	10916	2444		0.5882352941176471	0.5961538461538461	6	10910	4	55	2	10855	10916	0.21150432788589404
M1	string	0	network_modules	15	TRUE	9.340571130168636e-6	146	64	9	0.140625	0.06164383561643835	GO:0062207	GO:BP	regulation of pattern recognition receptor signaling pathway	16175	15863		0.6134969325153374	0.6158536585365854	146	16029	9	55	137	15974	16175	0.08769908584379928
M1	string	0	network_modules	15	TRUE	1.0316484360582505e-5	334	64	12	0.1875	0.03592814371257485	GO:0009615	GO:BP	response to virus	16175	3541		0.6196319018404908	0.6219512195121951	334	15841	12	52	322	15789	16175	0.07394978586755432
M1	string	0	network_modules	15	TRUE	1.1807593002154966e-5	72	49	7	0.14285714285714285	0.09722222222222222	KEGG:05140	KEGG	Leishmaniasis	8484	433		0.4583333333333333	0.48	72	8412	7	42	65	8370	8484	0.11164633411399037
M1	string	0	network_modules	15	TRUE	1.1847969063890619e-5	150	64	9	0.140625	0.06	GO:0002440	GO:BP	production of molecular mediator of immune response	16175	963		0.6257668711656442	0.6280487804878049	150	16025	9	55	141	15970	16175	0.08637005239319899
M1	string	0	network_modules	15	TRUE	1.2884572297201276e-5	7	64	4	0.0625	0.5714285714285714	GO:0008063	GO:BP	Toll signaling pathway	16175	3112		0.6319018404907976	0.6341463414634146	7	16168	4	60	3	16108	16175	0.1880867683561106
M1	string	0	network_modules	15	TRUE	1.4029962990604607e-5	95	59	8	0.13559322033898305	0.08421052631578947	REAC:R-HSA-168176	REAC	Toll Like Receptor 5 (TLR5) Cascade	10916	2517		0.6078431372549019	0.6538461538461539	95	10821	8	51	87	10770	10916	0.1007089052524447
M1	string	0	network_modules	15	TRUE	1.4029962990604607e-5	95	59	8	0.13559322033898305	0.08421052631578947	REAC:R-HSA-975871	REAC	MyD88 cascade initiated on plasma membrane	10916	1497		0.6078431372549019	0.6538461538461539	95	10821	8	51	87	10770	10916	0.1007089052524447
M1	string	0	network_modules	15	TRUE	1.4029962990604607e-5	95	59	8	0.13559322033898305	0.08421052631578947	REAC:R-HSA-168142	REAC	Toll Like Receptor 10 (TLR10) Cascade	10916	2513		0.6078431372549019	0.6538461538461539	95	10821	8	51	87	10770	10916	0.1007089052524447
M1	string	0	network_modules	15	TRUE	1.8069402371764088e-5	158	49	9	0.1836734693877551	0.056962025316455694	KEGG:04217	KEGG	Necroptosis	8484	294		0.5	0.52	158	8326	9	40	149	8286	8484	0.09305193485365267
M1	string	0	network_modules	15	TRUE	2.569267131918624e-5	8	64	4	0.0625	0.5	GO:0038172	GO:BP	interleukin-33-mediated signaling pathway	16175	9748		0.6380368098159509	0.6402439024390244	8	16167	4	60	4	16107	16175	0.17576924832305316
M1	string	0	network_modules	15	TRUE	3.170343780834984e-5	197	59	10	0.1694915254237288	0.050761421319796954	REAC:R-HSA-9705683	REAC	SARS-CoV-2-host interactions	10916	2128		0.6666666666666666	0.6730769230769231	197	10719	10	49	187	10670	10916	0.0838645112555146
M1	string	0	network_modules	15	TRUE	3.299590405320888e-5	228	64	10	0.15625	0.043859649122807015	GO:0051607	GO:BP	defense response to virus	16175	13823		0.6441717791411042	0.6463414634146342	228	15947	10	54	218	15893	16175	0.07600212239773034
M1	string	0	network_modules	15	TRUE	3.7197614343047364e-5	299	64	11	0.171875	0.03678929765886288	GO:0050727	GO:BP	regulation of inflammatory response	16175	13226		0.6503067484662577	0.6524390243902439	299	15876	11	53	288	15823	16175	0.07177332046867198
M1	string	0	network_modules	15	TRUE	3.8265677735223215e-5	78	64	7	0.109375	0.08974358974358974	GO:0046330	GO:BP	positive regulation of JNK cascade	16175	12063		0.656441717791411	0.6585365853658537	78	16097	7	57	71	16040	16175	0.09512368962212142
M1	string	0	network_modules	15	TRUE	5.128706948872877e-5	89	49	7	0.14285714285714285	0.07865168539325842	KEGG:05235	KEGG	PD-L1 expression and PD-1 checkpoint pathway in cancer	8484	480		0.5416666666666666	0.56	89	8395	7	42	82	8353	8484	0.09902159084143207
M1	string	0	network_modules	15	TRUE	5.281561848144282e-5	208	59	10	0.1694915254237288	0.04807692307692308	REAC:R-HSA-5357801	REAC	Programmed Cell Death	10916	1803		0.6862745098039216	0.6923076923076923	208	10708	10	49	198	10659	10916	0.0811153819780124
M1	string	0	network_modules	15	TRUE	5.422158731825332e-5	48	64	6	0.09375	0.125	GO:0071260	GO:BP	cellular response to mechanical stimulus	16175	16518		0.6625766871165644	0.6707317073170732	48	16127	6	58	42	16069	16175	0.10519074981467891
M1	string	0	network_modules	15	TRUE	5.422158731825332e-5	48	64	6	0.09375	0.125	GO:0071496	GO:BP	cellular response to external stimulus	16175	16729		0.6625766871165644	0.6707317073170732	48	16127	6	58	42	16069	16175	0.10519074981467891
M1	string	0	network_modules	15	TRUE	5.596916791411016e-5	3	59	3	0.05084745762711865	1	REAC:R-HSA-5602571	REAC	TRAF3 deficiency - HSE	10916	2463		0.7058823529411765	0.7115384615384616	3	10913	3	56	0	10857	10916	0.22491450414665626
M1	string	0	network_modules	15	TRUE	6.002984063411521e-5	182	49	9	0.1836734693877551	0.04945054945054945	KEGG:04621	KEGG	NOD-like receptor signaling pathway	8484	326		0.5833333333333334	0.6	182	8302	9	40	173	8262	8484	0.08533693490488073
M1	string	0	network_modules	15	TRUE	6.2734944831951e-5	244	64	10	0.15625	0.040983606557377046	GO:0042742	GO:BP	defense response to bacterium	16175	10335		0.6748466257668712	0.676829268292683	244	15931	10	54	234	15877	16175	0.0729934018250403
M1	string	0	network_modules	15	TRUE	6.97820492139386e-5	50	64	6	0.09375	0.12	GO:1901224	GO:BP	positive regulation of non-canonical NF-kappaB signal transduction	16175	21318		0.6809815950920245	0.6829268292682927	50	16125	6	58	44	16067	16175	0.10293147051860446
M1	string	0	network_modules	15	TRUE	7.985761564243723e-5	132	64	8	0.125	0.06060606060606061	GO:0001959	GO:BP	regulation of cytokine-mediated signaling pathway	16175	568		0.6871165644171779	0.6890243902439024	132	16043	8	56	124	15987	16175	0.08185252117687888
M1	string	0	network_modules	15	TRUE	9.847106792321507e-5	3	64	3	0.046875	1	GO:0071727	GO:BP	cellular response to triacyl bacterial lipopeptide	16175	16887		0.6932515337423313	0.7073170731707317	3	16172	3	61	0	16111	16175	0.21609763944209617
M1	string	0	network_modules	15	TRUE	9.847106792321507e-5	3	64	3	0.046875	1	GO:0070340	GO:BP	detection of bacterial lipopeptide	16175	16062		0.6932515337423313	0.7073170731707317	3	16172	3	61	0	16111	16175	0.21609763944209617
M1	string	0	network_modules	15	TRUE	9.847106792321507e-5	3	64	3	0.046875	1	GO:0071725	GO:BP	response to triacyl bacterial lipopeptide	16175	16885		0.6932515337423313	0.7073170731707317	3	16172	3	61	0	16111	16175	0.21609763944209617
M1	string	0	network_modules	15	TRUE	1.0098026760549683e-4	62	49	6	0.12244897959183673	0.0967741935483871	KEGG:05321	KEGG	Inflammatory bowel disease	8484	483		0.625	0.64	62	8422	6	43	56	8379	8484	0.10303460006773574
M1	string	0	network_modules	15	TRUE	1.286907449426565e-4	147	49	8	0.16326530612244897	0.05442176870748299	KEGG:04145	KEGG	Phagosome	8484	281		0.6666666666666666	0.68	147	8337	8	41	139	8296	8484	0.08524377713639097
M1	string	0	network_modules	15	TRUE	1.3307933866210856e-4	421	64	12	0.1875	0.028503562945368172	GO:0002694	GO:BP	regulation of leukocyte activation	16175	1212		0.7116564417177914	0.7134146341463414	421	15754	12	52	409	15702	16175	0.06391963196451939
M1	string	0	network_modules	15	TRUE	1.376463402992735e-4	12	59	4	0.06779661016949153	0.3333333333333333	REAC:R-HSA-9013973	REAC	TICAM1-dependent activation of IRF3/IRF7	10916	2442		0.7254901960784313	0.7307692307692307	12	10904	4	55	8	10849	10916	0.14837453282416016
M1	string	0	network_modules	15	TRUE	1.518588036268758e-4	95	64	7	0.109375	0.07368421052631578	GO:0002702	GO:BP	positive regulation of production of molecular mediator of immune response	16175	1220		0.7177914110429447	0.7195121951219512	95	16080	7	57	88	16023	16175	0.0853720772160994
M1	string	0	network_modules	15	TRUE	1.8377689005281476e-4	90	59	7	0.11864406779661017	0.07777777777777778	REAC:R-HSA-1236974	REAC	ER-Phagosome pathway	10916	824		0.7450980392156863	0.75	90	10826	7	52	83	10774	10916	0.09000064589005527
M1	string	0	network_modules	15	TRUE	1.9272757293555714e-4	275	64	10	0.15625	0.03636363636363636	GO:0002696	GO:BP	positive regulation of leukocyte activation	16175	1214		0.7239263803680982	0.725609756097561	275	15900	10	54	265	15846	16175	0.06788885778563775
M1	string	0	network_modules	15	TRUE	1.9802138503211916e-4	13	59	4	0.06779661016949153	0.3076923076923077	REAC:R-HSA-1679131	REAC	Trafficking and processing of endosomal TLR	10916	2531		0.7647058823529411	0.7692307692307693	13	10903	4	55	9	10848	10916	0.1423643711011235
M1	string	0	network_modules	15	TRUE	2.4835534736586146e-4	102	64	7	0.109375	0.06862745098039216	GO:0038061	GO:BP	non-canonical NF-kappaB signal transduction	16175	9680		0.7300613496932515	0.7317073170731707	102	16073	7	57	95	16016	16175	0.08206394950308879
M1	string	0	network_modules	15	TRUE	2.556257697500665e-4	32	64	5	0.078125	0.15625	GO:0070266	GO:BP	necroptotic process	16175	16027		0.7361963190184049	0.7378048780487805	32	16143	5	59	27	16084	16175	0.10800818052208383
M1	string	0	network_modules	15	TRUE	2.6016955265897044e-4	62	64	6	0.09375	0.0967741935483871	GO:0062208	GO:BP	positive regulation of pattern recognition receptor signaling pathway	16175	15864		0.7423312883435583	0.7439024390243902	62	16113	6	58	56	16055	16175	0.09171289911401885
M1	string	0	network_modules	15	TRUE	0.00027611301401868034	14	59	4	0.06779661016949153	0.2857142857142857	REAC:R-HSA-975144	REAC	IRAK1 recruits IKK complex upon TLR7/8 or 9 stimulation	10916	1155		0.7843137254901961	0.8076923076923077	14	10902	4	55	10	10847	10916	0.13700334004544462
M1	string	0	network_modules	15	TRUE	0.00027611301401868034	14	59	4	0.06779661016949153	0.2857142857142857	REAC:R-HSA-937039	REAC	IRAK1 recruits IKK complex	10916	1154		0.7843137254901961	0.8076923076923077	14	10902	4	55	10	10847	10916	0.13700334004544462
M1	string	0	network_modules	15	TRUE	2.787013899545604e-4	459	59	13	0.22033898305084745	0.02832244008714597	REAC:R-HSA-9679506	REAC	SARS-CoV Infections	10916	2112		0.8235294117647058	0.8269230769230769	459	10457	13	46	446	10411	10916	0.06548671370950121
M1	string	0	network_modules	15	TRUE	3.157800566201778e-4	290	64	10	0.15625	0.034482758620689655	GO:0050867	GO:BP	positive regulation of cell activation	16175	13315		0.7484662576687117	0.75	290	15885	10	54	280	15831	16175	0.0657005257264227
M1	string	0	network_modules	15	TRUE	3.755953550932662e-4	291	49	10	0.20408163265306123	0.03436426116838488	KEGG:04060	KEGG	Cytokine-cytokine receptor interaction	8484	253		0.7083333333333334	0.72	291	8193	10	39	281	8154	8484	0.07110158003158026
M1	string	0	network_modules	15	TRUE	3.927699874095345e-4	4	64	3	0.046875	0.75	GO:0071726	GO:BP	cellular response to diacyl bacterial lipopeptide	16175	16886		0.754601226993865	0.7682926829268293	4	16171	3	61	1	16110	16175	0.18690401528778552
M1	string	0	network_modules	15	TRUE	3.927699874095345e-4	4	64	3	0.046875	0.75	GO:0042494	GO:BP	detection of bacterial lipoprotein	16175	10222		0.754601226993865	0.7682926829268293	4	16171	3	61	1	16110	16175	0.18690401528778552
M1	string	0	network_modules	15	TRUE	3.927699874095345e-4	4	64	3	0.046875	0.75	GO:0071724	GO:BP	response to diacyl bacterial lipopeptide	16175	16884		0.754601226993865	0.7682926829268293	4	16171	3	61	1	16110	16175	0.18690401528778552
M1	string	0	network_modules	15	TRUE	4.177541533964447e-4	468	64	12	0.1875	0.02564102564102564	GO:0050865	GO:BP	regulation of cell activation	16175	13313		0.7730061349693251	0.774390243902439	468	15707	12	52	456	15655	16175	0.05962313551637189
M1	string	0	network_modules	15	TRUE	4.338134936172366e-4	231	49	9	0.1836734693877551	0.03896103896103896	KEGG:05171	KEGG	Coronavirus disease - COVID-19	8484	452		0.75	0.76	231	8253	9	40	222	8213	8484	0.073266931656177
M1	string	0	network_modules	15	TRUE	4.906946568921784e-4	15	64	4	0.0625	0.26666666666666666	GO:0007252	GO:BP	I-kappaB phosphorylation	16175	2785		0.7791411042944786	0.7804878048780488	15	16160	4	60	11	16100	16175	0.1274953999264633
M1	string	0	network_modules	15	TRUE	5.020283881051903e-4	113	64	7	0.109375	0.061946902654867256	GO:2001236	GO:BP	regulation of extrinsic apoptotic signaling pathway	16175	26425		0.7852760736196319	0.7865853658536586	113	16062	7	57	106	16005	16175	0.07747951904171248
M1	string	0	network_modules	15	TRUE	5.257984605985882e-4	105	59	7	0.11864406779661017	0.06666666666666667	REAC:R-HSA-1236975	REAC	Antigen processing-Cross presentation	10916	153		0.8431372549019608	0.8461538461538461	105	10811	7	52	98	10759	10916	0.08234434180264497
M1	string	0	network_modules	15	TRUE	5.395545796247599e-4	169	64	8	0.125	0.047337278106508875	GO:0050670	GO:BP	regulation of lymphocyte proliferation	16175	13204		0.7914110429447853	0.7926829268292683	169	16006	8	56	161	15950	16175	0.07100519119744418
M1	string	0	network_modules	15	TRUE	5.644517310900795e-4	170	64	8	0.125	0.047058823529411764	GO:0097191	GO:BP	extrinsic apoptotic signaling pathway	16175	18535		0.7975460122699386	0.7987804878048781	170	16005	8	56	162	15949	16175	0.070760046080739325
M1	string	0	network_modules	15	TRUE	5.90327231530882e-4	171	64	8	0.125	0.04678362573099415	GO:0032944	GO:BP	regulation of mononuclear cell proliferation	16175	7929		0.803680981595092	0.8048780487804879	171	16004	8	56	163	15948	16175	0.0705169469291927
M1	string	0	network_modules	15	TRUE	6.256385766090944e-4	38	64	5	0.078125	0.13157894736842105	GO:0097300	GO:BP	programmed necrotic cell death	16175	18585		0.8098159509202454	0.8109756097560976	38	16137	5	59	33	16078	16175	0.09865060681046672
M1	string	0	network_modules	15	TRUE	6.367657292524985e-4	49	49	5	0.10204081632653061	0.10204081632653061	KEGG:05144	KEGG	Malaria	8484	436		0.7916666666666666	0.8	49	8435	5	44	44	8391	8484	0.09682445592344822
M1	string	0	network_modules	15	TRUE	6.748315409572259e-4	118	64	7	0.109375	0.059322033898305086	GO:0046328	GO:BP	regulation of JNK cascade	16175	12061		0.8159509202453987	0.8170731707317073	118	16057	7	57	111	16000	16175	0.07560309831533728
M1	string	0	network_modules	15	TRUE	7.460701497423684e-4	699	64	14	0.21875	0.020028612303290415	GO:0045321	GO:BP	leukocyte activation	16175	11356		0.8220858895705522	0.823170731707317	699	15476	14	50	685	15426	16175	0.05440880710269017
M1	string	0	network_modules	15	TRUE	7.555870863369075e-4	74	64	6	0.09375	0.08108108108108109	GO:1901222	GO:BP	regulation of non-canonical NF-kappaB signal transduction	16175	21316		0.8282208588957055	0.8292682926829268	74	16101	6	58	68	16043	16175	0.08328639202867731
M1	string	0	network_modules	15	TRUE	7.679570222131536e-4	177	64	8	0.125	0.04519774011299435	GO:0002703	GO:BP	regulation of leukocyte mediated immunity	16175	1221		0.8343558282208589	0.8353658536585366	177	15998	8	56	169	15942	16175	0.06909970678537876
M1	string	0	network_modules	15	TRUE	8.243402652029899e-4	40	59	5	0.0847457627118644	0.125	REAC:R-HSA-9692916	REAC	SARS-CoV-1 activates/modulates innate immune responses	10916	2115		0.8627450980392157	0.8653846153846154	40	10876	5	54	35	10822	10916	0.0989216490675296
M1	string	0	network_modules	15	TRUE	8.505028291203743e-4	17	64	4	0.0625	0.23529411764705882	GO:0034162	GO:BP	toll-like receptor 9 signaling pathway	16175	8470		0.8404907975460123	0.8414634146341463	17	16158	4	60	13	16098	16175	0.11952797223793932
M1	string	0	network_modules	15	TRUE	0.0011325933442923163	197	49	8	0.16326530612244897	0.04060913705583756	KEGG:05130	KEGG	Pathogenic Escherichia coli infection	8484	427		0.8333333333333334	0.84	197	8287	8	41	189	8246	8484	0.07087488635340067
M1	string	0	network_modules	15	TRUE	0.0011569096446019252	334	64	10	0.15625	0.029940119760479042	GO:0002443	GO:BP	leukocyte mediated immunity	16175	966		0.8466257668711656	0.8536585365853658	334	15841	10	54	324	15787	16175	0.06009950696702294
M1	string	0	network_modules	15	TRUE	0.0011569096446019252	334	64	10	0.15625	0.029940119760479042	GO:0002250	GO:BP	adaptive immune response	16175	782		0.8466257668711656	0.8536585365853658	334	15841	10	54	324	15787	16175	0.06009950696702294
M1	string	0	network_modules	15	TRUE	0.0011822790358094414	292	59	10	0.1694915254237288	0.03424657534246575	REAC:R-HSA-9694516	REAC	SARS-CoV-2 Infection	10916	2122		0.8823529411764706	0.8846153846153846	292	10624	10	49	282	10575	10916	0.06521542470778877
M1	string	0	network_modules	15	TRUE	0.0012374835222723278	56	49	5	0.10204081632653061	0.08928571428571429	KEGG:05134	KEGG	Legionellosis	8484	431		0.875	0.88	56	8428	5	44	51	8384	8484	0.08983199013670044
M1	string	0	network_modules	15	TRUE	0.001315095304020382	190	64	8	0.125	0.042105263157894736	GO:0070663	GO:BP	regulation of leukocyte proliferation	16175	16244		0.8588957055214724	0.8597560975609756	190	15985	8	56	182	15929	16175	0.0662508497735359
M1	string	0	network_modules	15	TRUE	0.0013769021676332293	19	64	4	0.0625	0.21052631578947367	GO:0098543	GO:BP	detection of other organism	16175	18795		0.8650306748466258	0.8719512195121951	19	16156	4	60	15	16096	16175	0.11284162311640503
M1	string	0	network_modules	15	TRUE	0.0013769021676332293	19	64	4	0.0625	0.21052631578947367	GO:1900017	GO:BP	positive regulation of cytokine production involved in inflammatory response	16175	20328		0.8650306748466258	0.8719512195121951	19	16156	4	60	15	16096	16175	0.11284162311640503
M1	string	0	network_modules	15	TRUE	0.001423433648971946	192	64	8	0.125	0.041666666666666664	GO:0002699	GO:BP	positive regulation of immune effector process	16175	1217		0.8773006134969326	0.8780487804878049	192	15983	8	56	184	15927	16175	0.06583705529554615
M1	string	0	network_modules	15	TRUE	0.0014993419029798029	45	59	5	0.0847457627118644	0.1111111111111111	REAC:R-HSA-6783783	REAC	Interleukin-10 signaling	10916	1234		0.9019607843137255	0.9038461538461539	45	10871	5	54	40	10817	10916	0.09275868340017092
M1	string	0	network_modules	15	TRUE	0.001574833618331465	434	64	11	0.171875	0.02534562211981567	GO:0002521	GO:BP	leukocyte differentiation	16175	1043		0.8834355828220859	0.8841463414634146	434	15741	11	53	423	15688	16175	0.05657312695678187
M1	string	0	network_modules	15	TRUE	0.0016973647327430711	638	64	13	0.203125	0.02037617554858934	GO:0030097	GO:BP	hemopoiesis	16175	6675		0.8895705521472392	0.8902439024390244	638	15537	13	51	625	15486	16175	0.053000317833855747
M1	string	0	network_modules	15	TRUE	0.0017562845229330145	101	49	6	0.12244897959183673	0.0594059405940594	KEGG:05146	KEGG	Amoebiasis	8484	438		0.9166666666666666	0.92	101	8383	6	43	95	8340	8484	0.07768403352269135
M1	string	0	network_modules	15	TRUE	0.0019289461992494288	7	59	3	0.05084745762711865	0.42857142857142855	REAC:R-HSA-5688890	REAC	Defective CSF2RA causes SMDP4	10916	511		0.9215686274509803	0.9423076923076923	7	10909	3	56	4	10853	10916	0.1462010358528673
M1	string	0	network_modules	15	TRUE	0.0019289461992494288	7	59	3	0.05084745762711865	0.42857142857142855	REAC:R-HSA-5688849	REAC	Defective CSF2RB causes SMDP5	10916	512		0.9215686274509803	0.9423076923076923	7	10909	3	56	4	10853	10916	0.1462010358528673
M1	string	0	network_modules	15	TRUE	0.0019527566564887988	6	64	3	0.046875	0.5	GO:0070391	GO:BP	response to lipoteichoic acid	16175	16092		0.8957055214723927	0.9024390243902439	6	16169	3	61	3	16108	16175	0.152211219610155
M1	string	0	network_modules	15	TRUE	0.0019527566564887988	6	64	3	0.046875	0.5	GO:0071223	GO:BP	cellular response to lipoteichoic acid	16175	16485		0.8957055214723927	0.9024390243902439	6	16169	3	61	3	16108	16175	0.152211219610155
M1	string	0	network_modules	15	TRUE	0.0022528374183424476	141	64	7	0.109375	0.04964539007092199	GO:0007254	GO:BP	JNK cascade	16175	2787		0.9079754601226994	0.9085365853658537	141	16034	7	57	134	15977	16175	0.0682480355329358
M1	string	0	network_modules	15	TRUE	0.00257210268941012	108	49	6	0.12244897959183673	0.05555555555555555	KEGG:05145	KEGG	Toxoplasmosis	8484	437		0.9583333333333334	0.96	108	8376	6	43	102	8333	8484	0.0745947598449119
M1	string	0	network_modules	15	TRUE	0.00259982258888012	208	64	8	0.125	0.038461538461538464	GO:0046651	GO:BP	lymphocyte proliferation	16175	12287		0.9141104294478528	0.9146341463414634	208	15967	8	56	200	15911	16175	0.06273252424944004
M1	string	0	network_modules	15	TRUE	0.0028514253421249008	369	64	10	0.15625	0.02710027100271003	GO:0051249	GO:BP	regulation of lymphocyte activation	16175	13596		0.9202453987730062	0.9207317073170732	369	15806	10	54	359	15752	16175	0.056328110117952884
M1	string	0	network_modules	15	TRUE	0.0028941355885761643	211	64	8	0.125	0.037914691943127965	GO:0032943	GO:BP	mononuclear cell proliferation	16175	7928		0.9263803680981595	0.926829268292683	211	15964	8	56	203	15908	16175	0.06218779010767372
M1	string	0	network_modules	15	TRUE	0.0033754917793095526	376	64	10	0.15625	0.026595744680851064	GO:0043410	GO:BP	positive regulation of MAPK cascade	16175	10678		0.9325153374233128	0.9329268292682927	376	15799	10	54	366	15745	16175	0.05563265996133214
M1	string	0	network_modules	15	TRUE	0.004064584854218986	154	64	7	0.109375	0.045454545454545456	GO:0002819	GO:BP	regulation of adaptive immune response	16175	1329		0.9386503067484663	0.9390243902439024	154	16021	7	57	147	15964	16175	0.06480878930322284
M1	string	0	network_modules	15	TRUE	0.004507566336031458	56	64	5	0.078125	0.08928571428571429	GO:0002720	GO:BP	positive regulation of cytokine production involved in immune response	16175	1238		0.9447852760736196	0.9451219512195121	56	16119	5	59	51	16060	16175	0.0801151461565336
M1	string	0	network_modules	15	TRUE	0.004593934825857089	9	59	3	0.05084745762711865	0.3333333333333333	REAC:R-HSA-5687613	REAC	Diseases associated with surfactant metabolism	10916	752		0.9607843137254902	0.9615384615384616	9	10907	3	56	6	10851	10916	0.12847844188221952
M1	string	0	network_modules	15	TRUE	0.005155843885362064	228	64	8	0.125	0.03508771929824561	GO:0001818	GO:BP	negative regulation of cytokine production	16175	475		0.950920245398773	0.9512195121951219	228	15947	8	56	220	15891	16175	0.05929444317154776
M1	string	0	network_modules	15	TRUE	0.005329595586189016	58	59	5	0.0847457627118644	0.08620689655172414	REAC:R-HSA-5218859	REAC	Regulated Necrosis	10916	1959		0.9803921568627451	0.9807692307692307	58	10858	5	54	53	10804	10916	0.08054595171283417
M1	string	0	network_modules	15	TRUE	0.005436841548620464	8	64	3	0.046875	0.375	GO:0097527	GO:BP	necroptotic signaling pathway	16175	18687		0.9570552147239264	0.9573170731707317	8	16167	3	61	5	16106	16175	0.1314764273654694
M1	string	0	network_modules	15	TRUE	0.005643373946704115	104	64	6	0.09375	0.057692307692307696	GO:0009612	GO:BP	response to mechanical stimulus	16175	3540		0.9631901840490797	0.9634146341463414	104	16071	6	58	98	16013	16175	0.06885734111177151
M1	string	0	network_modules	15	TRUE	0.0061667449037680466	29	59	4	0.06779661016949153	0.13793103448275862	REAC:R-HSA-5683826	REAC	Surfactant metabolism	10916	2364		1	1	29	10887	4	55	25	10832	10916	0.09328868835665488
M1	string	0	network_modules	15	TRUE	0.006656057565314169	236	64	8	0.125	0.03389830508474576	GO:0070661	GO:BP	leukocyte proliferation	16175	16242		0.9693251533742331	0.9695121951219512	236	15939	8	56	228	15883	16175	0.05803543701731802
M1	string	0	network_modules	15	TRUE	0.008132207535439761	9	64	3	0.046875	0.3333333333333333	GO:0032621	GO:BP	interleukin-18 production	16175	7668		0.9754601226993865	0.9817073170731707	9	16166	3	61	6	16105	16175	0.12379576172112529
M1	string	0	network_modules	15	TRUE	0.008132207535439761	9	64	3	0.046875	0.3333333333333333	GO:0032661	GO:BP	regulation of interleukin-18 production	16175	7707		0.9754601226993865	0.9817073170731707	9	16166	3	61	6	16105	16175	0.12379576172112529
M1	string	0	network_modules	15	TRUE	0.008781168955809488	64	64	5	0.078125	0.078125	GO:0070534	GO:BP	protein K63-linked ubiquitination	16175	16168		0.9877300613496932	0.9878048780487805	64	16111	5	59	59	16052	16175	0.07446290577866053
M1	string	0	network_modules	15	TRUE	0.009349153165813332	136	49	6	0.12244897959183673	0.04411764705882353	KEGG:05135	KEGG	Yersinia infection	8484	432		1	1	136	8348	6	43	130	8305	8484	0.06458235245564399
M1	string	0	network_modules	15	TRUE	0.00959305640075203	248	64	8	0.125	0.03225806451612903	GO:0000209	GO:BP	protein polyubiquitination	16175	59		0.9938650306748467	0.9939024390243902	248	15927	8	56	240	15871	16175	0.05625471396316564
M1	string	0	network_modules	15	TRUE	0.009880879129403794	249	64	8	0.125	0.0321285140562249	GO:0051251	GO:BP	positive regulation of lymphocyte activation	16175	13598		1	1	249	15926	8	56	241	15870	16175	0.0561117514520189
M1	string	0	network_modules	16	TRUE	4.050507631529421e-23	44	63	15	0.23809523809523808	0.3409090909090909	GO:0140467	GO:BP	integrated stress response signaling	16175	19788		0	0.5	44	16131	15	48	29	16083	16175	0.2825811379352469
M1	string	0	network_modules	16	TRUE	1.433744200864681e-8	791	63	20	0.31746031746031744	0.025284450063211124	GO:0000122	GO:BP	negative regulation of transcription by RNA polymerase II	16175	48		1	1	791	15384	20	43	771	15341	16175	0.07786719898803789
M1	string	0	network_modules	16	TRUE	1.9035487851054024e-7	15	33	5	0.15151515151515152	0.3333333333333333	REAC:R-HSA-9648895	REAC	Response of EIF2AK1 (HRI) to heme deficiency	10916	2086		0	0.1	15	10901	5	28	10	10873	10916	0.22318589796482674
M1	string	0	network_modules	16	TRUE	5.054943597423924e-7	39	33	6	0.18181818181818182	0.15384615384615385	REAC:R-HSA-9031628	REAC	NGF-stimulated transcription	10916	1527		0.1111111111111111	0.2	39	10877	6	27	33	10850	10916	0.16450448915971672
M1	string	0	network_modules	16	TRUE	8.20957468240081e-6	61	33	6	0.18181818181818182	0.09836065573770492	REAC:R-HSA-198725	REAC	Nuclear Events (kinase and transcription factor activation)	10916	1614		0.2222222222222222	0.3	61	10855	6	27	55	10828	10916	0.13018061712192078
M1	string	0	network_modules	16	TRUE	8.827616172690233e-5	5	33	3	0.09090909090909091	0.6	REAC:R-HSA-9818035	REAC	NFE2L2 regulating ER-stress associated genes	10916	1518		0.3333333333333333	0.4	5	10911	3	30	2	10881	10916	0.2327783062501337
M1	string	0	network_modules	16	TRUE	1.8594460915421427e-4	192	29	7	0.2413793103448276	0.036458333333333336	KEGG:05202	KEGG	Transcriptional misregulation in cancer	8484	454		0	0.5	192	8292	7	22	185	8270	8484	0.08614054743744141
M1	string	0	network_modules	16	TRUE	2.98783453205014e-4	132	29	6	0.20689655172413793	0.045454545454545456	KEGG:04380	KEGG	Osteoclast differentiation	8484	309		1	1	132	8352	6	23	126	8329	8484	0.09054438866688926
M1	string	0	network_modules	16	TRUE	3.173213930667053e-4	112	33	6	0.18181818181818182	0.05357142857142857	REAC:R-HSA-187037	REAC	Signaling by NTRK1 (TRKA)	10916	2284		0.4444444444444444	0.5	112	10804	6	27	106	10777	10916	0.09374667895498025
M1	string	0	network_modules	16	TRUE	4.0722417962493556e-4	27	33	4	0.12121212121212122	0.14814814814814814	REAC:R-HSA-380994	REAC	ATF4 activates genes in response to endoplasmic reticulum  stress	10916	35		0.5555555555555556	0.6	27	10889	4	29	23	10860	10916	0.131632323181112
M1	string	0	network_modules	16	TRUE	7.96027957376625e-4	131	33	6	0.18181818181818182	0.04580152671755725	REAC:R-HSA-166520	REAC	Signaling by NTRKs	10916	2287		0.6666666666666666	0.7	131	10785	6	27	125	10758	10916	0.08587816820436958
M1	string	0	network_modules	16	TRUE	8.255739208932432e-4	32	33	4	0.12121212121212122	0.125	REAC:R-HSA-381042	REAC	PERK regulates gene expression	10916	1664		0.7777777777777778	0.8	32	10884	4	29	28	10855	10916	0.12047324512294029
M1	string	0	network_modules	16	TRUE	0.0026431772758740944	92	33	5	0.15151515151515152	0.05434782608695652	REAC:R-HSA-381119	REAC	Unfolded Protein Response (UPR)	10916	2624		0.8888888888888888	0.9	92	10824	5	28	87	10796	10916	0.08619042622010237
M1	string	0	network_modules	16	TRUE	0.00701273281313859	18	33	3	0.09090909090909091	0.16666666666666666	REAC:R-HSA-9818027	REAC	NFE2L2 regulating anti-oxidant/detoxification enzymes	10916	1521		1	1	18	10898	3	30	15	10868	10916	0.12114181287988735
M1	string	0	network_modules	17	TRUE	1.7585385523242377e-27	141	34	20	0.5882352941176471	0.14184397163120568	REAC:R-HSA-3214847	REAC	HATs acetylate histones	10916	1087		0	0.25	141	10775	20	14	121	10761	10916	0.2847991897548295
M1	string	0	network_modules	17	TRUE	3.77224485929538e-27	271	34	23	0.6764705882352942	0.08487084870848709	REAC:R-HSA-4839726	REAC	Chromatin organization	10916	356		0.3333333333333333	0.75	271	10645	23	11	248	10634	10916	0.23410030359094416
M1	string	0	network_modules	17	TRUE	3.77224485929538e-27	271	34	23	0.6764705882352942	0.08487084870848709	REAC:R-HSA-3247509	REAC	Chromatin modifying enzymes	10916	355		0.3333333333333333	0.75	271	10645	23	11	248	10634	10916	0.23410030359094416
M1	string	0	network_modules	17	TRUE	2.1092770987882757e-23	116	24	16	0.6666666666666666	0.13793103448275862	KEGG:03082	KEGG	ATP-dependent chromatin remodeling	8484	219		NA	1	116	8368	16	8	100	8360	8484	0.2994955498632734
M1	string	0	network_modules	17	TRUE	2.1143856376816222e-20	36	60	13	0.21666666666666667	0.3611111111111111	GO:1905168	GO:BP	positive regulation of double-strand break repair via homologous recombination	16175	24413		0	0.041666666666666664	36	16139	13	47	23	16092	16175	0.2776662161573279
M1	string	0	network_modules	17	TRUE	2.1163677257373504e-17	57	60	13	0.21666666666666667	0.22807017543859648	GO:0045911	GO:BP	positive regulation of DNA recombination	16175	11705		0.043478260869565216	0.08333333333333333	57	16118	13	47	44	16071	16175	0.21947357567274295
M1	string	0	network_modules	17	TRUE	4.835725889049405e-16	71	60	13	0.21666666666666667	0.18309859154929578	GO:0010569	GO:BP	regulation of double-strand break repair via homologous recombination	16175	4222		0.08695652173913043	0.125	71	16104	13	47	58	16057	16175	0.19593499366060854
M1	string	0	network_modules	17	TRUE	3.1022069054280692e-15	435	60	21	0.35	0.04827586206896552	GO:0051052	GO:BP	regulation of DNA metabolic process	16175	13462		0.13043478260869565	0.16666666666666666	435	15740	21	39	414	15701	16175	0.12187192145092807
M1	string	0	network_modules	17	TRUE	5.027839037770049e-15	84	60	13	0.21666666666666667	0.15476190476190477	GO:2000781	GO:BP	positive regulation of double-strand break repair	16175	26037		0.17391304347826086	0.20833333333333334	84	16091	13	47	71	16044	16175	0.179526880737986
M1	string	0	network_modules	17	TRUE	2.851096147403594e-13	113	60	13	0.21666666666666667	0.11504424778761062	GO:0000018	GO:BP	regulation of DNA recombination	16175	6		0.21739130434782608	0.25	113	16062	13	47	100	16015	16175	0.15361157079213364
M1	string	0	network_modules	17	TRUE	6.474852064424889e-13	246	60	16	0.26666666666666666	0.06504065040650407	GO:0051054	GO:BP	positive regulation of DNA metabolic process	16175	13464		0.2608695652173913	0.2916666666666667	246	15929	16	44	230	15885	16175	0.12537427265365428
M1	string	0	network_modules	17	TRUE	1.3597821743780114e-12	127	60	13	0.21666666666666667	0.10236220472440945	GO:0045739	GO:BP	positive regulation of DNA repair	16175	11579		0.30434782608695654	0.3333333333333333	127	16048	13	47	114	16001	16175	0.14436244367102014
M1	string	0	network_modules	17	TRUE	1.5093893580181934e-12	128	60	13	0.21666666666666667	0.1015625	GO:2000779	GO:BP	regulation of double-strand break repair	16175	26035		0.34782608695652173	0.375	128	16047	13	47	115	16000	16175	0.14375932720950835
M1	string	0	network_modules	17	TRUE	3.2813756543526614e-11	207	60	14	0.23333333333333334	0.06763285024154589	GO:0006282	GO:BP	regulation of DNA repair	16175	2096		0.391304347826087	0.4166666666666667	207	15968	14	46	193	15922	16175	0.11972185483011742
M1	string	0	network_modules	17	TRUE	7.358211257950945e-11	172	60	13	0.21666666666666667	0.0755813953488372	GO:0000724	GO:BP	double-strand break repair via homologous recombination	16175	203		0.43478260869565216	0.4583333333333333	172	16003	13	47	159	15956	16175	0.1225678483487935
M1	string	0	network_modules	17	TRUE	9.920637211402261e-11	176	60	13	0.21666666666666667	0.07386363636363637	GO:0000725	GO:BP	recombinational repair	16175	204		0.4782608695652174	0.5	176	15999	13	47	163	15952	16175	0.12103672147808736
M1	string	0	network_modules	17	TRUE	4.824178636926113e-9	437	60	16	0.26666666666666666	0.036613272311212815	GO:0080135	GO:BP	regulation of cellular response to stress	16175	17817		0.5217391304347826	0.5416666666666666	437	15738	16	44	421	15694	16175	0.09019160118618684
M1	string	0	network_modules	17	TRUE	3.876258173658366e-8	281	60	13	0.21666666666666667	0.046263345195729534	GO:0006310	GO:BP	DNA recombination	16175	2115		0.5652173913043478	0.5833333333333334	281	15894	13	47	268	15847	16175	0.09307426336330406
M1	string	0	network_modules	17	TRUE	8.070868641855124e-8	298	60	13	0.21666666666666667	0.0436241610738255	GO:0006302	GO:BP	double-strand break repair	16175	2109		0.6086956521739131	0.625	298	15877	13	47	285	15830	16175	0.08995196330686073
M1	string	0	network_modules	17	TRUE	8.966566407319376e-7	528	60	15	0.25	0.028409090909090908	GO:0006281	GO:BP	DNA repair	16175	2095		0.6521739130434783	0.6666666666666666	528	15647	15	45	513	15602	16175	0.07463558705356002
M1	string	0	network_modules	17	TRUE	9.203552056672925e-7	529	60	15	0.25	0.02835538752362949	GO:0006325	GO:BP	chromatin organization	16175	2122		0.6956521739130435	0.7083333333333334	529	15646	15	45	514	15601	16175	0.07454618296372359
M1	string	0	network_modules	17	TRUE	1.0308875265620818e-5	30	34	5	0.14705882352941177	0.16666666666666666	REAC:R-HSA-6804758	REAC	Regulation of TP53 Activity through Acetylation	10916	2013		1	1	30	10886	5	29	25	10857	10916	0.15408201762582888
M1	string	0	network_modules	17	TRUE	1.2162999537976553e-5	112	60	8	0.13333333333333333	0.07142857142857142	GO:0006275	GO:BP	regulation of DNA replication	16175	2090		0.7391304347826086	0.75	112	16063	8	52	104	16011	16175	0.09301663969013897
M1	string	0	network_modules	17	TRUE	1.3732404459229556e-5	454	60	13	0.21666666666666667	0.028634361233480177	GO:0006338	GO:BP	chromatin remodeling	16175	2126		0.782608695652174	0.7916666666666666	454	15721	13	47	441	15674	16175	0.06967473942495986
M1	string	0	network_modules	17	TRUE	3.223618614985032e-5	798	60	16	0.26666666666666666	0.020050125313283207	GO:0006974	GO:BP	DNA damage response	16175	2601		0.8260869565217391	0.8333333333333334	798	15377	16	44	782	15333	16175	0.06123359108671381
M1	string	0	network_modules	17	TRUE	4.147155900178294e-5	85	60	7	0.11666666666666667	0.08235294117647059	GO:2000278	GO:BP	regulation of DNA biosynthetic process	16175	25603		0.8695652173913043	0.875	85	16090	7	53	78	16037	16175	0.09402597714914528
M1	string	0	network_modules	17	TRUE	7.582265139716888e-5	3	60	3	0.05	1	GO:0140889	GO:BP	DNA replication-dependent chromatin disassembly	16175	19924		0.9130434782608695	0.9166666666666666	3	16172	3	57	0	16115	16175	0.22321238648003008
M1	string	0	network_modules	17	TRUE	0.0012882826475122489	140	60	7	0.11666666666666667	0.05	GO:0071897	GO:BP	DNA biosynthetic process	16175	16970		0.9565217391304348	0.9583333333333334	140	16035	7	53	133	15982	16175	0.07115011247978201
M1	string	0	network_modules	17	TRUE	0.0032333252321220347	231	60	8	0.13333333333333333	0.03463203463203463	GO:0006260	GO:BP	DNA replication	16175	2077		1	1	231	15944	8	52	223	15892	16175	0.06122614987973502
M1	string	0	network_modules	18	TRUE	4.408284763705883e-28	215	48	25	0.5208333333333334	0.11627906976744186	REAC:R-HSA-6805567	REAC	Keratinization	10916	1288		NA	1	215	10701	25	23	190	10678	10916	0.23968165699433677
M1	string	0	network_modules	19	TRUE	9.203063294330715e-5	389	55	11	0.2	0.028277634961439587	GO:0007264	GO:BP	small GTPase-mediated signal transduction	16175	2792		0	0.16666666666666666	389	15786	11	44	378	15742	16175	0.06708460575817908
M1	string	0	network_modules	19	TRUE	4.1055853810092465e-4	155	39	7	0.1794871794871795	0.04516129032258064	REAC:R-HSA-9013148	REAC	CDC42 GTPase cycle	10916	269		NA	1	155	10761	7	32	148	10729	10916	0.08365463397248507
M1	string	0	network_modules	19	TRUE	0.0018964676757266105	7	55	3	0.05454545454545454	0.42857142857142855	GO:0032483	GO:BP	regulation of Rab protein signal transduction	16175	7594		0.2	0.3333333333333333	7	16168	3	52	4	16116	16175	0.15197251552821844
M1	string	0	network_modules	19	TRUE	0.0021832519657180474	242	55	8	0.14545454545454545	0.03305785123966942	GO:0051056	GO:BP	regulation of small GTPase mediated signal transduction	16175	13466		0.4	0.5	242	15933	8	47	234	15886	16175	0.06278768729337718
M1	string	0	network_modules	19	TRUE	0.003027033996657966	8	55	3	0.05454545454545454	0.375	GO:0032482	GO:BP	Rab protein signal transduction	16175	7593		0.6	0.6666666666666666	8	16167	3	52	5	16115	16175	0.14199924793309887
M1	string	0	network_modules	19	TRUE	0.003991878180658119	183	55	7	0.12727272727272726	0.03825136612021858	GO:0043087	GO:BP	regulation of GTPase activity	16175	10520		0.8	0.8333333333333334	183	15992	7	48	176	15944	16175	0.06404283291634316
M1	string	0	network_modules	19	TRUE	0.00647406580383541	127	55	6	0.10909090909090909	0.047244094488188976	GO:0043547	GO:BP	positive regulation of GTPase activity	16175	10762		1	1	127	16048	6	49	121	15999	16175	0.06700078199319626
M1	string	0	network_modules	20	TRUE	2.0298671877211588e-97	291	63	59	0.9365079365079365	0.2027491408934708	GO:0000375	GO:BP	RNA splicing, via transesterification reactions	16175	107		0	0.037037037037037035	291	15884	59	4	232	15880	16175	0.4321163527332173
M1	string	0	network_modules	20	TRUE	4.133844958061194e-96	202	60	57	0.95	0.28217821782178215	REAC:R-HSA-72163	REAC	mRNA Splicing - Major Pathway	10916	2707		0	0.07692307692307693	202	10714	57	3	145	10711	10916	0.5138463571098617
M1	string	0	network_modules	20	TRUE	3.984875545773031e-95	209	60	57	0.95	0.2727272727272727	REAC:R-HSA-72172	REAC	mRNA Splicing	10916	2706		0.08333333333333333	0.15384615384615385	209	10707	57	3	152	10704	10916	0.5049852150249827
M1	string	0	network_modules	20	TRUE	6.684996451417677e-95	287	63	58	0.9206349206349206	0.20209059233449478	GO:0000377	GO:BP	RNA splicing, via transesterification reactions with bulged adenosine as nucleophile	16175	109		0.038461538461538464	0.1111111111111111	287	15888	58	5	229	15883	16175	0.42766118296748024
M1	string	0	network_modules	20	TRUE	6.684996451417677e-95	287	63	58	0.9206349206349206	0.20209059233449478	GO:0000398	GO:BP	mRNA splicing, via spliceosome	16175	121		0.038461538461538464	0.1111111111111111	287	15888	58	5	229	15883	16175	0.42766118296748024
M1	string	0	network_modules	20	TRUE	3.058871163878474e-89	352	63	58	0.9206349206349206	0.16477272727272727	GO:0006397	GO:BP	mRNA processing	16175	2158		0.11538461538461539	0.14814814814814814	352	15823	58	5	294	15818	16175	0.38523203887805296
M1	string	0	network_modules	20	TRUE	1.0668948657785525e-88	397	63	59	0.9365079365079365	0.1486146095717884	GO:0008380	GO:BP	RNA splicing	16175	3186		0.15384615384615385	0.18518518518518517	397	15778	59	4	338	15774	16175	0.36854985885846325
M1	string	0	network_modules	20	TRUE	2.7339339075025207e-87	276	60	57	0.95	0.20652173913043478	REAC:R-HSA-72203	REAC	Processing of Capped Intron-Containing Pre-mRNA	10916	1796		0.16666666666666666	0.23076923076923078	276	10640	57	3	219	10637	10916	0.4379124153752465
M1	string	0	network_modules	20	TRUE	2.2811468390304577e-80	174	52	49	0.9423076923076923	0.28160919540229884	KEGG:03040	KEGG	Spliceosome	8484	215		NA	1	174	8310	49	3	125	8307	8484	0.5107376725823657
M1	string	0	network_modules	20	TRUE	2.319543171180139e-75	590	63	58	0.9206349206349206	0.09830508474576272	GO:0016071	GO:BP	mRNA metabolic process	16175	5098		0.19230769230769232	0.2222222222222222	590	15585	58	5	532	15580	16175	0.2949108427054072
M1	string	0	network_modules	20	TRUE	5.0176216798081165e-48	73	63	28	0.4444444444444444	0.3835616438356164	GO:0000245	GO:BP	spliceosomal complex assembly	16175	69		0.23076923076923078	0.25925925925925924	73	16102	28	35	45	16067	16175	0.41041513223448844
M1	string	0	network_modules	20	TRUE	6.697243661332284e-47	188	63	34	0.5396825396825397	0.18085106382978725	GO:0071826	GO:BP	protein-RNA complex organization	16175	16929		0.2692307692307692	0.2962962962962963	188	15987	34	29	154	15958	16175	0.3080778119195635
M1	string	0	network_modules	20	TRUE	1.0959927135083452e-45	178	63	33	0.5238095238095238	0.1853932584269663	GO:0022618	GO:BP	protein-RNA complex assembly	16175	6625		0.3076923076923077	0.3333333333333333	178	15997	33	30	145	15967	16175	0.30737087911931493
M1	string	0	network_modules	20	TRUE	1.8695793675695622e-42	25	63	20	0.31746031746031744	0.8	GO:1903241	GO:BP	U2-type prespliceosome assembly	16175	22851		0.34615384615384615	0.37037037037037035	25	16150	20	43	5	16107	16175	0.5028673460089458
M1	string	0	network_modules	20	TRUE	7.6216808845455195e-34	390	63	33	0.5238095238095238	0.08461538461538462	GO:0022613	GO:BP	ribonucleoprotein complex biogenesis	16175	6620		0.38461538461538464	0.4074074074074074	390	15785	33	30	357	15755	16175	0.2037009533097072
M1	string	0	network_modules	20	TRUE	3.274838062832969e-27	48	60	18	0.3	0.375	REAC:R-HSA-72165	REAC	mRNA Splicing - Minor Pathway	10916	2708		0.25	0.3076923076923077	48	10868	18	42	30	10826	10916	0.3321370489136656
M1	string	0	network_modules	20	TRUE	8.853403582780246e-22	39	63	14	0.2222222222222222	0.358974358974359	GO:0000387	GO:BP	spliceosomal snRNP assembly	16175	114		0.4230769230769231	0.4444444444444444	39	16136	14	49	25	16087	16175	0.28025876182306986
M1	string	0	network_modules	20	TRUE	1.2399442874918594e-13	8	63	7	0.1111111111111111	0.875	GO:0036261	GO:BP	7-methylguanosine cap hypermethylation	16175	9522		0.46153846153846156	0.48148148148148145	8	16167	7	56	1	16111	16175	0.3111000772574001
M1	string	0	network_modules	20	TRUE	5.223361078561692e-11	14	63	7	0.1111111111111111	0.5	GO:0036260	GO:BP	RNA capping	16175	9521		0.5	0.5185185185185185	14	16161	7	56	7	16105	16175	0.23442443759072612
M1	string	0	network_modules	20	TRUE	2.488629757663214e-8	65	60	9	0.15	0.13846153846153847	REAC:R-HSA-73856	REAC	RNA Polymerase II Transcription Termination	10916	1895		0.3333333333333333	0.38461538461538464	65	10851	9	51	56	10800	10916	0.13919132946380938
M1	string	0	network_modules	20	TRUE	7.894775008389208e-8	18	63	6	0.09523809523809523	0.3333333333333333	GO:0045292	GO:BP	mRNA cis splicing, via spliceosome	16175	11346		0.5384615384615384	0.5555555555555556	18	16157	6	57	12	16100	16175	0.176534439349913
M1	string	0	network_modules	20	TRUE	9.602376552793275e-8	35	63	7	0.1111111111111111	0.2	GO:0000966	GO:BP	RNA 5'-end processing	16175	274		0.5769230769230769	0.5925925925925926	35	16140	7	56	28	16084	16175	0.14661230926415983
M1	string	0	network_modules	20	TRUE	4.2109804557058594e-7	10	60	5	0.08333333333333333	0.5	REAC:R-HSA-111367	REAC	SLBP independent Processing of Histone Pre-mRNAs	10916	2144		0.4166666666666667	0.46153846153846156	10	10906	5	55	5	10851	10916	0.20253010647487216
M1	string	0	network_modules	20	TRUE	7.687708098289659e-7	11	60	5	0.08333333333333333	0.45454545454545453	REAC:R-HSA-77588	REAC	SLBP Dependent Processing of Replication-Dependent Histone Pre-mRNAs	10916	2143		0.5	0.5384615384615384	11	10905	5	55	6	10850	10916	0.19289908316221124
M1	string	0	network_modules	20	TRUE	2.1335258596014775e-6	175	63	10	0.15873015873015872	0.05714285714285714	GO:0043484	GO:BP	regulation of RNA splicing	16175	10730		0.6153846153846154	0.6296296296296297	175	16000	10	53	165	15947	16175	0.0894048904847465
M1	string	0	network_modules	20	TRUE	4.086729462008853e-6	51	60	7	0.11666666666666667	0.13725490196078433	REAC:R-HSA-194441	REAC	Metabolism of non-coding RNA	10916	1431		0.5833333333333334	0.7692307692307693	51	10865	7	53	44	10812	10916	0.12209600776393416
M1	string	0	network_modules	20	TRUE	4.086729462008853e-6	51	60	7	0.11666666666666667	0.13725490196078433	REAC:R-HSA-9754678	REAC	SARS-CoV-2 modulates host translation machinery	10916	2125		0.5833333333333334	0.7692307692307693	51	10865	7	53	44	10812	10916	0.12209600776393416
M1	string	0	network_modules	20	TRUE	4.086729462008853e-6	51	60	7	0.11666666666666667	0.13725490196078433	REAC:R-HSA-191859	REAC	snRNP Assembly	10916	2736		0.5833333333333334	0.7692307692307693	51	10865	7	53	44	10812	10916	0.12209600776393416
M1	string	0	network_modules	20	TRUE	5.025253641779099e-6	6	63	4	0.06349206349206349	0.6666666666666666	GO:0000389	GO:BP	mRNA 3'-splice site recognition	16175	116		0.6538461538461539	0.6666666666666666	6	16169	4	59	2	16110	16175	0.2049733186457158
M1	string	0	network_modules	20	TRUE	2.073127044151387e-5	73	63	7	0.1111111111111111	0.0958904109589041	GO:0001510	GO:BP	RNA methylation	16175	324		0.6923076923076923	0.7037037037037037	73	16102	7	56	66	16046	16175	0.09944602879338556
M1	string	0	network_modules	20	TRUE	1.522509654169835e-4	28	60	5	0.08333333333333333	0.17857142857142858	REAC:R-HSA-75067	REAC	Processing of Capped Intronless Pre-mRNA	10916	1797		0.8333333333333334	0.8461538461538461	28	10888	5	55	23	10833	10916	0.11871129912678265
M1	string	0	network_modules	20	TRUE	1.6257912529566706e-4	30	63	5	0.07936507936507936	0.16666666666666666	GO:0006376	GO:BP	mRNA splice site recognition	16175	2146		0.7307692307692307	0.7407407407407407	30	16145	5	58	25	16087	16175	0.11264708792303967
M1	string	0	network_modules	20	TRUE	1.6315623170996368e-4	98	63	7	0.1111111111111111	0.07142857142857142	GO:0048024	GO:BP	regulation of mRNA splicing, via spliceosome	16175	12475		0.7692307692307693	0.7777777777777778	98	16077	7	56	91	16021	16175	0.08465062782722972
M1	string	0	network_modules	20	TRUE	3.276038271508566e-4	14	63	4	0.06349206349206349	0.2857142857142857	GO:0000244	GO:BP	spliceosomal tri-snRNP complex assembly	16175	68		0.8076923076923077	0.8148148148148148	14	16161	4	59	10	16102	16175	0.13316805460211104
M1	string	0	network_modules	20	TRUE	3.622996499435227e-4	4	63	3	0.047619047619047616	0.75	GO:0000393	GO:BP	spliceosomal conformational changes to generate catalytic conformation	16175	118		0.8461538461538461	0.8518518518518519	4	16171	3	60	1	16111	16175	0.18839130477637522
M1	string	0	network_modules	20	TRUE	4.622510245773188e-4	114	63	7	0.1111111111111111	0.06140350877192982	GO:0043414	GO:BP	macromolecule methylation	16175	10681		0.8846153846153846	0.8888888888888888	114	16061	7	56	107	16005	16175	0.07778543550022549
M1	string	0	network_modules	20	TRUE	6.198264308476591e-4	119	63	7	0.1111111111111111	0.058823529411764705	GO:0050684	GO:BP	regulation of mRNA processing	16175	13215		0.9230769230769231	0.9259259259259259	119	16056	7	56	112	16000	16175	0.0759194153918512
M1	string	0	network_modules	20	TRUE	8.663887811916715e-4	125	63	7	0.1111111111111111	0.056	GO:0032259	GO:BP	methylation	16175	7445		0.9615384615384616	0.9629629629629629	125	16050	7	56	118	15994	16175	0.0738239049603694
M1	string	0	network_modules	20	TRUE	0.0036398715729970364	52	60	5	0.08333333333333333	0.09615384615384616	REAC:R-HSA-6781823	REAC	Formation of TC-NER Pre-Incision Complex	10916	951		0.9166666666666666	0.9230769230769231	52	10864	5	55	47	10809	10916	0.08483258268356408
M1	string	0	network_modules	20	TRUE	0.0036870175825237683	155	63	7	0.1111111111111111	0.04516129032258064	GO:0009451	GO:BP	RNA modification	16175	3498		1	1	155	16020	7	56	148	15964	16175	0.06516739603801651
M1	string	0	network_modules	20	TRUE	0.00939958321841843	63	60	5	0.08333333333333333	0.07936507936507936	REAC:R-HSA-6782210	REAC	Gap-filling DNA repair synthesis and ligation in TC-NER	10916	1038		1	1	63	10853	5	55	58	10798	10916	0.07612161496638384
M1	string	0	network_modules	21	TRUE	2.255895848804583e-44	632	60	43	0.7166666666666667	0.0680379746835443	GO:0030036	GO:BP	actin cytoskeleton organization	16175	6660		0	0.01818181818181818	632	15543	43	17	589	15526	16175	0.21337737293915027
M1	string	0	network_modules	21	TRUE	5.350809230915507e-44	708	60	44	0.7333333333333333	0.062146892655367235	GO:0030029	GO:BP	actin filament-based process	16175	6653		0.018518518518518517	0.03636363636363636	708	15467	44	16	664	15451	16175	0.2056640860233641
M1	string	0	network_modules	21	TRUE	1.6839968637378339e-32	407	60	32	0.5333333333333333	0.07862407862407862	GO:0007015	GO:BP	actin filament organization	16175	2624		0.037037037037037035	0.05454545454545454	407	15768	32	28	375	15740	16175	0.19798357675220737
M1	string	0	network_modules	21	TRUE	1.8745185284198633e-25	748	60	33	0.55	0.04411764705882353	GO:0097435	GO:BP	supramolecular fiber organization	16175	18657		0.05555555555555555	0.07272727272727272	748	15427	33	27	715	15400	16175	0.14636366535053544
M1	string	0	network_modules	21	TRUE	2.8785614837411667e-18	193	45	19	0.4222222222222222	0.09844559585492228	KEGG:04814	KEGG	Motor proteins	8484	366		0	0.058823529411764705	193	8291	19	26	174	8265	8484	0.19564434813012216
M1	string	0	network_modules	21	TRUE	1.8175043221598866e-15	227	45	18	0.4	0.07929515418502203	KEGG:04810	KEGG	Regulation of actin cytoskeleton	8484	365		0.0625	0.11764705882352941	227	8257	18	27	209	8230	8484	0.16890009738649753
M1	string	0	network_modules	21	TRUE	1.343365684991107e-14	318	49	19	0.3877551020408163	0.059748427672955975	REAC:R-HSA-195258	REAC	RHO GTPase Effectors	10916	1846		0	0.025	318	10598	19	30	299	10568	10916	0.1431924182793062
M1	string	0	network_modules	21	TRUE	2.955426066164556e-13	170	45	15	0.3333333333333333	0.08823529411764706	KEGG:04530	KEGG	Tight junction	8484	317		0.125	0.17647058823529413	170	8314	15	30	155	8284	8484	0.16326243489524506
M1	string	0	network_modules	21	TRUE	1.0387981380665857e-11	77	45	11	0.24444444444444444	0.14285714285714285	KEGG:05100	KEGG	Bacterial invasion of epithelial cells	8484	423		0.1875	0.23529411764705882	77	8407	11	34	66	8373	8484	0.18123578139173513
M1	string	0	network_modules	21	TRUE	5.90436752576286e-11	197	45	14	0.3111111111111111	0.07106598984771574	KEGG:05130	KEGG	Pathogenic Escherichia coli infection	8484	427		0.25	0.29411764705882354	197	8287	14	31	183	8256	8484	0.13959106683106032
M1	string	0	network_modules	21	TRUE	2.9303971065027595e-10	74	49	10	0.20408163265306123	0.13513513513513514	REAC:R-HSA-9659379	REAC	Sensory processing of sound	10916	2201		0.02564102564102564	0.05	74	10842	10	39	64	10803	10916	0.16146149315292718
M1	string	0	network_modules	21	TRUE	3.4992667290068806e-10	110	60	11	0.18333333333333332	0.1	GO:0030048	GO:BP	actin filament-based movement	16175	6667		0.07407407407407407	0.09090909090909091	110	16065	11	49	99	16016	16175	0.13106696797935175
M1	string	0	network_modules	21	TRUE	7.839640147029329e-10	35	49	8	0.16326530612244897	0.22857142857142856	REAC:R-HSA-5663213	REAC	RHO GTPases Activate WASPs and WAVEs	10916	1852		0.05128205128205128	0.075	35	10881	8	41	27	10840	10916	0.1901158890202048
M1	string	0	network_modules	21	TRUE	2.2145372257007866e-9	90	49	10	0.20408163265306123	0.1111111111111111	REAC:R-HSA-2682334	REAC	EPH-Ephrin signaling	10916	818		0.07692307692307693	0.1	90	10826	10	39	80	10787	10916	0.14542728355971563
M1	string	0	network_modules	21	TRUE	2.5190913092401714e-9	40	49	8	0.16326530612244897	0.2	REAC:R-HSA-3928662	REAC	EPHB-mediated forward signaling	10916	821		0.10256410256410256	0.125	40	10876	8	41	32	10835	10916	0.1773689676282191
M1	string	0	network_modules	21	TRUE	4.200309219435503e-9	66	49	9	0.1836734693877551	0.13636363636363635	REAC:R-HSA-9662360	REAC	Sensory processing of sound by inner hair cells of the cochlea	10916	2202		0.1282051282051282	0.15	66	10850	9	40	57	10810	10916	0.1538613744479644
M1	string	0	network_modules	21	TRUE	1.6404934467567096e-8	50	60	8	0.13333333333333333	0.16	GO:0045010	GO:BP	actin nucleation	16175	11227		0.09259259259259259	0.10909090909090909	50	16125	8	52	42	16073	16175	0.14315991438996292
M1	string	0	network_modules	21	TRUE	1.7116532137721013e-8	150	49	11	0.22448979591836735	0.07333333333333333	REAC:R-HSA-1500931	REAC	Cell-Cell communication	10916	328		0.15384615384615385	0.175	150	10766	11	38	139	10728	10916	0.12156215930583925
M1	string	0	network_modules	21	TRUE	1.9906637614864827e-8	449	49	16	0.32653061224489793	0.035634743875278395	REAC:R-HSA-9012999	REAC	RHO GTPase cycle	10916	1847		0.1794871794871795	0.2	449	10467	16	33	433	10434	10916	0.09649923654771195
M1	string	0	network_modules	21	TRUE	2.2292405890144018e-8	113	49	10	0.20408163265306123	0.08849557522123894	REAC:R-HSA-9664422	REAC	FCGR3A-mediated phagocytosis	10916	899		0.20512820512820512	0.275	113	10803	10	39	103	10764	10916	0.12852626235672357
M1	string	0	network_modules	21	TRUE	2.2292405890144018e-8	113	49	10	0.20408163265306123	0.08849557522123894	REAC:R-HSA-9664417	REAC	Leishmania phagocytosis	10916	1312		0.20512820512820512	0.275	113	10803	10	39	103	10764	10916	0.12852626235672357
M1	string	0	network_modules	21	TRUE	2.2292405890144018e-8	113	49	10	0.20408163265306123	0.08849557522123894	REAC:R-HSA-9664407	REAC	Parasite infection	10916	1716		0.20512820512820512	0.275	113	10803	10	39	103	10764	10916	0.12852626235672357
M1	string	0	network_modules	21	TRUE	2.7917888750050596e-8	215	60	12	0.2	0.05581395348837209	GO:0110053	GO:BP	regulation of actin filament organization	16175	19377		0.1111111111111111	0.12727272727272726	215	15960	12	48	203	15912	16175	0.09947907532142246
M1	string	0	network_modules	21	TRUE	2.900158826515474e-8	116	49	10	0.20408163265306123	0.08620689655172414	REAC:R-HSA-2029482	REAC	Regulation of actin dynamics for phagocytic cup formation	10916	2020		0.28205128205128205	0.3	116	10800	10	39	106	10761	10916	0.12669103562054268
M1	string	0	network_modules	21	TRUE	6.52306842486957e-8	35	60	7	0.11666666666666667	0.2	GO:0030834	GO:BP	regulation of actin filament depolymerization	16175	6919		0.12962962962962962	0.14545454545454545	35	16140	7	53	28	16087	16175	0.15036100037996383
M1	string	0	network_modules	21	TRUE	7.168289702753162e-8	36	49	7	0.14285714285714285	0.19444444444444445	REAC:R-HSA-390522	REAC	Striated Muscle Contraction	10916	2356		0.3076923076923077	0.325	36	10880	7	42	29	10838	10916	0.16345552498222446
M1	string	0	network_modules	21	TRUE	1.21666883371262e-7	308	60	13	0.21666666666666667	0.04220779220779221	GO:0032970	GO:BP	regulation of actin filament-based process	16175	7953		0.14814814814814814	0.16363636363636364	308	15867	13	47	295	15820	16175	0.08823151407759411
M1	string	0	network_modules	21	TRUE	1.239332258027111e-7	21	49	6	0.12244897959183673	0.2857142857142857	REAC:R-HSA-5627123	REAC	RHO GTPases activate PAKs	10916	1856		0.3333333333333333	0.35	21	10895	6	43	15	10852	10916	0.18469762986904384
M1	string	0	network_modules	21	TRUE	1.7827087709490657e-7	40	60	7	0.11666666666666667	0.175	GO:0030042	GO:BP	actin filament depolymerization	16175	6663		0.16666666666666666	0.18181818181818182	40	16135	7	53	33	16082	16175	0.14029186198737664
M1	string	0	network_modules	21	TRUE	1.8081016722575433e-7	318	60	13	0.21666666666666667	0.040880503144654086	GO:1902903	GO:BP	regulation of supramolecular fiber organization	16175	22602		0.18518518518518517	0.2	318	15857	13	47	305	15810	16175	0.08658879133600003
M1	string	0	network_modules	21	TRUE	1.885244133670061e-7	140	49	10	0.20408163265306123	0.07142857142857142	REAC:R-HSA-2029480	REAC	Fcgamma receptor (FCGR) dependent phagocytosis	10916	939		0.358974358974359	0.375	140	10776	10	39	130	10737	10916	0.11413791923270453
M1	string	0	network_modules	21	TRUE	2.4892785438916536e-7	144	49	10	0.20408163265306123	0.06944444444444445	REAC:R-HSA-8856828	REAC	Clathrin-mediated endocytosis	10916	372		0.38461538461538464	0.4	144	10772	10	39	134	10733	10916	0.1123467372542712
M1	string	0	network_modules	21	TRUE	2.5649026049086214e-7	42	60	7	0.11666666666666667	0.16666666666666666	GO:0034314	GO:BP	Arp2/3 complex-mediated actin nucleation	16175	8568		0.2037037037037037	0.21818181818181817	42	16133	7	53	35	16080	16175	0.13677106984280793
M1	string	0	network_modules	21	TRUE	2.652685750070293e-7	246	45	12	0.26666666666666666	0.04878048780487805	KEGG:05131	KEGG	Shigellosis	8484	428		0.3125	0.35294117647058826	246	8238	12	33	234	8205	8484	0.10343297227367974
M1	string	0	network_modules	21	TRUE	4.5766173482125437e-7	793	60	18	0.3	0.02269861286254729	GO:0044087	GO:BP	regulation of cellular component biogenesis	16175	10909		0.2222222222222222	0.23636363636363636	793	15382	18	42	775	15340	16175	0.07092347704028584
M1	string	0	network_modules	21	TRUE	4.6588876001711457e-7	274	60	12	0.2	0.043795620437956206	GO:0032956	GO:BP	regulation of actin cytoskeleton organization	16175	7940		0.24074074074074073	0.2545454545454545	274	15901	12	48	262	15853	16175	0.08655882998691357
M1	string	0	network_modules	21	TRUE	8.773579044124626e-7	27	60	6	0.1	0.2222222222222222	GO:0030835	GO:BP	negative regulation of actin filament depolymerization	16175	6920		0.25925925925925924	0.2727272727272727	27	16148	6	54	21	16094	16175	0.1469781887866602
M1	string	0	network_modules	21	TRUE	1.1205397990457783e-6	173	60	10	0.16666666666666666	0.057803468208092484	GO:0031032	GO:BP	actomyosin structure organization	16175	7004		0.2777777777777778	0.2909090909090909	173	16002	10	50	163	15952	16175	0.09252068642561342
M1	string	0	network_modules	21	TRUE	1.249784500043341e-6	53	49	7	0.14285714285714285	0.1320754716981132	REAC:R-HSA-9662361	REAC	Sensory processing of sound by outer hair cells of the cochlea	10916	2203		0.41025641025641024	0.425	53	10863	7	42	46	10821	10916	0.13331497205514842
M1	string	0	network_modules	21	TRUE	2.437836429545351e-6	96	45	8	0.17777777777777778	0.08333333333333333	KEGG:04666	KEGG	Fc gamma R-mediated phagocytosis	8484	341		0.375	0.4117647058823529	96	8388	8	37	88	8351	8484	0.11492450576445948
M1	string	0	network_modules	21	TRUE	4.952062590999934e-6	63	60	7	0.11666666666666667	0.1111111111111111	GO:1901879	GO:BP	regulation of protein depolymerization	16175	21823		0.2962962962962963	0.3090909090909091	63	16112	7	53	56	16059	16175	0.11047401655612958
M1	string	0	network_modules	21	TRUE	5.0296685254961245e-6	37	49	6	0.12244897959183673	0.16216216216216217	REAC:R-HSA-9013424	REAC	RHOV GTPase cycle	10916	1875		0.4358974358974359	0.45	37	10879	6	43	31	10836	10916	0.1375546544204784
M1	string	0	network_modules	21	TRUE	5.768575313070769e-6	202	45	10	0.2222222222222222	0.04950495049504951	KEGG:04510	KEGG	Focal adhesion	8484	313		0.4375	0.47058823529411764	202	8282	10	35	192	8247	8484	0.09503587749389551
M1	string	0	network_modules	21	TRUE	6.609593606913337e-6	19	49	5	0.10204081632653061	0.2631578947368421	REAC:R-HSA-5625900	REAC	RHO GTPases activate CIT	10916	1853		0.46153846153846156	0.475	19	10897	5	44	14	10853	10916	0.16157660618158193
M1	string	0	network_modules	21	TRUE	7.642189477192697e-6	18	60	5	0.08333333333333333	0.2777777777777778	GO:0030050	GO:BP	vesicle transport along actin filament	16175	6669		0.3148148148148148	0.32727272727272727	18	16157	5	55	13	16102	16175	0.15047636234049852
M1	string	0	network_modules	21	TRUE	9.445720255007608e-6	440	60	13	0.21666666666666667	0.029545454545454545	GO:0051493	GO:BP	regulation of cytoskeleton organization	16175	13748		0.3333333333333333	0.34545454545454546	440	15735	13	47	427	15688	16175	0.07106768909743875
M1	string	0	network_modules	21	TRUE	1.2078549796926094e-5	215	49	10	0.20408163265306123	0.046511627906976744	REAC:R-HSA-9658195	REAC	Leishmania infection	10916	1310		0.48717948717948717	0.525	215	10701	10	39	205	10662	10916	0.08910513462360493
M1	string	0	network_modules	21	TRUE	1.2078549796926094e-5	215	49	10	0.20408163265306123	0.046511627906976744	REAC:R-HSA-9824443	REAC	Parasitic Infection Pathways	10916	1717		0.48717948717948717	0.525	215	10701	10	39	205	10662	10916	0.08910513462360493
M1	string	0	network_modules	21	TRUE	1.292449534637037e-5	43	49	6	0.12244897959183673	0.13953488372093023	REAC:R-HSA-445355	REAC	Smooth Muscle Contraction	10916	2336		0.5384615384615384	0.55	43	10873	6	43	37	10830	10916	0.1270433991716458
M1	string	0	network_modules	21	TRUE	1.3052207411356348e-5	113	60	8	0.13333333333333333	0.07079646017699115	GO:0008064	GO:BP	regulation of actin polymerization or depolymerization	16175	3113		0.35185185185185186	0.36363636363636365	113	16062	8	52	105	16010	16175	0.09256173768658409
M1	string	0	network_modules	21	TRUE	1.3750471005979498e-5	20	60	5	0.08333333333333333	0.25	GO:0099515	GO:BP	actin filament-based transport	16175	19105		0.37037037037037035	0.38181818181818183	20	16155	5	55	15	16100	16175	0.14254855294906327
M1	string	0	network_modules	21	TRUE	1.4170373413407064e-5	73	60	7	0.11666666666666667	0.0958904109589041	GO:0097581	GO:BP	lamellipodium organization	16175	18706		0.3888888888888889	0.4	73	16102	7	53	66	16049	16175	0.1020977949095238
M1	string	0	network_modules	21	TRUE	1.6065472894166984e-5	116	60	8	0.13333333333333333	0.06896551724137931	GO:0030832	GO:BP	regulation of actin filament length	16175	6917		0.4074074074074074	0.41818181818181815	116	16059	8	52	108	16007	16175	0.09123139111888627
M1	string	0	network_modules	21	TRUE	1.8871043637085494e-5	23	49	5	0.10204081632653061	0.21739130434782608	REAC:R-HSA-373753	REAC	Nephrin family interactions	10916	1582		0.5641025641025641	0.575	23	10893	5	44	18	10849	10916	0.14634623070938624
M1	string	0	network_modules	21	TRUE	3.284165472097051e-5	127	60	8	0.13333333333333333	0.06299212598425197	GO:0051494	GO:BP	negative regulation of cytoskeleton organization	16175	13749		0.42592592592592593	0.43636363636363634	127	16048	8	52	119	15996	16175	0.08675067671785465
M1	string	0	network_modules	21	TRUE	3.700017784779625e-5	136	45	8	0.17777777777777778	0.058823529411764705	KEGG:05135	KEGG	Yersinia infection	8484	432		0.5	0.5294117647058824	136	8348	8	37	128	8311	8484	0.09404562634727272
M1	string	0	network_modules	21	TRUE	3.7133483148137355e-5	129	60	8	0.13333333333333333	0.06201550387596899	GO:1902904	GO:BP	negative regulation of supramolecular fiber organization	16175	22603		0.4444444444444444	0.45454545454545453	129	16046	8	52	121	15994	16175	0.08599610532276046
M1	string	0	network_modules	21	TRUE	3.727133879887423e-5	24	60	5	0.08333333333333333	0.20833333333333334	GO:0051693	GO:BP	actin filament capping	16175	13896		0.46296296296296297	0.4909090909090909	24	16151	5	55	19	16096	16175	0.12975251672822538
M1	string	0	network_modules	21	TRUE	3.727133879887423e-5	24	60	5	0.08333333333333333	0.20833333333333334	GO:0051016	GO:BP	barbed-end actin filament capping	16175	13441		0.46296296296296297	0.4909090909090909	24	16151	5	55	19	16096	16175	0.12975251672822538
M1	string	0	network_modules	21	TRUE	3.89145109010684e-5	49	60	6	0.1	0.12244897959183673	GO:1901880	GO:BP	negative regulation of protein depolymerization	16175	21824		0.5	0.509090909090909	49	16126	6	54	43	16072	16175	0.10766725123007982
M1	string	0	network_modules	21	TRUE	3.902472876412079e-5	93	45	7	0.15555555555555556	0.07526881720430108	KEGG:04520	KEGG	Adherens junction	8484	316		0.5625	0.5882352941176471	93	8391	7	38	86	8353	8484	0.10140575313922442
M1	string	0	network_modules	21	TRUE	4.076759551000032e-5	249	45	10	0.2222222222222222	0.040160642570281124	KEGG:05132	KEGG	Salmonella infection	8484	429		0.625	0.6470588235294118	249	8235	10	35	239	8200	8484	0.08344514343746093
M1	string	0	network_modules	21	TRUE	5.208933198753214e-5	97	45	7	0.15555555555555556	0.07216494845360824	KEGG:05410	KEGG	Hypertrophic cardiomyopathy	8484	489		0.6875	0.7058823529411765	97	8387	7	38	90	8349	8484	0.09899273577112949
M1	string	0	network_modules	21	TRUE	5.2351344315600067e-5	258	60	10	0.16666666666666666	0.03875968992248062	GO:0006936	GO:BP	muscle contraction	16175	2575		0.5185185185185185	0.5272727272727272	258	15917	10	50	248	15867	16175	0.07340472570513422
M1	string	0	network_modules	21	TRUE	7.341802363689796e-5	102	45	7	0.15555555555555556	0.06862745098039216	KEGG:05414	KEGG	Dilated cardiomyopathy	8484	491		0.75	0.7647058823529411	102	8382	7	38	95	8344	8484	0.096169873231549
M1	string	0	network_modules	21	TRUE	7.778901372336202e-5	93	60	7	0.11666666666666667	0.07526881720430108	GO:0051261	GO:BP	protein depolymerization	16175	13608		0.5370370370370371	0.5454545454545454	93	16082	7	53	86	16029	16175	0.0895141266518643
M1	string	0	network_modules	21	TRUE	7.832846371170162e-5	205	45	9	0.2	0.04390243902439024	KEGG:05205	KEGG	Proteoglycans in cancer	8484	457		0.8125	0.8235294117647058	205	8279	9	36	196	8243	8484	0.08361910106828724
M1	string	0	network_modules	21	TRUE	9.275870355994065e-5	31	49	5	0.10204081632653061	0.16129032258064516	REAC:R-HSA-445095	REAC	Interaction between L1 and Ankyrins	10916	1219		0.5897435897435898	0.6	31	10885	5	44	26	10841	10916	0.1251778515446897
M1	string	0	network_modules	21	TRUE	9.696077126911763e-5	203	49	9	0.1836734693877551	0.04433497536945813	REAC:R-HSA-397014	REAC	Muscle contraction	10916	1496		0.6153846153846154	0.625	203	10713	9	40	194	10673	10916	0.08205206269212387
M1	string	0	network_modules	21	TRUE	9.869496824047994e-5	57	60	6	0.1	0.10526315789473684	GO:0032272	GO:BP	negative regulation of protein polymerization	16175	7453		0.5555555555555556	0.5636363636363636	57	16118	6	54	51	16064	16175	0.09934162041158745
M1	string	0	network_modules	21	TRUE	1.0427611053417672e-4	97	60	7	0.11666666666666667	0.07216494845360824	GO:0043244	GO:BP	regulation of protein-containing complex disassembly	16175	10582		0.5740740740740741	0.5818181818181818	97	16078	7	53	90	16025	16175	0.08746450447863768
M1	string	0	network_modules	21	TRUE	1.3499559992474807e-4	60	60	6	0.1	0.1	GO:0043242	GO:BP	negative regulation of protein-containing complex disassembly	16175	10580		0.5925925925925926	0.6	60	16115	6	54	54	16061	16175	0.09664908470369223
M1	string	0	network_modules	21	TRUE	1.4060508666067332e-4	153	60	8	0.13333333333333333	0.05228758169934641	GO:0008154	GO:BP	actin polymerization or depolymerization	16175	3127		0.6111111111111112	0.6181818181818182	153	16022	8	52	145	15970	16175	0.07808756211363597
M1	string	0	network_modules	21	TRUE	2.3613826446409266e-4	303	60	10	0.16666666666666666	0.033003300330033	GO:0003012	GO:BP	muscle system process	16175	1463		0.6296296296296297	0.6363636363636364	303	15872	10	50	293	15822	16175	0.06657877169050387
M1	string	0	network_modules	21	TRUE	2.7144004070981347e-4	114	49	7	0.14285714285714285	0.06140350877192982	REAC:R-HSA-446728	REAC	Cell junction organization	10916	324		0.6410256410256411	0.65	114	10802	7	42	107	10760	10916	0.08746520722115998
M1	string	0	network_modules	21	TRUE	3.1806946399536734e-4	114	60	7	0.11666666666666667	0.06140350877192982	GO:0031333	GO:BP	negative regulation of protein-containing complex assembly	16175	7124		0.6481481481481481	0.6545454545454545	114	16061	7	53	107	16008	16175	0.07995597086859953
M1	string	0	network_modules	21	TRUE	3.795025051494955e-4	248	45	9	0.2	0.036290322580645164	KEGG:04144	KEGG	Endocytosis	8484	280		0.875	0.8823529411764706	248	8236	9	36	239	8200	8484	0.07402615485182737
M1	string	0	network_modules	21	TRUE	4.221466000890543e-4	18	49	4	0.08163265306122448	0.2222222222222222	REAC:R-HSA-446353	REAC	Cell-extracellular matrix interactions	10916	330		0.6666666666666666	0.675	18	10898	4	45	14	10853	10916	0.13237273909613484
M1	string	0	network_modules	21	TRUE	4.689474443276109e-4	414	60	11	0.18333333333333332	0.026570048309178744	GO:0061061	GO:BP	muscle structure development	16175	15177		0.6666666666666666	0.6727272727272727	414	15761	11	49	403	15712	16175	0.0609466449767714
M1	string	0	network_modules	21	TRUE	5.329564684842901e-4	19	49	4	0.08163265306122448	0.21052631578947367	REAC:R-HSA-5627117	REAC	RHO GTPases Activate ROCKs	10916	1850		0.6923076923076923	0.7	19	10897	4	45	15	10852	10916	0.12870049976621262
M1	string	0	network_modules	21	TRUE	6.089192012082244e-4	77	60	6	0.1	0.07792207792207792	GO:0007044	GO:BP	cell-substrate junction assembly	16175	2648		0.6851851851851852	0.6909090909090909	77	16098	6	54	71	16044	16175	0.08442884513805776
M1	string	0	network_modules	21	TRUE	6.13522177044195e-4	17	60	4	0.06666666666666667	0.23529411764705882	GO:0051014	GO:BP	actin filament severing	16175	13440		0.7037037037037037	0.7090909090909091	17	16158	4	56	13	16102	16175	0.12356458418158028
M1	string	0	network_modules	21	TRUE	6.505243760915644e-4	82	49	6	0.12244897959183673	0.07317073170731707	REAC:R-HSA-6802957	REAC	Oncogenic MAPK signaling	10916	1641		0.717948717948718	0.725	82	10834	6	43	76	10791	10916	0.08938517921767039
M1	string	0	network_modules	21	TRUE	7.181581385777642e-4	418	49	11	0.22448979591836735	0.02631578947368421	REAC:R-HSA-5663202	REAC	Diseases of signal transduction by growth factor receptors and second messengers	10916	773		0.7435897435897436	0.75	418	10498	11	38	407	10460	10916	0.06515366892459212
M1	string	0	network_modules	21	TRUE	7.487309660252832e-4	533	60	12	0.2	0.0225140712945591	GO:0034330	GO:BP	cell junction organization	16175	8572		0.7222222222222222	0.7272727272727273	533	15642	12	48	521	15594	16175	0.057099994927401664
M1	string	0	network_modules	21	TRUE	8.027355068262611e-4	346	60	10	0.16666666666666666	0.028901734104046242	GO:0034329	GO:BP	cell junction assembly	16175	8571		0.7407407407407407	0.7454545454545455	346	15829	10	50	336	15779	16175	0.06126786425671089
M1	string	0	network_modules	21	TRUE	9.528612320208807e-4	83	60	6	0.1	0.07228915662650602	GO:0150115	GO:BP	cell-substrate junction organization	16175	20148		0.7592592592592593	0.7636363636363637	83	16092	6	54	77	16038	16175	0.08101833334018167
M1	string	0	network_modules	21	TRUE	0.0010094041688915641	45	60	5	0.08333333333333333	0.1111111111111111	GO:0030837	GO:BP	negative regulation of actin filament polymerization	16175	6922		0.7777777777777778	0.7818181818181819	45	16130	5	55	40	16075	16175	0.09331547460059515
M1	string	0	network_modules	21	TRUE	0.0011012662179608781	153	45	7	0.15555555555555556	0.0457516339869281	KEGG:04261	KEGG	Adrenergic signaling in cardiomyocytes	8484	297		0.9375	0.9411764705882353	153	8331	7	38	146	8293	8484	0.07546369854388489
M1	string	0	network_modules	21	TRUE	0.0011292959825973344	46	60	5	0.08333333333333333	0.10869565217391304	GO:1902743	GO:BP	regulation of lamellipodium organization	16175	22469		0.7962962962962963	0.8	46	16129	5	55	41	16074	16175	0.09222762396828683
M1	string	0	network_modules	21	TRUE	0.0012016053409955305	23	49	4	0.08163265306122448	0.17391304347826086	REAC:R-HSA-9013418	REAC	RHOBTB2 GTPase cycle	10916	1863		0.7692307692307693	0.775	23	10893	4	45	19	10848	10916	0.11645987345303656
M1	string	0	network_modules	21	TRUE	0.0023377952924681154	102	49	6	0.12244897959183673	0.058823529411764705	REAC:R-HSA-6807878	REAC	COPI-mediated anterograde transport	10916	279		0.7948717948717948	0.8	102	10814	6	43	96	10771	10916	0.07893959165776568
M1	string	0	network_modules	21	TRUE	0.002396553679978075	97	60	6	0.1	0.061855670103092786	GO:0030833	GO:BP	regulation of actin filament polymerization	16175	6918		0.8148148148148148	0.8181818181818182	97	16078	6	54	91	16024	16175	0.07429250727234409
M1	string	0	network_modules	21	TRUE	0.002625848430236123	7	60	3	0.05	0.42857142857142855	GO:0070358	GO:BP	actin polymerization-dependent cell motility	16175	16075		0.8333333333333334	0.8363636363636363	7	16168	3	57	4	16111	16175	0.14541937327756174
M1	string	0	network_modules	21	TRUE	0.003291724436934867	161	60	7	0.11666666666666667	0.043478260869565216	GO:0032271	GO:BP	regulation of protein polymerization	16175	7452		0.8518518518518519	0.8545454545454545	161	16014	7	53	154	15961	16175	0.06559328466689657
M1	string	0	network_modules	21	TRUE	0.003343648369625629	57	60	5	0.08333333333333333	0.08771929824561403	GO:0030032	GO:BP	lamellipodium assembly	16175	6656		0.8703703703703703	0.8727272727272727	57	16118	5	55	52	16063	16175	0.08217991251713666
M1	string	0	network_modules	21	TRUE	0.00372513770946235	64	49	5	0.10204081632653061	0.078125	REAC:R-HSA-6802952	REAC	Signaling by BRAF and RAF1 fusions	10916	2225		0.8205128205128205	0.825	64	10852	5	44	59	10808	10916	0.0845934965911351
M1	string	0	network_modules	21	TRUE	0.004736912268563636	32	49	4	0.08163265306122448	0.125	REAC:R-HSA-5626467	REAC	RHO GTPases activate IQGAPs	10916	1854		0.8461538461538461	0.85	32	10884	4	45	28	10839	10916	0.09775043561979538
M1	string	0	network_modules	21	TRUE	0.005094768400883377	62	60	5	0.08333333333333333	0.08064516129032258	GO:0070527	GO:BP	platelet aggregation	16175	16166		0.8888888888888888	0.8909090909090909	62	16113	5	55	57	16058	16175	0.07850354110920021
M1	string	0	network_modules	21	TRUE	0.006324373490058875	339	60	9	0.15	0.02654867256637168	GO:0042060	GO:BP	wound healing	16175	9947		0.9074074074074074	0.9090909090909091	339	15836	9	51	330	15785	16175	0.05496830488143565
M1	string	0	network_modules	21	TRUE	0.006829324877519397	35	49	4	0.08163265306122448	0.11428571428571428	REAC:R-HSA-6802948	REAC	Signaling by high-kinase activity BRAF mutants	10916	2321		0.8717948717948718	0.9	35	10881	4	45	31	10836	10916	0.09315374333931262
M1	string	0	network_modules	21	TRUE	0.006829324877519397	35	49	4	0.08163265306122448	0.11428571428571428	REAC:R-HSA-9706574	REAC	RHOBTB GTPase Cycle	10916	1861		0.8717948717948718	0.9	35	10881	4	45	31	10836	10916	0.09315374333931262
M1	string	0	network_modules	21	TRUE	0.00695719688164871	343	60	9	0.15	0.026239067055393587	GO:0140694	GO:BP	membraneless organelle assembly	16175	19860		0.9259259259259259	0.9272727272727272	343	15832	9	51	334	15781	16175	0.05454901465738352
M1	string	0	network_modules	21	TRUE	0.0071252519175350176	87	45	5	0.1111111111111111	0.05747126436781609	KEGG:04260	KEGG	Cardiac muscle contraction	8484	296		1	1	87	8397	5	40	82	8357	8484	0.07310442650835525
M1	string	0	network_modules	21	TRUE	0.007131743786038411	257	60	8	0.13333333333333333	0.0311284046692607	GO:0032535	GO:BP	regulation of cellular component size	16175	7629		0.9444444444444444	0.9454545454545454	257	15918	8	52	249	15866	16175	0.05730955822419531
M1	string	0	network_modules	21	TRUE	0.007329352065687277	12	49	3	0.061224489795918366	0.25	REAC:R-HSA-264870	REAC	Caspase-mediated cleavage of cytoskeletal proteins	10916	316		0.9230769230769231	0.925	12	10904	3	46	9	10858	10916	0.1218371193123554
M1	string	0	network_modules	21	TRUE	0.007496724245443712	67	60	5	0.08333333333333333	0.07462686567164178	GO:0099518	GO:BP	vesicle cytoskeletal trafficking	16175	19107		0.9629629629629629	0.9636363636363636	67	16108	5	55	62	16053	16175	0.07523555602732679
M1	string	0	network_modules	21	TRUE	0.007524971991946271	118	60	6	0.1	0.05084745762711865	GO:0055001	GO:BP	muscle cell development	16175	14190		0.9814814814814815	0.9818181818181818	118	16057	6	54	112	16003	16175	0.06647123273721807
M1	string	0	network_modules	21	TRUE	0.008104921807957783	264	49	8	0.16326530612244897	0.030303030303030304	REAC:R-HSA-5673001	REAC	RAF/MAP kinase cascade	10916	1841		0.9487179487179487	0.95	264	10652	8	41	256	10611	10916	0.060793314042149764
M1	string	0	network_modules	21	TRUE	0.008557630630421968	37	49	4	0.08163265306122448	0.10810810810810811	REAC:R-HSA-111465	REAC	Apoptotic cleavage of cellular proteins	10916	161		0.9743589743589743	0.975	37	10879	4	45	33	10834	10916	0.09039774888355513
M1	string	0	network_modules	21	TRUE	0.008892503775845575	32	60	4	0.06666666666666667	0.125	GO:1902745	GO:BP	positive regulation of lamellipodium organization	16175	22471		1	1	32	16143	4	56	28	16087	16175	0.08883076837234341
M1	string	0	network_modules	21	TRUE	0.009278382327331743	269	49	8	0.16326530612244897	0.02973977695167286	REAC:R-HSA-5684996	REAC	MAPK1/MAPK3 signaling	10916	1351		1	1	269	10647	8	41	261	10606	10916	0.06004141842510126
M1	string	0	network_modules	22	TRUE	3.356342219623335e-60	774	62	54	0.8709677419354839	0.06976744186046512	GO:0007186	GO:BP	G protein-coupled receptor signaling pathway	16175	2744		0	0.020833333333333332	774	15401	54	8	720	15393	16175	0.23920381196883184
M1	string	0	network_modules	22	TRUE	5.867101675190423e-50	312	59	42	0.711864406779661	0.1346153846153846	REAC:R-HSA-418594	REAC	G alpha (i) signalling events	10916	987		0	0.037037037037037035	312	10604	42	17	270	10587	10916	0.30228929011824135
M1	string	0	network_modules	22	TRUE	1.0317304954948064e-29	217	62	26	0.41935483870967744	0.11981566820276497	GO:0007188	GO:BP	adenylate cyclase-modulating G protein-coupled receptor signaling pathway	16175	2746		0.02127659574468085	0.041666666666666664	217	15958	26	36	191	15922	16175	0.21887375541672066
M1	string	0	network_modules	22	TRUE	2.1964798801893896e-27	365	45	29	0.6444444444444445	0.07945205479452055	KEGG:04080	KEGG	Neuroactive ligand-receptor interaction	8484	263		0	0.02702702702702703	365	8119	29	16	336	8103	8484	0.21644284646630335
M1	string	0	network_modules	22	TRUE	3.7652362405202014e-22	460	59	29	0.4915254237288136	0.06304347826086956	REAC:R-HSA-500792	REAC	GPCR ligand binding	10916	1019		0.038461538461538464	0.07407407407407407	460	10456	29	30	431	10426	10916	0.1648890870970049
M1	string	0	network_modules	22	TRUE	5.962401503002869e-22	328	59	26	0.4406779661016949	0.07926829268292683	REAC:R-HSA-373076	REAC	Class A/1 (Rhodopsin-like receptors)	10916	365		0.07692307692307693	0.1111111111111111	328	10588	26	33	302	10555	10916	0.1773134783485054
M1	string	0	network_modules	22	TRUE	2.185295518659269e-21	56	62	15	0.24193548387096775	0.26785714285714285	GO:0007193	GO:BP	adenylate cyclase-inhibiting G protein-coupled receptor signaling pathway	16175	2751		0.0425531914893617	0.0625	56	16119	15	47	41	16072	16175	0.2518423270968876
M1	string	0	network_modules	22	TRUE	5.0914584387083545e-21	48	59	15	0.2542372881355932	0.3125	REAC:R-HSA-418597	REAC	G alpha (z) signalling events	10916	990		0.11538461538461539	0.14814814814814814	48	10868	15	44	33	10824	10916	0.2783564432158274
M1	string	0	network_modules	22	TRUE	4.6517032363438193e-17	223	45	19	0.4222222222222222	0.08520179372197309	KEGG:04024	KEGG	cAMP signaling pathway	8484	252		0.027777777777777776	0.05405405405405406	223	8261	19	26	204	8235	8484	0.1807254286022456
M1	string	0	network_modules	22	TRUE	2.6579824423028386e-15	56	62	12	0.1935483870967742	0.21428571428571427	GO:0007187	GO:BP	G protein-coupled receptor signaling pathway, coupled to cyclic nucleotide second messenger	16175	2745		0.06382978723404255	0.08333333333333333	56	16119	12	50	44	16069	16175	0.20074261719412045
M1	string	0	network_modules	22	TRUE	4.1738899165553875e-12	97	45	12	0.26666666666666666	0.12371134020618557	KEGG:04713	KEGG	Circadian entrainment	8484	348		0.05555555555555555	0.08108108108108109	97	8387	12	33	85	8354	8484	0.1753112180678293
M1	string	0	network_modules	22	TRUE	2.3440650935787006e-11	156	59	14	0.23728813559322035	0.08974358974358974	REAC:R-HSA-418555	REAC	G alpha (s) signalling events	10916	989		0.15384615384615385	0.18518518518518517	156	10760	14	45	142	10715	10916	0.1385050354622993
M1	string	0	network_modules	22	TRUE	5.678216679233175e-11	120	45	12	0.26666666666666666	0.1	KEGG:04935	KEGG	Growth hormone synthesis, secretion and action	8484	392		0.08333333333333333	0.10810810810810811	120	8364	12	33	108	8331	8484	0.15615780220325334
M1	string	0	network_modules	22	TRUE	1.1600370969898097e-10	14	59	7	0.11864406779661017	0.5	REAC:R-HSA-170670	REAC	Adenylate cyclase inhibitory pathway	10916	120		0.19230769230769232	0.2222222222222222	14	10902	7	52	7	10850	10916	0.24173711332636857
M1	string	0	network_modules	22	TRUE	2.726171669054982e-10	140	62	12	0.1935483870967742	0.08571428571428572	GO:0007189	GO:BP	adenylate cyclase-activating G protein-coupled receptor signaling pathway	16175	2747		0.0851063829787234	0.10416666666666667	140	16035	12	50	128	15985	16175	0.12381521851983407
M1	string	0	network_modules	22	TRUE	3.800185860515761e-10	43	59	9	0.15254237288135594	0.20930232558139536	REAC:R-HSA-9660821	REAC	ADORA2B mediated anti-inflammatory cytokines production	10916	11		0.23076923076923078	0.25925925925925924	43	10873	9	50	34	10823	10916	0.17488552159982906
M1	string	0	network_modules	22	TRUE	4.757638609409978e-10	44	59	9	0.15254237288135594	0.20454545454545456	REAC:R-HSA-9634597	REAC	GPER1 signaling	10916	1020		0.2692307692307692	0.2962962962962963	44	10872	9	50	35	10822	10916	0.1727881315968184
M1	string	0	network_modules	22	TRUE	9.978739269631023e-10	58	45	9	0.2	0.15517241379310345	KEGG:04923	KEGG	Regulation of lipolysis in adipocytes	8484	380		0.1111111111111111	0.13513513513513514	58	8426	9	36	49	8390	8484	0.17118353660932037
M1	string	0	network_modules	22	TRUE	1.8130912990483707e-9	89	45	10	0.2222222222222222	0.11235955056179775	KEGG:05032	KEGG	Morphine addiction	8484	420		0.1388888888888889	0.16216216216216217	89	8395	10	35	79	8360	8484	0.15175476578240102
M1	string	0	network_modules	22	TRUE	7.700139119627523e-9	69	62	9	0.14516129032258066	0.13043478260869565	GO:0007218	GO:BP	neuropeptide signaling pathway	16175	2772		0.10638297872340426	0.125	69	16106	9	53	60	16053	16175	0.13410053176568976
M1	string	0	network_modules	22	TRUE	8.946898743064475e-9	437	62	16	0.25806451612903225	0.036613272311212815	GO:0014070	GO:BP	response to organic cyclic compound	16175	4635		0.1276595744680851	0.14583333333333334	437	15738	16	46	421	15692	16175	0.08839704404833988
M1	string	0	network_modules	22	TRUE	9.959925878721033e-9	49	45	8	0.17777777777777778	0.16326530612244897	KEGG:05030	KEGG	Cocaine addiction	8484	418		0.16666666666666666	0.1891891891891892	49	8435	8	37	41	8398	8484	0.16575049809407424
M1	string	0	network_modules	22	TRUE	1.2457342278438249e-8	76	45	9	0.2	0.11842105263157894	KEGG:04971	KEGG	Gastric acid secretion	8484	402		0.19444444444444445	0.21621621621621623	76	8408	9	36	67	8372	8484	0.1480597609345545
M1	string	0	network_modules	22	TRUE	2.8238684903205182e-8	213	59	13	0.22033898305084745	0.06103286384976526	REAC:R-HSA-416476	REAC	G alpha (q) signalling events	10916	988		0.3076923076923077	0.3333333333333333	213	10703	13	46	200	10657	10916	0.10703177436886756
M1	string	0	network_modules	22	TRUE	4.3232134445081426e-8	210	45	12	0.26666666666666666	0.05714285714285714	KEGG:04015	KEGG	Rap1 signaling pathway	8484	248		0.2222222222222222	0.24324324324324326	210	8274	12	33	198	8241	8484	0.11369866457066855
M1	string	0	network_modules	22	TRUE	4.770397779957294e-8	88	45	9	0.2	0.10227272727272728	KEGG:04540	KEGG	Gap junction	8484	318		0.25	0.2702702702702703	88	8396	9	36	79	8360	8484	0.13667380017047515
M1	string	0	network_modules	22	TRUE	5.2780580072468565e-8	122	62	10	0.16129032258064516	0.08196721311475409	GO:0008277	GO:BP	regulation of G protein-coupled receptor signaling pathway	16175	3149		0.14893617021276595	0.16666666666666666	122	16053	10	52	112	16001	16175	0.11023077868406653
M1	string	0	network_modules	22	TRUE	5.962092993701059e-8	345	62	14	0.22580645161290322	0.04057971014492753	GO:0071407	GO:BP	cellular response to organic cyclic compound	16175	16659		0.1702127659574468	0.1875	345	15830	14	48	331	15782	16175	0.08779037411837051
M1	string	0	network_modules	22	TRUE	8.770229726856306e-8	131	45	10	0.2222222222222222	0.07633587786259542	KEGG:04728	KEGG	Dopaminergic synapse	8484	358		0.2777777777777778	0.2972972972972973	131	8353	10	35	121	8318	8484	0.12246612890232891
M1	string	0	network_modules	22	TRUE	1.5086550172404168e-7	195	59	12	0.2033898305084746	0.06153846153846154	REAC:R-HSA-375276	REAC	Peptide ligand-binding receptors	10916	1726		0.34615384615384615	0.37037037037037035	195	10721	12	47	183	10674	10916	0.10325349927276463
M1	string	0	network_modules	22	TRUE	1.6263017197207672e-7	96	62	9	0.14516129032258066	0.09375	GO:0007200	GO:BP	phospholipase C-activating G protein-coupled receptor signaling pathway	16175	2758		0.19148936170212766	0.20833333333333334	96	16079	9	53	87	16026	16175	0.11243662029721757
M1	string	0	network_modules	22	TRUE	5.291082226699934e-7	115	45	9	0.2	0.0782608695652174	KEGG:04724	KEGG	Glutamatergic synapse	8484	354		0.3055555555555556	0.32432432432432434	115	8369	9	36	106	8333	8484	0.1177407046260223
M1	string	0	network_modules	22	TRUE	9.64827836713798e-7	43	59	7	0.11864406779661017	0.16279069767441862	REAC:R-HSA-991365	REAC	Activation of GABAB receptors	10916	83		0.38461538461538464	0.4444444444444444	43	10873	7	52	36	10821	10916	0.13499188051226527
M1	string	0	network_modules	22	TRUE	9.64827836713798e-7	43	59	7	0.11864406779661017	0.16279069767441862	REAC:R-HSA-977444	REAC	GABA B receptor activation	10916	1010		0.38461538461538464	0.4444444444444444	43	10873	7	52	36	10821	10916	0.13499188051226527
M1	string	0	network_modules	22	TRUE	1.1465875325758484e-6	27	62	6	0.0967741935483871	0.2222222222222222	GO:0007212	GO:BP	G protein-coupled dopamine receptor signaling pathway	16175	2766		0.2127659574468085	0.22916666666666666	27	16148	6	56	21	16092	16175	0.14451529166777508
M1	string	0	network_modules	22	TRUE	1.1484904068693851e-6	516	62	15	0.24193548387096775	0.029069767441860465	GO:0099536	GO:BP	synaptic signaling	16175	19115		0.23404255319148937	0.25	516	15659	15	47	501	15612	16175	0.07413708435355378
M1	string	0	network_modules	22	TRUE	3.6435906179347016e-6	101	45	8	0.17777777777777778	0.07920792079207921	KEGG:04916	KEGG	Melanogenesis	8484	373		0.3333333333333333	0.35135135135135137	101	8383	8	37	93	8346	8484	0.11168034433661245
M1	string	0	network_modules	22	TRUE	4.885272451447795e-6	69	45	7	0.15555555555555556	0.10144927536231885	KEGG:04924	KEGG	Renin secretion	8484	381		0.3611111111111111	0.3783783783783784	69	8415	7	38	62	8377	8484	0.11985989207673728
M1	string	0	network_modules	22	TRUE	5.064197877084595e-6	54	59	7	0.11864406779661017	0.12962962962962962	REAC:R-HSA-112040	REAC	G-protein mediated events	10916	998		0.46153846153846156	0.48148148148148145	54	10862	7	52	47	10810	10916	0.11946277737818305
M1	string	0	network_modules	22	TRUE	5.385110044912493e-6	487	62	14	0.22580645161290322	0.028747433264887063	GO:0007268	GO:BP	chemical synaptic transmission	16175	2796		0.2553191489361702	0.2916666666666667	487	15688	14	48	473	15640	16175	0.07103798330498345
M1	string	0	network_modules	22	TRUE	5.385110044912493e-6	487	62	14	0.22580645161290322	0.028747433264887063	GO:0098916	GO:BP	anterograde trans-synaptic signaling	16175	18949		0.2553191489361702	0.2916666666666667	487	15688	14	48	473	15640	16175	0.07103798330498345
M1	string	0	network_modules	22	TRUE	6.137384499408612e-6	492	62	14	0.22580645161290322	0.028455284552845527	GO:0099537	GO:BP	trans-synaptic signaling	16175	19116		0.2978723404255319	0.3125	492	15683	14	48	478	15635	16175	0.07057570601949693
M1	string	0	network_modules	22	TRUE	6.842407871070109e-6	791	62	17	0.27419354838709675	0.021491782553729456	GO:1901701	GO:BP	cellular response to oxygen-containing compound	16175	21654		0.3191489361702128	0.3333333333333333	791	15384	17	45	774	15339	16175	0.06479966242015166
M1	string	0	network_modules	22	TRUE	6.847266698286129e-6	154	45	9	0.2	0.05844155844155844	KEGG:04921	KEGG	Oxytocin signaling pathway	8484	378		0.3888888888888889	0.40540540540540543	154	8330	9	36	145	8294	8484	0.09946894976853933
M1	string	0	network_modules	22	TRUE	1.0349448292064074e-5	38	62	6	0.0967741935483871	0.15789473684210525	GO:1903351	GO:BP	cellular response to dopamine	16175	22934		0.3404255319148936	0.375	38	16137	6	56	32	16081	16175	0.1209860271746694
M1	string	0	network_modules	22	TRUE	1.0349448292064074e-5	38	62	6	0.0967741935483871	0.15789473684210525	GO:1903350	GO:BP	response to dopamine	16175	22933		0.3404255319148936	0.375	38	16137	6	56	32	16081	16175	0.1209860271746694
M1	string	0	network_modules	22	TRUE	1.0769920947648359e-5	60	59	7	0.11864406779661017	0.11666666666666667	REAC:R-HSA-977443	REAC	GABA receptor activation	10916	1011		0.5	0.5185185185185185	60	10856	7	52	53	10804	10916	0.11281561670749118
M1	string	0	network_modules	22	TRUE	1.17772752199237e-5	164	45	9	0.2	0.054878048780487805	KEGG:04022	KEGG	cGMP-PKG signaling pathway	8484	251		0.4166666666666667	0.43243243243243246	164	8320	9	36	155	8284	8484	0.09582143445819552
M1	string	0	network_modules	22	TRUE	1.1819944921619682e-5	132	59	9	0.15254237288135594	0.06818181818181818	REAC:R-HSA-9664433	REAC	Leishmania parasite growth and survival	10916	1311		0.5384615384615384	0.5925925925925926	132	10784	9	50	123	10734	10916	0.09472825762551278
M1	string	0	network_modules	22	TRUE	1.1819944921619682e-5	132	59	9	0.15254237288135594	0.06818181818181818	REAC:R-HSA-9662851	REAC	Anti-inflammatory response favouring Leishmania parasite infection	10916	150		0.5384615384615384	0.5925925925925926	132	10784	9	50	123	10734	10916	0.09472825762551278
M1	string	0	network_modules	22	TRUE	1.4304322839172659e-5	40	62	6	0.0967741935483871	0.15	GO:0071869	GO:BP	response to catecholamine	16175	16951		0.3829787234042553	0.4583333333333333	40	16135	6	56	34	16079	16175	0.11777547384467027
M1	string	0	network_modules	22	TRUE	1.4304322839172659e-5	40	62	6	0.0967741935483871	0.15	GO:0071870	GO:BP	cellular response to catecholamine stimulus	16175	16952		0.3829787234042553	0.4583333333333333	40	16135	6	56	34	16079	16175	0.11777547384467027
M1	string	0	network_modules	22	TRUE	1.4304322839172659e-5	40	62	6	0.0967741935483871	0.15	GO:0071867	GO:BP	response to monoamine	16175	16949		0.3829787234042553	0.4583333333333333	40	16135	6	56	34	16079	16175	0.11777547384467027
M1	string	0	network_modules	22	TRUE	1.4304322839172659e-5	40	62	6	0.0967741935483871	0.15	GO:0071868	GO:BP	cellular response to monoamine stimulus	16175	16950		0.3829787234042553	0.4583333333333333	40	16135	6	56	34	16079	16175	0.11777547384467027
M1	string	0	network_modules	22	TRUE	2.2706718013745837e-5	21	62	5	0.08064516129032258	0.23809523809523808	GO:0071880	GO:BP	adenylate cyclase-activating adrenergic receptor signaling pathway	16175	16961		0.46808510638297873	0.4791666666666667	21	16154	5	57	16	16097	16175	0.1366885060490708
M1	string	0	network_modules	22	TRUE	2.463014678889378e-5	129	45	8	0.17777777777777778	0.06201550387596899	KEGG:04926	KEGG	Relaxin signaling pathway	8484	383		0.4444444444444444	0.4594594594594595	129	8355	8	37	121	8318	8484	0.0970154543039756
M1	string	0	network_modules	22	TRUE	2.8834341756555197e-5	89	45	7	0.15555555555555556	0.07865168539325842	KEGG:04727	KEGG	GABAergic synapse	8484	357		0.4722222222222222	0.4864864864864865	89	8395	7	38	82	8357	8484	0.1039727122326556
M1	string	0	network_modules	22	TRUE	3.234167818525075e-5	42	59	6	0.1016949152542373	0.14285714285714285	REAC:R-HSA-375280	REAC	Amine ligand-binding receptors	10916	139		0.6153846153846154	0.6296296296296297	42	10874	6	53	36	10821	10916	0.11651031638772873
M1	string	0	network_modules	22	TRUE	3.6096199285879175e-5	187	45	9	0.2	0.0481283422459893	KEGG:05034	KEGG	Alcoholism	8484	422		0.5	0.5135135135135135	187	8297	9	36	178	8261	8484	0.08851132378790705
M1	string	0	network_modules	22	TRUE	3.700017784779625e-5	136	45	8	0.17777777777777778	0.058823529411764705	KEGG:04915	KEGG	Estrogen signaling pathway	8484	372		0.5277777777777778	0.5405405405405406	136	8348	8	37	128	8311	8484	0.09404562634727272
M1	string	0	network_modules	22	TRUE	4.590682660256996e-5	59	45	6	0.13333333333333333	0.1016949152542373	KEGG:04730	KEGG	Long-term depression	8484	359		0.5555555555555556	0.5675675675675675	59	8425	6	39	53	8386	8484	0.11105180088781844
M1	string	0	network_modules	22	TRUE	7.064675137822418e-5	148	45	8	0.17777777777777778	0.05405405405405406	KEGG:04723	KEGG	Retrograde endocannabinoid signaling	8484	353		0.5833333333333334	0.5945945945945946	148	8336	8	37	140	8299	8484	0.08942832749508203
M1	string	0	network_modules	22	TRUE	7.233036415663628e-5	26	62	5	0.08064516129032258	0.19230769230769232	GO:0071875	GO:BP	adrenergic receptor signaling pathway	16175	16957		0.48936170212765956	0.5	26	16149	5	57	21	16092	16175	0.12238465452480786
M1	string	0	network_modules	22	TRUE	8.942389513081622e-5	105	45	7	0.15555555555555556	0.06666666666666667	KEGG:04928	KEGG	Parathyroid hormone synthesis, secretion and action	8484	385		0.6111111111111112	0.6216216216216216	105	8379	7	38	98	8341	8484	0.09456947275699565
M1	string	0	network_modules	22	TRUE	9.09493823501902e-5	153	45	8	0.17777777777777778	0.05228758169934641	KEGG:04934	KEGG	Cushing syndrome	8484	391		0.6388888888888888	0.6486486486486487	153	8331	8	37	145	8294	8484	0.0876579354150412
M1	string	0	network_modules	22	TRUE	1.0547213525011511e-4	11	62	4	0.06451612903225806	0.36363636363636365	GO:1904321	GO:BP	response to forskolin	16175	23708		0.5106382978723404	0.5416666666666666	11	16164	4	58	7	16106	16175	0.1518963333105838
M1	string	0	network_modules	22	TRUE	1.0547213525011511e-4	11	62	4	0.06451612903225806	0.36363636363636365	GO:1904322	GO:BP	cellular response to forskolin	16175	23709		0.5106382978723404	0.5416666666666666	11	16164	4	58	7	16106	16175	0.1518963333105838
M1	string	0	network_modules	22	TRUE	1.4701915782396478e-4	113	45	7	0.15555555555555556	0.061946902654867256	KEGG:04725	KEGG	Cholinergic synapse	8484	355		0.6666666666666666	0.6756756756756757	113	8371	7	38	106	8333	8484	0.09060333421360618
M1	string	0	network_modules	22	TRUE	1.5775446901247712e-4	12	62	4	0.06451612903225806	0.3333333333333333	GO:0008542	GO:BP	visual learning	16175	3190		0.5531914893617021	0.5625	12	16163	4	58	8	16105	16175	0.14529331612168814
M1	string	0	network_modules	22	TRUE	1.7019370285891787e-4	89	59	7	0.11864406779661017	0.07865168539325842	REAC:R-HSA-111885	REAC	Opioid Signalling	10916	1642		0.6538461538461539	0.6666666666666666	89	10827	7	52	82	10775	10916	0.09057577234812858
M1	string	0	network_modules	22	TRUE	2.7438059652309135e-4	124	45	7	0.15555555555555556	0.056451612903225805	KEGG:04611	KEGG	Platelet activation	8484	321		0.6944444444444444	0.7027027027027027	124	8360	7	38	117	8322	8484	0.0857592784470102
M1	string	0	network_modules	22	TRUE	5.553922825907685e-4	5	59	3	0.05084745762711865	0.6	REAC:R-HSA-390651	REAC	Dopamine receptors	10916	783		0.6923076923076923	0.7037037037037037	5	10911	3	56	2	10855	10916	0.17360276780055128
M1	string	0	network_modules	22	TRUE	5.734022867268956e-4	16	62	4	0.06451612903225806	0.25	GO:0007632	GO:BP	visual behavior	16175	3088		0.574468085106383	0.5833333333333334	16	16159	4	58	12	16101	16175	0.12535529731946696
M1	string	0	network_modules	22	TRUE	5.973642269625296e-4	107	59	7	0.11864406779661017	0.06542056074766354	REAC:R-HSA-163685	REAC	Integration of energy metabolism	10916	1213		0.7307692307692307	0.7407407407407407	107	10809	7	52	100	10757	10916	0.08144159125197904
M1	string	0	network_modules	22	TRUE	6.093561205582962e-4	39	62	5	0.08064516129032258	0.1282051282051282	GO:0045761	GO:BP	regulation of adenylate cyclase activity	16175	11597		0.5957446808510638	0.6041666666666666	39	16136	5	57	34	16079	16175	0.09895036564378977
M1	string	0	network_modules	22	TRUE	6.485911122888464e-4	17	59	4	0.06779661016949153	0.23529411764705882	REAC:R-HSA-164378	REAC	PKA activation in glucagon signalling	10916	1687		0.7692307692307693	0.7777777777777778	17	10899	4	55	13	10844	10916	0.12383183816187246
M1	string	0	network_modules	22	TRUE	7.530013138345929e-4	215	59	9	0.15254237288135594	0.04186046511627907	REAC:R-HSA-9658195	REAC	Leishmania infection	10916	1310		0.8076923076923077	0.8518518518518519	215	10701	9	50	206	10651	10916	0.07047796623249893
M1	string	0	network_modules	22	TRUE	7.530013138345929e-4	215	59	9	0.15254237288135594	0.04186046511627907	REAC:R-HSA-9824443	REAC	Parasitic Infection Pathways	10916	1717		0.8076923076923077	0.8518518518518519	215	10701	9	50	206	10651	10916	0.07047796623249893
M1	string	0	network_modules	22	TRUE	8.200324875404987e-4	619	62	13	0.20967741935483872	0.0210016155088853	GO:1901698	GO:BP	response to nitrogen compound	16175	21651		0.6170212765957447	0.625	619	15556	13	49	606	15507	16175	0.055422990708464334
M1	string	0	network_modules	22	TRUE	0.0010935723414582507	101	45	6	0.13333333333333333	0.0594059405940594	KEGG:05142	KEGG	Chagas disease	8484	434		0.7222222222222222	0.7297297297297297	101	8383	6	39	95	8344	8484	0.08175642432297467
M1	string	0	network_modules	22	TRUE	0.0011012662179608781	153	45	7	0.15555555555555556	0.0457516339869281	KEGG:04261	KEGG	Adrenergic signaling in cardiomyocytes	8484	297		0.75	0.7567567567567568	153	8331	7	38	146	8293	8484	0.07546369854388489
M1	string	0	network_modules	22	TRUE	0.001157331986322087	102	45	6	0.13333333333333333	0.058823529411764705	KEGG:04914	KEGG	Progesterone-mediated oocyte maturation	8484	371		0.7777777777777778	0.7837837837837838	102	8382	6	39	96	8343	8484	0.08128054872159496
M1	string	0	network_modules	22	TRUE	0.0012106856166232331	19	62	4	0.06451612903225806	0.21052631578947367	GO:0008306	GO:BP	associative learning	16175	3162		0.6382978723404256	0.6458333333333334	19	16156	4	58	15	16098	16175	0.11470870912128306
M1	string	0	network_modules	22	TRUE	0.001270459345849937	45	62	5	0.08064516129032258	0.1111111111111111	GO:0031279	GO:BP	regulation of cyclase activity	16175	7103		0.6595744680851063	0.6666666666666666	45	16130	5	57	40	16073	16175	0.09169805537425756
M1	string	0	network_modules	22	TRUE	0.0014928946904944746	223	45	8	0.17777777777777778	0.03587443946188341	KEGG:05163	KEGG	Human cytomegalovirus infection	8484	444		0.8055555555555556	0.8108108108108109	223	8261	8	37	215	8224	8484	0.06914889828770701
M1	string	0	network_modules	22	TRUE	0.001764933382893744	48	62	5	0.08064516129032258	0.10416666666666667	GO:0051339	GO:BP	regulation of lyase activity	16175	13666		0.6808510638297872	0.6875	48	16127	5	57	43	16070	16175	0.0885830078327568
M1	string	0	network_modules	22	TRUE	0.0017730861320611774	6	62	3	0.04838709677419355	0.5	GO:0007191	GO:BP	adenylate cyclase-activating dopamine receptor signaling pathway	16175	2749		0.7021276595744681	0.7291666666666666	6	16169	3	59	3	16110	16175	0.15467570189402804
M1	string	0	network_modules	22	TRUE	0.0017730861320611774	6	62	3	0.04838709677419355	0.5	GO:0060134	GO:BP	prepulse inhibition	16175	14380		0.7021276595744681	0.7291666666666666	6	16169	3	59	3	16110	16175	0.15467570189402804
M1	string	0	network_modules	22	TRUE	0.0019536515234224693	22	59	4	0.06779661016949153	0.18181818181818182	REAC:R-HSA-392170	REAC	ADP signalling through P2Y purinoceptor 12	10916	13		0.8846153846153846	0.8888888888888888	22	10894	4	55	18	10839	10916	0.10812634213743627
M1	string	0	network_modules	22	TRUE	0.0019764462404818933	112	45	6	0.13333333333333333	0.05357142857142857	KEGG:04726	KEGG	Serotonergic synapse	8484	356		0.8333333333333334	0.8378378378378378	112	8372	6	39	106	8333	8484	0.07685932344582691
M1	string	0	network_modules	22	TRUE	0.0019999307624160825	90	62	6	0.0967741935483871	0.06666666666666667	GO:0097305	GO:BP	response to alcohol	16175	18586		0.7446808510638298	0.75	90	16085	6	56	84	16029	16175	0.07606114230210395
M1	string	0	network_modules	22	TRUE	0.00240001617969805	51	62	5	0.08064516129032258	0.09803921568627451	GO:1901655	GO:BP	cellular response to ketone	16175	21622		0.7659574468085106	0.7708333333333334	51	16124	5	57	46	16067	16175	0.08574092085687904
M1	string	0	network_modules	22	TRUE	0.0029236064560198625	120	45	6	0.13333333333333333	0.05	KEGG:04071	KEGG	Sphingolipid signaling pathway	8484	260		0.8611111111111112	0.8648648648648649	120	8364	6	39	114	8325	8484	0.07370554965829433
M1	string	0	network_modules	22	TRUE	0.003202764273210675	54	62	5	0.08064516129032258	0.09259259259259259	GO:0051937	GO:BP	catecholamine transport	16175	14007		0.7872340425531915	0.7916666666666666	54	16121	5	57	49	16064	16175	0.0831334993208679
M1	string	0	network_modules	22	TRUE	0.0034891158007476267	75	45	5	0.1111111111111111	0.06666666666666667	KEGG:04918	KEGG	Thyroid hormone synthesis	8484	375		0.8888888888888888	0.8918918918918919	75	8409	5	40	70	8369	8484	0.0797830930071279
M1	string	0	network_modules	22	TRUE	0.0045862435048203394	58	62	5	0.08064516129032258	0.08620689655172414	GO:0097306	GO:BP	cellular response to alcohol	16175	18587		0.8085106382978723	0.8125	58	16117	5	57	53	16060	16175	0.079968941135318
M1	string	0	network_modules	22	TRUE	0.004937522407565761	8	62	3	0.04838709677419355	0.375	GO:0001964	GO:BP	startle response	16175	572		0.8297872340425532	0.8958333333333334	8	16167	3	59	5	16108	16175	0.1336164052235635
M1	string	0	network_modules	22	TRUE	0.004937522407565761	8	62	3	0.04838709677419355	0.375	GO:0060158	GO:BP	phospholipase C-activating dopamine receptor signaling pathway	16175	14396		0.8297872340425532	0.8958333333333334	8	16167	3	59	5	16108	16175	0.1336164052235635
M1	string	0	network_modules	22	TRUE	0.004937522407565761	8	62	3	0.04838709677419355	0.375	GO:0051940	GO:BP	regulation of catecholamine uptake involved in synaptic transmission	16175	14010		0.8297872340425532	0.8958333333333334	8	16167	3	59	5	16108	16175	0.1336164052235635
M1	string	0	network_modules	22	TRUE	0.004937522407565761	8	62	3	0.04838709677419355	0.375	GO:0051584	GO:BP	regulation of dopamine uptake involved in synaptic transmission	16175	13801		0.8297872340425532	0.8958333333333334	8	16167	3	59	5	16108	16175	0.1336164052235635
M1	string	0	network_modules	22	TRUE	0.004996201703242891	59	62	5	0.08064516129032258	0.0847457627118644	GO:0051952	GO:BP	regulation of amine transport	16175	14022		0.9148936170212766	0.9166666666666666	59	16116	5	57	54	16059	16175	0.07922718786915067
M1	string	0	network_modules	22	TRUE	0.00513554990897984	265	45	8	0.17777777777777778	0.03018867924528302	KEGG:05012	KEGG	Parkinson disease	8484	412		0.9166666666666666	0.918918918918919	265	8219	8	37	257	8182	8484	0.061516642776199566
M1	string	0	network_modules	22	TRUE	0.0053376331892598106	28	59	4	0.06779661016949153	0.14285714285714285	REAC:R-HSA-400042	REAC	Adrenaline,noradrenaline inhibits insulin secretion	10916	124		0.9230769230769231	0.9259259259259259	28	10888	4	55	24	10833	10916	0.0950690951310719
M1	string	0	network_modules	22	TRUE	0.00637526282718855	85	45	5	0.1111111111111111	0.058823529411764705	KEGG:04911	KEGG	Insulin secretion	8484	368		0.9444444444444444	0.9459459459459459	85	8399	5	40	80	8359	8484	0.07412352109321836
M1	string	0	network_modules	22	TRUE	0.006404033663067528	138	45	6	0.13333333333333333	0.043478260869565216	KEGG:04371	KEGG	Apelin signaling pathway	8484	308		0.9722222222222222	0.972972972972973	138	8346	6	39	132	8307	8484	0.06758008612953696
M1	string	0	network_modules	22	TRUE	0.006537534498230399	10	59	3	0.05084745762711865	0.3	REAC:R-HSA-170660	REAC	Adenylate cyclase activating pathway	10916	119		0.9615384615384616	0.9629629629629629	10	10906	3	56	7	10850	10916	0.12166771714890312
M1	string	0	network_modules	22	TRUE	0.007498102316617605	64	62	5	0.08064516129032258	0.078125	GO:0015844	GO:BP	monoamine transport	16175	4954		0.9361702127659575	0.9375	64	16111	5	57	59	16054	16175	0.0757758098468216
M1	string	0	network_modules	22	TRUE	0.008438841510727567	431	62	10	0.16129032258064516	0.02320185614849188	GO:1901699	GO:BP	cellular response to nitrogen compound	16175	21652		0.9574468085106383	0.9583333333333334	431	15744	10	52	421	15692	16175	0.051861325334833015
M1	string	0	network_modules	22	TRUE	0.008633580833150089	211	45	7	0.15555555555555556	0.03317535545023697	KEGG:05207	KEGG	Chemical carcinogenesis - receptor activation	8484	459		1	1	211	8273	7	38	204	8235	8484	0.061279488013301985
M1	string	0	network_modules	22	TRUE	0.009218353081414558	539	62	11	0.1774193548387097	0.02040816326530612	GO:0009725	GO:BP	response to hormone	16175	3623		0.9787234042553191	0.9791666666666666	539	15636	11	51	528	15585	16175	0.04980209625057591
M1	string	0	network_modules	22	TRUE	0.009224495054897922	32	59	4	0.06779661016949153	0.125	REAC:R-HSA-392518	REAC	Signal amplification	10916	2213		1	1	32	10884	4	55	28	10829	10916	0.08844568992723187
M1	string	0	network_modules	22	TRUE	0.009235391099732026	255	62	8	0.12903225806451613	0.03137254901960784	GO:0007610	GO:BP	behavior	16175	3067		1	1	255	15920	8	54	247	15866	16175	0.05640458774091456
M1	string	0	network_modules	23	TRUE	2.0734076756239287e-33	64	39	20	0.5128205128205128	0.3125	REAC:R-HSA-8873719	REAC	RAB geranylgeranylation	10916	1835		0	0.16666666666666666	64	10852	20	19	44	10833	10916	0.39761978853874685
M1	string	0	network_modules	23	TRUE	1.0157350497890704e-31	263	59	28	0.4745762711864407	0.10646387832699619	GO:0006887	GO:BP	exocytosis	16175	2543		0	0.017241379310344827	263	15912	28	31	235	15881	16175	0.21926383438979946
M1	string	0	network_modules	23	TRUE	2.3779451925734015e-29	120	39	21	0.5384615384615384	0.175	REAC:R-HSA-9007101	REAC	Rab regulation of trafficking	10916	1939		0.2	0.3333333333333333	120	10796	21	18	99	10778	10916	0.30291148138251395
M1	string	0	network_modules	23	TRUE	4.892668235249852e-28	88	39	19	0.48717948717948717	0.2159090909090909	REAC:R-HSA-8876198	REAC	RAB GEFs exchange GTP for GDP on RABs	10916	1834		0.4	0.5	88	10828	19	20	69	10808	10916	0.3208250176895664
M1	string	0	network_modules	23	TRUE	2.3120138764951243e-23	583	59	29	0.4915254237288136	0.04974271012006861	GO:0032940	GO:BP	secretion by cell	16175	7926		0.017543859649122806	0.034482758620689655	583	15592	29	30	554	15562	16175	0.14785221479281863
M1	string	0	network_modules	23	TRUE	4.323926815600738e-22	646	59	29	0.4915254237288136	0.04489164086687306	GO:0140352	GO:BP	export from cell	16175	19748		0.03508771929824561	0.05172413793103448	646	15529	29	30	617	15499	16175	0.13953891158378326
M1	string	0	network_modules	23	TRUE	4.93290158835135e-22	649	59	29	0.4915254237288136	0.04468412942989214	GO:0046903	GO:BP	secretion	16175	12430		0.05263157894736842	0.06896551724137931	649	15526	29	30	620	15496	16175	0.13917229534659653
M1	string	0	network_modules	23	TRUE	1.2510630723988717e-16	148	59	16	0.2711864406779661	0.10810810810810811	GO:0017157	GO:BP	regulation of exocytosis	16175	5287		0.07017543859649122	0.08620689655172414	148	16027	16	43	132	15984	16175	0.16651237273060218
M1	string	0	network_modules	23	TRUE	9.707963130180682e-15	404	59	20	0.3389830508474576	0.04950495049504951	GO:1903530	GO:BP	regulation of secretion by cell	16175	23080		0.08771929824561403	0.10344827586206896	404	15771	20	39	384	15732	16175	0.12174738412662447
M1	string	0	network_modules	23	TRUE	1.2343629138541313e-14	409	59	20	0.3389830508474576	0.0488997555012225	GO:0060627	GO:BP	regulation of vesicle-mediated transport	16175	14803		0.10526315789473684	0.1206896551724138	409	15766	20	39	389	15727	16175	0.12090096751995331
M1	string	0	network_modules	23	TRUE	1.9913826126004266e-14	161	59	15	0.2542372881355932	0.09316770186335403	GO:0045055	GO:BP	regulated exocytosis	16175	11253		0.12280701754385964	0.13793103448275862	161	16014	15	44	146	15970	16175	0.1488926387581112
M1	string	0	network_modules	23	TRUE	5.587814076271107e-14	442	59	20	0.3389830508474576	0.04524886877828054	GO:0051046	GO:BP	regulation of secretion	16175	13456		0.14035087719298245	0.15517241379310345	442	15733	20	39	422	15694	16175	0.11566488982670788
M1	string	0	network_modules	23	TRUE	3.34865185696707e-10	250	59	14	0.23728813559322035	0.056	GO:0009306	GO:BP	protein secretion	16175	3452		0.15789473684210525	0.1724137931034483	250	15925	14	45	236	15880	16175	0.1088069152674292
M1	string	0	network_modules	23	TRUE	3.537145096966721e-10	251	59	14	0.23728813559322035	0.055776892430278883	GO:0035592	GO:BP	establishment of protein localization to extracellular region	16175	9108		0.17543859649122806	0.1896551724137931	251	15924	14	45	237	15879	16175	0.10856309712339793
M1	string	0	network_modules	23	TRUE	5.156168100903914e-10	258	59	14	0.23728813559322035	0.05426356589147287	GO:0071692	GO:BP	protein localization to extracellular region	16175	16860		0.19298245614035087	0.20689655172413793	258	15917	14	45	244	15872	16175	0.10689475363189276
M1	string	0	network_modules	23	TRUE	8.101223293427626e-10	36	59	8	0.13559322033898305	0.2222222222222222	GO:0006904	GO:BP	vesicle docking involved in exocytosis	16175	2556		0.21052631578947367	0.22413793103448276	36	16139	8	51	28	16088	16175	0.17123885750648588
M1	string	0	network_modules	23	TRUE	3.0901647798801704e-8	55	59	8	0.13559322033898305	0.14545454545454545	GO:0048278	GO:BP	vesicle docking	16175	12620		0.22807017543859648	0.2413793103448276	55	16120	8	51	47	16069	16175	0.13739975846163943
M1	string	0	network_modules	23	TRUE	3.5950735280835885e-8	56	59	8	0.13559322033898305	0.14285714285714285	GO:0140029	GO:BP	exocytic process	16175	19642		0.24561403508771928	0.25862068965517243	56	16119	8	51	48	16068	16175	0.1361079879085097
M1	string	0	network_modules	23	TRUE	3.769577167433028e-8	87	59	9	0.15254237288135594	0.10344827586206896	GO:1903305	GO:BP	regulation of regulated secretory pathway	16175	22892		0.2631578947368421	0.27586206896551724	87	16088	9	50	78	16038	16175	0.12173955648887688
M1	string	0	network_modules	23	TRUE	4.666542024869331e-8	519	59	16	0.2711864406779661	0.030828516377649325	GO:0051640	GO:BP	organelle localization	16175	13853		0.2807017543859649	0.29310344827586204	519	15656	16	43	503	15613	16175	0.08209126575779152
M1	string	0	network_modules	23	TRUE	1.5089064027973942e-7	195	59	11	0.1864406779661017	0.05641025641025641	GO:1903532	GO:BP	positive regulation of secretion by cell	16175	23082		0.2982456140350877	0.3103448275862069	195	15980	11	48	184	15932	16175	0.09668190283105571
M1	string	0	network_modules	23	TRUE	1.8087611437228382e-7	68	59	8	0.13559322033898305	0.11764705882352941	GO:0045921	GO:BP	positive regulation of exocytosis	16175	11715		0.3157894736842105	0.3275862068965517	68	16107	8	51	60	16056	16175	0.12286821651593147
M1	string	0	network_modules	23	TRUE	2.2970205718268774e-7	70	59	8	0.13559322033898305	0.11428571428571428	GO:0140056	GO:BP	organelle localization by membrane tethering	16175	19654		0.3333333333333333	0.3448275862068966	70	16105	8	51	62	16054	16175	0.12099378356783846
M1	string	0	network_modules	23	TRUE	3.4350106404352666e-7	594	59	16	0.2711864406779661	0.026936026936026935	GO:0051668	GO:BP	localization within membrane	16175	13880		0.3508771929824561	0.3620689655172414	594	15581	16	43	578	15538	16175	0.0754267311073985
M1	string	0	network_modules	23	TRUE	3.5150732835389105e-7	211	59	11	0.1864406779661017	0.052132701421800945	GO:0051047	GO:BP	positive regulation of secretion	16175	13457		0.3684210526315789	0.3793103448275862	211	15964	11	48	200	15916	16175	0.09246306636368518
M1	string	0	network_modules	23	TRUE	3.5273225021623657e-7	504	59	15	0.2542372881355932	0.02976190476190476	GO:0072657	GO:BP	protein localization to membrane	16175	17478		0.38596491228070173	0.39655172413793105	504	15671	15	44	489	15627	16175	0.07768460525474782
M1	string	0	network_modules	23	TRUE	6.857675839542124e-7	80	59	8	0.13559322033898305	0.1	GO:0022406	GO:BP	membrane docking	16175	6597		0.40350877192982454	0.41379310344827586	80	16095	8	51	72	16044	16175	0.11268125476001255
M1	string	0	network_modules	23	TRUE	7.967896468303978e-7	50	59	7	0.11864406779661017	0.14	GO:0017156	GO:BP	calcium-ion regulated exocytosis	16175	5286		0.42105263157894735	0.43103448275862066	50	16125	7	52	43	16073	16175	0.12594692465368829
M1	string	0	network_modules	23	TRUE	7.085664935061689e-6	248	22	8	0.36363636363636365	0.03225806451612903	KEGG:04144	KEGG	Endocytosis	8484	280		NA	1	248	8236	8	14	240	8222	8484	0.10121947319855555
M1	string	0	network_modules	23	TRUE	2.0749608277969027e-5	239	59	10	0.1694915254237288	0.04184100418410042	GO:0090150	GO:BP	establishment of protein localization to membrane	16175	18059		0.43859649122807015	0.4482758620689655	239	15936	10	49	229	15887	16175	0.07758669702253634
M1	string	0	network_modules	23	TRUE	2.0756777984698815e-5	311	59	11	0.1864406779661017	0.03536977491961415	GO:0023061	GO:BP	signal release	16175	6645		0.45614035087719296	0.46551724137931033	311	15864	11	48	300	15816	16175	0.07367606025061957
M1	string	0	network_modules	23	TRUE	2.3682164618042584e-5	315	59	11	0.1864406779661017	0.03492063492063492	GO:0016050	GO:BP	vesicle organization	16175	5082		0.47368421052631576	0.4827586206896552	315	15860	11	48	304	15812	16175	0.07310773168744909
M1	string	0	network_modules	23	TRUE	6.984874552951312e-5	3	59	3	0.05084745762711865	1	GO:0097051	GO:BP	establishment of protein localization to endoplasmic reticulum membrane	16175	18464		0.49122807017543857	0.5	3	16172	3	56	0	16116	16175	0.2251030526526565
M1	string	0	network_modules	23	TRUE	7.845368585674498e-5	145	59	8	0.13559322033898305	0.05517241379310345	GO:0006836	GO:BP	neurotransmitter transport	16175	2506		0.5087719298245614	0.5172413793103449	145	16030	8	51	137	15979	16175	0.08128741044873028
M1	string	0	network_modules	23	TRUE	1.1882456594141759e-4	101	59	7	0.11864406779661017	0.06930693069306931	GO:0099643	GO:BP	signal release from synapse	16175	19183		0.5263157894736842	0.5517241379310345	101	16074	7	52	94	16022	16175	0.086334580241537
M1	string	0	network_modules	23	TRUE	1.1882456594141759e-4	101	59	7	0.11864406779661017	0.06930693069306931	GO:0007269	GO:BP	neurotransmitter secretion	16175	2797		0.5263157894736842	0.5517241379310345	101	16074	7	52	94	16022	16175	0.086334580241537
M1	string	0	network_modules	23	TRUE	1.6839051527704164e-4	44	39	5	0.1282051282051282	0.11363636363636363	REAC:R-HSA-8854214	REAC	TBC/RABGAPs	10916	2420		0.6	0.6666666666666666	44	10872	5	34	39	10838	10916	0.11735243176121139
M1	string	0	network_modules	23	TRUE	2.456436560178801e-4	35	59	5	0.0847457627118644	0.14285714285714285	GO:1903307	GO:BP	positive regulation of regulated secretory pathway	16175	22894		0.5614035087719298	0.5689655172413793	35	16140	5	54	30	16086	16175	0.10753278776883239
M1	string	0	network_modules	23	TRUE	2.786693706136654e-4	4	59	3	0.05084745762711865	0.75	GO:0048210	GO:BP	Golgi vesicle fusion to target membrane	16175	12586		0.5789473684210527	0.5862068965517241	4	16171	3	56	1	16115	16175	0.19471308711826965
M1	string	0	network_modules	23	TRUE	4.2604913268240875e-4	16	59	4	0.06779661016949153	0.25	GO:0048791	GO:BP	calcium ion-regulated exocytosis of neurotransmitter	16175	13037		0.5964912280701754	0.603448275862069	16	16159	4	55	12	16104	16175	0.12858763090849887
M1	string	0	network_modules	23	TRUE	4.679983213804945e-4	253	59	9	0.15254237288135594	0.03557312252964427	GO:0072659	GO:BP	protein localization to plasma membrane	16175	17480		0.6140350877192983	0.6206896551724138	253	15922	9	50	244	15872	16175	0.0667558085147647
M1	string	0	network_modules	23	TRUE	7.423274808653192e-4	653	59	13	0.22033898305084745	0.019908116385911178	GO:0051050	GO:BP	positive regulation of transport	16175	13460		0.631578947368421	0.6379310344827587	653	15522	13	46	640	15476	16175	0.05532311470967612
M1	string	0	network_modules	23	TRUE	8.085281683217528e-4	270	59	9	0.15254237288135594	0.03333333333333333	GO:0016197	GO:BP	endosomal transport	16175	5169		0.6491228070175439	0.6551724137931034	270	15905	9	50	261	15855	16175	0.06415823649549306
M1	string	0	network_modules	23	TRUE	9.599512401934582e-4	137	59	7	0.11864406779661017	0.051094890510948905	GO:0098876	GO:BP	vesicle-mediated transport to the plasma membrane	16175	18924		0.6666666666666666	0.6724137931034483	137	16038	7	52	130	15986	16175	0.07274216296811996
M1	string	0	network_modules	23	TRUE	0.0012701379291448415	285	59	9	0.15254237288135594	0.031578947368421054	GO:1990778	GO:BP	protein localization to cell periphery	16175	25286		0.6842105263157895	0.6896551724137931	285	15890	9	50	276	15840	16175	0.06205002405902846
M1	string	0	network_modules	23	TRUE	0.0013861203255169316	6	59	3	0.05084745762711865	0.5	GO:0061669	GO:BP	spontaneous neurotransmitter secretion	16175	15606		0.7017543859649122	0.7068965517241379	6	16169	3	56	3	16113	16175	0.15860388501909614
M1	string	0	network_modules	23	TRUE	0.0017666840805487425	476	39	10	0.2564102564102564	0.02100840336134454	REAC:R-HSA-6798695	REAC	Neutrophil degranulation	10916	1597		0.8	0.8333333333333334	476	10440	10	29	466	10411	10916	0.06239767814587706
M1	string	0	network_modules	23	TRUE	0.0022324272951959436	98	59	6	0.1016949152542373	0.061224489795918366	GO:0019882	GO:BP	antigen processing and presentation	16175	6060		0.7192982456140351	0.7241379310344828	98	16077	6	53	92	16024	16175	0.07456728914392238
M1	string	0	network_modules	23	TRUE	0.002369781975275772	99	59	6	0.1016949152542373	0.06060606060606061	GO:0006906	GO:BP	vesicle fusion	16175	2557		0.7368421052631579	0.7413793103448276	99	16076	6	53	93	16023	16175	0.07414407697454903
M1	string	0	network_modules	23	TRUE	0.0024029071065147212	157	59	7	0.11864406779661017	0.044585987261146494	GO:0061025	GO:BP	membrane fusion	16175	15142		0.7543859649122807	0.7586206896551724	157	16018	7	52	150	15966	16175	0.06723045024186958
M1	string	0	network_modules	23	TRUE	0.002419413151085677	7	59	3	0.05084745762711865	0.42857142857142855	GO:0045054	GO:BP	constitutive secretory pathway	16175	11252		0.7719298245614035	0.7758620689655172	7	16168	3	56	4	16112	16175	0.14666335156642943
M1	string	0	network_modules	23	TRUE	0.0024338903875063124	24	59	4	0.06779661016949153	0.16666666666666666	GO:0090382	GO:BP	phagosome maturation	16175	18256		0.7894736842105263	0.7931034482758621	24	16151	4	55	20	16096	16175	0.10423989308450525
M1	string	0	network_modules	23	TRUE	0.0026652379118682567	101	59	6	0.1016949152542373	0.0594059405940594	GO:0090174	GO:BP	organelle membrane fusion	16175	18081		0.8070175438596491	0.8103448275862069	101	16074	6	53	95	16021	16175	0.07331589924842771
M1	string	0	network_modules	23	TRUE	0.00325218696269075	58	59	5	0.0847457627118644	0.08620689655172414	GO:0033059	GO:BP	cellular pigmentation	16175	8013		0.8245614035087719	0.8448275862068966	58	16117	5	54	53	16063	16175	0.08215377213678526
M1	string	0	network_modules	23	TRUE	0.00325218696269075	58	59	5	0.0847457627118644	0.08620689655172414	GO:0016079	GO:BP	synaptic vesicle exocytosis	16175	5106		0.8245614035087719	0.8448275862068966	58	16117	5	54	53	16063	16175	0.08215377213678526
M1	string	0	network_modules	23	TRUE	0.0038489641298294097	524	59	11	0.1864406779661017	0.02099236641221374	GO:0006886	GO:BP	intracellular protein transport	16175	2542		0.8596491228070176	0.8620689655172413	524	15651	11	48	513	15603	16175	0.05264445075419456
M1	string	0	network_modules	23	TRUE	0.0053219547204241035	64	59	5	0.0847457627118644	0.078125	GO:1990849	GO:BP	vacuolar localization	16175	25315		0.8771929824561403	0.896551724137931	64	16111	5	54	59	16057	16175	0.07786510510222631
M1	string	0	network_modules	23	TRUE	0.0053219547204241035	64	59	5	0.0847457627118644	0.078125	GO:0032418	GO:BP	lysosome localization	16175	7556		0.8771929824561403	0.896551724137931	64	16111	5	54	59	16057	16175	0.07786510510222631
M1	string	0	network_modules	23	TRUE	0.005776487186380974	9	59	3	0.05084745762711865	0.3333333333333333	GO:0060478	GO:BP	acrosomal vesicle exocytosis	16175	14672		0.9122807017543859	0.9137931034482759	9	16166	3	56	6	16110	16175	0.12903566669258948
M1	string	0	network_modules	23	TRUE	0.0061899304011908	181	59	7	0.11864406779661017	0.03867403314917127	GO:0050708	GO:BP	regulation of protein secretion	16175	13223		0.9298245614035088	0.9310344827586207	181	15994	7	52	174	15942	16175	0.061808222771728635
M1	string	0	network_modules	23	TRUE	0.006288055259488239	117	59	6	0.1016949152542373	0.05128205128205128	GO:0099504	GO:BP	synaptic vesicle cycle	16175	19100		0.9473684210526315	0.9482758620689655	117	16058	6	53	111	16005	16175	0.06744627758148238
M1	string	0	network_modules	23	TRUE	0.007640626502249316	121	59	6	0.1016949152542373	0.049586776859504134	GO:0099003	GO:BP	vesicle-mediated transport in synapse	16175	18999		0.9649122807017544	0.9655172413793104	121	16054	6	53	115	16001	16175	0.06615670678036221
M1	string	0	network_modules	23	TRUE	0.0080593244676907	32	59	4	0.06779661016949153	0.125	GO:0017158	GO:BP	regulation of calcium ion-dependent exocytosis	16175	5288		0.9824561403508771	0.9827586206896551	32	16143	4	55	28	16088	16175	0.08962328831149852
M1	string	0	network_modules	23	TRUE	0.00810206119379375	684	59	12	0.2033898305084746	0.017543859649122806	GO:0032880	GO:BP	regulation of protein localization	16175	7877		1	1	684	15491	12	47	672	15444	16175	0.04843683563157695
M1	string	0	network_modules	23	TRUE	0.00879458687926483	16	39	3	0.07692307692307693	0.1875	REAC:R-HSA-264642	REAC	Acetylcholine Neurotransmitter Release Cycle	10916	53		1	1	16	10900	3	36	13	10864	10916	0.11810533319127609
M1	string	0	network_modules	24	TRUE	4.4818663407641375e-26	791	60	34	0.5666666666666667	0.04298356510745891	GO:0000122	GO:BP	negative regulation of transcription by RNA polymerase II	16175	48		0	0.004016064257028112	791	15384	34	26	757	15358	16175	0.14649195194923662
M1	string	0	network_modules	24	TRUE	3.2871203831330613e-23	78	60	17	0.2833333333333333	0.21794871794871795	GO:2000628	GO:BP	regulation of miRNA metabolic process	16175	25910		0.004032258064516129	0.008032128514056224	78	16097	17	43	61	16054	16175	0.24531689467785636
M1	string	0	network_modules	24	TRUE	1.2824601281882088e-22	65	60	16	0.26666666666666666	0.24615384615384617	GO:1902893	GO:BP	regulation of miRNA transcription	16175	22593		0.008064516129032258	0.012048192771084338	65	16110	16	44	49	16066	16175	0.2533229908222412
M1	string	0	network_modules	24	TRUE	1.6884984594462605e-22	66	60	16	0.26666666666666666	0.24242424242424243	GO:0061614	GO:BP	miRNA transcription	16175	15585		0.012096774193548387	0.01606425702811245	66	16109	16	44	50	16065	16175	0.25134517797843525
M1	string	0	network_modules	24	TRUE	8.703254585581652e-22	93	60	17	0.2833333333333333	0.1827956989247312	GO:0010586	GO:BP	miRNA metabolic process	16175	4234		0.016129032258064516	0.020080321285140562	93	16082	17	43	76	16039	16175	0.22402023456155867
M1	string	0	network_modules	24	TRUE	4.1701899722052975e-20	218	59	23	0.3898305084745763	0.10550458715596331	KEGG:05166	KEGG	Human T-cell leukemia virus 1 infection	8484	447		0	0.011111111111111112	218	8266	23	36	195	8230	8484	0.1925875843147679
M1	string	0	network_modules	24	TRUE	1.5743458489879177e-19	171	59	20	0.3389830508474576	0.11695906432748537	REAC:R-HSA-3108232	REAC	SUMO E3 ligases SUMOylate target proteins	10916	2163		0	0.006802721088435374	171	10745	20	39	151	10706	10916	0.19193898546665616
M1	string	0	network_modules	24	TRUE	3.201313537257138e-19	177	59	20	0.3389830508474576	0.11299435028248588	REAC:R-HSA-2990846	REAC	SUMOylation	10916	2167		0.00684931506849315	0.013605442176870748	177	10739	20	39	157	10700	10916	0.18838961627549847
M1	string	0	network_modules	24	TRUE	2.1163677257373504e-17	57	60	13	0.21666666666666667	0.22807017543859648	GO:2000630	GO:BP	positive regulation of miRNA metabolic process	16175	25912		0.020161290322580645	0.024096385542168676	57	16118	13	47	44	16071	16175	0.21947357567274295
M1	string	0	network_modules	24	TRUE	4.2315722038737174e-17	162	59	19	0.3220338983050847	0.11728395061728394	KEGG:05161	KEGG	Hepatitis B	8484	442		0.011235955056179775	0.022222222222222223	162	8322	19	40	143	8282	8484	0.18523614071854222
M1	string	0	network_modules	24	TRUE	5.726053345227477e-17	194	59	20	0.3389830508474576	0.10309278350515463	KEGG:05167	KEGG	Kaposi sarcoma-associated herpesvirus infection	8484	448		0.02247191011235955	0.03333333333333333	194	8290	20	39	174	8251	8484	0.17697450893259434
M1	string	0	network_modules	24	TRUE	6.24015630579545e-17	701	60	26	0.43333333333333335	0.037089871611982884	GO:0009628	GO:BP	response to abiotic stimulus	16175	3549		0.024193548387096774	0.028112449799196786	701	15474	26	34	675	15440	16175	0.11687007539994608
M1	string	0	network_modules	24	TRUE	1.358387823040068e-16	97	59	16	0.2711864406779661	0.16494845360824742	KEGG:05215	KEGG	Prostate cancer	8484	466		0.033707865168539325	0.044444444444444446	97	8387	16	43	81	8344	8484	0.20446235216217118
M1	string	0	network_modules	24	TRUE	1.7366791608278446e-16	121	59	17	0.288135593220339	0.14049586776859505	KEGG:04919	KEGG	Thyroid hormone signaling pathway	8484	376		0.0449438202247191	0.05555555555555555	121	8363	17	42	104	8321	8484	0.19329379568004576
M1	string	0	network_modules	24	TRUE	2.069259175289062e-16	48	60	12	0.2	0.25	GO:1902895	GO:BP	positive regulation of miRNA transcription	16175	22595		0.028225806451612902	0.0321285140562249	48	16127	12	48	36	16079	16175	0.22102689466750441
M1	string	0	network_modules	24	TRUE	3.4577231882297764e-16	520	60	23	0.38333333333333336	0.04423076923076923	GO:0033993	GO:BP	response to lipid	16175	8371		0.03225806451612903	0.03614457831325301	520	15655	23	37	497	15618	16175	0.12148214607918302
M1	string	0	network_modules	24	TRUE	7.695981208611029e-16	539	60	23	0.38333333333333336	0.04267161410018553	GO:0009725	GO:BP	response to hormone	16175	3623		0.036290322580645164	0.040160642570281124	539	15636	23	37	516	15599	16175	0.11899490753833773
M1	string	0	network_modules	24	TRUE	1.2585300708774655e-15	791	60	26	0.43333333333333335	0.03286978508217446	GO:1901701	GO:BP	cellular response to oxygen-containing compound	16175	21654		0.04032258064516129	0.04417670682730924	791	15384	26	34	765	15350	16175	0.10876770155175364
M1	string	0	network_modules	24	TRUE	3.6297493420060035e-15	95	59	15	0.2542372881355932	0.15789473684210525	KEGG:01522	KEGG	Endocrine resistance	8484	196		0.056179775280898875	0.06666666666666667	95	8389	15	44	80	8345	8484	0.1932867584117555
M1	string	0	network_modules	24	TRUE	6.585377514226786e-15	24	59	10	0.1694915254237288	0.4166666666666667	REAC:R-HSA-4090294	REAC	SUMOylation of intracellular receptors	10916	2175		0.0136986301369863	0.02040816326530612	24	10892	10	49	14	10843	10916	0.2633011359579276
M1	string	0	network_modules	24	TRUE	1.3015720190811302e-14	155	59	17	0.288135593220339	0.10967741935483871	KEGG:04218	KEGG	Cellular senescence	8484	295		0.06741573033707865	0.07777777777777778	155	8329	17	42	138	8287	8484	0.168627133082301
M1	string	0	network_modules	24	TRUE	1.7425451822043254e-14	105	59	15	0.2542372881355932	0.14285714285714285	KEGG:04659	KEGG	Th17 cell differentiation	8484	337		0.07865168539325842	0.08888888888888889	105	8379	15	44	90	8335	8484	0.18306988175462177
M1	string	0	network_modules	24	TRUE	3.539957361359224e-14	418	59	22	0.3728813559322034	0.05263157894736842	REAC:R-HSA-5663202	REAC	Diseases of signal transduction by growth factor receptors and second messengers	10916	773		0.02054794520547945	0.027210884353741496	418	10498	22	37	396	10461	10916	0.12853007806397454
M1	string	0	network_modules	24	TRUE	3.6334011407049607e-14	128	60	14	0.23333333333333334	0.109375	GO:0018205	GO:BP	peptidyl-lysine modification	16175	5364		0.04435483870967742	0.04819277108433735	128	16047	14	46	114	16001	16175	0.15523694076173716
M1	string	0	network_modules	24	TRUE	1.2854356197992896e-13	290	59	19	0.3220338983050847	0.06551724137931035	REAC:R-HSA-9006931	REAC	Signaling by Nuclear Receptors	10916	2289		0.0273972602739726	0.034013605442176874	290	10626	19	40	271	10586	10916	0.13544415424085265
M1	string	0	network_modules	24	TRUE	1.8721643598882013e-13	76	59	13	0.22033898305084745	0.17105263157894737	KEGG:05212	KEGG	Pancreatic cancer	8484	463		0.0898876404494382	0.1111111111111111	76	8408	13	46	63	8362	8484	0.18773895541811578
M1	string	0	network_modules	24	TRUE	1.8721643598882013e-13	76	59	13	0.22033898305084745	0.17105263157894737	KEGG:05220	KEGG	Chronic myeloid leukemia	8484	471		0.0898876404494382	0.1111111111111111	76	8408	13	46	63	8362	8484	0.18773895541811578
M1	string	0	network_modules	24	TRUE	2.6355025400628387e-13	100	59	14	0.23728813559322035	0.14	KEGG:04933	KEGG	AGE-RAGE signaling pathway in diabetic complications	8484	390		0.11235955056179775	0.12222222222222222	100	8384	14	45	86	8339	8484	0.1748497499074842
M1	string	0	network_modules	24	TRUE	4.900984456698222e-13	638	60	22	0.36666666666666664	0.034482758620689655	GO:0018193	GO:BP	peptidyl-amino acid modification	16175	5353		0.04838709677419355	0.05220883534136546	638	15537	22	38	616	15499	16175	0.10257812742146424
M1	string	0	network_modules	24	TRUE	9.609533939827833e-13	232	59	17	0.288135593220339	0.07327586206896551	REAC:R-HSA-157118	REAC	Signaling by NOTCH	10916	2274		0.03424657534246575	0.04081632653061224	232	10684	17	42	215	10642	10916	0.1364091789682301
M1	string	0	network_modules	24	TRUE	1.0525928410615468e-12	162	60	14	0.23333333333333334	0.08641975308641975	GO:0007623	GO:BP	circadian rhythm	16175	3080		0.05241935483870968	0.05622489959839357	162	16013	14	46	148	15967	16175	0.13684671976734541
M1	string	0	network_modules	24	TRUE	1.073942348700631e-12	201	59	17	0.288135593220339	0.0845771144278607	KEGG:05203	KEGG	Viral carcinogenesis	8484	455		0.12359550561797752	0.13333333333333333	201	8283	17	42	184	8241	8484	0.1455068596975354
M1	string	0	network_modules	24	TRUE	1.114751834216058e-12	194	59	16	0.2711864406779661	0.08247422680412371	REAC:R-HSA-2559583	REAC	Cellular Senescence	10916	331		0.0410958904109589	0.047619047619047616	194	10722	16	43	178	10679	10916	0.14139272796665078
M1	string	0	network_modules	24	TRUE	1.854373950050622e-12	519	60	20	0.3333333333333333	0.038535645472061654	GO:0070848	GO:BP	response to growth factor	16175	16340		0.056451612903225805	0.060240963855421686	519	15656	20	40	499	15616	16175	0.10430451015602943
M1	string	0	network_modules	24	TRUE	2.214790246341538e-12	451	60	19	0.31666666666666665	0.04212860310421286	GO:0032870	GO:BP	cellular response to hormone stimulus	16175	7867		0.06048387096774194	0.0642570281124498	451	15724	19	41	432	15683	16175	0.10703068305367149
M1	string	0	network_modules	24	TRUE	2.259981070073302e-12	171	60	14	0.23333333333333334	0.08187134502923976	GO:0070482	GO:BP	response to oxygen levels	16175	16143		0.06451612903225806	0.06827309236947791	171	16004	14	46	157	15958	16175	0.13290229938070047
M1	string	0	network_modules	24	TRUE	3.3683993562799686e-12	615	60	21	0.35	0.03414634146341464	GO:0045597	GO:BP	positive regulation of cell differentiation	16175	11448		0.06854838709677419	0.07228915662650602	615	15560	21	39	594	15521	16175	0.09953753431879953
M1	string	0	network_modules	24	TRUE	3.5929876602942073e-12	617	60	21	0.35	0.03403565640194489	GO:0051093	GO:BP	negative regulation of developmental process	16175	13488		0.07258064516129033	0.07630522088353414	617	15558	21	39	596	15519	16175	0.09934307696983936
M1	string	0	network_modules	24	TRUE	5.128570278751958e-12	83	59	12	0.2033898305084746	0.14457831325301204	REAC:R-HSA-9843745	REAC	Adipogenesis	10916	122		0.04794520547945205	0.061224489795918366	83	10833	12	47	71	10786	10916	0.16615121578015232
M1	string	0	network_modules	24	TRUE	5.128570278751958e-12	83	59	12	0.2033898305084746	0.14457831325301204	REAC:R-HSA-381340	REAC	Transcriptional regulation of white adipocyte differentiation	10916	2562		0.04794520547945205	0.061224489795918366	83	10833	12	47	71	10786	10916	0.16615121578015232
M1	string	0	network_modules	24	TRUE	6.334108555030656e-12	184	60	14	0.23333333333333334	0.07608695652173914	GO:0048511	GO:BP	rhythmic process	16175	12796		0.07661290322580645	0.08032128514056225	184	15991	14	46	170	15945	16175	0.1277110152776012
M1	string	0	network_modules	24	TRUE	6.451270079526557e-12	408	60	18	0.3	0.04411764705882353	GO:0071396	GO:BP	cellular response to lipid	16175	16648		0.08064516129032258	0.08433734939759036	408	15767	18	42	390	15725	16175	0.10692487850294018
M1	string	0	network_modules	24	TRUE	9.263958515372869e-12	192	59	16	0.2711864406779661	0.08333333333333333	KEGG:05202	KEGG	Transcriptional misregulation in cancer	8484	454		0.1348314606741573	0.14444444444444443	192	8292	16	43	176	8249	8484	0.139857259152899
M1	string	0	network_modules	24	TRUE	1.1859724200704043e-11	744	60	22	0.36666666666666664	0.02956989247311828	GO:0072359	GO:BP	circulatory system development	16175	17370		0.0846774193548387	0.08835341365461848	744	15431	22	38	722	15393	16175	0.09340696477128568
M1	string	0	network_modules	24	TRUE	1.3733756668817208e-11	66	59	11	0.1864406779661017	0.16666666666666666	REAC:R-HSA-9614085	REAC	FOXO-mediated transcription	10916	923		0.06164383561643835	0.06802721088435375	66	10850	11	48	55	10802	10916	0.17154224391548875
M1	string	0	network_modules	24	TRUE	1.3944064696806855e-11	118	59	13	0.22033898305084745	0.11016949152542373	REAC:R-HSA-8878166	REAC	Transcriptional regulation by RUNX2	10916	2553		0.0684931506849315	0.07482993197278912	118	10798	13	46	105	10752	10916	0.1493710472917736
M1	string	0	network_modules	24	TRUE	1.4627599352431892e-11	152	60	13	0.21666666666666667	0.08552631578947369	GO:0001666	GO:BP	response to hypoxia	16175	377		0.08870967741935484	0.09236947791164658	152	16023	13	47	139	15976	16175	0.13108299077236907
M1	string	0	network_modules	24	TRUE	1.555066068367769e-11	502	60	19	0.31666666666666665	0.037848605577689244	GO:0071363	GO:BP	cellular response to growth factor stimulus	16175	16615		0.09274193548387097	0.0963855421686747	502	15673	19	41	483	15632	16175	0.10050377025058607
M1	string	0	network_modules	24	TRUE	1.8903266277922067e-11	155	60	13	0.21666666666666667	0.08387096774193549	GO:0036293	GO:BP	response to decreased oxygen levels	16175	9544		0.0967741935483871	0.10040160642570281	155	16020	13	47	142	15973	16175	0.12970423371694975
M1	string	0	network_modules	24	TRUE	2.758516881412846e-11	95	59	12	0.2033898305084746	0.12631578947368421	REAC:R-HSA-8878159	REAC	Transcriptional regulation by RUNX3	10916	2554		0.07534246575342465	0.08163265306122448	95	10821	12	47	83	10774	10916	0.1545169352922468
M1	string	0	network_modules	24	TRUE	3.100539299963529e-11	50	59	10	0.1694915254237288	0.2	REAC:R-HSA-2173793	REAC	Transcriptional activity of SMAD2/SMAD3:SMAD4 heterotrimer	10916	2550		0.0821917808219178	0.08843537414965986	50	10866	10	49	40	10817	10916	0.1800381872825786
M1	string	0	network_modules	24	TRUE	3.176422188282119e-11	86	59	12	0.2033898305084746	0.13953488372093023	KEGG:05210	KEGG	Colorectal cancer	8484	461		0.14606741573033707	0.15555555555555556	86	8398	12	47	74	8351	8484	0.161447388729627
M1	string	0	network_modules	24	TRUE	3.550248737696623e-11	25	60	8	0.13333333333333333	0.32	GO:1902894	GO:BP	negative regulation of miRNA transcription	16175	22594		0.10080645161290322	0.10441767068273092	25	16150	8	52	17	16098	16175	0.20470266498341533
M1	string	0	network_modules	24	TRUE	7.245728184714365e-11	27	60	8	0.13333333333333333	0.2962962962962963	GO:2000629	GO:BP	negative regulation of miRNA metabolic process	16175	25911		0.10483870967741936	0.10843373493975904	27	16148	8	52	19	16096	16175	0.1968026088563286
M1	string	0	network_modules	24	TRUE	7.265430113476739e-11	253	59	16	0.2711864406779661	0.06324110671936758	REAC:R-HSA-1257604	REAC	PIP3 activates AKT signaling	10916	1679		0.08904109589041095	0.09523809523809523	253	10663	16	43	237	10620	10916	0.12150744331307763
M1	string	0	network_modules	24	TRUE	9.570074570603019e-11	223	59	16	0.2711864406779661	0.07174887892376682	KEGG:05163	KEGG	Human cytomegalovirus infection	8484	444		0.15730337078651685	0.16666666666666666	223	8261	16	43	207	8218	8484	0.12810459675600142
M1	string	0	network_modules	24	TRUE	1.18439805720742e-10	216	59	15	0.2542372881355932	0.06944444444444445	REAC:R-HSA-8939211	REAC	ESR-mediated signaling	10916	830		0.0958904109589041	0.10204081632653061	216	10700	15	44	201	10656	10916	0.12409827750589962
M1	string	0	network_modules	24	TRUE	2.487402916001114e-10	147	59	13	0.22033898305084745	0.08843537414965986	REAC:R-HSA-9018519	REAC	Estrogen-dependent gene expression	10916	866		0.10273972602739725	0.10884353741496598	147	10769	13	46	134	10723	10916	0.13230950531240093
M1	string	0	network_modules	24	TRUE	3.329827876900104e-10	437	60	17	0.2833333333333333	0.038901601830663615	GO:0014070	GO:BP	response to organic cyclic compound	16175	4635		0.10887096774193548	0.11244979919678715	437	15738	17	43	420	15695	16175	0.09646406291628647
M1	string	0	network_modules	24	TRUE	5.883080894602525e-10	202	60	13	0.21666666666666667	0.06435643564356436	GO:0071560	GO:BP	cellular response to transforming growth factor beta stimulus	16175	16762		0.11290322580645161	0.11646586345381527	202	15973	13	47	189	15926	16175	0.11218772069293123
M1	string	0	network_modules	24	TRUE	6.524249092009982e-10	29	59	8	0.13559322033898305	0.27586206896551724	REAC:R-HSA-2173795	REAC	Downregulation of SMAD2/3:SMAD4 transcriptional activity	10916	787		0.1095890410958904	0.11564625850340136	29	10887	8	51	21	10836	10916	0.1903820377811294
M1	string	0	network_modules	24	TRUE	6.992041159593892e-10	293	59	16	0.2711864406779661	0.05460750853242321	REAC:R-HSA-9006925	REAC	Intracellular signaling by second messengers	10916	1266		0.11643835616438356	0.12244897959183673	293	10623	16	43	277	10580	10916	0.11145020187027668
M1	string	0	network_modules	24	TRUE	7.332656023959844e-10	46	59	9	0.15254237288135594	0.1956521739130435	REAC:R-HSA-2122947	REAC	NOTCH1 Intracellular Domain Regulates Transcription	10916	1532		0.1232876712328767	0.1292517006802721	46	10870	9	50	37	10820	10916	0.16879717156251456
M1	string	0	network_modules	24	TRUE	8.469306127723303e-10	463	60	17	0.2833333333333333	0.0367170626349892	GO:0097190	GO:BP	apoptotic signaling pathway	16175	18534		0.11693548387096774	0.12048192771084337	463	15712	17	43	446	15669	16175	0.09320574265189512
M1	string	0	network_modules	24	TRUE	8.566413531284518e-10	208	60	13	0.21666666666666667	0.0625	GO:0071559	GO:BP	response to transforming growth factor beta	16175	16761		0.12096774193548387	0.12449799196787148	208	15967	13	47	195	15920	16175	0.11037766405355728
M1	string	0	network_modules	24	TRUE	1.1881099402378544e-9	147	59	13	0.22033898305084745	0.08843537414965986	KEGG:05224	KEGG	Breast cancer	8484	475		0.16853932584269662	0.17777777777777778	147	8337	13	46	134	8291	8484	0.13019682336272317
M1	string	0	network_modules	24	TRUE	1.2427267881847599e-9	359	59	17	0.288135593220339	0.04735376044568245	REAC:R-HSA-3700989	REAC	Transcriptional Regulation by TP53	10916	2546		0.13013698630136986	0.1360544217687075	359	10557	17	42	342	10515	10916	0.10550659990012932
M1	string	0	network_modules	24	TRUE	1.4173100047385481e-9	60	60	9	0.15	0.15	GO:0016925	GO:BP	protein sumoylation	16175	5258		0.125	0.1285140562248996	60	16115	9	51	51	16064	16175	0.1468352466645982
M1	string	0	network_modules	24	TRUE	1.4796228355085734e-9	10	59	6	0.1016949152542373	0.6	REAC:R-HSA-450341	REAC	Activation of the AP-1 family of transcription factors	10916	103		0.136986301369863	0.14285714285714285	10	10906	6	53	4	10853	10916	0.24556766121234858
M1	string	0	network_modules	24	TRUE	2.215438186731139e-9	345	60	15	0.25	0.043478260869565216	GO:0071407	GO:BP	cellular response to organic cyclic compound	16175	16659		0.12903225806451613	0.13253012048192772	345	15830	15	45	330	15785	16175	0.09657516158723138
M1	string	0	network_modules	24	TRUE	2.6232940288399544e-9	176	60	12	0.2	0.06818181818181818	GO:0007179	GO:BP	transforming growth factor beta receptor signaling pathway	16175	2741		0.13306451612903225	0.13654618473895583	176	15999	12	48	164	15951	16175	0.11123390761879755
M1	string	0	network_modules	24	TRUE	2.6826012821095506e-9	70	59	10	0.1694915254237288	0.14285714285714285	KEGG:04917	KEGG	Prolactin signaling pathway	8484	374		0.1797752808988764	0.18888888888888888	70	8414	10	49	60	8365	8484	0.1491647185016682
M1	string	0	network_modules	24	TRUE	2.7526706428959247e-9	157	59	13	0.22033898305084745	0.08280254777070063	KEGG:04110	KEGG	Cell cycle	8484	264		0.19101123595505617	0.2	157	8327	13	46	144	8281	8484	0.12532594417705079
M1	string	0	network_modules	24	TRUE	3.000874831135855e-9	178	60	12	0.2	0.06741573033707865	GO:0009755	GO:BP	hormone-mediated signaling pathway	16175	3652		0.13709677419354838	0.14056224899598393	178	15997	12	48	166	15949	16175	0.11054182630029219
M1	string	0	network_modules	24	TRUE	3.2699379195271883e-9	231	60	13	0.21666666666666667	0.05627705627705628	GO:0051098	GO:BP	regulation of binding	16175	13493		0.14112903225806453	0.14457831325301204	231	15944	13	47	218	15897	16175	0.10408286505650126
M1	string	0	network_modules	24	TRUE	3.4839159360692367e-9	330	59	17	0.288135593220339	0.051515151515151514	KEGG:05165	KEGG	Human papillomavirus infection	8484	446		0.20224719101123595	0.2111111111111111	330	8154	17	42	313	8112	8484	0.10787358694488781
M1	string	0	network_modules	24	TRUE	3.71611332936711e-9	198	59	14	0.23728813559322035	0.0707070707070707	KEGG:05169	KEGG	Epstein-Barr virus infection	8484	450		0.21348314606741572	0.2222222222222222	198	8286	14	45	184	8241	8484	0.11859028689729688
M1	string	0	network_modules	24	TRUE	4.075822054059758e-9	686	60	19	0.31666666666666665	0.027696793002915453	GO:0008284	GO:BP	positive regulation of cell population proliferation	16175	3151		0.14516129032258066	0.14859437751004015	686	15489	19	41	667	15448	16175	0.08303982369801655
M1	string	0	network_modules	24	TRUE	5.222123389230418e-9	131	59	12	0.2033898305084746	0.0916030534351145	KEGG:04068	KEGG	FoxO signaling pathway	8484	258		0.2247191011235955	0.23333333333333334	131	8353	12	47	119	8306	8484	0.12756303495929758
M1	string	0	network_modules	24	TRUE	5.807079807152314e-9	302	60	14	0.23333333333333334	0.046357615894039736	GO:0030522	GO:BP	intracellular receptor signaling pathway	16175	6836		0.14919354838709678	0.15261044176706828	302	15873	14	46	288	15827	16175	0.09676717312853775
M1	string	0	network_modules	24	TRUE	5.828461507377321e-9	798	60	20	0.3333333333333333	0.02506265664160401	GO:0006974	GO:BP	DNA damage response	16175	2601		0.1532258064516129	0.1566265060240964	798	15377	20	40	778	15337	16175	0.08001707934439627
M1	string	0	network_modules	24	TRUE	6.919874019511655e-9	71	60	9	0.15	0.1267605633802817	GO:0060395	GO:BP	SMAD protein signal transduction	16175	14598		0.15725806451612903	0.1606425702811245	71	16104	9	51	62	16053	16175	0.13440066805401982
M1	string	0	network_modules	24	TRUE	1.2631792132185364e-8	152	60	11	0.18333333333333332	0.07236842105263158	GO:0141193	GO:BP	nuclear receptor-mediated signaling pathway	16175	20078		0.16129032258064516	0.1646586345381526	152	16023	11	49	141	15974	16175	0.11000205939365046
M1	string	0	network_modules	24	TRUE	1.3638949156556963e-8	551	60	17	0.2833333333333333	0.030852994555353903	GO:1902532	GO:BP	negative regulation of intracellular signal transduction	16175	22341		0.16532258064516128	0.1686746987951807	551	15624	17	43	534	15581	16175	0.08384942775862943
M1	string	0	network_modules	24	TRUE	1.3815213969719464e-8	41	59	8	0.13559322033898305	0.1951219512195122	REAC:R-HSA-3899300	REAC	SUMOylation of transcription cofactors	10916	2177		0.14383561643835616	0.14965986394557823	41	10875	8	51	33	10824	10916	0.15887890580262834
M1	string	0	network_modules	24	TRUE	1.8317581298931855e-8	92	59	10	0.1694915254237288	0.10869565217391304	REAC:R-HSA-170834	REAC	Signaling by TGF-beta Receptor Complex	10916	2308		0.1506849315068493	0.1564625850340136	92	10824	10	49	82	10775	10916	0.12988052072816084
M1	string	0	network_modules	24	TRUE	2.5355490218949644e-8	95	59	10	0.1694915254237288	0.10526315789473684	REAC:R-HSA-168176	REAC	Toll Like Receptor 5 (TLR5) Cascade	10916	2517		0.15753424657534246	0.17687074829931973	95	10821	10	49	85	10772	10916	0.12761292027234575
M1	string	0	network_modules	24	TRUE	2.5355490218949644e-8	95	59	10	0.1694915254237288	0.10526315789473684	REAC:R-HSA-168142	REAC	Toll Like Receptor 10 (TLR10) Cascade	10916	2513		0.15753424657534246	0.17687074829931973	95	10821	10	49	85	10772	10916	0.12761292027234575
M1	string	0	network_modules	24	TRUE	2.5355490218949644e-8	95	59	10	0.1694915254237288	0.10526315789473684	REAC:R-HSA-975871	REAC	MyD88 cascade initiated on plasma membrane	10916	1497		0.15753424657534246	0.17687074829931973	95	10821	10	49	85	10772	10916	0.12761292027234575
M1	string	0	network_modules	24	TRUE	2.60872173443213e-8	67	59	9	0.15254237288135594	0.13432835820895522	REAC:R-HSA-400253	REAC	Circadian Clock	10916	363		0.1780821917808219	0.1836734693877551	67	10849	9	50	58	10799	10916	0.13818377757889175
M1	string	0	network_modules	24	TRUE	2.9578143224220826e-8	275	60	13	0.21666666666666667	0.04727272727272727	GO:0141091	GO:BP	transforming growth factor beta receptor superfamily signaling pathway	16175	20020		0.1693548387096774	0.17269076305220885	275	15900	13	47	262	15853	16175	0.09424147100885255
M1	string	0	network_modules	24	TRUE	3.774622792592483e-8	28	59	7	0.11864406779661017	0.25	REAC:R-HSA-350054	REAC	Notch-HLH transcription pathway	10916	1610		0.18493150684931506	0.19047619047619047	28	10888	7	52	21	10836	10916	0.16917465371795998
M1	string	0	network_modules	24	TRUE	3.814043556510274e-8	123	60	10	0.16666666666666666	0.08130081300813008	GO:0017015	GO:BP	regulation of transforming growth factor beta receptor signaling pathway	16175	5276		0.17338709677419356	0.17670682730923695	123	16052	10	50	113	16002	16175	0.11172619096390844
M1	string	0	network_modules	24	TRUE	4.4839396165726274e-8	125	60	10	0.16666666666666666	0.08	GO:1903844	GO:BP	regulation of cellular response to transforming growth factor beta stimulus	16175	23323		0.1774193548387097	0.18072289156626506	125	16050	10	50	115	16000	16175	0.1107495238489497
M1	string	0	network_modules	24	TRUE	4.7034073625704895e-8	101	59	10	0.1694915254237288	0.09900990099009901	REAC:R-HSA-975138	REAC	TRAF6 mediated induction of NFkB and MAP kinases upon TLR7/8 or 9 activation	10916	2468		0.1917808219178082	0.19727891156462585	101	10815	10	49	91	10766	10916	0.12337553019911064
M1	string	0	network_modules	24	TRUE	4.711669724677611e-8	158	59	12	0.2033898305084746	0.0759493670886076	KEGG:05160	KEGG	Hepatitis C	8484	441		0.23595505617977527	0.24444444444444444	158	8326	12	47	146	8279	8484	0.11437162440056198
M1	string	0	network_modules	24	TRUE	4.7445970060630814e-8	790	60	19	0.31666666666666665	0.024050632911392405	GO:0007167	GO:BP	enzyme-linked receptor protein signaling pathway	16175	2731		0.1814516129032258	0.18473895582329317	790	15385	19	41	771	15344	16175	0.07582195473270888
M1	string	0	network_modules	24	TRUE	4.86182674437689e-8	172	60	11	0.18333333333333332	0.06395348837209303	GO:0042770	GO:BP	signal transduction in response to DNA damage	16175	10355		0.18548387096774194	0.18875502008032127	172	16003	11	49	161	15954	16175	0.10273803717086112
M1	string	0	network_modules	24	TRUE	5.0863923500671424e-8	72	59	9	0.15254237288135594	0.125	REAC:R-HSA-1980143	REAC	Signaling by NOTCH1	10916	2275		0.19863013698630136	0.20408163265306123	72	10844	9	50	63	10794	10916	0.1329129952693264
M1	string	0	network_modules	24	TRUE	5.193253432519176e-8	102	59	10	0.1694915254237288	0.09803921568627451	REAC:R-HSA-975155	REAC	MyD88 dependent cascade initiated on endosome	10916	1500		0.2054794520547945	0.2108843537414966	102	10814	10	49	92	10765	10916	0.1227047444245479
M1	string	0	network_modules	24	TRUE	5.728069590969492e-8	103	59	10	0.1694915254237288	0.0970873786407767	REAC:R-HSA-168181	REAC	Toll Like Receptor 7/8 (TLR7/8) Cascade	10916	2518		0.21232876712328766	0.22448979591836735	103	10813	10	49	93	10764	10916	0.12204343162131388
M1	string	0	network_modules	24	TRUE	5.728069590969492e-8	103	59	10	0.1694915254237288	0.0970873786407767	REAC:R-HSA-168164	REAC	Toll Like Receptor 3 (TLR3) Cascade	10916	2515		0.21232876712328766	0.22448979591836735	103	10813	10	49	93	10764	10916	0.12204343162131388
M1	string	0	network_modules	24	TRUE	5.748632202067853e-8	290	60	13	0.21666666666666667	0.04482758620689655	GO:0007178	GO:BP	cell surface receptor protein serine/threonine kinase signaling pathway	16175	2740		0.18951612903225806	0.1927710843373494	290	15885	13	47	277	15838	16175	0.09138871070507562
M1	string	0	network_modules	24	TRUE	6.146821665023538e-8	129	60	10	0.16666666666666666	0.07751937984496124	GO:0009411	GO:BP	response to UV	16175	3476		0.1935483870967742	0.19678714859437751	129	16046	10	50	119	15996	16175	0.10886289808284019
M1	string	0	network_modules	24	TRUE	6.417419880387635e-8	140	59	11	0.1864406779661017	0.07857142857142857	REAC:R-HSA-9678108	REAC	SARS-CoV-1 Infection	10916	2114		0.22602739726027396	0.23129251700680273	140	10776	11	48	129	10728	10916	0.11374445082992532
M1	string	0	network_modules	24	TRUE	6.761276850307737e-8	610	60	17	0.2833333333333333	0.027868852459016394	GO:0043066	GO:BP	negative regulation of apoptotic process	16175	10512		0.1975806451612903	0.20080321285140562	610	15565	17	43	593	15522	16175	0.07867385770055842
M1	string	0	network_modules	24	TRUE	7.639361560224256e-8	106	59	10	0.1694915254237288	0.09433962264150944	REAC:R-HSA-168138	REAC	Toll Like Receptor 9 (TLR9) Cascade	10916	2519		0.2328767123287671	0.23809523809523808	106	10810	10	49	96	10761	10916	0.12011410040131575
M1	string	0	network_modules	24	TRUE	8.278382936019394e-8	31	59	7	0.11864406779661017	0.22580645161290322	REAC:R-HSA-450282	REAC	MAPK targets/ Nuclear events mediated by MAP kinases	10916	1349		0.23972602739726026	0.24489795918367346	31	10885	7	52	24	10833	10916	0.16042197543734765
M1	string	0	network_modules	24	TRUE	8.290795736364613e-8	236	60	12	0.2	0.05084745762711865	GO:0043434	GO:BP	response to peptide hormone	16175	10691		0.20161290322580644	0.20481927710843373	236	15939	12	48	224	15891	16175	0.09435184548805979
M1	string	0	network_modules	24	TRUE	8.392343690141728e-8	107	59	10	0.1694915254237288	0.09345794392523364	REAC:R-HSA-937061	REAC	TRIF (TICAM1)-mediated TLR4 signaling 	10916	2471		0.2465753424657534	0.2585034013605442	107	10809	10	49	97	10760	10916	0.11948848536344724
M1	string	0	network_modules	24	TRUE	8.392343690141728e-8	107	59	10	0.1694915254237288	0.09345794392523364	REAC:R-HSA-166166	REAC	MyD88-independent TLR4 cascade 	10916	1501		0.2465753424657534	0.2585034013605442	107	10809	10	49	97	10760	10916	0.11948848536344724
M1	string	0	network_modules	24	TRUE	8.500750893759977e-8	619	60	17	0.2833333333333333	0.027463651050080775	GO:1901698	GO:BP	response to nitrogen compound	16175	21651		0.2056451612903226	0.20883534136546184	619	15556	17	43	602	15513	16175	0.07794543664259684
M1	string	0	network_modules	24	TRUE	8.708814257561627e-8	237	60	12	0.2	0.05063291139240506	GO:0045765	GO:BP	regulation of angiogenesis	16175	11601		0.20967741935483872	0.21285140562248997	237	15938	12	48	225	15890	16175	0.09412413856859968
M1	string	0	network_modules	24	TRUE	8.771764037574642e-8	300	60	13	0.21666666666666667	0.043333333333333335	GO:0009314	GO:BP	response to radiation	16175	3460		0.21370967741935484	0.21686746987951808	300	15875	13	47	287	15828	16175	0.08960134844374648
M1	string	0	network_modules	24	TRUE	9.511864414869114e-8	183	60	11	0.18333333333333332	0.060109289617486336	GO:0034599	GO:BP	cellular response to oxidative stress	16175	8684		0.21774193548387097	0.22088353413654618	183	15992	11	49	172	15943	16175	0.09924432926562403
M1	string	0	network_modules	24	TRUE	9.867833725834702e-8	132	59	11	0.1864406779661017	0.08333333333333333	KEGG:04380	KEGG	Osteoclast differentiation	8484	309		0.24719101123595505	0.25555555555555554	132	8352	11	48	121	8304	8484	0.11554622680904066
M1	string	0	network_modules	24	TRUE	1.1100161103925325e-7	242	60	12	0.2	0.049586776859504134	GO:0062012	GO:BP	regulation of small molecule metabolic process	16175	15781		0.2217741935483871	0.2248995983935743	242	15933	12	48	230	15885	16175	0.09300594847434684
M1	string	0	network_modules	24	TRUE	1.1127669070391736e-7	211	59	13	0.22033898305084745	0.061611374407582936	KEGG:05207	KEGG	Chemical carcinogenesis - receptor activation	8484	459		0.25842696629213485	0.26666666666666666	211	8273	13	46	198	8227	8484	0.10503790712911319
M1	string	0	network_modules	24	TRUE	1.11893137211018e-7	630	60	17	0.2833333333333333	0.026984126984126985	GO:0043069	GO:BP	negative regulation of programmed cell death	16175	10515		0.22580645161290322	0.2289156626506024	630	15545	17	43	613	15502	16175	0.07707481504303342
M1	string	0	network_modules	24	TRUE	1.1644484686779893e-7	243	60	12	0.2	0.04938271604938271	GO:1901342	GO:BP	regulation of vasculature development	16175	21401		0.22983870967741934	0.23293172690763053	243	15932	12	48	231	15884	16175	0.09278628224610531
M1	string	0	network_modules	24	TRUE	1.172109810282845e-7	20	60	6	0.1	0.3	GO:0033233	GO:BP	regulation of protein sumoylation	16175	8085		0.23387096774193547	0.23694779116465864	20	16155	6	54	14	16101	16175	0.17148765359482543
M1	string	0	network_modules	24	TRUE	1.265047625937585e-7	18	59	6	0.1016949152542373	0.3333333333333333	REAC:R-HSA-3232118	REAC	SUMOylation of transcription factors	10916	2178		0.2602739726027397	0.2653061224489796	18	10898	6	53	12	10845	10916	0.1817709653566788
M1	string	0	network_modules	24	TRUE	1.3242008922120694e-7	112	59	10	0.1694915254237288	0.08928571428571429	REAC:R-HSA-166058	REAC	MyD88:MAL(TIRAP) cascade initiated on plasma membrane	10916	1502		0.2671232876712329	0.2789115646258503	112	10804	10	49	102	10755	10916	0.11648282925821467
M1	string	0	network_modules	24	TRUE	1.3242008922120694e-7	112	59	10	0.1694915254237288	0.08928571428571429	REAC:R-HSA-168188	REAC	Toll Like Receptor TLR6:TLR2 Cascade	10916	2521		0.2671232876712329	0.2789115646258503	112	10804	10	49	102	10755	10916	0.11648282925821467
M1	string	0	network_modules	24	TRUE	1.3337193781540947e-7	33	59	7	0.11864406779661017	0.21212121212121213	REAC:R-HSA-2559585	REAC	Oncogene Induced Senescence	10916	1640		0.2808219178082192	0.2857142857142857	33	10883	7	52	26	10831	10916	0.15525299415529323
M1	string	0	network_modules	24	TRUE	1.4363999027071284e-7	174	59	12	0.2033898305084746	0.06896551724137931	KEGG:04310	KEGG	Wnt signaling pathway	8484	299		0.2696629213483146	0.2777777777777778	174	8310	12	47	162	8263	8484	0.1079777565701516
M1	string	0	network_modules	24	TRUE	1.7227244850260765e-7	115	59	10	0.1694915254237288	0.08695652173913043	REAC:R-HSA-181438	REAC	Toll Like Receptor 2 (TLR2) Cascade	10916	2514		0.2876712328767123	0.29931972789115646	115	10801	10	49	105	10752	10916	0.11477097916274275
M1	string	0	network_modules	24	TRUE	1.7227244850260765e-7	115	59	10	0.1694915254237288	0.08695652173913043	REAC:R-HSA-168179	REAC	Toll Like Receptor TLR1:TLR2 Cascade	10916	2520		0.2876712328767123	0.29931972789115646	115	10801	10	49	105	10752	10916	0.11477097916274275
M1	string	0	network_modules	24	TRUE	1.9693435103541438e-7	145	60	10	0.16666666666666666	0.06896551724137931	GO:0045444	GO:BP	fat cell differentiation	16175	11377		0.23790322580645162	0.24096385542168675	145	16030	10	50	135	15980	16175	0.10209201874015286
M1	string	0	network_modules	24	TRUE	2.2350114437234386e-7	57	59	8	0.13559322033898305	0.14035087719298245	REAC:R-HSA-2894858	REAC	Signaling by NOTCH1 HD+PEST Domain Mutants in Cancer	10916	2277		0.3013698630136986	0.3333333333333333	57	10859	8	51	49	10808	10916	0.1333475445942109
M1	string	0	network_modules	24	TRUE	2.2350114437234386e-7	57	59	8	0.13559322033898305	0.14035087719298245	REAC:R-HSA-2644603	REAC	Signaling by NOTCH1 in Cancer	10916	2279		0.3013698630136986	0.3333333333333333	57	10859	8	51	49	10808	10916	0.1333475445942109
M1	string	0	network_modules	24	TRUE	2.2350114437234386e-7	57	59	8	0.13559322033898305	0.14035087719298245	REAC:R-HSA-2644602	REAC	Signaling by NOTCH1 PEST Domain Mutants in Cancer	10916	2278		0.3013698630136986	0.3333333333333333	57	10859	8	51	49	10808	10916	0.1333475445942109
M1	string	0	network_modules	24	TRUE	2.2350114437234386e-7	57	59	8	0.13559322033898305	0.14035087719298245	REAC:R-HSA-2894862	REAC	Constitutive Signaling by NOTCH1 HD+PEST Domain Mutants	10916	405		0.3013698630136986	0.3333333333333333	57	10859	8	51	49	10808	10916	0.1333475445942109
M1	string	0	network_modules	24	TRUE	2.2350114437234386e-7	57	59	8	0.13559322033898305	0.14035087719298245	REAC:R-HSA-2644606	REAC	Constitutive Signaling by NOTCH1 PEST Domain Mutants	10916	406		0.3013698630136986	0.3333333333333333	57	10859	8	51	49	10808	10916	0.1333475445942109
M1	string	0	network_modules	24	TRUE	2.573632487245934e-7	36	59	7	0.11864406779661017	0.19444444444444445	REAC:R-HSA-2173796	REAC	SMAD2/SMAD3:SMAD4 heterotrimer regulates transcription	10916	2154		0.3356164383561644	0.3401360544217687	36	10880	7	52	29	10828	10916	0.14831054933920496
M1	string	0	network_modules	24	TRUE	2.705627149468089e-7	160	59	11	0.1864406779661017	0.06875	REAC:R-HSA-5633007	REAC	Regulation of TP53 Activity	10916	2012		0.3424657534246575	0.3469387755102041	160	10756	11	48	149	10708	10916	0.10537319606658872
M1	string	0	network_modules	24	TRUE	2.84148977381703e-7	770	60	18	0.3	0.023376623376623377	GO:0048646	GO:BP	anatomical structure formation involved in morphogenesis	16175	12904		0.24193548387096775	0.24497991967871485	770	15405	18	42	752	15363	16175	0.07232866509074995
M1	string	0	network_modules	24	TRUE	2.9743836342703715e-7	59	59	8	0.13559322033898305	0.13559322033898305	REAC:R-HSA-8943724	REAC	Regulation of PTEN gene transcription	10916	1999		0.3493150684931507	0.35374149659863946	59	10857	8	51	51	10806	10916	0.13089579010963792
M1	string	0	network_modules	24	TRUE	3.006685664607304e-7	107	60	9	0.15	0.08411214953271028	GO:0030518	GO:BP	nuclear receptor-mediated steroid hormone signaling pathway	16175	6833		0.24596774193548387	0.24899598393574296	107	16068	9	51	98	16017	16175	0.10792827482764181
M1	string	0	network_modules	24	TRUE	3.09480627660306e-7	122	59	10	0.1694915254237288	0.08196721311475409	REAC:R-HSA-9006936	REAC	Signaling by TGFB family members	10916	2310		0.3561643835616438	0.36054421768707484	122	10794	10	49	112	10745	10916	0.11101618492193573
M1	string	0	network_modules	24	TRUE	3.1725609745042814e-7	265	60	12	0.2	0.045283018867924525	GO:0006979	GO:BP	response to oxidative stress	16175	2604		0.25	0.25301204819277107	265	15910	12	48	253	15862	16175	0.08825897771370596
M1	string	0	network_modules	24	TRUE	3.195260720527248e-7	88	59	9	0.15254237288135594	0.10227272727272728	REAC:R-HSA-9616222	REAC	Transcriptional regulation of granulopoiesis	10916	2559		0.363013698630137	0.3673469387755102	88	10828	9	50	79	10778	10916	0.11910481740728027
M1	string	0	network_modules	24	TRUE	3.343289849633766e-7	113	59	10	0.1694915254237288	0.08849557522123894	KEGG:04668	KEGG	TNF signaling pathway	8484	342		0.2808988764044944	0.28888888888888886	113	8371	10	49	103	8322	8484	0.11400343198866748
M1	string	0	network_modules	24	TRUE	3.3487456202886774e-7	148	59	11	0.1864406779661017	0.07432432432432433	KEGG:05226	KEGG	Gastric cancer	8484	477		0.29213483146067415	0.3	148	8336	11	48	137	8288	8484	0.10802110654643655
M1	string	0	network_modules	24	TRUE	3.554895924644835e-7	109	60	9	0.15	0.08256880733944955	GO:0043401	GO:BP	steroid hormone receptor signaling pathway	16175	10670		0.2540322580645161	0.2570281124497992	109	16066	9	51	100	16015	16175	0.10684795902184085
M1	string	0	network_modules	24	TRUE	3.5733704232328427e-7	10	59	5	0.0847457627118644	0.5	REAC:R-HSA-9617629	REAC	Regulation of FOXO transcriptional activity by acetylation	10916	1973		0.3698630136986301	0.3741496598639456	10	10906	5	54	5	10852	10916	0.20426767985786676
M1	string	0	network_modules	24	TRUE	3.8392627674611523e-7	338	60	13	0.21666666666666667	0.038461538461538464	GO:0045786	GO:BP	negative regulation of cell cycle	16175	11618		0.25806451612903225	0.26104417670682734	338	15837	13	47	325	15790	16175	0.0835134804436938
M1	string	0	network_modules	24	TRUE	3.858487069112044e-7	38	59	7	0.11864406779661017	0.18421052631578946	REAC:R-HSA-8864260	REAC	Transcriptional regulation by the AP-2 (TFAP2) family of transcription factors	10916	2556		0.3767123287671233	0.38095238095238093	38	10878	7	52	31	10826	10916	0.14413884202612648
M1	string	0	network_modules	24	TRUE	4.2773330080428837e-7	45	60	7	0.11666666666666667	0.15555555555555556	GO:0030521	GO:BP	androgen receptor signaling pathway	16175	6835		0.2620967741935484	0.26506024096385544	45	16130	7	53	38	16077	16175	0.1319308324941577
M1	string	0	network_modules	24	TRUE	4.338369559809228e-7	501	60	15	0.25	0.029940119760479042	GO:0008285	GO:BP	negative regulation of cell population proliferation	16175	3152		0.2661290322580645	0.26907630522088355	501	15674	15	45	486	15629	16175	0.07714223065449237
M1	string	0	network_modules	24	TRUE	4.7128719497194994e-7	504	60	15	0.25	0.02976190476190476	GO:0001944	GO:BP	vasculature development	16175	555		0.2701612903225806	0.27309236947791166	504	15671	15	45	489	15626	16175	0.07685452401227531
M1	string	0	network_modules	24	TRUE	4.7612965410517426e-7	153	59	11	0.1864406779661017	0.0718954248366013	KEGG:04934	KEGG	Cushing syndrome	8484	391		0.30337078651685395	0.3111111111111111	153	8331	11	48	142	8283	8484	0.10590266175540315
M1	string	0	network_modules	24	TRUE	5.108917033618667e-7	63	59	8	0.13559322033898305	0.12698412698412698	REAC:R-HSA-450294	REAC	MAP kinase activation	10916	1345		0.3835616438356164	0.3877551020408163	63	10853	8	51	55	10802	10916	0.1263389655813895
M1	string	0	network_modules	24	TRUE	6.022085161340781e-7	120	59	10	0.1694915254237288	0.08333333333333333	KEGG:04935	KEGG	Growth hormone synthesis, secretion and action	8484	392		0.3146067415730337	0.32222222222222224	120	8364	10	49	110	8315	8484	0.11008994537398527
M1	string	0	network_modules	24	TRUE	6.526901108529565e-7	89	59	9	0.15254237288135594	0.10112359550561797	KEGG:04658	KEGG	Th1 and Th2 cell differentiation	8484	336		0.3258426966292135	0.34444444444444444	89	8395	9	50	80	8345	8484	0.11667661651625728
M1	string	0	network_modules	24	TRUE	6.526901108529565e-7	89	59	9	0.15254237288135594	0.10112359550561797	KEGG:05235	KEGG	PD-L1 expression and PD-1 checkpoint pathway in cancer	8484	480		0.3258426966292135	0.34444444444444444	89	8395	9	50	80	8345	8484	0.11667661651625728
M1	string	0	network_modules	24	TRUE	6.535648103037215e-7	431	60	14	0.23333333333333334	0.03248259860788863	GO:1901699	GO:BP	cellular response to nitrogen compound	16175	21652		0.27419354838709675	0.27710843373493976	431	15744	14	46	417	15698	16175	0.07831091937296632
M1	string	0	network_modules	24	TRUE	6.78788869215615e-7	41	59	7	0.11864406779661017	0.17073170731707318	REAC:R-HSA-383280	REAC	Nuclear Receptor transcription pathway	10916	1616		0.3904109589041096	0.3945578231292517	41	10875	7	52	34	10823	10916	0.13845324850197127
M1	string	0	network_modules	24	TRUE	6.849790205394815e-7	220	60	11	0.18333333333333332	0.05	GO:0009416	GO:BP	response to light stimulus	16175	3480		0.2782258064516129	0.28112449799196787	220	15955	11	49	209	15906	16175	0.08941471393111261
M1	string	0	network_modules	24	TRUE	7.980968656315208e-7	41	59	7	0.11864406779661017	0.17073170731707318	KEGG:05219	KEGG	Bladder cancer	8484	470		0.34831460674157305	0.35555555555555557	41	8443	7	52	34	8391	8484	0.13733692289906063
M1	string	0	network_modules	24	TRUE	8.127663978998607e-7	80	60	8	0.13333333333333333	0.1	GO:0090398	GO:BP	cellular senescence	16175	18269		0.28225806451612906	0.285140562248996	80	16095	8	52	72	16043	16175	0.1116700673840112
M1	string	0	network_modules	24	TRUE	8.515180417114363e-7	472	59	16	0.2711864406779661	0.03389830508474576	REAC:R-HSA-449147	REAC	Signaling by Interleukins	10916	2261		0.3972602739726027	0.4013605442176871	472	10444	16	43	456	10401	10916	0.08261603853479405
M1	string	0	network_modules	24	TRUE	8.778829076758182e-7	92	59	9	0.15254237288135594	0.09782608695652174	KEGG:04657	KEGG	IL-17 signaling pathway	8484	335		0.3595505617977528	0.36666666666666664	92	8392	9	50	83	8342	8484	0.11449330765306201
M1	string	0	network_modules	24	TRUE	9.117784495848146e-7	226	60	11	0.18333333333333332	0.048672566371681415	GO:0062197	GO:BP	cellular response to chemical stress	16175	15861		0.2862903225806452	0.2891566265060241	226	15949	11	49	215	15900	16175	0.08804356418245014
M1	string	0	network_modules	24	TRUE	9.280476387992095e-7	50	60	7	0.11666666666666667	0.14	GO:0006473	GO:BP	protein acetylation	16175	2210		0.2903225806451613	0.2931726907630522	50	16125	7	53	43	16072	16175	0.12484020224393721
M1	string	0	network_modules	24	TRUE	9.285074990449478e-7	291	60	12	0.2	0.041237113402061855	GO:0030099	GO:BP	myeloid cell differentiation	16175	6677		0.29435483870967744	0.2971887550200803	291	15884	12	48	279	15836	16175	0.08355488431404845
M1	string	0	network_modules	24	TRUE	1.1230462602167049e-6	166	59	11	0.1864406779661017	0.06626506024096386	KEGG:05225	KEGG	Hepatocellular carcinoma	8484	476		0.3707865168539326	0.37777777777777777	166	8318	11	48	155	8270	8484	0.10082495080545947
M1	string	0	network_modules	24	TRUE	1.21635724703551e-6	129	59	10	0.1694915254237288	0.07751937984496124	KEGG:04926	KEGG	Relaxin signaling pathway	8484	383		0.38202247191011235	0.3888888888888889	129	8355	10	49	119	8306	8484	0.10551188175732278
M1	string	0	network_modules	24	TRUE	1.242563392766295e-6	67	59	8	0.13559322033898305	0.11940298507462686	KEGG:05221	KEGG	Acute myeloid leukemia	8484	472		0.39325842696629215	0.4	67	8417	8	51	59	8366	8484	0.12072659347430278
M1	string	0	network_modules	24	TRUE	1.3224064491055984e-6	638	60	16	0.26666666666666666	0.025078369905956112	GO:0030097	GO:BP	hemopoiesis	16175	6675		0.29838709677419356	0.30120481927710846	638	15537	16	44	622	15493	16175	0.0712300552916878
M1	string	0	network_modules	24	TRUE	1.3300152521553637e-6	310	59	14	0.23728813559322035	0.04516129032258064	KEGG:05206	KEGG	MicroRNAs in cancer	8484	458		0.4044943820224719	0.4111111111111111	310	8174	14	45	296	8129	8484	0.08953574149824077
M1	string	0	network_modules	24	TRUE	1.3573914052203378e-6	71	59	8	0.13559322033898305	0.11267605633802817	REAC:R-HSA-448424	REAC	Interleukin-17 signaling	10916	1238		0.4041095890410959	0.40816326530612246	71	10845	8	51	63	10794	10916	0.1183804316532354
M1	string	0	network_modules	24	TRUE	1.4708476901689193e-6	143	59	10	0.1694915254237288	0.06993006993006994	REAC:R-HSA-166016	REAC	Toll Like Receptor 4 (TLR4) Cascade	10916	2516		0.410958904109589	0.41496598639455784	143	10773	10	49	133	10724	10916	0.10139379521943857
M1	string	0	network_modules	24	TRUE	1.517405808072933e-6	26	59	6	0.1016949152542373	0.23076923076923078	REAC:R-HSA-5674400	REAC	Constitutive Signaling by AKT1 E17K in Cancer	10916	400		0.4178082191780822	0.4217687074829932	26	10890	6	53	20	10837	10916	0.15018981988085922
M1	string	0	network_modules	24	TRUE	1.8513324375776138e-6	131	60	9	0.15	0.06870229007633588	GO:0006109	GO:BP	regulation of carbohydrate metabolic process	16175	1968		0.3024193548387097	0.30522088353413657	131	16044	9	51	122	15993	16175	0.09660475242424342
M1	string	0	network_modules	24	TRUE	1.8518096120358688e-6	47	59	7	0.11864406779661017	0.14893617021276595	REAC:R-HSA-9707616	REAC	Heme signaling	10916	1117		0.4246575342465753	0.42857142857142855	47	10869	7	52	40	10817	10916	0.12873102704855505
M1	string	0	network_modules	24	TRUE	2.0515872199659376e-6	244	60	11	0.18333333333333332	0.045081967213114756	GO:0097193	GO:BP	intrinsic apoptotic signaling pathway	16175	18537		0.3064516129032258	0.3092369477911647	244	15931	11	49	233	15882	16175	0.0842246235386344
M1	string	0	network_modules	24	TRUE	2.3311660626237785e-6	138	59	10	0.1694915254237288	0.07246376811594203	KEGG:05162	KEGG	Measles	8484	443		0.4157303370786517	0.43333333333333335	138	8346	10	49	128	8297	8484	0.1013664752506475
M1	string	0	network_modules	24	TRUE	2.3311660626237785e-6	138	59	10	0.1694915254237288	0.07246376811594203	KEGG:05418	KEGG	Fluid shear stress and atherosclerosis	8484	495		0.4157303370786517	0.43333333333333335	138	8346	10	49	128	8297	8484	0.1013664752506475
M1	string	0	network_modules	24	TRUE	2.392959610525722e-6	187	60	10	0.16666666666666666	0.053475935828877004	GO:0031669	GO:BP	cellular response to nutrient levels	16175	7272		0.31048387096774194	0.3132530120481928	187	15988	10	50	177	15938	16175	0.08853488111526293
M1	string	0	network_modules	24	TRUE	2.6037642780483103e-6	104	59	9	0.15254237288135594	0.08653846153846154	KEGG:04625	KEGG	C-type lectin receptor signaling pathway	8484	330		0.43820224719101125	0.4444444444444444	104	8380	9	50	95	8330	8484	0.10668692199835085
M1	string	0	network_modules	24	TRUE	2.641067268479271e-6	480	60	14	0.23333333333333334	0.029166666666666667	GO:0001568	GO:BP	blood vessel development	16175	353		0.31451612903225806	0.3172690763052209	480	15695	14	46	466	15649	16175	0.07323265169233427
M1	string	0	network_modules	24	TRUE	2.999682669610411e-6	400	60	13	0.21666666666666667	0.0325	GO:0001525	GO:BP	angiogenesis	16175	330		0.3185483870967742	0.321285140562249	400	15775	13	47	387	15728	16175	0.07541350262661145
M1	string	0	network_modules	24	TRUE	3.088768513505896e-6	59	60	7	0.11666666666666667	0.11864406779661017	GO:0072332	GO:BP	intrinsic apoptotic signaling pathway by p53 class mediator	16175	17355		0.3225806451612903	0.3253012048192771	59	16116	7	53	52	16063	16175	0.11439362547234609
M1	string	0	network_modules	24	TRUE	3.0916756261770293e-6	401	60	13	0.21666666666666667	0.032418952618453865	GO:0043068	GO:BP	positive regulation of programmed cell death	16175	10514		0.32661290322580644	0.3293172690763052	401	15774	13	47	388	15727	16175	0.07529753806366538
M1	string	0	network_modules	24	TRUE	3.3438078327016958e-6	107	59	9	0.15254237288135594	0.08411214953271028	KEGG:04350	KEGG	TGF-beta signaling pathway	8484	304		0.449438202247191	0.45555555555555555	107	8377	9	50	98	8327	8484	0.10493433916461027
M1	string	0	network_modules	24	TRUE	3.4004297567540093e-6	256	60	11	0.18333333333333332	0.04296875	GO:0090287	GO:BP	regulation of cellular response to growth factor stimulus	16175	18171		0.33064516129032256	0.3333333333333333	256	15919	11	49	245	15870	16175	0.08189518988752631
M1	string	0	network_modules	24	TRUE	3.7901586193924038e-6	142	60	9	0.15	0.06338028169014084	GO:0071383	GO:BP	cellular response to steroid hormone stimulus	16175	16635		0.3346774193548387	0.3373493975903614	142	16033	9	51	133	15982	16175	0.09237459245937137
M1	string	0	network_modules	24	TRUE	3.848702728029157e-6	30	59	6	0.1016949152542373	0.2	REAC:R-HSA-9022692	REAC	Regulation of MECP2 expression and activity	10916	1983		0.4315068493150685	0.4489795918367347	30	10886	6	53	24	10833	10916	0.13932881458669785
M1	string	0	network_modules	24	TRUE	3.848702728029157e-6	30	59	6	0.1016949152542373	0.2	REAC:R-HSA-8941326	REAC	RUNX2 regulates bone development	10916	1926		0.4315068493150685	0.4489795918367347	30	10886	6	53	24	10833	10916	0.13932881458669785
M1	string	0	network_modules	24	TRUE	3.848702728029157e-6	30	59	6	0.1016949152542373	0.2	REAC:R-HSA-9615017	REAC	FOXO-mediated transcription of oxidative stress, metabolic and neuronal genes	10916	926		0.4315068493150685	0.4489795918367347	30	10886	6	53	24	10833	10916	0.13932881458669785
M1	string	0	network_modules	24	TRUE	3.9070410613693206e-6	34	60	6	0.1	0.17647058823529413	GO:0042771	GO:BP	intrinsic apoptotic signaling pathway in response to DNA damage by p53 class mediator	16175	10356		0.3387096774193548	0.3413654618473896	34	16141	6	54	28	16087	16175	0.13042890874504032
M1	string	0	network_modules	24	TRUE	3.973968760233596e-6	795	60	17	0.2833333333333333	0.021383647798742137	GO:0051241	GO:BP	negative regulation of multicellular organismal process	16175	13591		0.34274193548387094	0.3453815261044177	795	15380	17	43	778	15337	16175	0.06609964914356903
M1	string	0	network_modules	24	TRUE	4.171200712835422e-6	15	59	5	0.0847457627118644	0.3333333333333333	REAC:R-HSA-9735871	REAC	SARS-CoV-1 targets host intracellular signalling and regulatory pathways	10916	2118		0.4520547945205479	0.4557823129251701	15	10901	5	54	10	10847	10916	0.16591059569016012
M1	string	0	network_modules	24	TRUE	4.190350256180572e-6	98	60	8	0.13333333333333333	0.08163265306122448	GO:0042752	GO:BP	regulation of circadian rhythm	16175	10345		0.3467741935483871	0.3493975903614458	98	16077	8	52	90	16025	16175	0.10007623520427784
M1	string	0	network_modules	24	TRUE	4.3359850177123766e-6	262	60	11	0.18333333333333332	0.04198473282442748	GO:0031667	GO:BP	response to nutrient levels	16175	7271		0.35080645161290325	0.3534136546184739	262	15913	11	49	251	15864	16175	0.0807879857363496
M1	string	0	network_modules	24	TRUE	4.89933029638342e-6	459	59	15	0.2542372881355932	0.032679738562091505	REAC:R-HSA-9679506	REAC	SARS-CoV Infections	10916	2112		0.4589041095890411	0.46258503401360546	459	10457	15	44	444	10413	10916	0.07793766978869712
M1	string	0	network_modules	24	TRUE	5.465479475575132e-6	148	60	9	0.15	0.060810810810810814	GO:0072331	GO:BP	signal transduction by p53 class mediator	16175	17354		0.3548387096774194	0.357429718875502	148	16027	9	51	139	15976	16175	0.09026198353646787
M1	string	0	network_modules	24	TRUE	5.5375949385258975e-6	164	59	10	0.1694915254237288	0.06097560975609756	REAC:R-HSA-168898	REAC	Toll-like Receptor Cascades	10916	2522		0.4657534246575342	0.46938775510204084	164	10752	10	49	154	10703	10916	0.09360644723395413
M1	string	0	network_modules	24	TRUE	6.355343519921422e-6	271	59	12	0.2033898305084746	0.04428044280442804	REAC:R-HSA-4839726	REAC	Chromatin organization	10916	356		0.4726027397260274	0.48299319727891155	271	10645	12	47	259	10598	10916	0.08460007860690343
M1	string	0	network_modules	24	TRUE	6.355343519921422e-6	271	59	12	0.2033898305084746	0.04428044280442804	REAC:R-HSA-3247509	REAC	Chromatin modifying enzymes	10916	355		0.4726027397260274	0.48299319727891155	271	10645	12	47	259	10598	10916	0.08460007860690343
M1	string	0	network_modules	24	TRUE	6.390419178679665e-6	345	60	12	0.2	0.034782608695652174	GO:0051090	GO:BP	regulation of DNA-binding transcription factor activity	16175	13485		0.3588709677419355	0.3614457831325301	345	15830	12	48	333	15782	16175	0.07545852436285197
M1	string	0	network_modules	24	TRUE	7.019118216941762e-6	209	60	10	0.16666666666666666	0.04784688995215311	GO:0040029	GO:BP	epigenetic regulation of gene expression	16175	9916		0.3629032258064516	0.3654618473895582	209	15966	10	50	199	15916	16175	0.08306841898066233
M1	string	0	network_modules	24	TRUE	7.642189477192697e-6	18	60	5	0.08333333333333333	0.2777777777777778	GO:0018394	GO:BP	peptidyl-lysine acetylation	16175	5418		0.36693548387096775	0.36947791164658633	18	16157	5	55	13	16102	16175	0.15047636234049852
M1	string	0	network_modules	24	TRUE	7.861576421424845e-6	118	59	9	0.15254237288135594	0.07627118644067797	KEGG:04722	KEGG	Neurotrophin signaling pathway	8484	352		0.4606741573033708	0.4666666666666667	118	8366	9	50	109	8316	8484	0.09906289769111731
M1	string	0	network_modules	24	TRUE	8.013216190316777e-6	434	60	13	0.21666666666666667	0.029953917050691243	GO:0045596	GO:BP	negative regulation of cell differentiation	16175	11447		0.3709677419354839	0.37349397590361444	434	15741	13	47	421	15694	16175	0.07168368691715012
M1	string	0	network_modules	24	TRUE	8.459390371052747e-6	119	59	9	0.15254237288135594	0.07563025210084033	KEGG:04660	KEGG	T cell receptor signaling pathway	8484	338		0.47191011235955055	0.4777777777777778	119	8365	9	50	110	8315	8484	0.09856780966718615
M1	string	0	network_modules	24	TRUE	8.524479665351782e-6	17	59	5	0.0847457627118644	0.29411764705882354	REAC:R-HSA-9617828	REAC	FOXO-mediated transcription of cell cycle genes	10916	924		0.4863013698630137	0.4897959183673469	17	10899	5	54	12	10845	10916	0.1555176482782551
M1	string	0	network_modules	24	TRUE	9.145941796326687e-6	626	60	15	0.25	0.023961661341853034	GO:0035295	GO:BP	tube development	16175	8953		0.375	0.37751004016064255	626	15549	15	45	611	15504	16175	0.06684398973680153
M1	string	0	network_modules	24	TRUE	9.343288405582987e-6	39	60	6	0.1	0.15384615384615385	GO:0006476	GO:BP	protein deacetylation	16175	2213		0.3790322580645161	0.3815261044176707	39	16136	6	54	33	16082	16175	0.1214156894700983
M1	string	0	network_modules	24	TRUE	9.553303298386895e-6	59	59	7	0.11864406779661017	0.11864406779661017	REAC:R-HSA-8986944	REAC	Transcriptional Regulation by MECP2	10916	2544		0.4931506849315068	0.4965986394557823	59	10857	7	52	52	10805	10916	0.11385453109217984
M1	string	0	network_modules	24	TRUE	9.93109351790396e-6	7	59	4	0.06779661016949153	0.5714285714285714	REAC:R-HSA-8941855	REAC	RUNX3 regulates CDKN1A transcription	10916	1933		0.5	0.5034013605442177	7	10909	4	55	3	10854	10916	0.19555716720805208
M1	string	0	network_modules	24	TRUE	1.0072178270410225e-5	217	60	10	0.16666666666666666	0.04608294930875576	GO:0090092	GO:BP	regulation of transmembrane receptor protein serine/threonine kinase signaling pathway	16175	18013		0.38306451612903225	0.3855421686746988	217	15958	10	50	207	15908	16175	0.08128093682229653
M1	string	0	network_modules	24	TRUE	1.0303741451766616e-5	35	59	6	0.1016949152542373	0.17142857142857143	REAC:R-HSA-3232142	REAC	SUMOylation of ubiquitinylation proteins	10916	2179		0.5068493150684932	0.5102040816326531	35	10881	6	53	29	10828	10916	0.12842577822628667
M1	string	0	network_modules	24	TRUE	1.0879223213037869e-05	92	59	8	0.13559322033898305	0.08695652173913043	REAC:R-HSA-1912408	REAC	Pre-NOTCH Transcription and Translation	10916	1786		0.5136986301369864	0.5170068027210885	92	10824	8	51	84	10773	10916	0.10254516106540289
M1	string	0	network_modules	24	TRUE	1.1407843089760573e-5	447	60	13	0.21666666666666667	0.029082774049217	GO:0048514	GO:BP	blood vessel morphogenesis	16175	12799		0.3870967741935484	0.3895582329317269	447	15728	13	47	434	15681	16175	0.0703636339888389
M1	string	0	network_modules	24	TRUE	1.1632673639952508e-5	71	60	7	0.11666666666666667	0.09859154929577464	GO:0030330	GO:BP	DNA damage response, signal transduction by p53 class mediator	16175	6779		0.3911290322580645	0.39357429718875503	71	16104	7	53	64	16051	16175	0.10363350525072547
M1	string	0	network_modules	24	TRUE	1.1953789347494923e-5	89	59	8	0.13559322033898305	0.0898876404494382	KEGG:04211	KEGG	Longevity regulating pathway	8484	288		0.48314606741573035	0.4888888888888889	89	8395	8	51	81	8344	8484	0.10275517056275293
M1	string	0	network_modules	24	TRUE	1.2115243256112812e-5	61	59	7	0.11864406779661017	0.11475409836065574	REAC:R-HSA-198725	REAC	Nuclear Events (kinase and transcription factor activation)	10916	1614		0.5205479452054794	0.5238095238095238	61	10855	7	52	54	10803	10916	0.11180163862222153
M1	string	0	network_modules	24	TRUE	1.3421213343467224e-5	37	59	6	0.1016949152542373	0.16216216216216217	KEGG:05216	KEGG	Thyroid cancer	8484	467		0.4943820224719101	0.5	37	8447	6	53	31	8394	8484	0.12360986266418682
M1	string	0	network_modules	24	TRUE	1.3732404459229556e-5	454	60	13	0.21666666666666667	0.028634361233480177	GO:0006338	GO:BP	chromatin remodeling	16175	2126		0.3951612903225806	0.39759036144578314	454	15721	13	47	441	15674	16175	0.06967473942495986
M1	string	0	network_modules	24	TRUE	1.4029962990604607e-5	95	59	8	0.13559322033898305	0.08421052631578947	REAC:R-HSA-9692914	REAC	SARS-CoV-1-host interactions	10916	2119		0.5273972602739726	0.5306122448979592	95	10821	8	51	87	10770	10916	0.1007089052524447
M1	string	0	network_modules	24	TRUE	1.4990609420196895e-5	166	60	9	0.15	0.05421686746987952	GO:0048545	GO:BP	response to steroid hormone	16175	12826		0.39919354838709675	0.40160642570281124	166	16009	9	51	157	15958	16175	0.08460203349172991
M1	string	0	network_modules	24	TRUE	1.5395771674406535e-5	214	59	11	0.1864406779661017	0.0514018691588785	KEGG:05417	KEGG	Lipid and atherosclerosis	8484	494		0.5056179775280899	0.5111111111111111	214	8270	11	48	203	8222	8484	0.08603836906730043
M1	string	0	network_modules	24	TRUE	1.5591451115082142e-5	62	59	7	0.11864406779661017	0.11290322580645161	KEGG:05321	KEGG	Inflammatory bowel disease	8484	483		0.5168539325842697	0.5222222222222223	62	8422	7	52	55	8370	8484	0.10938924356719888
M1	string	0	network_modules	24	TRUE	1.7414542695731222e-5	138	59	9	0.15254237288135594	0.06521739130434782	REAC:R-HSA-6807070	REAC	PTEN Regulation	10916	1703		0.5342465753424658	0.5374149659863946	138	10778	9	50	129	10728	10916	0.09230917585947312
M1	string	0	network_modules	24	TRUE	1.85007465620359e-5	8	60	4	0.06666666666666667	0.5	GO:0090400	GO:BP	stress-induced premature senescence	16175	18271		0.4032258064516129	0.40562248995983935	8	16167	4	56	4	16111	16175	0.18160165766724023
M1	string	0	network_modules	24	TRUE	1.978211981921167e-5	8	59	4	0.06779661016949153	0.5	REAC:R-HSA-9818749	REAC	Regulation of NFE2L2 gene expression	10916	1993		0.541095890410959	0.54421768707483	8	10908	4	55	4	10853	10916	0.1826858169292542
M1	string	0	network_modules	24	TRUE	2.0368251799223462e-5	39	59	6	0.1016949152542373	0.15384615384615385	REAC:R-HSA-8853884	REAC	Transcriptional Regulation by VENTX	10916	2547		0.547945205479452	0.5510204081632653	39	10877	6	53	33	10824	10916	0.12123134561492632
M1	string	0	network_modules	24	TRUE	2.176056506669531e-5	776	60	16	0.26666666666666666	0.020618556701030927	GO:0060341	GO:BP	regulation of cellular localization	16175	14553		0.40725806451612906	0.40963855421686746	776	15399	16	44	760	15355	16175	0.062439488506408465
M1	string	0	network_modules	24	TRUE	2.1761235283475412e-5	385	60	12	0.2	0.03116883116883117	GO:0043065	GO:BP	positive regulation of apoptotic process	16175	10511		0.4112903225806452	0.41365461847389556	385	15790	12	48	373	15742	16175	0.07053162673976844
M1	string	0	network_modules	24	TRUE	2.2127969833855684e-5	175	59	10	0.1694915254237288	0.05714285714285714	KEGG:05152	KEGG	Tuberculosis	8484	440		0.5280898876404494	0.5333333333333333	175	8309	10	49	165	8260	8484	0.08764746131064682
M1	string	0	network_modules	24	TRUE	2.2428815554521502e-5	121	60	8	0.13333333333333333	0.06611570247933884	GO:0033002	GO:BP	muscle cell proliferation	16175	7971		0.4153225806451613	0.41767068273092367	121	16054	8	52	113	16002	16175	0.08912156845453584
M1	string	0	network_modules	24	TRUE	2.4779323189815108e-5	79	60	7	0.11666666666666667	0.08860759493670886	GO:0008630	GO:BP	intrinsic apoptotic signaling pathway in response to DNA damage	16175	3218		0.41935483870967744	0.42168674698795183	79	16096	7	53	72	16043	16175	0.09783773407548026
M1	string	0	network_modules	24	TRUE	2.6379152723214384e-5	575	60	14	0.23333333333333334	0.02434782608695652	GO:0044092	GO:BP	negative regulation of molecular function	16175	10914		0.42338709677419356	0.42570281124497994	575	15600	14	46	561	15554	16175	0.06517801274087305
M1	string	0	network_modules	24	TRUE	2.6725291288530943e-5	136	59	9	0.15254237288135594	0.0661764705882353	KEGG:05135	KEGG	Yersinia infection	8484	432		0.5393258426966292	0.5555555555555556	136	8348	9	50	127	8298	8484	0.09096042842962127
M1	string	0	network_modules	24	TRUE	2.6725291288530943e-5	136	59	9	0.15254237288135594	0.0661764705882353	KEGG:04915	KEGG	Estrogen signaling pathway	8484	372		0.5393258426966292	0.5555555555555556	136	8348	9	50	127	8298	8484	0.09096042842962127
M1	string	0	network_modules	24	TRUE	2.8996509392892713e-5	792	60	16	0.26666666666666666	0.020202020202020204	GO:0000278	GO:BP	mitotic cell cycle	16175	76		0.4274193548387097	0.42971887550200805	792	15383	16	44	776	15339	16175	0.061557999428637815
M1	string	0	network_modules	24	TRUE	2.9553805357516448e-5	81	60	7	0.11666666666666667	0.08641975308641975	GO:0034644	GO:BP	cellular response to UV	16175	8706		0.4314516129032258	0.43373493975903615	81	16094	7	53	74	16041	16175	0.09652142994693422
M1	string	0	network_modules	24	TRUE	2.9756858792114595e-5	68	59	7	0.11864406779661017	0.10294117647058823	KEGG:05211	KEGG	Renal cell carcinoma	8484	462		0.5617977528089888	0.5666666666666667	68	8416	7	52	61	8364	8484	0.10382532556461542
M1	string	0	network_modules	24	TRUE	2.998179297722334e-5	684	60	15	0.25	0.021929824561403508	GO:0032880	GO:BP	regulation of protein localization	16175	7877		0.43548387096774194	0.43775100401606426	684	15491	15	45	669	15446	16175	0.06297956476928686
M1	string	0	network_modules	24	TRUE	3.0052550006352846e-5	47	60	6	0.1	0.1276595744680851	GO:0035601	GO:BP	protein deacylation	16175	9110		0.43951612903225806	0.4457831325301205	47	16128	6	54	41	16074	16175	0.11006753100583173
M1	string	0	network_modules	24	TRUE	3.0052550006352846e-5	47	60	6	0.1	0.1276595744680851	GO:0098732	GO:BP	macromolecule deacylation	16175	18861		0.43951612903225806	0.4457831325301205	47	16128	6	54	41	16074	16175	0.11006753100583173
M1	string	0	network_modules	24	TRUE	3.206767789968279e-5	101	59	8	0.13559322033898305	0.07920792079207921	KEGG:05142	KEGG	Chagas disease	8484	434		0.5730337078651685	0.5777777777777777	101	8383	8	51	93	8332	8484	0.09543561307402836
M1	string	0	network_modules	24	TRUE	3.221942279111348e-5	82	60	7	0.11666666666666667	0.08536585365853659	GO:0062014	GO:BP	negative regulation of small molecule metabolic process	16175	15783		0.4475806451612903	0.4497991967871486	82	16093	7	53	75	16040	16175	0.09588094256388782
M1	string	0	network_modules	24	TRUE	3.508601180992613e-5	83	60	7	0.11666666666666667	0.08433734939759036	GO:0043543	GO:BP	protein acylation	16175	10760		0.45161290322580644	0.4538152610441767	83	16092	7	53	76	16039	16175	0.09525175944833242
M1	string	0	network_modules	24	TRUE	3.546428900851749e-5	9	59	4	0.06779661016949153	0.4444444444444444	REAC:R-HSA-139915	REAC	Activation of PUMA and translocation to mitochondria	10916	93		0.5547945205479452	0.564625850340136	9	10907	4	55	5	10852	10916	0.17201044894638776
M1	string	0	network_modules	24	TRUE	3.546428900851749e-5	9	59	4	0.06779661016949153	0.4444444444444444	REAC:R-HSA-8951936	REAC	RUNX3 regulates p14-ARF	10916	1938		0.5547945205479452	0.564625850340136	9	10907	4	55	5	10852	10916	0.17201044894638776
M1	string	0	network_modules	24	TRUE	3.8485576237126966e-5	108	59	8	0.13559322033898305	0.07407407407407407	REAC:R-HSA-1912422	REAC	Pre-NOTCH Expression and Processing	10916	1783		0.5684931506849316	0.5714285714285714	108	10808	8	51	100	10757	10916	0.09362321944544054
M1	string	0	network_modules	24	TRUE	3.861625389738103e-5	142	59	9	0.15254237288135594	0.06338028169014084	KEGG:04936	KEGG	Alcoholic liver disease	8484	393		0.5842696629213483	0.5888888888888889	142	8342	9	50	133	8292	8484	0.08858866506644153
M1	string	0	network_modules	24	TRUE	4.035788854005107e-5	251	60	10	0.16666666666666666	0.0398406374501992	GO:0104004	GO:BP	cellular response to environmental stimulus	16175	19202		0.45564516129032256	0.46184738955823296	251	15924	10	50	241	15874	16175	0.074618546178459
M1	string	0	network_modules	24	TRUE	4.035788854005107e-5	251	60	10	0.16666666666666666	0.0398406374501992	GO:0071214	GO:BP	cellular response to abiotic stimulus	16175	16476		0.45564516129032256	0.46184738955823296	251	15924	10	50	241	15874	16175	0.074618546178459
M1	string	0	network_modules	24	TRUE	4.329979841388578e-5	105	59	8	0.13559322033898305	0.0761904761904762	KEGG:04928	KEGG	Parathyroid hormone synthesis, secretion and action	8484	385		0.5955056179775281	0.6	105	8379	8	51	97	8328	8484	0.09326561018444478
M1	string	0	network_modules	24	TRUE	4.4252814259280576e-5	72	59	7	0.11864406779661017	0.09722222222222222	KEGG:05218	KEGG	Melanoma	8484	469		0.6067415730337079	0.6222222222222222	72	8412	7	52	65	8360	8484	0.1004939509441747
M1	string	0	network_modules	24	TRUE	4.4252814259280576e-5	72	59	7	0.11864406779661017	0.09722222222222222	KEGG:05140	KEGG	Leishmaniasis	8484	433		0.6067415730337079	0.6222222222222222	72	8412	7	52	65	8360	8484	0.1004939509441747
M1	string	0	network_modules	24	TRUE	4.658313037330057e-5	106	59	8	0.13559322033898305	0.07547169811320754	KEGG:04620	KEGG	Toll-like receptor signaling pathway	8484	325		0.6292134831460674	0.6333333333333333	106	8378	8	51	98	8327	8484	0.09274137416431931
M1	string	0	network_modules	24	TRUE	5.478806843544246e-5	113	59	8	0.13559322033898305	0.07079646017699115	REAC:R-HSA-1989781	REAC	PPARA activates gene expression	10916	1700		0.5753424657534246	0.5782312925170068	113	10803	8	51	105	10752	10916	0.09121605118849889
M1	string	0	network_modules	24	TRUE	5.596916791411016e-5	3	59	3	0.05084745762711865	1	REAC:R-HSA-3304347	REAC	Loss of Function of SMAD4 in Cancer	10916	1324		0.5821917808219178	0.5986394557823129	3	10913	3	56	0	10857	10916	0.22491450414665626
M1	string	0	network_modules	24	TRUE	5.596916791411016e-5	3	59	3	0.05084745762711865	1	REAC:R-HSA-3311021	REAC	SMAD4 MH2 Domain Mutants in Cancer	10916	2155		0.5821917808219178	0.5986394557823129	3	10913	3	56	0	10857	10916	0.22491450414665626
M1	string	0	network_modules	24	TRUE	5.596916791411016e-5	3	59	3	0.05084745762711865	1	REAC:R-HSA-3315487	REAC	SMAD2/3 MH2 Domain Mutants in Cancer	10916	2152		0.5821917808219178	0.5986394557823129	3	10913	3	56	0	10857	10916	0.22491450414665626
M1	string	0	network_modules	24	TRUE	5.86691564872512e-5	75	59	7	0.11864406779661017	0.09333333333333334	KEGG:05214	KEGG	Glioma	8484	465		0.6404494382022472	0.6444444444444445	75	8409	7	52	68	8357	8484	0.09816499773661293
M1	string	0	network_modules	24	TRUE	5.867741767169985e-5	114	59	8	0.13559322033898305	0.07017543859649122	REAC:R-HSA-400206	REAC	Regulation of lipid metabolism by PPARalpha	10916	2041		0.6027397260273972	0.6054421768707483	114	10802	8	51	106	10751	10916	0.09075287274373926
M1	string	0	network_modules	24	TRUE	5.886892365264677e-5	10	59	4	0.06779661016949153	0.4	REAC:R-HSA-9701898	REAC	STAT3 nuclear events downstream of ALK signaling	10916	2158		0.6095890410958904	0.6122448979591837	10	10906	4	55	6	10851	10916	0.16296769850338494
M1	string	0	network_modules	24	TRUE	6.0387664068822206e-5	211	59	10	0.1694915254237288	0.04739336492890995	REAC:R-HSA-9711123	REAC	Cellular response to chemical stress	10916	333		0.6164383561643836	0.6190476190476191	211	10705	10	49	201	10656	10916	0.080400802904811
M1	string	0	network_modules	24	TRUE	6.187963493643583e-5	90	60	7	0.11666666666666667	0.07777777777777778	GO:0045598	GO:BP	regulation of fat cell differentiation	16175	11449		0.4637096774193548	0.46586345381526106	90	16085	7	53	83	16032	16175	0.0911374555365871
M1	string	0	network_modules	24	TRUE	6.29871875844254e-5	138	60	8	0.13333333333333333	0.057971014492753624	GO:0009267	GO:BP	cellular response to starvation	16175	3432		0.46774193548387094	0.46987951807228917	138	16037	8	52	130	15985	16175	0.08279878696349695
M1	string	0	network_modules	24	TRUE	6.427388377679251e-5	76	59	7	0.11864406779661017	0.09210526315789473	KEGG:05133	KEGG	Pertussis	8484	430		0.651685393258427	0.6555555555555556	76	8408	7	52	69	8356	8484	0.09741814993456287
M1	string	0	network_modules	24	TRUE	6.821687979630413e-5	427	60	12	0.2	0.02810304449648712	GO:0007346	GO:BP	regulation of mitotic cell cycle	16175	2855		0.4717741935483871	0.4738955823293173	427	15748	12	48	415	15700	16175	0.066074050837965
M1	string	0	network_modules	24	TRUE	7.239612453876412e-5	199	60	9	0.15	0.04522613065326633	GO:0071375	GO:BP	cellular response to peptide hormone stimulus	16175	16627		0.47580645161290325	0.4779116465863454	199	15976	9	51	190	15925	16175	0.07621998759240525
M1	string	0	network_modules	24	TRUE	7.670942807262075e-5	154	59	9	0.15254237288135594	0.05844155844155844	KEGG:04932	KEGG	Non-alcoholic fatty liver disease	8484	389		0.6629213483146067	0.6666666666666666	154	8330	9	50	145	8280	8484	0.08424179381097281
M1	string	0	network_modules	24	TRUE	8.270278432212622e-5	630	60	14	0.23333333333333334	0.022222222222222223	GO:0010564	GO:BP	regulation of cell cycle process	16175	4217		0.4798387096774194	0.4819277108433735	630	15545	14	46	616	15499	16175	0.06130563448031307
M1	string	0	network_modules	24	TRUE	8.352441872444808e-5	529	60	13	0.21666666666666667	0.024574669187145556	GO:0006325	GO:BP	chromatin organization	16175	2122		0.4838709677419355	0.4859437751004016	529	15646	13	47	516	15599	16175	0.06311071330549063
M1	string	0	network_modules	24	TRUE	8.789748070701711e-5	437	60	12	0.2	0.02745995423340961	GO:0080135	GO:BP	regulation of cellular response to stress	16175	17817		0.4879032258064516	0.4899598393574297	437	15738	12	48	425	15690	16175	0.0651017542657883
M1	string	0	network_modules	24	TRUE	9.213549913186503e-5	11	59	4	0.06779661016949153	0.36363636363636365	REAC:R-HSA-9005895	REAC	Pervasive developmental disorders	10916	1729		0.6232876712328768	0.6462585034013606	11	10905	4	55	7	10850	10916	0.1551778837915528
M1	string	0	network_modules	24	TRUE	9.213549913186503e-5	11	59	4	0.06779661016949153	0.36363636363636365	REAC:R-HSA-9697154	REAC	Disorders of Nervous System Development	10916	777		0.6232876712328768	0.6462585034013606	11	10905	4	55	7	10850	10916	0.1551778837915528
M1	string	0	network_modules	24	TRUE	9.213549913186503e-5	11	59	4	0.06779661016949153	0.36363636363636365	REAC:R-HSA-9005891	REAC	Loss of function of MECP2 in Rett syndrome	10916	1332		0.6232876712328768	0.6462585034013606	11	10905	4	55	7	10850	10916	0.1551778837915528
M1	string	0	network_modules	24	TRUE	9.213549913186503e-5	11	59	4	0.06779661016949153	0.36363636363636365	REAC:R-HSA-9675151	REAC	Disorders of Developmental Biology	10916	776		0.6232876712328768	0.6462585034013606	11	10905	4	55	7	10850	10916	0.1551778837915528
M1	string	0	network_modules	24	TRUE	9.541011760277577e-5	205	59	10	0.1694915254237288	0.04878048780487805	KEGG:05205	KEGG	Proteoglycans in cancer	8484	457		0.6741573033707865	0.6777777777777778	205	8279	10	49	195	8230	8484	0.07920020683974234
M1	string	0	network_modules	24	TRUE	9.747701383201762e-5	206	60	9	0.15	0.043689320388349516	GO:1903320	GO:BP	regulation of protein modification by small protein conjugation or removal	16175	22904		0.49193548387096775	0.4939759036144578	206	15969	9	51	197	15918	16175	0.0746947156589
M1	string	0	network_modules	24	TRUE	9.928955900790182e-5	122	59	8	0.13559322033898305	0.06557377049180328	REAC:R-HSA-2559580	REAC	Oxidative Stress Induced Senescence	10916	1654		0.6506849315068494	0.6530612244897959	122	10794	8	51	114	10743	10916	0.08724551203188158
M1	string	0	network_modules	24	TRUE	9.951283299669276e-5	81	59	7	0.11864406779661017	0.08641975308641975	KEGG:04662	KEGG	B cell receptor signaling pathway	8484	339		0.6853932584269663	0.6888888888888889	81	8403	7	52	74	8351	8484	0.09388442959289094
M1	string	0	network_modules	24	TRUE	1.0266847935757531e-4	29	60	5	0.08333333333333333	0.1724137931034483	GO:0060765	GO:BP	regulation of androgen receptor signaling pathway	16175	14933		0.4959677419354839	0.5020080321285141	29	16146	5	55	24	16091	16175	0.11761056966658898
M1	string	0	network_modules	24	TRUE	1.0266847935757531e-4	29	60	5	0.08333333333333333	0.1724137931034483	GO:0071276	GO:BP	cellular response to cadmium ion	16175	16533		0.4959677419354839	0.5020080321285141	29	16146	5	55	24	16091	16175	0.11761056966658898
M1	string	0	network_modules	24	TRUE	1.0590958904398802e-4	208	60	9	0.15	0.04326923076923077	GO:0051091	GO:BP	positive regulation of DNA-binding transcription factor activity	16175	13486		0.5040322580645161	0.5060240963855421	208	15967	9	51	199	15916	16175	0.07427242952151575
M1	string	0	network_modules	24	TRUE	1.0864729330986684e-4	148	60	8	0.13333333333333333	0.05405405405405406	GO:0071478	GO:BP	cellular response to radiation	16175	16711		0.5080645161290323	0.5100401606425703	148	16027	8	52	140	15975	16175	0.079581361833389
M1	string	0	network_modules	24	TRUE	1.1035966023120482e-4	209	60	9	0.15	0.0430622009569378	GO:1901873	GO:BP	regulation of post-translational protein modification	16175	21817		0.5120967741935484	0.5140562248995983	209	15966	9	51	200	15915	16175	0.07406344828826764
M1	string	0	network_modules	24	TRUE	1.3106948483114787e-4	507	59	14	0.23728813559322035	0.027613412228796843	REAC:R-HSA-9006934	REAC	Signaling by Receptor Tyrosine Kinases	10916	2302		0.6575342465753424	0.6598639455782312	507	10409	14	45	493	10364	10916	0.06684998950605489
M1	string	0	network_modules	24	TRUE	1.3714648500031892e-4	552	60	13	0.21666666666666667	0.02355072463768116	GO:0035239	GO:BP	tube morphogenesis	16175	8921		0.5161290322580645	0.5180722891566265	552	15623	13	47	539	15576	16175	0.06134947900626782
M1	string	0	network_modules	24	TRUE	1.376463402992735e-4	12	59	4	0.06779661016949153	0.3333333333333333	REAC:R-HSA-4755510	REAC	SUMOylation of immune response proteins	10916	2174		0.6643835616438356	0.6666666666666666	12	10904	4	55	8	10849	10916	0.14837453282416016
M1	string	0	network_modules	24	TRUE	1.460639334420671e-4	31	60	5	0.08333333333333333	0.16129032258064516	GO:0046686	GO:BP	response to cadmium ion	16175	12317		0.5201612903225806	0.5301204819277109	31	16144	5	55	26	16089	16175	0.11358797127878514
M1	string	0	network_modules	24	TRUE	1.460639334420671e-4	31	60	5	0.08333333333333333	0.16129032258064516	GO:0044819	GO:BP	mitotic G1/S transition checkpoint signaling	16175	11175		0.5201612903225806	0.5301204819277109	31	16144	5	55	26	16089	16175	0.11358797127878514
M1	string	0	network_modules	24	TRUE	1.460639334420671e-4	31	60	5	0.08333333333333333	0.16129032258064516	GO:0031571	GO:BP	mitotic G1 DNA damage checkpoint signaling	16175	7221		0.5201612903225806	0.5301204819277109	31	16144	5	55	26	16089	16175	0.11358797127878514
M1	string	0	network_modules	24	TRUE	1.4929395335453713e-4	61	60	6	0.1	0.09836065573770492	GO:2000134	GO:BP	negative regulation of G1/S transition of mitotic cell cycle	16175	25483		0.532258064516129	0.5341365461847389	61	16114	6	54	55	16060	16175	0.09579503449069891
M1	string	0	network_modules	24	TRUE	1.514575468524645e-4	54	59	6	0.1016949152542373	0.1111111111111111	REAC:R-HSA-109606	REAC	Intrinsic Pathway for Apoptosis	10916	1268		0.6712328767123288	0.673469387755102	54	10862	6	53	48	10809	10916	0.10165413457562322
M1	string	0	network_modules	24	TRUE	1.57892228950749e-4	234	59	10	0.1694915254237288	0.042735042735042736	REAC:R-HSA-8878171	REAC	Transcriptional regulation by RUNX1	10916	2552		0.678082191780822	0.6802721088435374	234	10682	10	49	224	10633	10916	0.07535703037510955
M1	string	0	network_modules	24	TRUE	1.6900237200007866e-4	104	60	7	0.11666666666666667	0.0673076923076923	GO:0071453	GO:BP	cellular response to oxygen levels	16175	16687		0.5362903225806451	0.5381526104417671	104	16071	7	53	97	16018	16175	0.08415772574245807
M1	string	0	network_modules	24	TRUE	1.805541979584875e-4	105	60	7	0.11666666666666667	0.06666666666666667	GO:0071482	GO:BP	cellular response to light stimulus	16175	16715		0.5403225806451613	0.54216867469879515	105	16070	7	53	98	16017	16175	0.08371164782454159
M1	string	0	network_modules	24	TRUE	1.8605222775429806e-4	30	59	5	0.0847457627118644	0.16666666666666666	REAC:R-HSA-6804758	REAC	Regulation of TP53 Activity through Acetylation	10916	2013		0.684931506849315	0.6938775510204082	30	10886	5	54	25	10832	10916	0.11546236541323028
M1	string	0	network_modules	24	TRUE	1.8605222775429806e-4	30	59	5	0.0847457627118644	0.16666666666666666	REAC:R-HSA-114452	REAC	Activation of BH3-only proteins	10916	77		0.684931506849315	0.6938775510204082	30	10886	5	54	25	10832	10916	0.11546236541323028
M1	string	0	network_modules	24	TRUE	1.8934977414080374e-4	159	60	8	0.13333333333333333	0.050314465408805034	GO:0042594	GO:BP	response to starvation	16175	10254		0.5443548387096774	0.5461847389558233	159	16016	8	52	151	15964	16175	0.0763849679987547
M1	string	0	network_modules	24	TRUE	1.960550651896409e-4	297	60	10	0.16666666666666666	0.03367003367003367	GO:0031647	GO:BP	regulation of protein stability	16175	7257		0.5483870967741935	0.5502008032128514	297	15878	10	50	287	15828	16175	0.06740380628932872
M1	string	0	network_modules	24	TRUE	2.047997078378498e-4	223	59	10	0.1694915254237288	0.04484304932735426	KEGG:04024	KEGG	cAMP signaling pathway	8484	252		0.6966292134831461	0.7	223	8261	10	49	213	8212	8484	0.07490942603424873
M1	string	0	network_modules	24	TRUE	2.087485989609189e-4	58	59	6	0.1016949152542373	0.10344827586206896	KEGG:05213	KEGG	Endometrial cancer	8484	464		0.7078651685393258	0.7111111111111111	58	8426	6	53	52	8373	8484	0.0963370445759311
M1	string	0	network_modules	24	TRUE	2.1369179232043667e-4	92	59	7	0.11864406779661017	0.07608695652173914	REAC:R-HSA-2219528	REAC	PI3K/AKT Signaling in Cancer	10916	1674		0.6986301369863014	0.7006802721088435	92	10824	7	52	85	10772	10916	0.0888774812340239
M1	string	0	network_modules	24	TRUE	2.3628600882219102e-4	92	59	7	0.11864406779661017	0.07608695652173914	KEGG:05222	KEGG	Small cell lung cancer	8484	473		0.7191011235955056	0.7222222222222222	92	8392	7	52	85	8340	8484	0.08710324386644522
M1	string	0	network_modules	24	TRUE	2.408213775811801e-4	66	60	6	0.1	0.09090909090909091	GO:1902807	GO:BP	negative regulation of cell cycle G1/S phase transition	16175	22526		0.5524193548387096	0.5542168674698795	66	16109	6	54	60	16055	16175	0.09181338337000682
M1	string	0	network_modules	24	TRUE	2.4883067925233766e-4	110	60	7	0.11666666666666667	0.06363636363636363	GO:1900180	GO:BP	regulation of protein localization to nucleus	16175	20456		0.5564516129032258	0.5582329317269076	110	16065	7	53	103	16012	16175	0.08157020552049252
M1	string	0	network_modules	24	TRUE	2.5196945387935847e-4	165	60	8	0.13333333333333333	0.048484848484848485	GO:0002573	GO:BP	myeloid leukocyte differentiation	16175	1094		0.5604838709677419	0.5622489959839357	165	16010	8	52	157	15958	16175	0.07477208432822799
M1	string	0	network_modules	24	TRUE	2.637518564746017e-4	67	60	6	0.1	0.08955223880597014	GO:1900542	GO:BP	regulation of purine nucleotide metabolic process	16175	20727		0.5645161290322581	0.5662650602409639	67	16108	6	54	61	16054	16175	0.0910697258112317
M1	string	0	network_modules	24	TRUE	2.639683827127343e-4	166	60	8	0.13333333333333333	0.04819277108433735	GO:1902806	GO:BP	regulation of cell cycle G1/S phase transition	16175	22525		0.5685483870967742	0.570281124497992	166	16009	8	52	158	15957	16175	0.07451142484424451
M1	string	0	network_modules	24	TRUE	2.884484967398911e-4	68	60	6	0.1	0.08823529411764706	GO:0006140	GO:BP	regulation of nucleotide metabolic process	16175	1985		0.5725806451612904	0.5742971887550201	68	16107	6	54	62	16053	16175	0.09034211739895122
M1	string	0	network_modules	24	TRUE	2.9267192469561705e-4	135	59	8	0.13559322033898305	0.05925925925925926	KEGG:04210	KEGG	Apoptosis	8484	287		0.7303370786516854	0.7333333333333333	135	8349	8	51	127	8298	8484	0.08003546939189472
M1	string	0	network_modules	24	TRUE	3.0248886966306835e-4	4	60	3	0.05	0.75	GO:0018076	GO:BP	N-terminal peptidyl-lysine acetylation	16175	5317		0.5766129032258065	0.5783132530120482	4	16171	3	57	1	16114	16175	0.19307365646199193
M1	string	0	network_modules	24	TRUE	3.060459259940358e-4	33	59	5	0.0847457627118644	0.15151515151515152	REAC:R-HSA-9634815	REAC	Transcriptional Regulation by NPAS4	10916	2545		0.7054794520547946	0.7074829931972789	33	10883	5	54	28	10829	10916	0.10973518889915462
M1	string	0	network_modules	24	TRUE	3.1806946399536734e-4	114	60	7	0.11666666666666667	0.06140350877192982	GO:0000077	GO:BP	DNA damage checkpoint signaling	16175	28		0.5806451612903226	0.5823293172690763	114	16061	7	53	107	16008	16175	0.07995597086859953
M1	string	0	network_modules	24	TRUE	3.538293333697352e-4	15	60	4	0.06666666666666667	0.26666666666666666	GO:0060766	GO:BP	negative regulation of androgen receptor signaling pathway	16175	14934		0.5846774193548387	0.5863453815261044	15	16160	4	56	11	16104	16175	0.13178427474961446
M1	string	0	network_modules	24	TRUE	3.625610132349985e-4	173	60	8	0.13333333333333333	0.046242774566473986	GO:0006352	GO:BP	DNA-templated transcription initiation	16175	2129		0.5887096774193549	0.5903614457831325	173	16002	8	52	165	15950	16175	0.07274765209999677
M1	string	0	network_modules	24	TRUE	3.7162430234968395e-4	241	60	9	0.15	0.03734439834024896	GO:0034504	GO:BP	protein localization to nucleus	16175	8670		0.592741935483871	0.5943775100401606	241	15934	9	51	232	15883	16175	0.06804413091448179
M1	string	0	network_modules	24	TRUE	3.750009461298982e-4	15	59	4	0.06779661016949153	0.26666666666666666	REAC:R-HSA-9823730	REAC	Formation of definitive endoderm	10916	957		0.7123287671232876	0.7142857142857143	15	10901	4	55	11	10846	10916	0.13218156947628942
M1	string	0	network_modules	24	TRUE	4.469006214577714e-4	301	59	11	0.1864406779661017	0.036544850498338874	KEGG:04010	KEGG	MAPK signaling pathway	8484	243		0.7415730337078652	0.7444444444444445	301	8183	11	48	290	8135	8484	0.06829205834707763
M1	string	0	network_modules	24	TRUE	4.704663807001883e-4	16	60	4	0.06666666666666667	0.25	GO:1900034	GO:BP	regulation of cellular response to heat	16175	20340		0.5967741935483871	0.5983935742971888	16	16159	4	56	12	16103	16175	0.12748352022554962
M1	string	0	network_modules	24	TRUE	4.928376825469134e-4	246	59	10	0.1694915254237288	0.04065040650406504	KEGG:05131	KEGG	Shigellosis	8484	428		0.7528089887640449	0.7555555555555555	246	8238	10	49	236	8189	8484	0.07006909501841241
M1	string	0	network_modules	24	TRUE	5.03644422950319e-4	103	59	7	0.11864406779661017	0.06796116504854369	KEGG:04137	KEGG	Mitophagy - animal	8484	274		0.7640449438202247	0.7666666666666667	103	8381	7	52	96	8329	8484	0.0813840570185348
M1	string	0	network_modules	24	TRUE	5.3501293492893e-4	123	60	7	0.11666666666666667	0.056910569105691054	GO:0031570	GO:BP	DNA integrity checkpoint signaling	16175	7220		0.6008064516129032	0.6024096385542169	123	16052	7	53	116	15999	16175	0.07660593821710752
M1	string	0	network_modules	24	TRUE	5.553922825907685e-4	5	59	3	0.05084745762711865	0.6	REAC:R-HSA-3134973	REAC	LRR FLII-interacting protein 1 (LRRFIP1) activates type I IFN production	10916	1299		0.7191780821917808	0.7210884353741497	5	10911	3	56	2	10855	10916	0.17360276780055128
M1	string	0	network_modules	24	TRUE	5.725884597180573e-4	625	60	13	0.21666666666666667	0.0208	GO:1901652	GO:BP	response to peptide	16175	21619		0.6048387096774194	0.6104417670682731	625	15550	13	47	612	15503	16175	0.056361808001638945
M1	string	0	network_modules	24	TRUE	5.725884597180573e-4	625	60	13	0.21666666666666667	0.0208	GO:0034097	GO:BP	response to cytokine	16175	8408		0.6048387096774194	0.6104417670682731	625	15550	13	47	612	15503	16175	0.056361808001638945
M1	string	0	network_modules	24	TRUE	5.828047038482202e-4	69	59	6	0.1016949152542373	0.08695652173913043	KEGG:05031	KEGG	Amphetamine addiction	8484	419		0.7752808988764045	0.7777777777777778	69	8415	6	53	63	8362	8484	0.08717448940627254
M1	string	0	network_modules	24	TRUE	6.089192012082244e-4	77	60	6	0.1	0.07792207792207792	GO:0044773	GO:BP	mitotic DNA damage checkpoint signaling	16175	11149		0.6129032258064516	0.6144578313253012	77	16098	6	54	71	16044	16175	0.08442884513805776
M1	string	0	network_modules	24	TRUE	6.13522177044195e-4	17	60	4	0.06666666666666667	0.23529411764705882	GO:1900543	GO:BP	negative regulation of purine nucleotide metabolic process	16175	20728		0.6169354838709677	0.6184738955823293	17	16158	4	56	13	16102	16175	0.12356458418158028
M1	string	0	network_modules	24	TRUE	6.262065397484605e-4	41	60	5	0.08333333333333333	0.12195121951219512	GO:0003300	GO:BP	cardiac muscle hypertrophy	16175	1722		0.6209677419354839	0.6224899598393574	41	16134	5	55	36	16079	16175	0.09804950647361428
M1	string	0	network_modules	24	TRUE	6.383730782377958e-4	631	60	13	0.21666666666666667	0.020602218700475437	GO:0022603	GO:BP	regulation of anatomical structure morphogenesis	16175	6611		0.625	0.6265060240963856	631	15544	13	47	618	15497	16175	0.05598712840105727
M1	string	0	network_modules	24	TRUE	6.485911122888464e-4	17	59	4	0.06779661016949153	0.23529411764705882	REAC:R-HSA-1502540	REAC	Signaling by Activin	10916	2223		0.726027397260274	0.7482993197278912	17	10899	4	55	13	10844	10916	0.12383183816187246
M1	string	0	network_modules	24	TRUE	6.485911122888464e-4	17	59	4	0.06779661016949153	0.23529411764705882	REAC:R-HSA-9659787	REAC	Aberrant regulation of mitotic G1/S transition in cancer due to RB1 defects	10916	47		0.726027397260274	0.7482993197278912	17	10899	4	55	13	10844	10916	0.12383183816187246
M1	string	0	network_modules	24	TRUE	6.485911122888464e-4	17	59	4	0.06779661016949153	0.23529411764705882	REAC:R-HSA-9754189	REAC	Germ layer formation at gastrulation	10916	1046		0.726027397260274	0.7482993197278912	17	10899	4	55	13	10844	10916	0.12383183816187246
M1	string	0	network_modules	24	TRUE	6.485911122888464e-4	17	59	4	0.06779661016949153	0.23529411764705882	REAC:R-HSA-9661069	REAC	Defective binding of RB1 mutants to E2F1,(E2F2, E2F3)	10916	689		0.726027397260274	0.7482993197278912	17	10899	4	55	13	10844	10916	0.12383183816187246
M1	string	0	network_modules	24	TRUE	6.49973311230436e-4	632	60	13	0.21666666666666667	0.020569620253164556	GO:0031401	GO:BP	positive regulation of protein modification process	16175	7157		0.6290322580645161	0.6305220883534136	632	15543	13	47	619	15496	16175	0.05592514824693737
M1	string	0	network_modules	24	TRUE	6.653954527546602e-4	127	60	7	0.11666666666666667	0.05511811023622047	GO:0000302	GO:BP	response to reactive oxygen species	16175	88		0.6330645161290323	0.6345381526104418	127	16048	7	53	120	15995	16175	0.07522832332722154
M1	string	0	network_modules	24	TRUE	7.088163521952524e-4	42	60	5	0.08333333333333333	0.11904761904761904	GO:0043502	GO:BP	regulation of muscle adaptation	16175	10740		0.6370967741935484	0.6465863453815262	42	16133	5	55	37	16078	16175	0.09680409355975986
M1	string	0	network_modules	24	TRUE	7.088163521952524e-4	42	60	5	0.08333333333333333	0.11904761904761904	GO:0045815	GO:BP	transcription initiation-coupled chromatin remodeling	16175	11637		0.6370967741935484	0.6465863453815262	42	16133	5	55	37	16078	16175	0.09680409355975986
M1	string	0	network_modules	24	TRUE	7.088163521952524e-4	42	60	5	0.08333333333333333	0.11904761904761904	GO:0141137	GO:BP	positive regulation of gene expression, epigenetic	16175	20039		0.6370967741935484	0.6465863453815262	42	16133	5	55	37	16078	16175	0.09680409355975986
M1	string	0	network_modules	24	TRUE	7.217215279089432e-4	202	59	9	0.15254237288135594	0.04455445544554455	KEGG:05415	KEGG	Diabetic cardiomyopathy	8484	492		0.7865168539325843	0.7888888888888889	202	8282	9	50	193	8232	8484	0.07066230404257945
M1	string	0	network_modules	24	TRUE	7.242805942999625e-4	39	59	5	0.0847457627118644	0.1282051282051282	REAC:R-HSA-9031628	REAC	NGF-stimulated transcription	10916	1527		0.7534246575342466	0.7551020408163265	39	10877	5	54	34	10823	10916	0.10029042673317087
M1	string	0	network_modules	24	TRUE	7.333123779364785e-4	109	59	7	0.11864406779661017	0.06422018348623854	KEGG:04066	KEGG	HIF-1 signaling pathway	8484	257		0.797752808988764	0.8	109	8375	7	52	102	8323	8484	0.07861524225377611
M1	string	0	network_modules	24	TRUE	7.474477433018999e-4	72	59	6	0.1016949152542373	0.08333333333333333	KEGG:05223	KEGG	Non-small cell lung cancer	8484	474		0.8089887640449438	0.8111111111111111	72	8412	6	53	66	8359	8484	0.08503166077713846
M1	string	0	network_modules	24	TRUE	7.514331544920964e-4	262	60	9	0.15	0.03435114503816794	GO:0010948	GO:BP	negative regulation of cell cycle process	16175	4526		0.6491935483870968	0.6506024096385542	262	15913	9	51	253	15862	16175	0.06467571214077049
M1	string	0	network_modules	24	TRUE	7.542233871495228e-4	5	60	3	0.05	0.6	GO:0030578	GO:BP	PML body organization	16175	6850		0.6532258064516129	0.6546184738955824	5	16170	3	57	2	16113	16175	0.17248107253519926
M1	string	0	network_modules	24	TRUE	7.651450023668361e-4	111	59	7	0.11864406779661017	0.06306306306306306	REAC:R-HSA-2559582	REAC	Senescence-Associated Secretory Phenotype (SASP)	10916	2194		0.7602739726027398	0.7687074829931972	111	10805	7	52	104	10753	10916	0.07970625992034655
M1	string	0	network_modules	24	TRUE	7.651450023668361e-4	111	59	7	0.11864406779661017	0.06306306306306306	REAC:R-HSA-6785807	REAC	Interleukin-4 and Interleukin-13 signaling	10916	1252		0.7602739726027398	0.7687074829931972	111	10805	7	52	104	10753	10916	0.07970625992034655
M1	string	0	network_modules	24	TRUE	7.866307449204823e-4	18	60	4	0.06666666666666667	0.2222222222222222	GO:0045980	GO:BP	negative regulation of nucleotide metabolic process	16175	11772		0.657258064516129	0.6586345381526104	18	16157	4	56	14	16101	16175	0.11997375991105351
M1	string	0	network_modules	24	TRUE	7.998106589118199e-4	43	60	5	0.08333333333333333	0.11627906976744186	GO:0014897	GO:BP	striated muscle hypertrophy	16175	4772		0.6612903225806451	0.6626506024096386	43	16132	5	55	38	16077	16175	0.09560154565657399
M1	string	0	network_modules	24	TRUE	8.127465127384521e-4	112	59	7	0.11864406779661017	0.0625	REAC:R-HSA-187037	REAC	Signaling by NTRK1 (TRKA)	10916	2284		0.773972602739726	0.7755102040816326	112	10804	7	52	105	10752	10916	0.07928628806401063
M1	string	0	network_modules	24	TRUE	8.240065271409771e-4	81	60	6	0.1	0.07407407407407407	GO:0044774	GO:BP	mitotic DNA integrity checkpoint signaling	16175	11150		0.6653225806451613	0.6666666666666666	81	16094	6	54	75	16040	16175	0.08211424931304263
M1	string	0	network_modules	24	TRUE	8.242069168373154e-4	347	60	10	0.16666666666666666	0.02881844380403458	GO:0007507	GO:BP	heart development	16175	2993		0.6693548387096774	0.6706827309236948	347	15828	10	50	337	15778	16175	0.06115541443455717
M1	string	0	network_modules	24	TRUE	8.499675755484785e-4	72	59	6	0.1016949152542373	0.08333333333333333	REAC:R-HSA-3108214	REAC	SUMOylation of DNA damage response and repair proteins	10916	2168		0.7808219178082192	0.782312925170068	72	10844	6	53	66	10791	10916	0.08660639957291484
M1	string	0	network_modules	24	TRUE	8.553319510217096e-4	156	59	8	0.13559322033898305	0.05128205128205128	KEGG:04148	KEGG	Efferocytosis	8484	283		0.8202247191011236	0.8222222222222222	156	8328	8	51	148	8277	8484	0.07300585059058633
M1	string	0	network_modules	24	TRUE	8.997956627114554e-4	44	60	5	0.08333333333333333	0.11363636363636363	GO:0014896	GO:BP	muscle hypertrophy	16175	4771		0.6733870967741935	0.6746987951807228	44	16131	5	55	39	16076	16175	0.09443942255472595
M1	string	0	network_modules	24	TRUE	9.154065468676466e-4	114	59	7	0.11864406779661017	0.06140350877192982	REAC:R-HSA-9758941	REAC	Gastrulation	10916	1040		0.7876712328767124	0.7891156462585034	114	10802	7	52	107	10750	10916	0.07846213108880938
M1	string	0	network_modules	24	TRUE	9.580283813381503e-4	654	60	13	0.21666666666666667	0.019877675840978593	GO:0031347	GO:BP	regulation of defense response	16175	7138		0.6774193548387096	0.678714859437751	654	15521	13	47	641	15474	16175	0.054594072009158376
M1	string	0	network_modules	24	TRUE	9.9166341043983e-4	656	60	13	0.21666666666666667	0.019817073170731708	GO:1903047	GO:BP	mitotic cell cycle process	16175	22727		0.6814516129032258	0.6827309236947792	656	15519	13	47	643	15472	16175	0.05447605039631094
M1	string	0	network_modules	24	TRUE	0.00110651115393592	6	59	3	0.05084745762711865	0.5	REAC:R-HSA-3304349	REAC	Loss of Function of SMAD2/3 in Cancer	10916	1323		0.7945205479452054	0.8027210884353742	6	10910	3	56	3	10854	10916	0.15819605628112796
M1	string	0	network_modules	24	TRUE	0.00110651115393592	6	59	3	0.05084745762711865	0.5	REAC:R-HSA-9022537	REAC	Loss of MECP2 binding ability to the NCoR/SMRT complex	10916	1330		0.7945205479452054	0.8027210884353742	6	10910	3	56	3	10854	10916	0.15819605628112796
M1	string	0	network_modules	24	TRUE	0.0011269281984780904	275	60	9	0.15	0.03272727272727273	GO:2001233	GO:BP	regulation of apoptotic signaling pathway	16175	26422		0.6854838709677419	0.6867469879518072	275	15900	9	51	266	15849	16175	0.06277495998177084
M1	string	0	network_modules	24	TRUE	0.001149465817920884	555	60	12	0.2	0.021621621621621623	GO:0071345	GO:BP	cellular response to cytokine stimulus	16175	16597		0.6895161290322581	0.6907630522088354	555	15620	12	48	543	15572	16175	0.055540304694642696
M1	string	0	network_modules	24	TRUE	0.0011803704905035486	202	60	8	0.13333333333333333	0.039603960396039604	GO:0045930	GO:BP	negative regulation of mitotic cell cycle	16175	11724		0.6935483870967742	0.6947791164658634	202	15973	8	52	194	15921	16175	0.06639941400856388
M1	string	0	network_modules	24	TRUE	0.0011962901009389387	667	60	13	0.21666666666666667	0.019490254872563718	GO:0032446	GO:BP	protein modification by small protein conjugation	16175	7568		0.6975806451612904	0.6987951807228916	667	15508	13	47	654	15461	16175	0.053835441840815415
M1	string	0	network_modules	24	TRUE	0.0012601582960010227	47	60	5	0.08333333333333333	0.10638297872340426	GO:0043470	GO:BP	regulation of carbohydrate catabolic process	16175	10718		0.7016129032258065	0.7028112449799196	47	16128	5	55	42	16073	16175	0.0911739481339297
M1	string	0	network_modules	24	TRUE	0.0012632194849623575	77	59	6	0.1016949152542373	0.07792207792207792	REAC:R-HSA-5693565	REAC	Recruitment and ATM-mediated phosphorylation of repair and signaling proteins at DNA double strand breaks	10916	1949		0.8082191780821918	0.8095238095238095	77	10839	6	53	71	10786	10916	0.0833631641092523
M1	string	0	network_modules	24	TRUE	0.0012906216493125267	120	59	7	0.11864406779661017	0.058333333333333334	REAC:R-HSA-5617472	REAC	Activation of anterior HOX genes in hindbrain development during early embryogenesis	10916	99		0.815068493150685	0.8231292517006803	120	10796	7	52	113	10744	10916	0.07610807590531866
M1	string	0	network_modules	24	TRUE	0.0012906216493125267	120	59	7	0.11864406779661017	0.058333333333333334	REAC:R-HSA-5619507	REAC	Activation of HOX genes during differentiation	10916	84		0.815068493150685	0.8231292517006803	120	10796	7	52	113	10744	10916	0.07610807590531866
M1	string	0	network_modules	24	TRUE	0.0013044593643693715	20	59	4	0.06779661016949153	0.2	REAC:R-HSA-9013695	REAC	NOTCH4 Intracellular Domain Regulates Transcription	10916	1538		0.8287671232876712	0.8435374149659864	20	10896	4	55	16	10841	10916	0.11370928541978069
M1	string	0	network_modules	24	TRUE	0.0013044593643693715	20	59	4	0.06779661016949153	0.2	REAC:R-HSA-6803204	REAC	TP53 Regulates Transcription of Genes Involved in Cytochrome C Release	10916	2458		0.8287671232876712	0.8435374149659864	20	10896	4	55	16	10841	10916	0.11370928541978069
M1	string	0	network_modules	24	TRUE	0.0013044593643693715	20	59	4	0.06779661016949153	0.2	REAC:R-HSA-5621575	REAC	CD209 (DC-SIGN) signaling	10916	265		0.8287671232876712	0.8435374149659864	20	10896	4	55	16	10841	10916	0.11370928541978069
M1	string	0	network_modules	24	TRUE	0.0013516890094049606	141	60	7	0.11666666666666667	0.04964539007092199	GO:2000045	GO:BP	regulation of G1/S transition of mitotic cell cycle	16175	25406		0.7056451612903226	0.7068273092369478	141	16034	7	53	134	15981	16175	0.07085898730741305
M1	string	0	network_modules	24	TRUE	0.0013627936278895094	78	59	6	0.1016949152542373	0.07692307692307693	REAC:R-HSA-5693606	REAC	DNA Double Strand Break Response	10916	442		0.8493150684931506	0.8503401360544217	78	10838	6	53	72	10785	10916	0.0827507051923173
M1	string	0	network_modules	24	TRUE	0.0014178338627528477	298	59	10	0.1694915254237288	0.03355704697986577	REAC:R-HSA-5688426	REAC	Deubiquitination	10916	736		0.8561643835616438	0.8571428571428571	298	10618	10	49	288	10569	10916	0.06432513958953175
M1	string	0	network_modules	24	TRUE	0.0014419958719674977	89	60	6	0.1	0.06741573033707865	GO:0071456	GO:BP	cellular response to hypoxia	16175	16690		0.7096774193548387	0.714859437751004	89	16086	6	54	83	16032	16175	0.07794834125703974
M1	string	0	network_modules	24	TRUE	0.0014419958719674977	89	60	6	0.1	0.06741573033707865	GO:0048660	GO:BP	regulation of smooth muscle cell proliferation	16175	12918		0.7096774193548387	0.714859437751004	89	16086	6	54	83	16032	16175	0.07794834125703974
M1	string	0	network_modules	24	TRUE	0.0014719396474317773	798	60	14	0.23333333333333334	0.017543859649122806	GO:0043687	GO:BP	post-translational protein modification	16175	10838		0.717741935483871	0.7188755020080321	798	15377	14	46	784	15331	16175	0.05184184695787258
M1	string	0	network_modules	24	TRUE	0.001486384236555408	143	60	7	0.11666666666666667	0.04895104895104895	GO:0006367	GO:BP	transcription initiation at RNA polymerase II promoter	16175	2142		0.7217741935483871	0.7228915662650602	143	16032	7	53	136	15979	16175	0.07028551500218061
M1	string	0	network_modules	24	TRUE	0.0015044602744159839	6	60	3	0.05	0.5	GO:0032906	GO:BP	transforming growth factor beta2 production	16175	7898		0.7258064516129032	0.7309236947791165	6	16169	3	57	3	16112	16175	0.15726192186902072
M1	string	0	network_modules	24	TRUE	0.0015044602744159839	6	60	3	0.05	0.5	GO:0032909	GO:BP	regulation of transforming growth factor beta2 production	16175	7901		0.7258064516129032	0.7309236947791165	6	16169	3	57	3	16112	16175	0.15726192186902072
M1	string	0	network_modules	24	TRUE	0.0015258177507725106	21	60	4	0.06666666666666667	0.19047619047619047	GO:0006977	GO:BP	DNA damage response, signal transduction by p53 class mediator resulting in cell cycle arrest	16175	2602		0.7338709677419355	0.7349397590361446	21	16154	4	56	17	16098	16175	0.1107701407514713
M1	string	0	network_modules	24	TRUE	0.0015405756031840047	90	60	6	0.1	0.06666666666666667	GO:0010212	GO:BP	response to ionizing radiation	16175	3993		0.7379032258064516	0.7389558232931727	90	16085	6	54	84	16031	16175	0.07746578066244571
M1	string	0	network_modules	24	TRUE	0.0015576823784234294	49	60	5	0.08333333333333333	0.10204081632653061	GO:0034605	GO:BP	cellular response to heat	16175	8685		0.7419354838709677	0.7429718875502008	49	16126	5	55	44	16071	16175	0.08916212118389406
M1	string	0	network_modules	24	TRUE	0.001604903197553804	21	59	4	0.06779661016949153	0.19047619047619047	REAC:R-HSA-9768919	REAC	NPAS4 regulates expression of target genes	10916	1539		0.863013698630137	0.8639455782312925	21	10895	4	55	17	10840	10916	0.11081987643859513
M1	string	0	network_modules	24	TRUE	0.0016060327843409941	124	59	7	0.11864406779661017	0.056451612903225805	REAC:R-HSA-9755511	REAC	KEAP1-NFE2L2 pathway	10916	1281		0.8698630136986302	0.8707482993197279	124	10792	7	52	117	10740	10916	0.074629437962382
M1	string	0	network_modules	24	TRUE	0.0016160013310000775	49	59	5	0.0847457627118644	0.10204081632653061	KEGG:05030	KEGG	Cocaine addiction	8484	418		0.8314606741573034	0.8333333333333334	49	8435	5	54	44	8381	8484	0.08720959782005623
M1	string	0	network_modules	24	TRUE	0.0016446037261351365	91	60	6	0.1	0.06593406593406594	GO:0048659	GO:BP	smooth muscle cell proliferation	16175	12917		0.7459677419354839	0.7469879518072289	91	16084	6	54	85	16030	16175	0.07699092731829037
M1	string	0	network_modules	24	TRUE	0.001754310428587161	92	60	6	0.1	0.06521739130434782	GO:0016525	GO:BP	negative regulation of angiogenesis	16175	5237		0.75	0.7550200803212851	92	16083	6	54	86	16029	16175	0.07652357263238123
M1	string	0	network_modules	24	TRUE	0.001754310428587161	92	60	6	0.1	0.06521739130434782	GO:0036294	GO:BP	cellular response to decreased oxygen levels	16175	9545		0.75	0.7550200803212851	92	16083	6	54	86	16029	16175	0.07652357263238123
M1	string	0	network_modules	24	TRUE	0.0018239078205326263	214	60	8	0.13333333333333333	0.037383177570093455	GO:0044843	GO:BP	cell cycle G1/S phase transition	16175	11189		0.7580645161290323	0.7590361445783133	214	15961	8	52	206	15909	16175	0.06413894663731363
M1	string	0	network_modules	24	TRUE	0.0018699325951294936	93	60	6	0.1	0.06451612903225806	GO:2000181	GO:BP	negative regulation of blood vessel morphogenesis	16175	25513		0.7620967741935484	0.7630522088353414	93	16082	6	54	87	16028	16175	0.07606351586089487
M1	string	0	network_modules	24	TRUE	0.0018732178550685257	148	60	7	0.11666666666666667	0.0472972972972973	GO:2000058	GO:BP	regulation of ubiquitin-dependent protein catabolic process	16175	25413		0.7661290322580645	0.7670682730923695	148	16027	7	53	141	15974	16175	0.06890074013031011
M1	string	0	network_modules	24	TRUE	0.0019289461992494288	7	59	3	0.05084745762711865	0.42857142857142855	REAC:R-HSA-3304351	REAC	Signaling by TGF-beta Receptor Complex in Cancer	10916	2309		0.8767123287671232	0.8775510204081632	7	10909	3	56	4	10853	10916	0.1462010358528673
M1	string	0	network_modules	24	TRUE	0.001991713909032576	94	60	6	0.1	0.06382978723404255	GO:1901343	GO:BP	negative regulation of vasculature development	16175	21402		0.7701612903225806	0.7710843373493976	94	16081	6	54	88	16027	16175	0.07561056373226553
M1	string	0	network_modules	24	TRUE	0.002105042859788433	52	60	5	0.08333333333333333	0.09615384615384616	GO:1903053	GO:BP	regulation of extracellular matrix organization	16175	22732		0.7741935483870968	0.7751004016064257	52	16123	5	55	47	16068	16175	0.08636006226407679
M1	string	0	network_modules	24	TRUE	0.0021748005371860324	356	59	11	0.1864406779661017	0.03089887640449438	KEGG:04151	KEGG	PI3K-Akt signaling pathway	8484	285		0.8426966292134831	0.8444444444444444	356	8128	11	48	345	8080	8484	0.060301846439400314
M1	string	0	network_modules	24	TRUE	0.0022450196631890592	23	60	4	0.06666666666666667	0.17391304347826086	GO:0034391	GO:BP	regulation of smooth muscle cell apoptotic process	16175	8612		0.7782258064516129	0.7831325301204819	23	16152	4	56	19	16096	16175	0.10565086450772422
M1	string	0	network_modules	24	TRUE	0.0022450196631890592	23	60	4	0.06666666666666667	0.17391304347826086	GO:0034390	GO:BP	smooth muscle cell apoptotic process	16175	8611		0.7782258064516129	0.7831325301204819	23	16152	4	56	19	16096	16175	0.10565086450772422
M1	string	0	network_modules	24	TRUE	0.0023123194161859236	131	59	7	0.11864406779661017	0.05343511450381679	REAC:R-HSA-166520	REAC	Signaling by NTRKs	10916	2287		0.8835616438356164	0.8843537414965986	131	10785	7	52	124	10733	10916	0.07219757476320299
M1	string	0	network_modules	24	TRUE	0.002317739151060131	53	60	5	0.08333333333333333	0.09433962264150944	GO:0071479	GO:BP	cellular response to ionizing radiation	16175	16712		0.7862903225806451	0.7871485943775101	53	16122	5	55	48	16067	16175	0.08547810739274674
M1	string	0	network_modules	24	TRUE	0.002345983700899125	594	60	12	0.2	0.020202020202020204	GO:0006954	GO:BP	inflammatory response	16175	2585		0.7903225806451613	0.7911646586345381	594	15581	12	48	582	15533	16175	0.0529709772482601
M1	string	0	network_modules	24	TRUE	0.0023554266593736506	23	59	4	0.06779661016949153	0.17391304347826086	REAC:R-HSA-1181150	REAC	Signaling by NODAL	10916	2273		0.8904109589041096	0.8979591836734694	23	10893	4	55	19	10838	10916	0.10560722620308775
M1	string	0	network_modules	24	TRUE	0.0023554266593736506	23	59	4	0.06779661016949153	0.17391304347826086	REAC:R-HSA-8940973	REAC	RUNX2 regulates osteoblast differentiation	10916	1930		0.8904109589041096	0.8979591836734694	23	10893	4	55	19	10838	10916	0.10560722620308775
M1	string	0	network_modules	24	TRUE	0.0025691699758362547	224	60	8	0.13333333333333333	0.03571428571428571	GO:1901988	GO:BP	negative regulation of cell cycle phase transition	16175	21921		0.7943548387096774	0.7951807228915663	224	15951	8	52	216	15899	16175	0.062387769637638146
M1	string	0	network_modules	24	TRUE	0.002625848430236123	7	60	3	0.05	0.42857142857142855	GO:0097709	GO:BP	connective tissue replacement	16175	18738		0.7983870967741935	0.7991967871485943	7	16168	3	57	4	16111	16175	0.14541937327756174
M1	string	0	network_modules	24	TRUE	0.0027937851304777528	55	60	5	0.08333333333333333	0.09090909090909091	GO:0043500	GO:BP	muscle adaptation	16175	10738		0.8024193548387096	0.8032128514056225	55	16120	5	55	50	16065	16175	0.08378516719846858
M1	string	0	network_modules	24	TRUE	0.002815135165933335	24	59	4	0.06779661016949153	0.16666666666666666	REAC:R-HSA-9634638	REAC	Estrogen-dependent nuclear events downstream of ESR-membrane signaling	10916	867		0.9041095890410958	0.9115646258503401	24	10892	4	55	20	10837	10916	0.1032442306945215
M1	string	0	network_modules	24	TRUE	0.002815135165933335	24	59	4	0.06779661016949153	0.16666666666666666	REAC:R-HSA-9013508	REAC	NOTCH3 Intracellular Domain Regulates Transcription	10916	1536		0.9041095890410958	0.9115646258503401	24	10892	4	55	20	10837	10916	0.1032442306945215
M1	string	0	network_modules	24	TRUE	0.002866272335281385	100	60	6	0.1	0.06	GO:0009266	GO:BP	response to temperature stimulus	16175	3431		0.8064516129032258	0.8072289156626506	100	16075	6	54	94	16021	16175	0.07303208158353307
M1	string	0	network_modules	24	TRUE	0.0030301481886277413	229	60	8	0.13333333333333333	0.034934497816593885	GO:0033044	GO:BP	regulation of chromosome organization	16175	7999		0.8104838709677419	0.8112449799196787	229	15946	8	52	221	15894	16175	0.061552937945154755
M1	string	0	network_modules	24	TRUE	0.0030385831723553957	101	60	6	0.1	0.0594059405940594	GO:0010565	GO:BP	regulation of ketone metabolic process	16175	4218		0.8145161290322581	0.8152610441767069	101	16074	6	54	95	16020	16175	0.07262400846621465
M1	string	0	network_modules	24	TRUE	0.0031894478305012327	25	60	4	0.06666666666666667	0.16	GO:1903055	GO:BP	positive regulation of extracellular matrix organization	16175	22734		0.8185483870967742	0.8273092369477911	25	16150	4	56	21	16094	16175	0.10115096502698866
M1	string	0	network_modules	24	TRUE	0.0031894478305012327	25	60	4	0.06666666666666667	0.16	GO:1903846	GO:BP	positive regulation of cellular response to transforming growth factor beta stimulus	16175	23325		0.8185483870967742	0.8273092369477911	25	16150	4	56	21	16094	16175	0.10115096502698866
M1	string	0	network_modules	24	TRUE	0.0031894478305012327	25	60	4	0.06666666666666667	0.16	GO:0030511	GO:BP	positive regulation of transforming growth factor beta receptor signaling pathway	16175	6827		0.8185483870967742	0.8273092369477911	25	16150	4	56	21	16094	16175	0.10115096502698866
M1	string	0	network_modules	24	TRUE	0.0032192595108280564	102	60	6	0.1	0.058823529411764705	GO:0043534	GO:BP	blood vessel endothelial cell migration	16175	10755		0.8306451612903226	0.8313253012048193	102	16073	6	54	96	16019	16175	0.07222172425071337
M1	string	0	network_modules	24	TRUE	0.0032579302901704233	93	59	6	0.1016949152542373	0.06451612903225806	KEGG:04520	KEGG	Adherens junction	8484	316		0.8539325842696629	0.8555555555555555	93	8391	6	53	87	8338	8484	0.07292209687222863
M1	string	0	network_modules	24	TRUE	0.003291724436934867	161	60	7	0.11666666666666667	0.043478260869565216	GO:0045637	GO:BP	regulation of myeloid cell differentiation	16175	11488		0.8346774193548387	0.8353413654618473	161	16014	7	53	154	15961	16175	0.06559328466689657
M1	string	0	network_modules	24	TRUE	0.003337863363361311	25	59	4	0.06779661016949153	0.16	REAC:R-HSA-201556	REAC	Signaling by ALK	10916	2217		0.9178082191780822	0.9183673469387755	25	10891	4	55	21	10836	10916	0.10102164203685966
M1	string	0	network_modules	24	TRUE	0.003343648369625629	57	60	5	0.08333333333333333	0.08771929824561403	GO:1903578	GO:BP	regulation of ATP metabolic process	16175	23121		0.8387096774193549	0.8393574297188755	57	16118	5	55	52	16063	16175	0.08217991251713666
M1	string	0	network_modules	24	TRUE	0.003407354067582669	53	59	5	0.0847457627118644	0.09433962264150944	REAC:R-HSA-2151201	REAC	Transcriptional activation of mitochondrial biogenesis	10916	2548		0.9246575342465754	0.9251700680272109	53	10863	5	54	48	10809	10916	0.08472604856541766
M1	string	0	network_modules	24	TRUE	0.0034104341938086037	138	59	7	0.11864406779661017	0.050724637681159424	KEGG:04371	KEGG	Apelin signaling pathway	8484	308		0.8651685393258427	0.8666666666666667	138	8346	7	52	131	8294	8484	0.06772831613203319
M1	string	0	network_modules	24	TRUE	0.0035688648859962422	92	59	6	0.1016949152542373	0.06521739130434782	REAC:R-HSA-1592230	REAC	Mitochondrial biogenesis	10916	1464		0.9315068493150684	0.9387755102040817	92	10824	6	53	86	10771	10916	0.07520980140264494
M1	string	0	network_modules	24	TRUE	0.0035688648859962422	92	59	6	0.1016949152542373	0.06521739130434782	REAC:R-HSA-6804756	REAC	Regulation of TP53 Activity through Phosphorylation	10916	2016		0.9315068493150684	0.9387755102040817	92	10824	6	53	86	10771	10916	0.07520980140264494
M1	string	0	network_modules	24	TRUE	0.003606954130844349	104	60	6	0.1	0.057692307692307696	GO:0051100	GO:BP	negative regulation of binding	16175	13495		0.842741935483871	0.8433734939759037	104	16071	6	54	98	16017	16175	0.071433968076577245
M1	string	0	network_modules	24	TRUE	0.00363523629574309	510	60	11	0.18333333333333332	0.021568627450980392	GO:0048871	GO:BP	multicellular organismal-level homeostasis	16175	13114		0.8467741935483871	0.8473895582329317	510	15665	11	49	499	15616	16175	0.05300726321207897
M1	string	0	network_modules	24	TRUE	0.0037589191658639427	26	60	4	0.06666666666666667	0.15384615384615385	GO:0045648	GO:BP	positive regulation of erythrocyte differentiation	16175	11499		0.8508064516129032	0.8514056224899599	26	16149	4	56	22	16093	16175	0.0990955850840464
M1	string	0	network_modules	24	TRUE	0.0039005149172066087	263	59	9	0.15254237288135594	0.034220532319391636	REAC:R-HSA-913531	REAC	Interferon Signaling	10916	1227		0.9452054794520548	0.9455782312925171	263	10653	9	50	254	10603	10916	0.06175221115250983
M1	string	0	network_modules	24	TRUE	0.004259228153557958	107	60	6	0.1	0.056074766355140186	GO:0034614	GO:BP	cellular response to reactive oxygen species	16175	8691		0.8548387096774194	0.8554216867469879	107	16068	6	54	101	16014	16175	0.0702924044959159
M1	string	0	network_modules	24	TRUE	0.004282409061925852	143	59	7	0.11864406779661017	0.04895104895104895	KEGG:04550	KEGG	Signaling pathways regulating pluripotency of stem cells	8484	319		0.8764044943820225	0.8777777777777778	143	8341	7	52	136	8289	8484	0.06617053900236418
M1	string	0	network_modules	24	TRUE	0.004295773393185783	95	59	6	0.1016949152542373	0.06315789473684211	REAC:R-HSA-9759194	REAC	Nuclear events mediated by NFE2L2	10916	1617		0.952054794520548	0.9523809523809523	95	10821	6	53	89	10768	10916	0.07380489023254366
M1	string	0	network_modules	24	TRUE	0.00435450375566447	749	60	13	0.21666666666666667	0.017356475300400534	GO:0070647	GO:BP	protein modification by small protein conjugation or removal	16175	16231		0.8588709677419355	0.8594377510040161	749	15426	13	47	736	15379	16175	0.04946596059978464
M1	string	0	network_modules	24	TRUE	0.0043659628148079305	60	59	5	0.0847457627118644	0.08333333333333333	KEGG:04330	KEGG	Notch signaling pathway	8484	301		0.8876404494382022	0.8888888888888888	60	8424	5	54	55	8370	8484	0.0775676244917869
M1	string	0	network_modules	24	TRUE	0.004379935905118805	98	59	6	0.1016949152542373	0.061224489795918366	KEGG:05231	KEGG	Choline metabolism in cancer	8484	479		0.898876404494382	0.9	98	8386	6	53	92	8333	8484	0.0705971085055935
M1	string	0	network_modules	24	TRUE	0.004400437033977477	27	60	4	0.06666666666666667	0.14814814814814814	GO:0007622	GO:BP	rhythmic behavior	16175	3079		0.8629032258064516	0.8674698795180723	27	16148	4	56	23	16092	16175	0.09715376871699177
M1	string	0	network_modules	24	TRUE	0.004400437033977477	27	60	4	0.06666666666666667	0.14814814814814814	GO:0048512	GO:BP	circadian behavior	16175	12797		0.8629032258064516	0.8674698795180723	27	16148	4	56	23	16092	16175	0.09715376871699177
M1	string	0	network_modules	24	TRUE	0.004525375192919546	419	60	10	0.16666666666666666	0.02386634844868735	GO:0019221	GO:BP	cytokine-mediated signaling pathway	16175	5598		0.8709677419354839	0.8714859437751004	419	15756	10	50	409	15706	16175	0.05407066534774292
M1	string	0	network_modules	24	TRUE	0.004593934825857089	9	59	3	0.05084745762711865	0.3333333333333333	REAC:R-HSA-6811555	REAC	PI5P Regulates TP53 Acetylation	10916	1676		0.958904109589041	0.9591836734693877	9	10907	3	56	6	10851	10916	0.12847844188221952
M1	string	0	network_modules	24	TRUE	0.004615545039457596	634	60	12	0.2	0.01892744479495268	GO:0001817	GO:BP	regulation of cytokine production	16175	474		0.875	0.8755020080321285	634	15541	12	48	622	15493	16175	0.050561123223203976
M1	string	0	network_modules	24	TRUE	0.0046971916549867565	61	60	5	0.08333333333333333	0.08196721311475409	GO:0033143	GO:BP	regulation of intracellular steroid hormone receptor signaling pathway	16175	8057		0.8790322580645161	0.8795180722891566	61	16114	5	55	56	16059	16175	0.07920348632829335
M1	string	0	network_modules	24	TRUE	0.004712803054363906	243	60	8	0.13333333333333333	0.03292181069958848	GO:0019216	GO:BP	regulation of lipid metabolic process	16175	5593		0.8830645161290323	0.8835341365461847	243	15932	8	52	235	15880	16175	0.05934559340183719
M1	string	0	network_modules	24	TRUE	0.004745213594625648	109	60	6	0.1	0.05504587155963303	GO:0043467	GO:BP	regulation of generation of precursor metabolites and energy	16175	10715		0.8870967741935484	0.8875502008032129	109	16066	6	54	103	16012	16175	0.0695566495563478
M1	string	0	network_modules	24	TRUE	0.00492494254121433	638	60	12	0.2	0.018808777429467086	GO:0001816	GO:BP	cytokine production	16175	473		0.8911290322580645	0.891566265060241	638	15537	12	48	626	15489	16175	0.05033134053850351
M1	string	0	network_modules	24	TRUE	0.005161637916824527	246	60	8	0.13333333333333333	0.032520325203252036	GO:0051054	GO:BP	positive regulation of DNA metabolic process	16175	13464		0.8951612903225806	0.8955823293172691	246	15929	8	52	238	15877	16175	0.058895699954986586
M1	string	0	network_modules	24	TRUE	0.005189201212632205	101	59	6	0.1016949152542373	0.0594059405940594	KEGG:04916	KEGG	Melanogenesis	8484	373		0.9101123595505618	0.9111111111111111	101	8383	6	53	95	8330	8484	0.06928033901785093
M1	string	0	network_modules	24	TRUE	0.005309008084348263	173	60	7	0.11666666666666667	0.04046242774566474	GO:2001234	GO:BP	negative regulation of apoptotic signaling pathway	16175	26423		0.8991935483870968	0.8995983935742972	173	16002	7	53	166	15949	16175	0.06286113493718844
M1	string	0	network_modules	24	TRUE	0.005518313554943715	63	60	5	0.08333333333333333	0.07936507936507936	GO:1904356	GO:BP	regulation of telomere maintenance via telomere lengthening	16175	23743		0.9032258064516129	0.9036144578313253	63	16112	5	55	58	16057	16175	0.07781985752108192
M1	string	0	network_modules	24	TRUE	0.005922357543059471	29	60	4	0.06666666666666667	0.13793103448275862	GO:0071354	GO:BP	cellular response to interleukin-6	16175	16606		0.907258064516129	0.9076305220883534	29	16146	4	56	25	16090	16175	0.09357125754986342
M1	string	0	network_modules	24	TRUE	0.005949140873005474	176	60	7	0.11666666666666667	0.03977272727272727	GO:0000075	GO:BP	cell cycle checkpoint signaling	16175	26		0.9112903225806451	0.9116465863453815	176	15999	7	53	169	15946	16175	0.062219838322348536
M1	string	0	network_modules	24	TRUE	0.0061868449790201	434	60	10	0.16666666666666666	0.02304147465437788	GO:0002521	GO:BP	leukocyte differentiation	16175	1043		0.9153225806451613	0.9156626506024096	434	15741	10	50	424	15691	16175	0.05280317611488827
M1	string	0	network_modules	24	TRUE	0.006314379762677655	435	60	10	0.16666666666666666	0.022988505747126436	GO:0051052	GO:BP	regulation of DNA metabolic process	16175	13462		0.9193548387096774	0.9196787148594378	435	15740	10	50	425	15690	16175	0.05272080409732406
M1	string	0	network_modules	24	TRUE	0.006410688945703911	178	60	7	0.11666666666666667	0.03932584269662921	GO:0045926	GO:BP	negative regulation of growth	16175	11720		0.9233870967741935	0.9236947791164659	178	15997	7	53	171	15944	16175	0.06180084820610328
M1	string	0	network_modules	24	TRUE	0.006537534498230399	10	59	3	0.05084745762711865	0.3	REAC:R-HSA-8866904	REAC	Negative regulation of activity of TFAP2 (AP-2) family transcription factors	10916	1579		0.9657534246575342	0.9795918367346939	10	10906	3	56	7	10850	10916	0.12166771714890312
M1	string	0	network_modules	24	TRUE	0.006537534498230399	10	59	3	0.05084745762711865	0.3	REAC:R-HSA-198693	REAC	AKT phosphorylates targets in the nucleus	10916	15		0.9657534246575342	0.9795918367346939	10	10906	3	56	7	10850	10916	0.12166771714890312
M1	string	0	network_modules	24	TRUE	0.006537534498230399	10	59	3	0.05084745762711865	0.3	REAC:R-HSA-1234158	REAC	Regulation of gene expression by Hypoxia-inducible Factor	10916	2033		0.9657534246575342	0.9795918367346939	10	10906	3	56	7	10850	10916	0.12166771714890312
M1	string	0	network_modules	24	TRUE	0.006814998752880214	116	60	6	0.1	0.05172413793103448	GO:0051099	GO:BP	positive regulation of binding	16175	13494		0.9274193548387096	0.9317269076305221	116	16059	6	54	110	16005	16175	0.06712705019520145
M1	string	0	network_modules	24	TRUE	0.006814998752880214	116	60	6	0.1	0.05172413793103448	GO:1901875	GO:BP	positive regulation of post-translational protein modification	16175	21819		0.9274193548387096	0.9317269076305221	116	16059	6	54	110	16005	16175	0.06712705019520145
M1	string	0	network_modules	24	TRUE	0.00695695018656542	66	60	5	0.08333333333333333	0.07575757575757576	GO:0003170	GO:BP	heart valve development	16175	1600		0.9354838709677419	0.9357429718875502	66	16109	5	55	61	16054	16175	0.07586020390916397
M1	string	0	network_modules	24	TRUE	0.007125185653600911	547	60	11	0.18333333333333332	0.02010968921389397	GO:0006511	GO:BP	ubiquitin-dependent protein catabolic process	16175	2235		0.9395161290322581	0.9397590361445783	547	15628	11	49	536	15579	16175	0.05047150243189808
M1	string	0	network_modules	24	TRUE	0.007165513646868683	107	59	6	0.1016949152542373	0.056074766355140186	KEGG:04922	KEGG	Glucagon signaling pathway	8484	379		0.9213483146067416	0.9222222222222223	107	8377	6	53	101	8324	8484	0.06680363659022509
M1	string	0	network_modules	24	TRUE	0.007228507315267654	210	59	8	0.13559322033898305	0.0380952380952381	KEGG:05170	KEGG	Human immunodeficiency virus 1 infection	8484	451		0.9325842696629213	0.9333333333333333	210	8274	8	51	202	8223	8484	0.059699918984571186
M1	string	0	network_modules	24	TRUE	0.007496724245443712	67	60	5	0.08333333333333333	0.07462686567164178	GO:0060173	GO:BP	limb development	16175	14409		0.9435483870967742	0.9477911646586346	67	16108	5	55	62	16053	16175	0.07523555602732679
M1	string	0	network_modules	24	TRUE	0.007496724245443712	67	60	5	0.08333333333333333	0.07462686567164178	GO:0048736	GO:BP	appendage development	16175	12993		0.9435483870967742	0.9477911646586346	67	16108	5	55	62	16053	16175	0.07523555602732679
M1	string	0	network_modules	24	TRUE	0.0075464304996845895	108	59	6	0.1016949152542373	0.05555555555555555	KEGG:05145	KEGG	Toxoplasmosis	8484	437		0.9438202247191011	0.9555555555555556	108	8376	6	53	102	8323	8484	0.06640962497566534
M1	string	0	network_modules	24	TRUE	0.0075464304996845895	108	59	6	0.1016949152542373	0.05555555555555555	KEGG:04931	KEGG	Insulin resistance	8484	388		0.9438202247191011	0.9555555555555556	108	8376	6	53	102	8323	8484	0.06640962497566534
M1	string	0	network_modules	24	TRUE	0.007739563718453457	157	59	7	0.11864406779661017	0.044585987261146494	KEGG:04390	KEGG	Hippo signaling pathway	8484	310		0.9662921348314607	0.9666666666666667	157	8327	7	52	150	8275	8484	0.06217979938309466
M1	string	0	network_modules	24	TRUE	0.0078025186160839595	31	60	4	0.06666666666666667	0.12903225806451613	GO:0033144	GO:BP	negative regulation of intracellular steroid hormone receptor signaling pathway	16175	8058		0.9516129032258065	0.9558232931726908	31	16144	4	56	27	16088	16175	0.0903356086206272
M1	string	0	network_modules	24	TRUE	0.0078025186160839595	31	60	4	0.06666666666666667	0.12903225806451613	GO:0010611	GO:BP	regulation of cardiac muscle hypertrophy	16175	4258		0.9516129032258065	0.9558232931726908	31	16144	4	56	27	16088	16175	0.0903356086206272
M1	string	0	network_modules	24	TRUE	0.007901863905787307	119	60	6	0.1	0.05042016806722689	GO:0001936	GO:BP	regulation of endothelial cell proliferation	16175	550		0.9596774193548387	0.9598393574297188	119	16056	6	54	113	16002	16175	0.0661492701955725
M1	string	0	network_modules	24	TRUE	0.008068809622324978	68	60	5	0.08333333333333333	0.07352941176470588	GO:0032922	GO:BP	circadian regulation of gene expression	16175	7913		0.9637096774193549	0.963855421686747	68	16107	5	55	63	16052	16175	0.07462431865819574
M1	string	0	network_modules	24	TRUE	0.008183578345719636	555	60	11	0.18333333333333332	0.01981981981981982	GO:0019941	GO:BP	modification-dependent protein catabolic process	16175	6072		0.967741935483871	0.9678714859437751	555	15620	11	49	544	15571	16175	0.04995346123422077
M1	string	0	network_modules	24	TRUE	0.008651615074309454	64	59	5	0.0847457627118644	0.078125	REAC:R-HSA-1834949	REAC	Cytosolic sensors of pathogen-associated DNA 	10916	428		0.9863013698630136	0.9863945578231292	64	10852	5	54	59	10798	10916	0.07616792124118041
M1	string	0	network_modules	24	TRUE	0.00867457476319876	69	60	5	0.08333333333333333	0.07246376811594203	GO:0043255	GO:BP	regulation of carbohydrate biosynthetic process	16175	10589		0.9717741935483871	0.9718875502008032	69	16106	5	55	64	16051	16175	0.07402600710894283
M1	string	0	network_modules	24	TRUE	0.0087626386186826	559	60	11	0.18333333333333332	0.01967799642218247	GO:0043632	GO:BP	modification-dependent macromolecule catabolic process	16175	10812		0.9758064516129032	0.9759036144578314	559	15616	11	49	548	15567	16175	0.04969818094711763
M1	string	0	network_modules	24	TRUE	0.008874457497939952	187	60	7	0.11666666666666667	0.0374331550802139	GO:0000082	GO:BP	G1/S transition of mitotic cell cycle	16175	31		0.9798387096774194	0.9799196787148594	187	15988	7	53	180	15935	16175	0.059994689086311004
M1	string	0	network_modules	24	TRUE	0.008892503775845575	32	60	4	0.06666666666666667	0.125	GO:0070741	GO:BP	response to interleukin-6	16175	16280		0.9838709677419355	0.9879518072289156	32	16143	4	56	28	16087	16175	0.08883076837234341
M1	string	0	network_modules	24	TRUE	0.008892503775845575	32	60	4	0.06666666666666667	0.125	GO:0014743	GO:BP	regulation of muscle hypertrophy	16175	4679		0.9838709677419355	0.9879518072289156	32	16143	4	56	28	16087	16175	0.08883076837234341
M1	string	0	network_modules	24	TRUE	0.00895455912289237	11	59	3	0.05084745762711865	0.2727272727272727	REAC:R-HSA-9683610	REAC	Maturation of nucleoprotein	10916	1397		0.9931506849315068	1	11	10905	3	56	8	10849	10916	0.11579809117342912
M1	string	0	network_modules	24	TRUE	0.00895455912289237	11	59	3	0.05084745762711865	0.2727272727272727	REAC:R-HSA-9818030	REAC	NFE2L2 regulating tumorigenic genes	10916	1523		0.9931506849315068	1	11	10905	3	56	8	10849	10916	0.11579809117342912
M1	string	0	network_modules	24	TRUE	0.009175515917367254	70	59	5	0.0847457627118644	0.07142857142857142	KEGG:05120	KEGG	Epithelial cell signaling in Helicobacter pylori infection	8484	426		0.9775280898876404	0.9777777777777777	70	8414	5	54	65	8360	8484	0.07076591588934301
M1	string	0	network_modules	24	TRUE	0.009212112795296714	454	60	10	0.16666666666666666	0.022026431718061675	GO:0030855	GO:BP	epithelial cell differentiation	16175	6938		0.9919354838709677	0.9919678714859438	454	15721	10	50	444	15671	16175	0.05120304422679461
M1	string	0	network_modules	24	TRUE	0.009422407367892963	162	59	7	0.11864406779661017	0.043209876543209874	KEGG:04630	KEGG	JAK-STAT signaling pathway	8484	332		0.9887640449438202	0.9888888888888889	162	8322	7	52	155	8270	8484	0.06087073749327319
M1	string	0	network_modules	24	TRUE	0.009818445292479763	71	59	5	0.0847457627118644	0.07042253521126761	KEGG:04622	KEGG	RIG-I-like receptor signaling pathway	8484	327		1	1	71	8413	5	54	66	8359	8484	0.07016169598943078
M1	string	0	network_modules	24	TRUE	0.009972875536414646	808	60	13	0.21666666666666667	0.01608910891089109	GO:0033365	GO:BP	protein localization to organelle	16175	8175		0.9959677419354839	0.9959839357429718	808	15367	13	47	795	15320	16175	0.04669539894869639
M1	string	0	network_modules	24	TRUE	0.0099927869581507	71	60	5	0.08333333333333333	0.07042253521126761	GO:0009408	GO:BP	response to heat	16175	3473		1	1	71	16104	5	55	66	16049	16175	0.07286634244743112
M1	string	0	network_modules	25	TRUE	9.080883693338984e-78	50	57	37	0.6491228070175439	0.74	REAC:R-HSA-211733	REAC	Regulation of activated PAK-2p34 by proteasome mediated degradation	10916	2021		0	0.007518796992481203	50	10866	37	20	13	10846	10916	0.6915724125129068
M1	string	0	network_modules	25	TRUE	1.1426791148931004e-76	52	57	37	0.6491228070175439	0.7115384615384616	REAC:R-HSA-349425	REAC	Autodegradation of the E3 ubiquitin ligase COP1	10916	191		0.007575757575757576	0.05263157894736842	52	10864	37	20	15	10844	10916	0.6780121755460937
M1	string	0	network_modules	25	TRUE	1.1426791148931004e-76	52	57	37	0.6491228070175439	0.7115384615384616	REAC:R-HSA-69613	REAC	p53-Independent G1/S DNA damage checkpoint	10916	2720		0.007575757575757576	0.05263157894736842	52	10864	37	20	15	10844	10916	0.6780121755460937
M1	string	0	network_modules	25	TRUE	1.1426791148931004e-76	52	57	37	0.6491228070175439	0.7115384615384616	REAC:R-HSA-180534	REAC	Vpu mediated degradation of CD4	10916	2666		0.007575757575757576	0.05263157894736842	52	10864	37	20	15	10844	10916	0.6780121755460937
M1	string	0	network_modules	25	TRUE	1.1426791148931004e-76	52	57	37	0.6491228070175439	0.7115384615384616	REAC:R-HSA-69601	REAC	Ubiquitin Mediated Degradation of Phosphorylated Cdc25A	10916	2619		0.007575757575757576	0.05263157894736842	52	10864	37	20	15	10844	10916	0.6780121755460937
M1	string	0	network_modules	25	TRUE	1.1426791148931004e-76	52	57	37	0.6491228070175439	0.7115384615384616	REAC:R-HSA-75815	REAC	Ubiquitin-dependent degradation of Cyclin D	10916	2620		0.007575757575757576	0.05263157894736842	52	10864	37	20	15	10844	10916	0.6780121755460937
M1	string	0	network_modules	25	TRUE	1.1426791148931004e-76	52	57	37	0.6491228070175439	0.7115384615384616	REAC:R-HSA-69610	REAC	p53-Independent DNA Damage Response	10916	2719		0.007575757575757576	0.05263157894736842	52	10864	37	20	15	10844	10916	0.6780121755460937
M1	string	0	network_modules	25	TRUE	3.778340112212803e-76	53	57	37	0.6491228070175439	0.6981132075471698	REAC:R-HSA-180585	REAC	Vif-mediated degradation of APOBEC3G	10916	2646		0.05303030303030303	0.06766917293233082	53	10863	37	20	16	10843	10916	0.6715208018968398
M1	string	0	network_modules	25	TRUE	3.778340112212803e-76	53	57	37	0.6491228070175439	0.6981132075471698	REAC:R-HSA-169911	REAC	Regulation of Apoptosis	10916	1964		0.05303030303030303	0.06766917293233082	53	10863	37	20	16	10843	10916	0.6715208018968398
M1	string	0	network_modules	25	TRUE	1.1980272339139717e-75	54	57	37	0.6491228070175439	0.6851851851851852	REAC:R-HSA-450408	REAC	AUF1 (hnRNP D0) binds and destabilizes mRNA	10916	40		0.06818181818181818	0.07518796992481203	54	10862	37	20	17	10842	10916	0.6652099842882799
M1	string	0	network_modules	25	TRUE	3.4775364205532787e-75	49	57	36	0.631578947368421	0.7346938775510204	REAC:R-HSA-1236978	REAC	Cross-presentation of soluble exogenous antigens (endosomes)	10916	416		0.07575757575757576	0.08270676691729323	49	10867	36	21	13	10846	10916	0.6796465639763605
M1	string	0	network_modules	25	TRUE	3.654076282091238e-75	55	57	37	0.6491228070175439	0.6727272727272727	REAC:R-HSA-4641257	REAC	Degradation of AXIN	10916	719		0.08333333333333333	0.10526315789473684	55	10861	37	20	18	10841	10916	0.6590714831458525
M1	string	0	network_modules	25	TRUE	3.654076282091238e-75	55	57	37	0.6491228070175439	0.6727272727272727	REAC:R-HSA-174113	REAC	SCF-beta-TrCP mediated degradation of Emi1	10916	2130		0.08333333333333333	0.10526315789473684	55	10861	37	20	18	10841	10916	0.6590714831458525
M1	string	0	network_modules	25	TRUE	3.654076282091238e-75	55	57	37	0.6491228070175439	0.6727272727272727	REAC:R-HSA-8854050	REAC	FBXL7 down-regulates AURKA during mitotic entry and in early mitosis	10916	892		0.08333333333333333	0.10526315789473684	55	10861	37	20	18	10841	10916	0.6590714831458525
M1	string	0	network_modules	25	TRUE	1.0750599938538968e-74	56	57	37	0.6491228070175439	0.6607142857142857	REAC:R-HSA-5362768	REAC	Hh mutants are degraded by ERAD	10916	1122		0.10606060606060606	0.11278195488721804	56	10860	37	20	19	10840	10916	0.6530975760633597
M1	string	0	network_modules	25	TRUE	3.0584272684442955e-74	57	57	37	0.6491228070175439	0.6491228070175439	REAC:R-HSA-69541	REAC	Stabilization of p53	10916	2351		0.11363636363636363	0.12781954887218044	57	10859	37	20	20	10839	10916	0.6472810167974501
M1	string	0	network_modules	25	TRUE	3.0584272684442955e-74	57	57	37	0.6491228070175439	0.6491228070175439	REAC:R-HSA-4641258	REAC	Degradation of DVL	10916	720		0.11363636363636363	0.12781954887218044	57	10859	37	20	20	10839	10916	0.6472810167974501
M1	string	0	network_modules	25	TRUE	4.2068584504725666e-74	51	57	36	0.631578947368421	0.7058823529411765	REAC:R-HSA-350562	REAC	Regulation of ornithine decarboxylase (ODC)	10916	2046		0.12878787878787878	0.13533834586466165	51	10865	36	21	15	10844	10916	0.6660535373911011
M1	string	0	network_modules	25	TRUE	1.364657968394998e-73	52	57	36	0.631578947368421	0.6923076923076923	REAC:R-HSA-9762114	REAC	GSK3B and BTRC:CUL1-mediated-degradation of NFE2L2	10916	1026		0.13636363636363635	0.14285714285714285	52	10864	36	21	16	10843	10916	0.6595520507649332
M1	string	0	network_modules	25	TRUE	2.2572370618694697e-73	59	57	37	0.6491228070175439	0.6271186440677966	REAC:R-HSA-5676590	REAC	NIK-->noncanonical NF-kB signaling	10916	1528		0.14393939393939395	0.15789473684210525	59	10857	37	20	22	10837	10916	0.636093118427615
M1	string	0	network_modules	25	TRUE	2.2572370618694697e-73	59	57	37	0.6491228070175439	0.6271186440677966	REAC:R-HSA-5387390	REAC	Hh mutants abrogate ligand secretion	10916	1121		0.14393939393939395	0.15789473684210525	59	10857	37	20	22	10837	10916	0.636093118427615
M1	string	0	network_modules	25	TRUE	4.246520710641021e-73	53	57	36	0.631578947368421	0.6792452830188679	REAC:R-HSA-9604323	REAC	Negative regulation of NOTCH4 signaling	10916	1576		0.1590909090909091	0.16541353383458646	53	10863	36	21	17	10842	10916	0.6532348169453069
M1	string	0	network_modules	25	TRUE	5.877883526249058e-73	60	57	37	0.6491228070175439	0.6166666666666667	REAC:R-HSA-5610785	REAC	GLI3 is processed to GLI3R by the proteasome	10916	1016		0.16666666666666666	0.19548872180451127	60	10856	37	20	23	10836	10916	0.6307093507365159
M1	string	0	network_modules	25	TRUE	5.877883526249058e-73	60	57	37	0.6491228070175439	0.6166666666666667	REAC:R-HSA-5607761	REAC	Dectin-1 mediated noncanonical NF-kB signaling	10916	456		0.16666666666666666	0.19548872180451127	60	10856	37	20	23	10836	10916	0.6307093507365159
M1	string	0	network_modules	25	TRUE	5.877883526249058e-73	60	57	37	0.6491228070175439	0.6166666666666667	REAC:R-HSA-5610780	REAC	Degradation of GLI1 by the proteasome	10916	722		0.16666666666666666	0.19548872180451127	60	10856	37	20	23	10836	10916	0.6307093507365159
M1	string	0	network_modules	25	TRUE	5.877883526249058e-73	60	57	37	0.6491228070175439	0.6166666666666667	REAC:R-HSA-5610783	REAC	Degradation of GLI2 by the proteasome	10916	723		0.16666666666666666	0.19548872180451127	60	10856	37	20	23	10836	10916	0.6307093507365159
M1	string	0	network_modules	25	TRUE	8.743658421059342e-73	46	52	35	0.6730769230769231	0.7608695652173914	KEGG:03050	KEGG	Proteasome	8484	216		0	0.1111111111111111	46	8438	35	17	11	8421	8484	0.7139872082924247
M1	string	0	network_modules	25	TRUE	1.4912823902081875e-72	61	57	37	0.6491228070175439	0.6065573770491803	REAC:R-HSA-5678895	REAC	Defective CFTR causes cystic fibrosis	10916	505		0.19696969696969696	0.20300751879699247	61	10855	37	20	24	10835	10916	0.6254580153881072
M1	string	0	network_modules	25	TRUE	3.6739085254572247e-72	55	57	36	0.631578947368421	0.6545454545454545	REAC:R-HSA-8941858	REAC	Regulation of RUNX3 expression and activity	10916	2006		0.20454545454545456	0.21052631578947367	55	10861	36	21	19	10840	10916	0.6411193966944115
M1	string	0	network_modules	25	TRUE	2.1127860848389265e-71	64	57	37	0.6491228070175439	0.578125	REAC:R-HSA-4608870	REAC	Asymmetric localization of PCP proteins	10916	184		0.21212121212121213	0.21804511278195488	64	10852	37	20	27	10832	10916	0.6104464974848302
M1	string	0	network_modules	25	TRUE	4.89588149403892e-71	65	57	37	0.6491228070175439	0.5692307692307692	REAC:R-HSA-5358346	REAC	Hedgehog ligand biogenesis	10916	1114		0.2196969696969697	0.22556390977443608	65	10851	37	20	28	10831	10916	0.605674196855985
M1	string	0	network_modules	25	TRUE	7.319709168573981e-71	58	57	36	0.631578947368421	0.6206896551724138	REAC:R-HSA-351202	REAC	Metabolism of polyamines	10916	1433		0.22727272727272727	0.23308270676691728	58	10858	36	21	22	10837	10916	0.6241309390140013
M1	string	0	network_modules	25	TRUE	1.1122356455850263e-70	66	57	37	0.6491228070175439	0.5606060606060606	REAC:R-HSA-69563	REAC	p53-Dependent G1 DNA Damage Response	10916	2717		0.23484848484848486	0.2556390977443609	66	10850	37	20	29	10830	10916	0.6010103247955471
M1	string	0	network_modules	25	TRUE	1.1122356455850263e-70	66	57	37	0.6491228070175439	0.5606060606060606	REAC:R-HSA-69580	REAC	p53-Dependent G1/S DNA damage checkpoint	10916	2718		0.23484848484848486	0.2556390977443609	66	10850	37	20	29	10830	10916	0.6010103247955471
M1	string	0	network_modules	25	TRUE	1.1122356455850263e-70	66	57	37	0.6491228070175439	0.5606060606060606	REAC:R-HSA-1234176	REAC	Oxygen-dependent proline hydroxylation of Hypoxia-inducible Factor Alpha	10916	1655		0.23484848484848486	0.2556390977443609	66	10850	37	20	29	10830	10916	0.6010103247955471
M1	string	0	network_modules	25	TRUE	2.4795351150792228e-70	67	57	37	0.6491228070175439	0.5522388059701493	REAC:R-HSA-1169091	REAC	Activation of NF-kappaB in B cells	10916	87		0.25757575757575757	0.2706766917293233	67	10849	37	20	30	10829	10916	0.5964508234360387
M1	string	0	network_modules	25	TRUE	2.4795351150792228e-70	67	57	37	0.6491228070175439	0.5522388059701493	REAC:R-HSA-5658442	REAC	Regulation of RAS by GAPs	10916	2003		0.25757575757575757	0.2706766917293233	67	10849	37	20	30	10829	10916	0.5964508234360387
M1	string	0	network_modules	25	TRUE	4.676511822575947e-70	60	57	36	0.631578947368421	0.6	REAC:R-HSA-187577	REAC	SCF(Skp2)-mediated degradation of p27/p21	10916	2129		0.2727272727272727	0.2781954887218045	60	10856	36	21	24	10835	10916	0.6135175788457475
M1	string	0	network_modules	25	TRUE	5.429218478181473e-70	68	57	37	0.6491228070175439	0.5441176470588235	REAC:R-HSA-69615	REAC	G1/S DNA Damage Checkpoints	10916	1001		0.2803030303030303	0.2932330827067669	68	10848	37	20	31	10828	10916	0.5919918444773442
M1	string	0	network_modules	25	TRUE	5.429218478181473e-70	68	57	37	0.6491228070175439	0.5441176470588235	REAC:R-HSA-174154	REAC	APC/C:Cdc20 mediated degradation of Securin	10916	26		0.2803030303030303	0.2932330827067669	68	10848	37	20	31	10828	10916	0.5919918444773442
M1	string	0	network_modules	25	TRUE	1.168573943534502e-69	69	57	37	0.6491228070175439	0.5362318840579711	REAC:R-HSA-8948751	REAC	Regulation of PTEN stability and activity	10916	2002		0.29545454545454547	0.3007518796992481	69	10847	37	20	32	10827	10916	0.5876297354715426
M1	string	0	network_modules	25	TRUE	3.2588559454484174e-69	55	57	35	0.6140350877192983	0.6363636363636364	REAC:R-HSA-9824272	REAC	Somitogenesis	10916	2341		0.30303030303030304	0.3082706766917293	55	10861	35	22	20	10839	10916	0.6231673102429706
M1	string	0	network_modules	25	TRUE	5.15773538867155e-69	71	57	37	0.6491228070175439	0.5211267605633803	REAC:R-HSA-68949	REAC	Orc1 removal from chromatin	10916	1644		0.3106060606060606	0.3233082706766917	71	10845	37	20	34	10825	10916	0.5791824219674455
M1	string	0	network_modules	25	TRUE	5.15773538867155e-69	71	57	37	0.6491228070175439	0.5211267605633803	REAC:R-HSA-8939902	REAC	Regulation of RUNX2 expression and activity	10916	2005		0.3106060606060606	0.3233082706766917	71	10845	37	20	34	10825	10916	0.5791824219674455
M1	string	0	network_modules	25	TRUE	1.440310470877093e-68	64	57	36	0.631578947368421	0.5625	REAC:R-HSA-174084	REAC	Autodegradation of Cdh1 by Cdh1:APC/C	10916	190		0.32575757575757575	0.3308270676691729	64	10852	36	21	28	10831	10916	0.5937975684152016
M1	string	0	network_modules	25	TRUE	2.1437933499826697e-68	73	57	37	0.6491228070175439	0.5068493150684932	REAC:R-HSA-174184	REAC	Cdc20:Phospho-APC/C mediated degradation of Cyclin A	10916	319		0.3333333333333333	0.3458646616541353	73	10843	37	20	36	10823	10916	0.5710831241506088
M1	string	0	network_modules	25	TRUE	2.1437933499826697e-68	73	57	37	0.6491228070175439	0.5068493150684932	REAC:R-HSA-69017	REAC	CDK-mediated phosphorylation and removal of Cdc6	10916	272		0.3333333333333333	0.3458646616541353	73	10843	37	20	36	10823	10916	0.5710831241506088
M1	string	0	network_modules	25	TRUE	4.279887333839598e-68	74	57	37	0.6491228070175439	0.5	REAC:R-HSA-179419	REAC	APC:Cdc20 mediated degradation of cell cycle proteins prior to satisfation of the cell cycle checkpoint	10916	29		0.3484848484848485	0.3609022556390977	74	10842	37	20	37	10822	10916	0.5671566012312244
M1	string	0	network_modules	25	TRUE	4.279887333839598e-68	74	57	37	0.6491228070175439	0.5	REAC:R-HSA-174178	REAC	APC/C:Cdh1 mediated degradation of Cdc20 and other APC/C:Cdh1 targeted proteins in late mitosis/early G1	10916	28		0.3484848484848485	0.3609022556390977	74	10842	37	20	37	10822	10916	0.5671566012312244
M1	string	0	network_modules	25	TRUE	8.431975880583211e-68	75	57	37	0.6491228070175439	0.49333333333333335	REAC:R-HSA-1234174	REAC	Cellular response to hypoxia	10916	335		0.36363636363636365	0.3684210526315789	75	10841	37	20	38	10821	10916	0.5633085029938071
M1	string	0	network_modules	25	TRUE	1.6402030829444635e-67	76	57	37	0.6491228070175439	0.4868421052631579	REAC:R-HSA-176409	REAC	APC/C:Cdc20 mediated degradation of mitotic proteins	10916	27		0.3712121212121212	0.37593984962406013	76	10840	37	20	39	10820	10916	0.5595362434636382
M1	string	0	network_modules	25	TRUE	3.151719592526381e-67	77	57	37	0.6491228070175439	0.4805194805194805	REAC:R-HSA-176814	REAC	Activation of APC/C and APC/C:Cdc20 mediated degradation of mitotic proteins	10916	74		0.3787878787878788	0.38345864661654133	77	10839	37	20	40	10819	10916	0.5558373545502703
M1	string	0	network_modules	25	TRUE	5.985183389749206e-67	78	57	37	0.6491228070175439	0.47435897435897434	REAC:R-HSA-5619084	REAC	ABC transporter disorders	10916	7		0.38636363636363635	0.39097744360902253	78	10838	37	20	41	10818	10916	0.5522094792258841
M1	string	0	network_modules	25	TRUE	8.981510959538144e-67	89	57	38	0.6666666666666666	0.42696629213483145	REAC:R-HSA-5687128	REAC	MAPK6/MAPK4 signaling	10916	1353		0.3939393939393939	0.39849624060150374	89	10827	38	19	51	10808	10916	0.5305442930972927
M1	string	0	network_modules	25	TRUE	1.1237619891720993e-66	79	57	37	0.6491228070175439	0.46835443037974683	REAC:R-HSA-8852276	REAC	The role of GTSE1 in G2/M progression after G2 checkpoint	10916	2503		0.4015151515151515	0.40601503759398494	79	10837	37	20	42	10817	10916	0.5486503651800311
M1	string	0	network_modules	25	TRUE	1.8056600413141815e-66	102	57	39	0.6842105263157895	0.38235294117647056	REAC:R-HSA-5689603	REAC	UCH proteinases	10916	2615		0.4090909090909091	0.41353383458646614	102	10814	39	18	63	10796	10916	0.508195253454514
M1	string	0	network_modules	25	TRUE	2.086963605878138e-66	80	57	37	0.6491228070175439	0.4625	REAC:R-HSA-1168372	REAC	Downstream signaling events of B Cell Receptor (BCR)	10916	791		0.4166666666666667	0.42105263157894735	80	10836	37	20	43	10816	10916	0.5451578589119374
M1	string	0	network_modules	25	TRUE	3.8350069439584334e-66	81	57	37	0.6491228070175439	0.4567901234567901	REAC:R-HSA-176408	REAC	Regulation of APC/C activators between G1/S and early anaphase	10916	1963		0.42424242424242425	0.42857142857142855	81	10835	37	20	44	10815	10916	0.5417299002251486
M1	string	0	network_modules	25	TRUE	1.2563927436197519e-65	83	57	37	0.6491228070175439	0.4457831325301205	REAC:R-HSA-195253	REAC	Degradation of beta-catenin by the destruction complex	10916	724		0.4318181818181818	0.43609022556390975	83	10833	37	20	46	10813	10916	0.5350598208625091
M1	string	0	network_modules	25	TRUE	3.962067992002843e-65	85	57	37	0.6491228070175439	0.43529411764705883	REAC:R-HSA-5632684	REAC	Hedgehog 'on' state	10916	1113		0.4393939393939394	0.44360902255639095	85	10831	37	20	48	10811	10916	0.5286253247987829
M1	string	0	network_modules	25	TRUE	6.941333093312387e-65	86	57	37	0.6491228070175439	0.43023255813953487	REAC:R-HSA-450531	REAC	Regulation of mRNA stability by proteins that bind AU-rich elements	10916	2043		0.44696969696969696	0.45112781954887216	86	10830	37	20	49	10810	10916	0.5254921256603253
M1	string	0	network_modules	25	TRUE	2.076546218141131e-64	88	57	37	0.6491228070175439	0.42045454545454547	REAC:R-HSA-174143	REAC	APC/C-mediated degradation of cell cycle proteins	10916	24		0.45454545454545453	0.46616541353383456	88	10828	37	20	51	10808	10916	0.5193858360253032
M1	string	0	network_modules	25	TRUE	2.076546218141131e-64	88	57	37	0.6491228070175439	0.42045454545454547	REAC:R-HSA-453276	REAC	Regulation of mitotic cell cycle	10916	2044		0.45454545454545453	0.46616541353383456	88	10828	37	20	51	10808	10916	0.5193858360253032
M1	string	0	network_modules	25	TRUE	3.5209510190709376e-64	69	57	35	0.6140350877192983	0.5072463768115942	REAC:R-HSA-9793380	REAC	Formation of paraxial mesoderm	10916	961		0.4696969696969697	0.47368421052631576	69	10847	35	22	34	10825	10916	0.5555536167073325
M1	string	0	network_modules	25	TRUE	6.013559316046007e-64	90	57	37	0.6491228070175439	0.4111111111111111	REAC:R-HSA-1236974	REAC	ER-Phagosome pathway	10916	824		0.4772727272727273	0.48120300751879697	90	10826	37	20	53	10806	10916	0.5134831006934402
M1	string	0	network_modules	25	TRUE	1.6242711813445875e-63	81	57	36	0.631578947368421	0.4444444444444444	REAC:R-HSA-9013694	REAC	Signaling by NOTCH4	10916	2283		0.48484848484848486	0.48872180451127817	81	10835	36	21	45	10814	10916	0.526919246938923
M1	string	0	network_modules	25	TRUE	1.6890433119896268e-63	92	57	37	0.6491228070175439	0.40217391304347827	REAC:R-HSA-4086400	REAC	PCP/CE pathway	10916	1659		0.49242424242424243	0.5037593984962406	92	10824	37	20	55	10804	10916	0.5077728076429795
M1	string	0	network_modules	25	TRUE	1.6890433119896268e-63	92	57	37	0.6491228070175439	0.40217391304347827	REAC:R-HSA-69052	REAC	Switching of origins to a post-replicative state	10916	2365		0.49242424242424243	0.5037593984962406	92	10824	37	20	55	10804	10916	0.5077728076429795
M1	string	0	network_modules	25	TRUE	2.889980706512363e-63	82	57	36	0.631578947368421	0.43902439024390244	REAC:R-HSA-69202	REAC	Cyclin E associated events during G1/S transition 	10916	421		0.5075757575757576	0.5112781954887218	82	10834	36	21	46	10813	10916	0.5236437703612117
M1	string	0	network_modules	25	TRUE	8.897618412704248e-63	84	57	36	0.631578947368421	0.42857142857142855	REAC:R-HSA-69656	REAC	Cyclin A:Cdk2-associated events at S phase entry	10916	419		0.5151515151515151	0.518796992481203	84	10832	36	21	48	10811	10916	0.5172682151094253
M1	string	0	network_modules	25	TRUE	1.9752126103091482e-62	97	57	37	0.6491228070175439	0.38144329896907214	REAC:R-HSA-5607764	REAC	CLEC7A (Dectin-1) signaling	10916	275		0.5227272727272727	0.5263157894736842	97	10819	37	20	60	10799	10916	0.4942733811501078
M1	string	0	network_modules	25	TRUE	3.1675818600094107e-62	98	57	37	0.6491228070175439	0.37755102040816324	REAC:R-HSA-202424	REAC	Downstream TCR signaling	10916	789		0.5303030303030303	0.5338345864661654	98	10818	37	20	61	10798	10916	0.4916974746676951
M1	string	0	network_modules	25	TRUE	7.284068186834343e-62	113	57	38	0.6666666666666666	0.336283185840708	REAC:R-HSA-9020702	REAC	Interleukin-1 signaling	10916	1233		0.5378787878787878	0.5413533834586466	113	10803	38	19	75	10784	10916	0.4697933721509414
M1	string	0	network_modules	25	TRUE	7.999560147861193e-62	100	57	37	0.6491228070175439	0.37	REAC:R-HSA-5668541	REAC	TNFR2 non-canonical NF-kB pathway	10916	2450		0.5454545454545454	0.5488721804511278	100	10816	37	20	63	10796	10916	0.48666133905377806
M1	string	0	network_modules	25	TRUE	3.0749640924332665e-61	103	57	37	0.6491228070175439	0.3592233009708738	REAC:R-HSA-382556	REAC	ABC-family proteins mediated transport	10916	9		0.553030303030303	0.556390977443609	103	10813	37	20	66	10793	10916	0.4793822266043187
M1	string	0	network_modules	25	TRUE	7.343677247597587e-61	105	57	37	0.6491228070175439	0.3523809523809524	REAC:R-HSA-1236975	REAC	Antigen processing-Cross presentation	10916	153		0.5606060606060606	0.5639097744360902	105	10811	37	20	68	10791	10916	0.4747026451754066
M1	string	0	network_modules	25	TRUE	2.431376651635913e-60	95	57	36	0.631578947368421	0.37894736842105264	REAC:R-HSA-8878159	REAC	Transcriptional regulation by RUNX3	10916	2554		0.5681818181818182	0.5789473684210527	95	10821	36	21	59	10800	10916	0.48586120423155943
M1	string	0	network_modules	25	TRUE	2.431376651635913e-60	95	57	36	0.631578947368421	0.37894736842105264	REAC:R-HSA-9759194	REAC	Nuclear events mediated by NFE2L2	10916	1617		0.5681818181818182	0.5789473684210527	95	10821	36	21	59	10800	10916	0.48586120423155943
M1	string	0	network_modules	25	TRUE	1.9644177570161577e-59	113	57	37	0.6491228070175439	0.3274336283185841	REAC:R-HSA-5610787	REAC	Hedgehog 'off' state	10916	1112		0.5833333333333334	0.5864661654135338	113	10803	37	20	76	10783	10916	0.4572353925629735
M1	string	0	network_modules	25	TRUE	1.3294055753465614e-58	118	57	37	0.6491228070175439	0.3135593220338983	REAC:R-HSA-8878166	REAC	Transcriptional regulation by RUNX2	10916	2553		0.5909090909090909	0.5939849624060151	118	10798	37	20	81	10778	10916	0.4472260098137939
M1	string	0	network_modules	25	TRUE	1.5022021219948377e-58	151	57	39	0.6842105263157895	0.2582781456953642	REAC:R-HSA-446652	REAC	Interleukin-1 family signaling	10916	1231		0.5984848484848485	0.6015037593984962	151	10765	39	18	112	10747	10916	0.4158436318472691
M1	string	0	network_modules	25	TRUE	2.7792414494541993e-58	120	57	37	0.6491228070175439	0.30833333333333335	REAC:R-HSA-202403	REAC	TCR signaling	10916	2422		0.6060606060606061	0.6090225563909775	120	10796	37	20	83	10776	10916	0.4433972370829441
M1	string	0	network_modules	25	TRUE	3.9962119820963e-58	121	57	37	0.6491228070175439	0.30578512396694213	REAC:R-HSA-69239	REAC	Synthesis of DNA	10916	2376		0.6136363636363636	0.6165413533834586	121	10795	37	20	84	10775	10916	0.4415182748451747
M1	string	0	network_modules	25	TRUE	1.1629112239232625e-57	124	57	37	0.6491228070175439	0.29838709677419356	REAC:R-HSA-9755511	REAC	KEAP1-NFE2L2 pathway	10916	1281		0.6212121212121212	0.6240601503759399	124	10792	37	20	87	10772	10916	0.43601735414633835
M1	string	0	network_modules	25	TRUE	2.3301620432216675e-57	126	57	37	0.6491228070175439	0.29365079365079366	REAC:R-HSA-162909	REAC	Host Interactions of HIV factors	10916	1132		0.6287878787878788	0.631578947368421	126	10790	37	20	89	10770	10916	0.43245886953341783
M1	string	0	network_modules	25	TRUE	6.450075447976037e-57	129	57	37	0.6491228070175439	0.2868217054263566	REAC:R-HSA-8939236	REAC	RUNX1 regulates transcription of genes involved in differentiation of HSCs	10916	1922		0.6363636363636364	0.6390977443609023	129	10787	37	20	92	10767	10916	0.42727587097062913
M1	string	0	network_modules	25	TRUE	4.111671001575801e-56	298	57	44	0.7719298245614035	0.1476510067114094	REAC:R-HSA-5688426	REAC	Deubiquitination	10916	736		0.6439393939393939	0.6466165413533834	298	10618	44	13	254	10605	10916	0.33106809970242285
M1	string	0	network_modules	25	TRUE	6.243829906249498e-56	136	57	37	0.6491228070175439	0.27205882352941174	REAC:R-HSA-2871837	REAC	FCERI mediated NF-kB activation	10916	896		0.6515151515151515	0.6616541353383458	136	10780	37	20	99	10760	10916	0.41585077791196495
M1	string	0	network_modules	25	TRUE	6.243829906249498e-56	136	57	37	0.6491228070175439	0.27205882352941174	REAC:R-HSA-5621481	REAC	C-type lectin receptors (CLRs)	10916	261		0.6515151515151515	0.6616541353383458	136	10780	37	20	99	10760	10916	0.41585077791196495
M1	string	0	network_modules	25	TRUE	1.164553239017747e-55	138	57	37	0.6491228070175439	0.26811594202898553	REAC:R-HSA-6807070	REAC	PTEN Regulation	10916	1703		0.6666666666666666	0.6691729323308271	138	10778	37	20	101	10758	10916	0.41274585641439704
M1	string	0	network_modules	25	TRUE	2.7989779461101292e-55	470	58	45	0.7758620689655172	0.09574468085106383	GO:0010498	GO:BP	proteasomal protein catabolic process	16175	4177		0	0.034482758620689655	470	15705	45	13	425	15692	16175	0.2667199076729672
M1	string	0	network_modules	25	TRUE	5.287538756494722e-55	143	57	37	0.6491228070175439	0.25874125874125875	REAC:R-HSA-3858494	REAC	Beta-catenin independent WNT signaling	10916	216		0.6742424242424242	0.6766917293233082	143	10773	37	20	106	10753	10916	0.40526803792429367
M1	string	0	network_modules	25	TRUE	1.5800731892911463e-54	114	57	35	0.6140350877192983	0.30701754385964913	REAC:R-HSA-9758941	REAC	Gastrulation	10916	1040		0.6818181818181818	0.6842105263157895	114	10802	35	22	79	10780	10916	0.43017462285825486
M1	string	0	network_modules	25	TRUE	1.8168883383893952e-54	130	57	36	0.631578947368421	0.27692307692307694	REAC:R-HSA-69206	REAC	G1/S Transition	10916	1002		0.6893939393939394	0.6917293233082706	130	10786	36	21	94	10765	10916	0.4138705282991848
M1	string	0	network_modules	25	TRUE	3.0006873367710163e-54	149	57	37	0.6491228070175439	0.24832214765100671	REAC:R-HSA-5358351	REAC	Signaling by Hedgehog	10916	2258		0.696969696969697	0.6992481203007519	149	10767	37	20	112	10747	10916	0.3967918392158091
M1	string	0	network_modules	25	TRUE	4.2650710822135267e-54	363	58	42	0.7241379310344828	0.11570247933884298	GO:0043161	GO:BP	proteasome-mediated ubiquitin-dependent protein catabolic process	16175	10561		0.03571428571428571	0.06896551724137931	363	15812	42	16	321	15796	16175	0.2841962879812785
M1	string	0	network_modules	25	TRUE	7.021895058816181e-53	142	57	36	0.631578947368421	0.2535211267605634	REAC:R-HSA-68867	REAC	Assembly of the pre-replicative complex	10916	181		0.7045454545454546	0.706766917293233	142	10774	36	21	106	10753	10916	0.3955146717846359
M1	string	0	network_modules	25	TRUE	9.92376982618804e-53	162	57	37	0.6491228070175439	0.22839506172839505	REAC:R-HSA-69242	REAC	S Phase	10916	2111		0.7121212121212122	0.7142857142857143	162	10754	37	20	125	10734	10916	0.38005464336554134
M1	string	0	network_modules	25	TRUE	1.2814656093947326e-52	163	57	37	0.6491228070175439	0.22699386503067484	REAC:R-HSA-983705	REAC	Signaling by the B Cell Receptor (BCR)	10916	2328		0.7196969696969697	0.7218045112781954	163	10753	37	20	126	10733	10916	0.37884993057941346
M1	string	0	network_modules	25	TRUE	2.8981462571240814e-52	147	57	36	0.631578947368421	0.24489795918367346	REAC:R-HSA-453279	REAC	Mitotic G1 phase and G1/S transition	10916	1480		0.7272727272727273	0.7293233082706767	147	10769	36	21	111	10748	10916	0.38853235636131694
M1	string	0	network_modules	25	TRUE	3.5007790816047175e-52	167	57	37	0.6491228070175439	0.2215568862275449	REAC:R-HSA-69481	REAC	G2/M Checkpoints	10916	1005		0.7348484848484849	0.7368421052631579	167	10749	37	20	130	10729	10916	0.3741386395509116
M1	string	0	network_modules	25	TRUE	5.23254198636147e-52	141	52	36	0.6923076923076923	0.2553191489361702	KEGG:05017	KEGG	Spinocerebellar ataxia	8484	415		0.125	0.2222222222222222	141	8343	36	16	105	8327	8484	0.41506171098098693
M1	string	0	network_modules	25	TRUE	5.6957021525606774e-52	673	58	47	0.8103448275862069	0.06983655274888559	GO:0051603	GO:BP	proteolysis involved in protein catabolic process	16175	13820		0.07142857142857142	0.10344827586206896	673	15502	47	11	626	15491	16175	0.23093661738028304
M1	string	0	network_modules	25	TRUE	6.526288820190092e-52	555	58	45	0.7758620689655172	0.08108108108108109	GO:0019941	GO:BP	modification-dependent protein catabolic process	16175	6072		0.10714285714285714	0.13793103448275862	555	15620	45	13	510	15607	16175	0.24438217930520667
M1	string	0	network_modules	25	TRUE	9.108715480641495e-52	559	58	45	0.7758620689655172	0.08050089445438283	GO:0043632	GO:BP	modification-dependent macromolecule catabolic process	16175	10812		0.14285714285714285	0.1724137931034483	559	15616	45	13	514	15603	16175	0.24345622356098126
M1	string	0	network_modules	25	TRUE	9.307972318872719e-52	171	57	37	0.6491228070175439	0.21637426900584794	REAC:R-HSA-9010553	REAC	Regulation of expression of SLITs and ROBOs	10916	2031		0.7424242424242424	0.7443609022556391	171	10745	37	20	134	10725	10916	0.36959187231963386
M1	string	0	network_modules	25	TRUE	1.5030798294367626e-51	173	57	37	0.6491228070175439	0.2138728323699422	REAC:R-HSA-5619115	REAC	Disorders of transmembrane transporters	10916	778		0.75	0.7518796992481203	173	10743	37	20	136	10723	10916	0.36737720610200786
M1	string	0	network_modules	25	TRUE	2.338403553786582e-51	221	57	39	0.6842105263157895	0.17647058823529413	REAC:R-HSA-5689880	REAC	Ub-specific processing proteases	10916	2617		0.7575757575757576	0.7593984962406015	221	10695	39	18	182	10677	10916	0.3415581901213984
M1	string	0	network_modules	25	TRUE	3.048629624487118e-51	176	57	37	0.6491228070175439	0.21022727272727273	REAC:R-HSA-109581	REAC	Apoptosis	10916	158		0.7651515151515151	0.7669172932330827	176	10740	37	20	139	10720	10916	0.36412546947121555
M1	string	0	network_modules	25	TRUE	7.014566095980682e-51	159	57	36	0.631578947368421	0.22641509433962265	REAC:R-HSA-69002	REAC	DNA Replication Pre-Initiation	10916	446		0.7727272727272727	0.7744360902255639	159	10757	36	21	123	10736	10916	0.37312670029126516
M1	string	0	network_modules	25	TRUE	1.2048797938083738e-50	182	57	37	0.6491228070175439	0.2032967032967033	REAC:R-HSA-2454202	REAC	Fc epsilon receptor (FCERI) signaling	10916	938		0.7803030303030303	0.7819548872180451	182	10734	37	20	145	10714	10916	0.35786215135643823
M1	string	0	network_modules	25	TRUE	2.284759994612754e-50	208	57	38	0.6666666666666666	0.18269230769230768	REAC:R-HSA-5357801	REAC	Programmed Cell Death	10916	1803		0.7878787878787878	0.7894736842105263	208	10708	38	19	170	10689	10916	0.343190393385459
M1	string	0	network_modules	25	TRUE	3.3206830864054943e-50	547	58	44	0.7586206896551724	0.08043875685557587	GO:0006511	GO:BP	ubiquitin-dependent protein catabolic process	16175	2235		0.17857142857142858	0.20689655172413793	547	15628	44	14	503	15614	16175	0.24054195857938102
M1	string	0	network_modules	25	TRUE	3.644079143775705e-50	187	57	37	0.6491228070175439	0.19786096256684493	REAC:R-HSA-69306	REAC	DNA Replication	10916	445		0.7954545454545454	0.7969924812030075	187	10729	37	20	150	10709	10916	0.35287198968047284
M1	string	0	network_modules	25	TRUE	4.528768853350026e-50	188	57	37	0.6491228070175439	0.19680851063829788	REAC:R-HSA-2467813	REAC	Separation of Sister Chromatids	10916	2204		0.803030303030303	0.8045112781954887	188	10728	37	20	151	10708	10916	0.3518976354108055
M1	string	0	network_modules	25	TRUE	2.0013968884956063e-49	195	57	37	0.6491228070175439	0.18974358974358974	REAC:R-HSA-69275	REAC	G2/M Transition	10916	1008		0.8106060606060606	0.8120300751879699	195	10721	37	20	158	10701	10916	0.3452858257698087
M1	string	0	network_modules	25	TRUE	2.9142477250235487e-49	308	57	41	0.7192982456140351	0.1331168831168831	REAC:R-HSA-983168	REAC	Antigen processing: Ubiquitination & Proteasome degradation	10916	154		0.8181818181818182	0.8195488721804511	308	10608	41	16	267	10592	10916	0.3023736882989934
M1	string	0	network_modules	25	TRUE	3.026635450202137e-49	197	57	37	0.6491228070175439	0.18781725888324874	REAC:R-HSA-453274	REAC	Mitotic G2-G2/M phases	10916	1481		0.8257575757575758	0.8270676691729323	197	10719	37	20	160	10699	10916	0.34346096625982336
M1	string	0	network_modules	25	TRUE	4.83040053889609e-48	211	57	37	0.6491228070175439	0.17535545023696683	REAC:R-HSA-9711123	REAC	Cellular response to chemical stress	10916	333		0.8333333333333334	0.8345864661654135	211	10705	37	20	174	10685	10916	0.33141302109980886
M1	string	0	network_modules	25	TRUE	1.4881690498476095e-47	217	57	37	0.6491228070175439	0.17050691244239632	REAC:R-HSA-376176	REAC	Signaling by ROBO receptors	10916	2301		0.8409090909090909	0.8421052631578947	217	10699	37	20	180	10679	10916	0.32660548551236684
M1	string	0	network_modules	25	TRUE	1.6230772547820748e-47	244	57	38	0.6666666666666666	0.1557377049180328	REAC:R-HSA-8951664	REAC	Neddylation	10916	1559		0.8484848484848485	0.849624060150376	244	10672	38	19	206	10653	10916	0.3157809234270037
M1	string	0	network_modules	25	TRUE	6.330322603671599e-47	225	57	37	0.6491228070175439	0.16444444444444445	REAC:R-HSA-162906	REAC	HIV Infection	10916	1102		0.8560606060606061	0.8571428571428571	225	10691	37	20	188	10671	10916	0.32049289163666383
M1	string	0	network_modules	25	TRUE	1.0736736191796674e-46	228	57	37	0.6491228070175439	0.16228070175438597	REAC:R-HSA-68882	REAC	Mitotic Anaphase	10916	1479		0.8636363636363636	0.8646616541353384	228	10688	37	20	191	10668	10916	0.31828284830499165
M1	string	0	network_modules	25	TRUE	1.2782478863795125e-46	229	57	37	0.6491228070175439	0.1615720524017467	REAC:R-HSA-2555396	REAC	Mitotic Metaphase and Anaphase	10916	1482		0.8712121212121212	0.8721804511278195	229	10687	37	20	192	10667	10916	0.317555693129069
M1	string	0	network_modules	25	TRUE	1.8072271461677154e-46	231	57	37	0.6491228070175439	0.16017316017316016	REAC:R-HSA-201681	REAC	TCF dependent signaling in response to WNT	10916	2421		0.8787878787878788	0.8796992481203008	231	10685	37	20	194	10665	10916	0.3161153626144714
M1	string	0	network_modules	25	TRUE	3.019537197921294e-46	234	57	37	0.6491228070175439	0.1581196581196581	REAC:R-HSA-8878171	REAC	Transcriptional regulation by RUNX1	10916	2552		0.8863636363636364	0.8872180451127819	234	10682	37	20	197	10662	10916	0.31398906981001906
M1	string	0	network_modules	25	TRUE	2.495020359869177e-45	380	57	41	0.7192982456140351	0.10789473684210527	REAC:R-HSA-983169	REAC	Class I MHC mediated antigen processing & presentation	10916	368		0.8939393939393939	0.8947368421052632	380	10536	41	16	339	10520	10916	0.270546261778867
M1	string	0	network_modules	25	TRUE	6.647573193144728e-45	253	57	37	0.6491228070175439	0.14624505928853754	REAC:R-HSA-1257604	REAC	PIP3 activates AKT signaling	10916	1679		0.9015151515151515	0.9022556390977443	253	10663	37	20	216	10643	10916	0.301399700252871
M1	string	0	network_modules	25	TRUE	2.0590889716926513e-44	232	57	36	0.631578947368421	0.15517241379310345	REAC:R-HSA-157118	REAC	Signaling by NOTCH	10916	2274		0.9090909090909091	0.9097744360902256	232	10684	36	21	196	10663	10916	0.30658915839795975
M1	string	0	network_modules	25	TRUE	3.55203248141542e-44	264	57	37	0.6491228070175439	0.14015151515151514	REAC:R-HSA-5673001	REAC	RAF/MAP kinase cascade	10916	1841		0.9166666666666666	0.9172932330827067	264	10652	37	20	227	10632	10916	0.2947307948302078
M1	string	0	network_modules	25	TRUE	7.420511182657202e-44	269	57	37	0.6491228070175439	0.137546468401487	REAC:R-HSA-5684996	REAC	MAPK1/MAPK3 signaling	10916	1351		0.9242424242424242	0.924812030075188	269	10647	37	20	232	10627	10916	0.29183331023519316
M1	string	0	network_modules	25	TRUE	1.9622573403275517e-43	308	57	38	0.6666666666666666	0.12337662337662338	REAC:R-HSA-5683057	REAC	MAPK family signaling cascades	10916	1348		0.9318181818181818	0.9323308270676691	308	10608	38	19	270	10589	10916	0.27934547075384125
M1	string	0	network_modules	25	TRUE	2.400944556031923e-43	363	52	40	0.7692307692307693	0.11019283746556474	KEGG:05014	KEGG	Amyotrophic lateral sclerosis	8484	413		0.25	0.3333333333333333	363	8121	40	12	323	8109	8484	0.2818910672963013
M1	string	0	network_modules	25	TRUE	4.067014053400538e-43	265	52	37	0.7115384615384616	0.13962264150943396	KEGG:05012	KEGG	Parkinson disease	8484	412		0.375	0.4444444444444444	265	8219	37	15	228	8204	8484	0.3071193049420397
M1	string	0	network_modules	25	TRUE	1.2261444814737925e-42	289	57	37	0.6491228070175439	0.12802768166089964	REAC:R-HSA-69620	REAC	Cell Cycle Checkpoints	10916	321		0.9393939393939394	0.9398496240601504	289	10627	37	20	252	10607	10916	0.28099222920623723
M1	string	0	network_modules	25	TRUE	2.094908387409484e-42	293	57	37	0.6491228070175439	0.12627986348122866	REAC:R-HSA-9006925	REAC	Intracellular signaling by second messengers	10916	1266		0.946969696969697	0.9473684210526315	293	10623	37	20	256	10603	10916	0.27895587253927906
M1	string	0	network_modules	25	TRUE	1.4782095784940744e-40	327	57	37	0.6491228070175439	0.11314984709480122	REAC:R-HSA-195721	REAC	Signaling by WNT	10916	2314		0.9545454545454546	0.9548872180451128	327	10589	37	20	290	10569	10916	0.26315542918155116
M1	string	0	network_modules	25	TRUE	1.4424191585250035e-39	472	57	40	0.7017543859649122	0.0847457627118644	REAC:R-HSA-449147	REAC	Signaling by Interleukins	10916	2261		0.9621212121212122	0.9624060150375939	472	10444	40	17	432	10427	10916	0.2345672347402016
M1	string	0	network_modules	25	TRUE	6.93244142279405e-39	305	52	36	0.6923076923076923	0.1180327868852459	KEGG:05016	KEGG	Huntington disease	8484	414		0.5	0.5555555555555556	305	8179	36	16	269	8163	8484	0.2768710659677334
M1	string	0	network_modules	25	TRUE	3.922592963986314e-37	271	52	34	0.6538461538461539	0.12546125461254612	KEGG:05020	KEGG	Prion disease	8484	416		0.625	0.6666666666666666	271	8213	34	18	237	8195	8484	0.27773115373621393
M1	string	0	network_modules	25	TRUE	5.864771717200122e-37	406	57	37	0.6491228070175439	0.09113300492610837	REAC:R-HSA-68886	REAC	M Phase	10916	1343		0.9696969696969697	0.9699248120300752	406	10510	37	20	369	10490	10916	0.23428430347165072
M1	string	0	network_modules	25	TRUE	9.46785055713599e-37	370	57	36	0.631578947368421	0.0972972972972973	REAC:R-HSA-71291	REAC	Metabolism of amino acids and derivatives	10916	1421		0.9772727272727273	0.9774436090225563	370	10546	36	21	334	10525	10916	0.23929451240043895
M1	string	0	network_modules	25	TRUE	1.7717416676547455e-36	418	57	37	0.6491228070175439	0.08851674641148326	REAC:R-HSA-5663202	REAC	Diseases of signal transduction by growth factor receptors and second messengers	10916	773		0.9848484848484849	0.9849624060150376	418	10498	37	20	381	10478	10916	0.23061377802014185
M1	string	0	network_modules	25	TRUE	3.0972975081029776e-35	382	52	36	0.6923076923076923	0.09424083769633508	KEGG:05010	KEGG	Alzheimer disease	8484	411		0.75	0.7777777777777778	382	8102	36	16	346	8086	8484	0.24513346362996644
M1	string	0	network_modules	25	TRUE	1.403525199531266e-16	198	52	19	0.36538461538461536	0.09595959595959595	KEGG:05169	KEGG	Epstein-Barr virus infection	8484	450		0.875	0.8888888888888888	198	8286	19	33	179	8253	8484	0.17791690267615062
M1	string	0	network_modules	25	TRUE	4.206438540582565e-13	201	58	15	0.25862068965517243	0.07462686567164178	GO:1903050	GO:BP	regulation of proteolysis involved in protein catabolic process	16175	22729		0.21428571428571427	0.2413793103448276	201	15974	15	43	186	15931	16175	0.13331805372830044
M1	string	0	network_modules	25	TRUE	1.2666602150124602e-12	171	58	14	0.2413793103448276	0.08187134502923976	GO:0061136	GO:BP	regulation of proteasomal protein catabolic process	16175	15243		0.25	0.27586206896551724	171	16004	14	44	157	15960	16175	0.13537973541822781
M1	string	0	network_modules	25	TRUE	2.4566747369670174e-10	375	58	16	0.27586206896551724	0.042666666666666665	GO:0030162	GO:BP	regulation of proteolysis	16175	6690		0.2857142857142857	0.3103448275862069	375	15800	16	42	359	15758	16175	0.10072555813969068
M1	string	0	network_modules	25	TRUE	4.504919979012559e-9	309	58	14	0.2413793103448276	0.045307443365695796	GO:0042176	GO:BP	regulation of protein catabolic process	16175	10004		0.32142857142857145	0.3448275862068966	309	15866	14	44	295	15822	16175	0.09740815410338233
M1	string	0	network_modules	25	TRUE	1.8165487836609955e-7	10	58	5	0.08620689655172414	0.5	GO:0043248	GO:BP	proteasome assembly	16175	10584		0.35714285714285715	0.3793103448275862	10	16165	5	53	5	16112	16175	0.20655920252874527
M1	string	0	network_modules	25	TRUE	5.586831618735239e-7	476	57	16	0.2807017543859649	0.03361344537815126	REAC:R-HSA-6798695	REAC	Neutrophil degranulation	10916	1597		0.9924242424242424	0.9924812030075187	476	10440	16	41	460	10399	10916	0.08411561205169556
M1	string	0	network_modules	25	TRUE	9.466736684374995e-7	12	57	5	0.08771929824561403	0.4166666666666667	REAC:R-HSA-5689877	REAC	Josephin domain DUBs	10916	1280		1	1	12	10904	5	52	7	10852	10916	0.18938284895176433
M1	string	0	network_modules	25	TRUE	3.76335727104516e-6	148	58	9	0.15517241379310345	0.060810810810810814	GO:2000058	GO:BP	regulation of ubiquitin-dependent protein catabolic process	16175	25413		0.39285714285714285	0.41379310344827586	148	16027	9	49	139	15978	16175	0.09199812158538354
M1	string	0	network_modules	25	TRUE	4.112673515928008e-6	102	58	8	0.13793103448275862	0.0784313725490196	GO:1901800	GO:BP	positive regulation of proteasomal protein catabolic process	16175	21744		0.42857142857142855	0.4482758620689655	102	16073	8	50	94	16023	16175	0.09974842134427993
M1	string	0	network_modules	25	TRUE	1.227053629870474e-5	117	58	8	0.13793103448275862	0.06837606837606838	GO:1903052	GO:BP	positive regulation of proteolysis involved in protein catabolic process	16175	22731		0.4642857142857143	0.4827586206896552	117	16058	8	50	109	16008	16175	0.09252206199529323
M1	string	0	network_modules	25	TRUE	6.434719927145593e-5	3	58	3	0.05172413793103448	1	GO:0070682	GO:BP	proteasome regulatory particle assembly	16175	16258		0.5	0.5172413793103449	3	16172	3	55	0	16117	16175	0.2270423468138765
M1	string	0	network_modules	25	TRUE	1.0603317952145112e-4	12	58	4	0.06896551724137931	0.3333333333333333	GO:1901526	GO:BP	positive regulation of mitophagy	16175	21541		0.5357142857142857	0.5517241379310345	12	16163	4	54	8	16109	16175	0.1503139914737635
M1	string	0	network_modules	25	TRUE	1.171185572097754e-4	156	58	8	0.13793103448275862	0.05128205128205128	GO:0016241	GO:BP	regulation of macroautophagy	16175	5183		0.5714285714285714	0.5862068965517241	156	16019	8	50	148	15969	16175	0.07874395286505348
M1	string	0	network_modules	25	TRUE	1.4412311928244356e-4	477	58	12	0.20689655172413793	0.025157232704402517	GO:0009896	GO:BP	positive regulation of catabolic process	16175	3756		0.6071428571428571	0.6206896551724138	477	15698	12	46	465	15652	16175	0.06290781476464453
M1	string	0	network_modules	25	TRUE	2.1327913085242834e-4	14	58	4	0.06896551724137931	0.2857142857142857	GO:1903599	GO:BP	positive regulation of autophagy of mitochondrion	16175	23138		0.6428571428571429	0.6551724137931034	14	16161	4	54	10	16107	16175	0.1389200913250304
M1	string	0	network_modules	25	TRUE	3.841461170595079e-4	182	58	8	0.13793103448275862	0.04395604395604396	GO:0045732	GO:BP	positive regulation of protein catabolic process	16175	11573		0.6785714285714286	0.6896551724137931	182	15993	8	50	174	15943	16175	0.07204776255290694
M1	string	0	network_modules	25	TRUE	6.340357638867921e-4	43	58	5	0.08620689655172414	0.11627906976744186	GO:0000423	GO:BP	mitophagy	16175	127		0.7142857142857143	0.7241379310344828	43	16132	5	53	38	16079	16175	0.0973366434074892
M1	string	0	network_modules	25	TRUE	0.001100421293496547	209	58	8	0.13793103448275862	0.03827751196172249	GO:0045862	GO:BP	positive regulation of proteolysis	16175	11674		0.75	0.7586206896551724	209	15966	8	50	201	15916	16175	0.06640323625875483
M1	string	0	network_modules	25	TRUE	0.002076676790975083	309	58	9	0.15517241379310345	0.02912621359223301	GO:0016236	GO:BP	macroautophagy	16175	5179		0.7857142857142857	0.7931034482758621	309	15866	9	49	300	15817	16175	0.05962960895303779
M1	string	0	network_modules	25	TRUE	0.002204331264109569	24	58	4	0.06896551724137931	0.16666666666666666	GO:1901524	GO:BP	regulation of mitophagy	16175	21539		0.8214285714285714	0.8275862068965517	24	16151	4	54	20	16097	16175	0.1051712811966921
M1	string	0	network_modules	25	TRUE	0.002654437531956977	57	58	5	0.08620689655172414	0.08771929824561403	GO:0000422	GO:BP	autophagy of mitochondrion	16175	126		0.8571428571428571	0.8620689655172413	57	16118	5	53	52	16065	16175	0.0837026271676693
M1	string	0	network_modules	25	TRUE	0.004988803714831137	115	58	6	0.10344827586206896	0.05217391304347826	GO:0032434	GO:BP	regulation of proteasomal ubiquitin-dependent protein catabolic process	16175	7563		0.8928571428571429	0.896551724137931	115	16060	6	52	109	16008	16175	0.06878512749778472
M1	string	0	network_modules	25	TRUE	0.005808107633112998	168	52	7	0.1346153846153846	0.041666666666666664	KEGG:04141	KEGG	Protein processing in endoplasmic reticulum	8484	278		1	1	168	8316	7	45	161	8271	8484	0.06471690600042222
M1	string	0	network_modules	25	TRUE	0.006406399100472315	31	58	4	0.06896551724137931	0.12903225806451613	GO:1903146	GO:BP	regulation of autophagy of mitochondrion	16175	22796		0.9285714285714286	0.9310344827586207	31	16144	4	54	27	16090	16175	0.09196486404924871
M1	string	0	network_modules	25	TRUE	0.0074051557887585785	70	58	5	0.08620689655172414	0.07142857142857142	GO:0016239	GO:BP	positive regulation of macroautophagy	16175	5181		0.9642857142857143	0.9655172413793104	70	16105	5	53	65	16052	16175	0.07482738196954154
M1	string	0	network_modules	25	TRUE	0.007584894029744172	10	58	3	0.05172413793103448	0.3	GO:0035973	GO:BP	aggrephagy	16175	9373		1	1	10	16165	3	55	7	16110	16175	0.12333870060702026
M1	string	0	network_modules	26	TRUE	1.8434061456746583e-15	514	51	21	0.4117647058823529	0.04085603112840467	GO:1901137	GO:BP	carbohydrate derivative biosynthetic process	16175	21245		0	0.058823529411764705	514	15661	21	30	493	15631	16175	0.12183462409386903
M1	string	0	network_modules	26	TRUE	1.892646333679987e-12	315	51	16	0.3137254901960784	0.050793650793650794	GO:0009100	GO:BP	glycoprotein metabolic process	16175	3272		0.0625	0.11764705882352941	315	15860	16	35	299	15825	16175	0.11975786657366383
M1	string	0	network_modules	26	TRUE	3.4720350106759207e-12	265	51	15	0.29411764705882354	0.05660377358490566	GO:0009101	GO:BP	glycoprotein biosynthetic process	16175	3273		0.125	0.17647058823529413	265	15910	15	36	250	15874	16175	0.12304516011488795
M1	string	0	network_modules	26	TRUE	1.7668578436072887e-11	183	51	13	0.2549019607843137	0.07103825136612021	GO:0006486	GO:BP	protein glycosylation	16175	2220		0.1875	0.29411764705882354	183	15992	13	38	170	15954	16175	0.1295305776578215
M1	string	0	network_modules	26	TRUE	1.7668578436072887e-11	183	51	13	0.2549019607843137	0.07103825136612021	GO:0043413	GO:BP	macromolecule glycosylation	16175	10680		0.1875	0.29411764705882354	183	15992	13	38	170	15954	16175	0.1295305776578215
M1	string	0	network_modules	26	TRUE	7.250194382735042e-11	204	51	13	0.2549019607843137	0.06372549019607843	GO:0070085	GO:BP	glycosylation	16175	15903		0.3125	0.35294117647058826	204	15971	13	38	191	15933	16175	0.12210885642498807
M1	string	0	network_modules	26	TRUE	1.4560934651692098e-8	17	51	6	0.11764705882352941	0.35294117647058826	GO:0035269	GO:BP	protein O-linked mannosylation	16175	8933		0.375	0.47058823529411764	17	16158	6	45	11	16113	16175	0.20237579762556487
M1	string	0	network_modules	26	TRUE	1.4560934651692098e-8	17	51	6	0.11764705882352941	0.35294117647058826	GO:0035268	GO:BP	protein mannosylation	16175	8932		0.375	0.47058823529411764	17	16158	6	45	11	16113	16175	0.20237579762556487
M1	string	0	network_modules	26	TRUE	2.178929657043091e-8	18	51	6	0.11764705882352941	0.3333333333333333	GO:0097502	GO:BP	mannosylation	16175	18684		0.5	0.5294117647058824	18	16157	6	45	12	16112	16175	0.19657572222583522
M1	string	0	network_modules	26	TRUE	8.30607672633408e-7	94	51	8	0.1568627450980392	0.0851063829787234	GO:0006493	GO:BP	protein O-linked glycosylation	16175	2225		0.5625	0.5882352941176471	94	16081	8	43	86	16038	16175	0.11176273455030514
M1	string	0	network_modules	26	TRUE	3.483444293965832e-6	23	38	5	0.13157894736842105	0.21739130434782608	KEGG:00515	KEGG	Mannose type O-glycan biosynthesis	8484	68		0	0.25	23	8461	5	33	18	8428	8484	0.16624060639290653
M1	string	0	network_modules	26	TRUE	1.1677474255379009e-5	108	34	7	0.20588235294117646	0.06481481481481481	REAC:R-HSA-5173105	REAC	O-linked glycosylation	10916	1631		0	0.16666666666666666	108	10808	7	27	101	10781	10916	0.1106865705351661
M1	string	0	network_modules	26	TRUE	3.8133597305507625e-4	26	38	4	0.10526315789473684	0.15384615384615385	KEGG:00563	KEGG	Glycosylphosphatidylinositol (GPI)-anchor biosynthesis	8484	87		0.3333333333333333	0.5	26	8458	4	34	22	8424	8484	0.12401985123617063
M1	string	0	network_modules	26	TRUE	7.013475802413827e-4	92	51	6	0.11764705882352941	0.06521739130434782	GO:0006664	GO:BP	glycolipid metabolic process	16175	2373		0.625	0.6470588235294118	92	16083	6	45	86	16038	16175	0.08372893984683177
M1	string	0	network_modules	26	TRUE	7.479274629824301e-4	93	51	6	0.11764705882352941	0.06451612903225806	GO:1903509	GO:BP	liposaccharide metabolic process	16175	23059		0.6875	0.7058823529411765	93	16082	6	45	87	16037	16175	0.0832341695014079
M1	string	0	network_modules	26	TRUE	0.0014185032680389133	140	34	6	0.17647058823529413	0.04285714285714286	REAC:R-HSA-3781865	REAC	Diseases of glycosylation	10916	765		0.2	0.3333333333333333	140	10776	6	28	134	10748	10916	0.08129419930700603
M1	string	0	network_modules	26	TRUE	0.0017081739686044776	37	34	4	0.11764705882352941	0.10810810810810811	REAC:R-HSA-9694548	REAC	Maturation of spike protein	10916	1408		0.4	0.5	37	10879	4	30	33	10849	10916	0.10988493086947705
M1	string	0	network_modules	26	TRUE	0.0024302261146682894	27	51	4	0.0784313725490196	0.14814814814814814	GO:0006505	GO:BP	GPI anchor metabolic process	16175	2231		0.75	0.7647058823529411	27	16148	4	47	23	16101	16175	0.10575447330422888
M1	string	0	network_modules	26	TRUE	0.0027121516848552	42	38	4	0.10526315789473684	0.09523809523809523	KEGG:00513	KEGG	Various types of N-glycan biosynthesis	8484	66		0.6666666666666666	0.75	42	8442	4	34	38	8408	8484	0.0958683735889563
M1	string	0	network_modules	26	TRUE	0.00353968854945526	67	51	5	0.09803921568627451	0.07462686567164178	GO:0009247	GO:BP	glycolipid biosynthetic process	16175	3412		0.8125	0.8235294117647058	67	16108	5	46	62	16062	16175	0.08222172510124238
M1	string	0	network_modules	26	TRUE	0.003811568047381962	68	51	5	0.09803921568627451	0.07352941176470588	GO:0006487	GO:BP	protein N-linked glycosylation	16175	2221		0.875	0.8823529411764706	68	16107	5	46	63	16061	16175	0.08156370922326546
M1	string	0	network_modules	26	TRUE	0.00431676095916293	31	51	4	0.0784313725490196	0.12903225806451613	GO:0180046	GO:BP	GPI anchored protein biosynthesis	16175	20314		0.9375	0.9411764705882353	31	16144	4	47	27	16097	16175	0.09839028204908667
M1	string	0	network_modules	26	TRUE	0.006849414947151398	53	38	4	0.10526315789473684	0.07547169811320754	KEGG:00510	KEGG	N-Glycan biosynthesis	8484	63		1	1	53	8431	4	34	49	8397	8484	0.08429373099969137
M1	string	0	network_modules	26	TRUE	0.00977662905522525	57	34	4	0.11764705882352941	0.07017543859649122	REAC:R-HSA-9694635	REAC	Translation of Structural Proteins	10916	2571		0.6	0.6666666666666666	57	10859	4	30	53	10829	10916	0.08719279312193683
M1	string	0	network_modules	26	TRUE	0.00996340916908592	38	51	4	0.0784313725490196	0.10526315789473684	GO:0018279	GO:BP	protein N-linked glycosylation via asparagine	16175	5395		1	1	38	16137	4	47	34	16090	16175	0.08838368280377878
M1	string	0	network_modules	26	TRUE	0.009998342288767158	3	34	2	0.058823529411764705	0.6666666666666666	REAC:R-HSA-5083629	REAC	Defective POMT2 causes MDDGA2, MDDGB2 and MDDGC2	10916	610		0.8	1	3	10913	2	32	1	10881	10916	0.19743911789809265
M1	string	0	network_modules	26	TRUE	0.009998342288767158	3	34	2	0.058823529411764705	0.6666666666666666	REAC:R-HSA-5083633	REAC	Defective POMT1 causes MDDGA1, MDDGB1 and MDDGC1	10916	609		0.8	1	3	10913	2	32	1	10881	10916	0.19743911789809265
M1	string	0	network_modules	27	TRUE	7.695533149783792e-51	96	35	28	0.8	0.2916666666666667	REAC:R-HSA-5620912	REAC	Anchoring of the basal body to the plasma membrane	10916	147		0	0.07142857142857142	96	10820	28	7	68	10813	10916	0.48062154257928486
M1	string	0	network_modules	27	TRUE	7.54675051419304e-42	68	35	23	0.6571428571428571	0.3382352941176471	REAC:R-HSA-380284	REAC	Loss of proteins required for interphase microtubule organization from the centrosome	10916	1335		0.07692307692307693	0.21428571428571427	68	10848	23	12	45	10836	10916	0.46919903228873266
M1	string	0	network_modules	27	TRUE	7.54675051419304e-42	68	35	23	0.6571428571428571	0.3382352941176471	REAC:R-HSA-380259	REAC	Loss of Nlp from mitotic centrosomes	10916	1331		0.07692307692307693	0.21428571428571427	68	10848	23	12	45	10836	10916	0.46919903228873266
M1	string	0	network_modules	27	TRUE	2.4859182755140427e-41	71	35	23	0.6571428571428571	0.323943661971831	REAC:R-HSA-8854518	REAC	AURKA Activation by TPX2	10916	41		0.23076923076923078	0.2857142857142857	71	10845	23	12	48	10833	10916	0.45904899940847826
M1	string	0	network_modules	27	TRUE	6.661378849920898e-41	200	35	28	0.8	0.14	REAC:R-HSA-5617833	REAC	Cilium Assembly	10916	361		0.3076923076923077	0.35714285714285715	200	10716	28	7	172	10709	10916	0.3305672562220785
M1	string	0	network_modules	27	TRUE	6.347009200792994e-40	80	35	23	0.6571428571428571	0.2875	REAC:R-HSA-380270	REAC	Recruitment of mitotic centrosome proteins and complexes	10916	1951		0.38461538461538464	0.5	80	10836	23	12	57	10824	10916	0.43208861829728556
M1	string	0	network_modules	27	TRUE	6.347009200792994e-40	80	35	23	0.6571428571428571	0.2875	REAC:R-HSA-380287	REAC	Centrosome maturation	10916	341		0.38461538461538464	0.5	80	10836	23	12	57	10824	10916	0.43208861829728556
M1	string	0	network_modules	27	TRUE	3.2002661316104295e-39	85	35	23	0.6571428571428571	0.27058823529411763	REAC:R-HSA-2565942	REAC	Regulation of PLK1 Activity at G2/M Transition	10916	1998		0.5384615384615384	0.5714285714285714	85	10831	23	12	62	10819	10916	0.41898873115866914
M1	string	0	network_modules	27	TRUE	2.1377732935482952e-38	586	53	37	0.6981132075471698	0.06313993174061433	GO:0000226	GO:BP	microtubule cytoskeleton organization	16175	61		0	0.01639344262295082	586	15589	37	16	549	15573	16175	0.20309396271635013
M1	string	0	network_modules	27	TRUE	4.527304517538125e-38	94	35	23	0.6571428571428571	0.24468085106382978	REAC:R-HSA-380320	REAC	Recruitment of NuMA to mitotic centrosomes	10916	1950		0.6153846153846154	0.6428571428571429	94	10822	23	12	71	10810	10916	0.3980857430920218
M1	string	0	network_modules	27	TRUE	4.79374351253298e-36	292	35	28	0.8	0.0958904109589041	REAC:R-HSA-1852241	REAC	Organelle biogenesis and maintenance	10916	1646		0.6923076923076923	0.7142857142857143	292	10624	28	7	264	10617	10916	0.27179894728528525
M1	string	0	network_modules	27	TRUE	1.0251521322327953e-34	146	53	25	0.4716981132075472	0.17123287671232876	GO:0031023	GO:BP	microtubule organizing center organization	16175	6997		0.016666666666666666	0.03278688524590164	146	16029	25	28	121	16001	16175	0.2804892292483545
M1	string	0	network_modules	27	TRUE	4.618605435626747e-34	129	53	24	0.4528301886792453	0.18604651162790697	GO:0007098	GO:BP	centrosome cycle	16175	2681		0.03333333333333333	0.04918032786885246	129	16046	24	29	105	16017	16175	0.28675626365409984
M1	string	0	network_modules	27	TRUE	3.860264632605577e-30	195	35	23	0.6571428571428571	0.11794871794871795	REAC:R-HSA-69275	REAC	G2/M Transition	10916	1008		0.7692307692307693	0.7857142857142857	195	10721	23	12	172	10709	10916	0.2737276977445465
M1	string	0	network_modules	27	TRUE	4.940975326711206e-30	197	35	23	0.6571428571428571	0.116751269035533	REAC:R-HSA-453274	REAC	Mitotic G2-G2/M phases	10916	1481		0.8461538461538461	0.8571428571428571	197	10719	23	12	174	10707	10916	0.27228201961793086
M1	string	0	network_modules	27	TRUE	6.307376177320496e-30	199	35	23	0.6571428571428571	0.11557788944723618	REAC:R-HSA-68877	REAC	Mitotic Prometaphase	10916	1484		0.9230769230769231	0.9285714285714286	199	10717	23	12	176	10705	10916	0.2708579180877221
M1	string	0	network_modules	27	TRUE	4.983062969651899e-25	343	53	25	0.4716981132075472	0.0728862973760933	GO:0140694	GO:BP	membraneless organelle assembly	16175	19860		0.05	0.06557377049180328	343	15832	25	28	318	15804	16175	0.17928560763668244
M1	string	0	network_modules	27	TRUE	4.156504648163826e-23	176	53	20	0.37735849056603776	0.11363636363636363	GO:0007051	GO:BP	spindle organization	16175	2650		0.06666666666666667	0.08196721311475409	176	15999	20	33	156	15966	16175	0.2025430429526583
M1	string	0	network_modules	27	TRUE	1.328812702831885e-22	406	35	23	0.6571428571428571	0.05665024630541872	REAC:R-HSA-68886	REAC	M Phase	10916	1343		1	1	406	10510	23	12	383	10498	10916	0.18580408403649815
M1	string	0	network_modules	27	TRUE	2.6337028054645978e-21	113	53	17	0.32075471698113206	0.1504424778761062	GO:0051225	GO:BP	spindle assembly	16175	13578		0.08333333333333333	0.09836065573770492	113	16062	17	36	96	16026	16175	0.21599477772090783
M1	string	0	network_modules	27	TRUE	3.0888747595905574e-20	343	53	22	0.41509433962264153	0.0641399416909621	GO:0060271	GO:BP	cilium assembly	16175	14488		0.1	0.11475409836065574	343	15832	22	31	321	15801	16175	0.15675861587454606
M1	string	0	network_modules	27	TRUE	1.4533337287879507e-19	368	53	22	0.41509433962264153	0.059782608695652176	GO:0044782	GO:BP	cilium organization	16175	11155		0.11666666666666667	0.13114754098360656	368	15807	22	31	346	15776	16175	0.15086560475596944
M1	string	0	network_modules	27	TRUE	2.0627254419739744e-19	47	53	13	0.24528301886792453	0.2765957446808511	GO:0098534	GO:BP	centriole assembly	16175	18792		0.13333333333333333	0.14754098360655737	47	16128	13	40	34	16088	16175	0.25818173974801933
M1	string	0	network_modules	27	TRUE	6.4428069578419664e-18	42	53	12	0.22641509433962265	0.2857142857142857	GO:0007099	GO:BP	centriole replication	16175	2682		0.15	0.16393442622950818	42	16133	12	41	30	16092	16175	0.2521659968707472
M1	string	0	network_modules	27	TRUE	2.1976410289475123e-17	232	53	18	0.33962264150943394	0.07758620689655173	GO:0032886	GO:BP	regulation of microtubule-based process	16175	7882		0.16666666666666666	0.18032786885245902	232	15943	18	35	214	15908	16175	0.15685575947388286
M1	string	0	network_modules	27	TRUE	8.061180930727954e-17	71	53	13	0.24528301886792453	0.18309859154929578	GO:0051298	GO:BP	centrosome duplication	16175	13629		0.18333333333333332	0.19672131147540983	71	16104	13	40	58	16064	16175	0.20893050029281082
M1	string	0	network_modules	27	TRUE	1.2992073779001578e-16	503	53	22	0.41509433962264153	0.0437375745526839	GO:0120031	GO:BP	plasma membrane bounded cell projection assembly	16175	19467		0.2	0.21311475409836064	503	15672	22	31	481	15641	16175	0.1268394516921326
M1	string	0	network_modules	27	TRUE	2.068913221824709e-16	514	53	22	0.41509433962264153	0.042801556420233464	GO:0030031	GO:BP	cell projection assembly	16175	6655		0.21666666666666667	0.22950819672131148	514	15661	22	31	492	15630	16175	0.12529664280933944
M1	string	0	network_modules	27	TRUE	3.869740982684052e-14	147	53	14	0.2641509433962264	0.09523809523809523	GO:0070507	GO:BP	regulation of microtubule cytoskeleton organization	16175	16162		0.23333333333333334	0.2459016393442623	147	16028	14	39	133	15989	16175	0.15410673884151777
M1	string	0	network_modules	27	TRUE	6.14151631685158e-14	361	53	18	0.33962264150943394	0.04986149584487535	GO:0007059	GO:BP	chromosome segregation	16175	2658		0.25	0.26229508196721313	361	15814	18	35	343	15779	16175	0.12316127755407723
M1	string	0	network_modules	27	TRUE	1.0739774805358385e-13	88	53	12	0.22641509433962265	0.13636363636363635	GO:0046785	GO:BP	microtubule polymerization	16175	12369		0.26666666666666666	0.2786885245901639	88	16087	12	41	76	16046	16175	0.17224088753501465
M1	string	0	network_modules	27	TRUE	1.6841027827532922e-13	124	53	13	0.24528301886792453	0.10483870967741936	GO:0031109	GO:BP	microtubule polymerization or depolymerization	16175	7034		0.2833333333333333	0.29508196721311475	124	16051	13	40	111	16011	16175	0.1562025580718798
M1	string	0	network_modules	27	TRUE	3.378753349932299e-13	46	53	10	0.18867924528301888	0.21739130434782608	GO:0007020	GO:BP	microtubule nucleation	16175	2628		0.3	0.3114754098360656	46	16129	10	43	36	16086	16175	0.20008680976658774
M1	string	0	network_modules	27	TRUE	8.78036493707215e-13	19	53	8	0.1509433962264151	0.42105263157894735	GO:0010968	GO:BP	regulation of microtubule nucleation	16175	4544		0.31666666666666665	0.32786885245901637	19	16156	8	45	11	16111	16175	0.25069763135073686
M1	string	0	network_modules	27	TRUE	2.7316981116904952e-11	793	53	21	0.39622641509433965	0.02648171500630517	GO:0044087	GO:BP	regulation of cellular component biogenesis	16175	10909		0.3333333333333333	0.3442622950819672	793	15382	21	32	772	15350	16175	0.09219548645806895
M1	string	0	network_modules	27	TRUE	8.895810944432817e-11	31	53	8	0.1509433962264151	0.25806451612903225	GO:0071539	GO:BP	protein localization to centrosome	16175	16751		0.35	0.36065573770491804	31	16144	8	45	23	16099	16175	0.1953668573477708
M1	string	0	network_modules	27	TRUE	1.1831718335461925e-10	32	53	8	0.1509433962264151	0.25	GO:1905508	GO:BP	protein localization to microtubule organizing center	16175	24684		0.36666666666666664	0.3770491803278688	32	16143	8	45	24	16098	16175	0.1922162033762645
M1	string	0	network_modules	27	TRUE	3.1375120349049616e-10	58	53	9	0.16981132075471697	0.15517241379310345	GO:0031113	GO:BP	regulation of microtubule polymerization	16175	7038		0.38333333333333336	0.39344262295081966	58	16117	9	44	49	16073	16175	0.1594462902003296
M1	string	0	network_modules	27	TRUE	3.3787870355345456e-10	88	53	10	0.18867924528301888	0.11363636363636363	GO:0031110	GO:BP	regulation of microtubule polymerization or depolymerization	16175	7035		0.4	0.4098360655737705	88	16087	10	43	78	16044	16175	0.1428272981868563
M1	string	0	network_modules	27	TRUE	6.322767420442389e-10	440	53	16	0.3018867924528302	0.03636363636363636	GO:0051493	GO:BP	regulation of cytoskeleton organization	16175	13748		0.4166666666666667	0.4262295081967213	440	15735	16	37	424	15698	16175	0.09681595239956635
M1	string	0	network_modules	27	TRUE	6.801569020842413e-10	39	53	8	0.1509433962264151	0.20512820512820512	GO:1905515	GO:BP	non-motile cilium assembly	16175	24691		0.43333333333333335	0.4426229508196721	39	16136	8	45	31	16091	16175	0.17364541957775503
M1	string	0	network_modules	27	TRUE	1.034134227005168e-9	186	53	12	0.22641509433962265	0.06451612903225806	GO:1902115	GO:BP	regulation of organelle assembly	16175	22028		0.45	0.45901639344262296	186	15989	12	41	174	15948	16175	0.11557771997432655
M1	string	0	network_modules	27	TRUE	4.079609325662884e-9	48	53	8	0.1509433962264151	0.16666666666666666	GO:0072698	GO:BP	protein localization to microtubule cytoskeleton	16175	17509		0.4666666666666667	0.47540983606557374	48	16127	8	45	40	16082	16175	0.155979027515641
M1	string	0	network_modules	27	TRUE	5.775607668759976e-9	50	53	8	0.1509433962264151	0.16	GO:0044380	GO:BP	protein localization to cytoskeleton	16175	10982		0.48333333333333334	0.4918032786885246	50	16125	8	45	42	16080	16175	0.15270937896429426
M1	string	0	network_modules	27	TRUE	1.9094392804524633e-8	238	53	12	0.22641509433962265	0.05042016806722689	GO:0051258	GO:BP	protein polymerization	16175	13605		0.5	0.5081967213114754	238	15937	12	41	226	15896	16175	0.1008100826318395
M1	string	0	network_modules	27	TRUE	8.58097873144065e-8	69	53	8	0.1509433962264151	0.11594202898550725	GO:1902117	GO:BP	positive regulation of organelle assembly	16175	22030		0.5166666666666667	0.5245901639344263	69	16106	8	45	61	16061	16175	0.12903812137187626
M1	string	0	network_modules	27	TRUE	3.554409223068358e-7	124	53	9	0.16981132075471697	0.07258064516129033	GO:0007052	GO:BP	mitotic spindle organization	16175	2651		0.5333333333333333	0.5409836065573771	124	16051	9	44	115	16007	16175	0.1065896141915706
M1	string	0	network_modules	27	TRUE	1.7990825222172762e-6	62	53	7	0.1320754716981132	0.11290322580645161	GO:1902017	GO:BP	regulation of cilium assembly	16175	21945		0.55	0.5573770491803278	62	16113	7	46	55	16067	16175	0.11899270598363378
M1	string	0	network_modules	27	TRUE	2.323372950429205e-6	153	53	9	0.16981132075471697	0.058823529411764705	GO:1902850	GO:BP	microtubule cytoskeleton organization involved in mitosis	16175	22560		0.5666666666666667	0.5737704918032787	153	16022	9	44	144	15978	16175	0.09498254966443608
M1	string	0	network_modules	27	TRUE	3.6478585223715916e-6	161	53	9	0.16981132075471697	0.055900621118012424	GO:0032271	GO:BP	regulation of protein polymerization	16175	7452		0.5833333333333334	0.5901639344262295	161	16014	9	44	152	15970	16175	0.09233012952632029
M1	string	0	network_modules	27	TRUE	8.024234783529854e-6	43	53	6	0.11320754716981132	0.13953488372093023	GO:0010824	GO:BP	regulation of centrosome duplication	16175	4434		0.6	0.6065573770491803	43	16132	6	47	37	16085	16175	0.12309764247556665
M1	string	0	network_modules	27	TRUE	1.1125141293135658e-5	8	53	4	0.07547169811320754	0.5	GO:0061511	GO:BP	centriole elongation	16175	15513		0.6166666666666667	0.6229508196721312	8	16167	4	49	4	16118	16175	0.19334891361811074
M1	string	0	network_modules	27	TRUE	1.5649338321431687e-5	23	53	5	0.09433962264150944	0.21739130434782608	GO:0046599	GO:BP	regulation of centriole replication	16175	12249		0.6333333333333333	0.639344262295082	23	16152	5	48	18	16104	16175	0.14138197037709566
M1	string	0	network_modules	27	TRUE	1.59517024255528e-5	48	53	6	0.11320754716981132	0.125	GO:0046605	GO:BP	regulation of centrosome cycle	16175	12255		0.65	0.6557377049180327	48	16127	6	47	42	16080	16175	0.1162022606293212
M1	string	0	network_modules	27	TRUE	1.9976720939247475e-5	9	53	4	0.07547169811320754	0.4444444444444444	GO:0046601	GO:BP	positive regulation of centriole replication	16175	12251		0.6666666666666666	0.6721311475409836	9	16166	4	49	5	16117	16175	0.1821464257031294
M1	string	0	network_modules	27	TRUE	1.079322262260227e-4	318	53	10	0.18867924528301888	0.031446540880503145	GO:1902903	GO:BP	regulation of supramolecular fiber organization	16175	22602		0.6833333333333333	0.6885245901639344	318	15857	10	43	308	15814	16175	0.06980474263234089
M1	string	0	network_modules	27	TRUE	1.268753146850655e-4	748	53	14	0.2641509433962264	0.01871657754010695	GO:0097435	GO:BP	supramolecular fiber organization	16175	18657		0.7	0.7049180327868853	748	15427	14	39	734	15388	16175	0.05949108494488757
M1	string	0	network_modules	27	TRUE	1.3122391387999346e-4	630	53	13	0.24528301886792453	0.020634920634920634	GO:0010564	GO:BP	regulation of cell cycle process	16175	4217		0.7166666666666667	0.7213114754098361	630	15545	13	40	617	15505	16175	0.06114739708921092
M1	string	0	network_modules	27	TRUE	2.097820022072802e-4	656	53	13	0.24528301886792453	0.019817073170731708	GO:1903047	GO:BP	mitotic cell cycle process	16175	22727		0.7333333333333333	0.7377049180327869	656	15519	13	40	643	15479	16175	0.05950634327951768
M1	string	0	network_modules	27	TRUE	2.1328700466763522e-4	15	53	4	0.07547169811320754	0.26666666666666666	GO:0010457	GO:BP	centriole-centriole cohesion	16175	4153		0.75	0.7540983606557377	15	16160	4	49	11	16111	16175	0.14041746820421835
M1	string	0	network_modules	27	TRUE	5.166551522051071e-4	5	53	3	0.05660377358490566	0.6	GO:0098535	GO:BP	de novo centriole assembly involved in multi-ciliated epithelial cell differentiation	16175	18793		0.7666666666666667	0.7704918032786885	5	16170	3	50	2	16120	16175	0.18361151424279867
M1	string	0	network_modules	27	TRUE	0.0010309147469754142	6	53	3	0.05660377358490566	0.5	GO:0097742	GO:BP	de novo centriole assembly	16175	18754		0.7833333333333333	0.7868852459016393	6	16169	3	50	3	16119	16175	0.167434714734746
M1	string	0	network_modules	27	TRUE	0.001357044463258978	23	53	4	0.07547169811320754	0.17391304347826086	GO:0045724	GO:BP	positive regulation of cilium assembly	16175	11566		0.8	0.8032786885245902	23	16152	4	49	19	16103	16175	0.11267285404123241
M1	string	0	network_modules	27	TRUE	0.0017952359220826828	792	53	13	0.24528301886792453	0.016414141414141416	GO:0000278	GO:BP	mitotic cell cycle	16175	76		0.8166666666666667	0.819672131147541	792	15383	13	40	779	15343	16175	0.05216161525702257
M1	string	0	network_modules	27	TRUE	0.0017999187430267356	7	53	3	0.05660377358490566	0.42857142857142855	GO:1905832	GO:BP	positive regulation of spindle assembly	16175	24942		0.8333333333333334	0.8524590163934426	7	16168	3	50	4	16118	16175	0.15484878602713312
M1	string	0	network_modules	27	TRUE	0.0017999187430267356	7	53	3	0.05660377358490566	0.42857142857142855	GO:1903722	GO:BP	regulation of centriole elongation	16175	23234		0.8333333333333334	0.8524590163934426	7	16168	3	50	4	16118	16175	0.15484878602713312
M1	string	0	network_modules	27	TRUE	0.0021705516060932066	172	53	7	0.1320754716981132	0.040697674418604654	GO:0120032	GO:BP	regulation of plasma membrane bounded cell projection assembly	16175	19468		0.8666666666666667	0.8688524590163934	172	16003	7	46	165	15957	16175	0.0678853334654999
M1	string	0	network_modules	27	TRUE	0.0022564370165967474	173	53	7	0.1320754716981132	0.04046242774566474	GO:0060491	GO:BP	regulation of cell projection assembly	16175	14685		0.8833333333333333	0.8852459016393442	173	16002	7	46	166	15956	16175	0.06765650347035931
M1	string	0	network_modules	27	TRUE	0.0023475760434478275	252	53	8	0.1509433962264151	0.031746031746031744	GO:0140014	GO:BP	mitotic nuclear division	16175	19633		0.9	0.9016393442622951	252	15923	8	45	244	15878	16175	0.06267041624782274
M1	string	0	network_modules	27	TRUE	0.0025532768799541696	346	53	9	0.16981132075471697	0.02601156069364162	GO:0043254	GO:BP	regulation of protein-containing complex assembly	16175	10588		0.9166666666666666	0.9180327868852459	346	15829	9	44	337	15785	16175	0.058816779156776786
M1	string	0	network_modules	27	TRUE	0.0027298211819283317	178	53	7	0.1320754716981132	0.03932584269662921	GO:0000070	GO:BP	mitotic sister chromatid segregation	16175	24		0.9333333333333333	0.9344262295081968	178	15997	7	46	171	15951	16175	0.06654003569736427
M1	string	0	network_modules	27	TRUE	0.002873194904066899	8	53	3	0.05660377358490566	0.375	GO:1903251	GO:BP	multi-ciliated epithelial cell differentiation	16175	22858		0.95	0.9508196721311475	8	16167	3	50	5	16117	16175	0.1446928261550928
M1	string	0	network_modules	27	TRUE	0.00433706478032776	68	53	5	0.09433962264150944	0.07352941176470588	GO:0090307	GO:BP	mitotic spindle assembly	16175	18189		0.9666666666666667	0.9672131147540983	68	16107	5	48	63	16059	16175	0.07987435308943001
M1	string	0	network_modules	27	TRUE	0.004729448127611655	31	53	4	0.07547169811320754	0.12903225806451613	GO:0090169	GO:BP	regulation of spindle assembly	16175	18077		0.9833333333333333	0.9836065573770492	31	16144	4	49	27	16095	16175	0.09642718538928108
M1	string	0	network_modules	27	TRUE	0.007913224860695758	209	53	7	0.1320754716981132	0.03349282296650718	GO:0090068	GO:BP	positive regulation of cell cycle process	16175	17994		1	1	209	15966	7	46	202	15920	16175	0.060493856123519124
M1	string	0	network_modules	28	TRUE	1.7140677199579608e-14	132	24	12	0.5	0.09090909090909091	KEGG:05322	KEGG	Systemic lupus erythematosus	8484	484		0	0.2	132	8352	12	12	120	8340	8484	0.20848751492532225
M1	string	0	network_modules	28	TRUE	4.5785892229014595e-14	72	24	10	0.4166666666666667	0.1388888888888889	REAC:R-HSA-2299718	REAC	Condensation of Prophase Chromosomes	10916	395		0	0.01098901098901099	72	10844	10	14	62	10830	10916	0.23780075052137511
M1	string	0	network_modules	28	TRUE	1.9279781966772746e-13	51	24	9	0.375	0.17647058823529413	REAC:R-HSA-171306	REAC	Packaging Of Telomere Ends	10916	1712		0.011111111111111112	0.02197802197802198	51	10865	9	15	42	10850	10916	0.254918808393782
M1	string	0	network_modules	28	TRUE	2.9742144685514664e-13	86	24	10	0.4166666666666667	0.11627906976744186	REAC:R-HSA-912446	REAC	Meiotic recombination	10916	1411		0.022222222222222223	0.03296703296703297	86	10830	10	14	76	10816	10916	0.21704528670346332
M1	string	0	network_modules	28	TRUE	3.357553125306788e-13	54	24	9	0.375	0.16666666666666666	REAC:R-HSA-73927	REAC	Depurination	10916	731		0.03333333333333333	0.06593406593406594	54	10862	9	15	45	10847	10916	0.24758688616106653
M1	string	0	network_modules	28	TRUE	3.357553125306788e-13	54	24	9	0.375	0.16666666666666666	REAC:R-HSA-110330	REAC	Recognition and association of DNA glycosylase with site containing an affected purine	10916	1946		0.03333333333333333	0.06593406593406594	54	10862	9	15	45	10847	10916	0.24758688616106653
M1	string	0	network_modules	28	TRUE	3.357553125306788e-13	54	24	9	0.375	0.16666666666666666	REAC:R-HSA-110331	REAC	Cleavage of the damaged purine	10916	373		0.03333333333333333	0.06593406593406594	54	10862	9	15	45	10847	10916	0.24758688616106653
M1	string	0	network_modules	28	TRUE	4.782600586001654e-13	90	24	10	0.4166666666666667	0.1111111111111111	REAC:R-HSA-201722	REAC	Formation of the beta-catenin:TCF transactivating complex	10916	968		0.06666666666666667	0.07692307692307693	90	10826	10	14	80	10812	10916	0.2120162137100112
M1	string	0	network_modules	28	TRUE	7.884371993690678e-13	59	24	9	0.375	0.15254237288135594	REAC:R-HSA-110329	REAC	Cleavage of the damaged pyrimidine 	10916	374		0.07777777777777778	0.10989010989010989	59	10857	9	15	50	10842	10916	0.23662498508069324
M1	string	0	network_modules	28	TRUE	7.884371993690678e-13	59	24	9	0.375	0.15254237288135594	REAC:R-HSA-73928	REAC	Depyrimidination	10916	732		0.07777777777777778	0.10989010989010989	59	10857	9	15	50	10842	10916	0.23662498508069324
M1	string	0	network_modules	28	TRUE	7.884371993690678e-13	59	24	9	0.375	0.15254237288135594	REAC:R-HSA-110328	REAC	Recognition and association of DNA glycosylase with site containing an affected pyrimidine	10916	1947		0.07777777777777778	0.10989010989010989	59	10857	9	15	50	10842	10916	0.23662498508069324
M1	string	0	network_modules	28	TRUE	9.264210096872573e-13	60	24	9	0.375	0.15	REAC:R-HSA-73929	REAC	Base-Excision Repair, AP Site Formation	10916	206		0.1111111111111111	0.12087912087912088	60	10856	9	15	51	10841	10916	0.23459746951213398
M1	string	0	network_modules	28	TRUE	1.2154435870729474e-12	187	24	12	0.5	0.06417112299465241	KEGG:05034	KEGG	Alcoholism	8484	422		0.25	0.4	187	8297	12	12	175	8285	8484	0.17339235674840994
M1	string	0	network_modules	28	TRUE	1.2681511543845268e-12	62	24	9	0.375	0.14516129032258066	REAC:R-HSA-73728	REAC	RNA Polymerase I Promoter Opening	10916	1883		0.12222222222222222	0.13186813186813187	62	10854	9	15	53	10839	10916	0.23068944026533936
M1	string	0	network_modules	28	TRUE	1.296586509212448e-12	188	24	12	0.5	0.06382978723404255	KEGG:04613	KEGG	Neutrophil extracellular trap formation	8484	323		0.5	0.6	188	8296	12	12	176	8284	8484	0.17289836537810652
M1	string	0	network_modules	28	TRUE	1.7173359322694788e-12	64	24	9	0.375	0.140625	REAC:R-HSA-5334118	REAC	DNA methylation	10916	447		0.13333333333333333	0.14285714285714285	64	10852	9	15	55	10837	10916	0.22696457918071608
M1	string	0	network_modules	28	TRUE	2.3023411438093027e-12	66	24	9	0.375	0.13636363636363635	REAC:R-HSA-5625886	REAC	Activated PKN1 stimulates transcription of AR (androgen receptor) regulated genes KLK2 and KLK3	10916	68		0.14444444444444443	0.16483516483516483	66	10850	9	15	57	10835	10916	0.22340892393095296
M1	string	0	network_modules	28	TRUE	2.3023411438093027e-12	66	24	9	0.375	0.13636363636363635	REAC:R-HSA-9670095	REAC	Inhibition of DNA recombination at telomere	10916	1189		0.14444444444444443	0.16483516483516483	66	10850	9	15	57	10835	10916	0.22340892393095296
M1	string	0	network_modules	28	TRUE	2.6562957682027943e-12	67	24	9	0.375	0.13432835820895522	REAC:R-HSA-427359	REAC	SIRT1 negatively regulates rRNA expression	10916	2142		0.16666666666666666	0.17582417582417584	67	10849	9	15	58	10834	10916	0.22169058632256655
M1	string	0	network_modules	28	TRUE	3.0576884996199073e-12	68	24	9	0.375	0.1323529411764706	REAC:R-HSA-68616	REAC	Assembly of the ORC complex at the origin of replication	10916	178		0.17777777777777778	0.18681318681318682	68	10848	9	15	59	10833	10916	0.22000995939856385
M1	string	0	network_modules	28	TRUE	4.025121432354249e-12	70	24	9	0.375	0.12857142857142856	REAC:R-HSA-9821002	REAC	Chromatin modifications during the maternal to zygotic transition (MZT)	10916	354		0.18888888888888888	0.1978021978021978	70	10846	9	15	61	10831	10916	0.2167564303005083
M1	string	0	network_modules	28	TRUE	5.254811500423468e-12	72	24	9	0.375	0.125	REAC:R-HSA-212300	REAC	PRC2 methylates histones and DNA	10916	1701		0.2	0.21978021978021978	72	10844	9	15	63	10829	10916	0.21363818263944673
M1	string	0	network_modules	28	TRUE	5.254811500423468e-12	72	24	9	0.375	0.125	REAC:R-HSA-9710421	REAC	Defective pyroptosis	10916	702		0.2	0.21978021978021978	72	10844	9	15	63	10829	10916	0.21363818263944673
M1	string	0	network_modules	28	TRUE	6.614343070634274e-12	116	24	10	0.4166666666666667	0.08620689655172414	REAC:R-HSA-1500620	REAC	Meiosis	10916	1410		0.2222222222222222	0.23076923076923078	116	10800	10	14	106	10786	10916	0.18588457216922466
M1	string	0	network_modules	28	TRUE	7.72528933873077e-12	75	24	9	0.375	0.12	REAC:R-HSA-427389	REAC	ERCC6 (CSB) and EHMT2 (G9a) positively regulate rRNA expression	10916	827		0.23333333333333334	0.24175824175824176	75	10841	9	15	66	10826	10916	0.20919460168927637
M1	string	0	network_modules	28	TRUE	8.752117622214103e-12	76	24	9	0.375	0.11842105263157894	REAC:R-HSA-1221632	REAC	Meiotic synapsis	10916	1412		0.24444444444444444	0.25274725274725274	76	10840	9	15	67	10825	10916	0.2077716327823925
M1	string	0	network_modules	28	TRUE	1.2596447960798213e-11	79	24	9	0.375	0.11392405063291139	REAC:R-HSA-2559586	REAC	DNA Damage/Telomere Stress Induced Senescence	10916	441		0.25555555555555554	0.26373626373626374	79	10837	9	15	70	10822	10916	0.20366442923474287
M1	string	0	network_modules	28	TRUE	2.894693318031927e-11	134	24	10	0.4166666666666667	0.07462686567164178	REAC:R-HSA-68875	REAC	Mitotic Prophase	10916	1485		0.26666666666666666	0.27472527472527475	134	10782	10	14	124	10768	10916	0.17239110995899717
M1	string	0	network_modules	28	TRUE	3.4579172106525255e-11	88	24	9	0.375	0.10227272727272728	REAC:R-HSA-73884	REAC	Base Excision Repair	10916	205		0.2777777777777778	0.2967032967032967	88	10828	9	15	79	10813	10916	0.19261631987124836
M1	string	0	network_modules	28	TRUE	3.4579172106525255e-11	88	24	9	0.375	0.10227272727272728	REAC:R-HSA-9616222	REAC	Transcriptional regulation of granulopoiesis	10916	2559		0.2777777777777778	0.2967032967032967	88	10828	9	15	79	10813	10916	0.19261631987124836
M1	string	0	network_modules	28	TRUE	3.842144675479038e-11	89	24	9	0.375	0.10112359550561797	REAC:R-HSA-5250924	REAC	B-WICH complex positively regulates rRNA expression	10916	198		0.3	0.3076923076923077	89	10827	9	15	80	10812	10916	0.1914921744895699
M1	string	0	network_modules	28	TRUE	4.263735638770066e-11	90	24	9	0.375	0.1	REAC:R-HSA-73772	REAC	RNA Polymerase I Promoter Escape	10916	1882		0.3111111111111111	0.31868131868131866	90	10826	9	15	81	10811	10916	0.19038659699170762
M1	string	0	network_modules	28	TRUE	5.2317328487209635e-11	92	24	9	0.375	0.09782608695652174	REAC:R-HSA-1912408	REAC	Pre-NOTCH Transcription and Translation	10916	1786		0.32222222222222224	0.32967032967032966	92	10824	9	15	83	10809	10916	0.18822912365595226
M1	string	0	network_modules	28	TRUE	5.785064047991001e-11	93	24	9	0.375	0.0967741935483871	REAC:R-HSA-5625740	REAC	RHO GTPases activate PKNs	10916	1857		0.3333333333333333	0.34065934065934067	93	10823	9	15	84	10808	10916	0.1871762645040123
M1	string	0	network_modules	28	TRUE	6.38963441823642e-11	94	24	9	0.375	0.09574468085106383	REAC:R-HSA-3214815	REAC	HDACs deacetylate histones	10916	1092		0.34444444444444444	0.3516483516483517	94	10822	9	15	85	10807	10916	0.18614004477677434
M1	string	0	network_modules	28	TRUE	7.049527967527347e-11	95	24	9	0.375	0.09473684210526316	REAC:R-HSA-8936459	REAC	RUNX1 regulates genes involved in megakaryocyte differentiation and platelet function	10916	1919		0.35555555555555557	0.3626373626373626	95	10821	9	15	86	10806	10916	0.185120026472119
M1	string	0	network_modules	28	TRUE	1.1894329522575876e-10	154	24	10	0.4166666666666667	0.06493506493506493	REAC:R-HSA-1474165	REAC	Reproduction	10916	2064		0.36666666666666664	0.37362637362637363	154	10762	10	14	144	10748	10916	0.1602278287536612
M1	string	0	network_modules	28	TRUE	1.3622293962195686e-10	102	24	9	0.375	0.08823529411764706	REAC:R-HSA-5578749	REAC	Transcriptional regulation by small RNAs	10916	2555		0.37777777777777777	0.38461538461538464	102	10814	9	15	93	10799	10916	0.17839992589017897
M1	string	0	network_modules	28	TRUE	1.4907958832765137e-10	103	24	9	0.375	0.08737864077669903	REAC:R-HSA-9645723	REAC	Diseases of programmed cell death	10916	771		0.3888888888888889	0.3956043956043956	103	10813	9	15	94	10798	10916	0.1774955240517668
M1	string	0	network_modules	28	TRUE	1.629995653052463e-10	104	24	9	0.375	0.08653846153846154	REAC:R-HSA-5250913	REAC	Positive epigenetic regulation of rRNA expression	10916	1771		0.4	0.4065934065934066	104	10812	9	15	95	10797	10916	0.17660402026862834
M1	string	0	network_modules	28	TRUE	1.780586192002423e-10	105	24	9	0.375	0.08571428571428572	REAC:R-HSA-427413	REAC	NoRC negatively regulates rRNA expression	10916	1602		0.4111111111111111	0.4175824175824176	105	10811	9	15	96	10796	10916	0.17572510751269152
M1	string	0	network_modules	28	TRUE	2.3089718140581074e-10	108	24	9	0.375	0.08333333333333333	REAC:R-HSA-1912422	REAC	Pre-NOTCH Expression and Processing	10916	1783		0.4222222222222222	0.43956043956043955	108	10808	9	15	99	10793	10916	0.1731609948367297
M1	string	0	network_modules	28	TRUE	2.3089718140581074e-10	108	24	9	0.375	0.08333333333333333	REAC:R-HSA-5250941	REAC	Negative epigenetic regulation of rRNA expression	10916	1566		0.4222222222222222	0.43956043956043955	108	10808	9	15	99	10793	10916	0.1731609948367297
M1	string	0	network_modules	28	TRUE	2.5136422335688037e-10	109	24	9	0.375	0.08256880733944955	REAC:R-HSA-73854	REAC	RNA Polymerase I Promoter Clearance	10916	1881		0.4444444444444444	0.45054945054945056	109	10807	9	15	100	10792	10916	0.1723295726285832
M1	string	0	network_modules	28	TRUE	2.734217589697709e-10	110	24	9	0.375	0.08181818181818182	REAC:R-HSA-73864	REAC	RNA Polymerase I Transcription	10916	1884		0.45555555555555555	0.46153846153846156	110	10806	9	15	101	10791	10916	0.17150935032778247
M1	string	0	network_modules	28	TRUE	2.9717627747243407e-10	111	24	9	0.375	0.08108108108108109	REAC:R-HSA-157579	REAC	Telomere Maintenance	10916	2489		0.4666666666666667	0.4835164835164835	111	10805	9	15	102	10790	10916	0.17070007581069196
M1	string	0	network_modules	28	TRUE	2.9717627747243407e-10	111	24	9	0.375	0.08108108108108109	REAC:R-HSA-2559582	REAC	Senescence-Associated Secretory Phenotype (SASP)	10916	2194		0.4666666666666667	0.4835164835164835	111	10805	9	15	102	10790	10916	0.17070007581069196
M1	string	0	network_modules	28	TRUE	3.502324981498459e-10	113	24	9	0.375	0.07964601769911504	REAC:R-HSA-9610379	REAC	HCMV Late Events	10916	1090		0.4888888888888889	0.4945054945054945	113	10803	9	15	104	10788	10916	0.16911340075371073
M1	string	0	network_modules	28	TRUE	5.010329802506579e-10	72	24	8	0.3333333333333333	0.1111111111111111	REAC:R-HSA-774815	REAC	Nucleosome assembly	10916	1621		0.5	0.5164835164835165	72	10844	8	16	64	10828	10916	0.18947561475751834
M1	string	0	network_modules	28	TRUE	5.010329802506579e-10	72	24	8	0.3333333333333333	0.1111111111111111	REAC:R-HSA-606279	REAC	Deposition of new CENPA-containing nucleosomes at the centromere	10916	730		0.5	0.5164835164835165	72	10844	8	16	64	10828	10916	0.18947561475751834
M1	string	0	network_modules	28	TRUE	5.631944342070123e-10	119	24	9	0.375	0.07563025210084033	REAC:R-HSA-9816359	REAC	Maternal to zygotic transition (MZT)	10916	1394		0.5222222222222223	0.5274725274725275	119	10797	9	15	110	10782	10916	0.1645922091890666
M1	string	0	network_modules	28	TRUE	6.080993424480714e-10	120	24	9	0.375	0.075	REAC:R-HSA-5619507	REAC	Activation of HOX genes during differentiation	10916	84		0.5333333333333333	0.5494505494505495	120	10796	9	15	111	10781	10916	0.1638713233574248
M1	string	0	network_modules	28	TRUE	6.080993424480714e-10	120	24	9	0.375	0.075	REAC:R-HSA-5617472	REAC	Activation of anterior HOX genes in hindbrain development during early embryogenesis	10916	99		0.5333333333333333	0.5494505494505495	120	10796	9	15	111	10781	10916	0.1638713233574248
M1	string	0	network_modules	28	TRUE	7.075204186302169e-10	122	24	9	0.375	0.07377049180327869	REAC:R-HSA-2559580	REAC	Oxidative Stress Induced Senescence	10916	1654		0.5555555555555556	0.5604395604395604	122	10794	9	15	113	10779	10916	0.162455810495533
M1	string	0	network_modules	28	TRUE	1.1784108872436978e-9	129	24	9	0.375	0.06976744186046512	REAC:R-HSA-8939236	REAC	RUNX1 regulates transcription of genes involved in differentiation of HSCs	10916	1922		0.5666666666666667	0.5714285714285714	129	10787	9	15	120	10772	10916	0.15775932238263582
M1	string	0	network_modules	28	TRUE	1.2155968035201935e-9	194	24	10	0.4166666666666667	0.05154639175257732	REAC:R-HSA-2559583	REAC	Cellular Senescence	10916	331		0.5777777777777777	0.5824175824175825	194	10722	10	14	184	10708	10916	0.14172116385973835
M1	string	0	network_modules	28	TRUE	1.6670437844518837e-9	134	24	9	0.375	0.06716417910447761	REAC:R-HSA-211000	REAC	Gene Silencing by RNA	10916	1041		0.5888888888888889	0.5934065934065934	134	10782	9	15	125	10767	10916	0.1546286943780071
M1	string	0	network_modules	28	TRUE	1.783887921490085e-9	135	24	9	0.375	0.06666666666666667	REAC:R-HSA-9609690	REAC	HCMV Early Events	10916	1088		0.6	0.6043956043956044	135	10781	9	15	126	10766	10916	0.1540231661093849
M1	string	0	network_modules	28	TRUE	2.1790866486304366e-9	138	24	9	0.375	0.06521739130434782	REAC:R-HSA-73886	REAC	Chromosome Maintenance	10916	357		0.6111111111111112	0.6153846153846154	138	10778	9	15	129	10763	10916	0.15224553355376377
M1	string	0	network_modules	28	TRUE	2.649837831902741e-9	141	24	9	0.375	0.06382978723404255	REAC:R-HSA-3214847	REAC	HATs acetylate histones	10916	1087		0.6222222222222222	0.6263736263736264	141	10775	9	15	132	10760	10916	0.1505239087454735
M1	string	0	network_modules	28	TRUE	2.825615504698321e-9	142	24	9	0.375	0.06338028169014084	REAC:R-HSA-68867	REAC	Assembly of the pre-replicative complex	10916	181		0.6333333333333333	0.6373626373626373	142	10774	9	15	133	10759	10916	0.1499619686301771
M1	string	0	network_modules	28	TRUE	3.868631884447225e-9	147	24	9	0.375	0.061224489795918366	REAC:R-HSA-9018519	REAC	Estrogen-dependent gene expression	10916	866		0.6444444444444445	0.6483516483516484	147	10769	9	15	138	10754	10916	0.14723720200176543
M1	string	0	network_modules	28	TRUE	6.925975704210452e-9	231	24	10	0.4166666666666667	0.04329004329004329	REAC:R-HSA-201681	REAC	TCF dependent signaling in response to WNT	10916	2421		0.6555555555555556	0.6593406593406593	231	10685	10	14	221	10671	10916	0.12899537291096577
M1	string	0	network_modules	28	TRUE	7.872138052567401e-9	159	24	9	0.375	0.05660377358490566	REAC:R-HSA-9609646	REAC	HCMV Infection	10916	1089		0.6666666666666666	0.6813186813186813	159	10757	9	15	150	10742	10916	0.14122032534583567
M1	string	0	network_modules	28	TRUE	7.872138052567401e-9	159	24	9	0.375	0.05660377358490566	REAC:R-HSA-69002	REAC	DNA Replication Pre-Initiation	10916	446		0.6666666666666666	0.6813186813186813	159	10757	9	15	150	10742	10916	0.14122032534583567
M1	string	0	network_modules	28	TRUE	1.6316629692705864e-8	110	24	8	0.3333333333333333	0.07272727272727272	REAC:R-HSA-977225	REAC	Amyloid fiber formation	10916	145		0.6888888888888889	0.6923076923076923	110	10806	8	16	102	10790	10916	0.15192652881217567
M1	string	0	network_modules	28	TRUE	3.0776013439387354e-8	185	24	9	0.375	0.04864864864864865	REAC:R-HSA-212165	REAC	Epigenetic regulation of gene expression	10916	852		0.7	0.7032967032967034	185	10731	9	15	176	10716	10916	0.1302134840334323
M1	string	0	network_modules	28	TRUE	3.359045330126061e-8	271	24	10	0.4166666666666667	0.03690036900369004	REAC:R-HSA-3247509	REAC	Chromatin modifying enzymes	10916	355		0.7111111111111111	0.7252747252747253	271	10645	10	14	261	10631	10916	0.1182135943279909
M1	string	0	network_modules	28	TRUE	3.359045330126061e-8	271	24	10	0.4166666666666667	0.03690036900369004	REAC:R-HSA-4839726	REAC	Chromatin organization	10916	356		0.7111111111111111	0.7252747252747253	271	10645	10	14	261	10631	10916	0.1182135943279909
M1	string	0	network_modules	28	TRUE	3.389099659815389e-8	187	24	9	0.375	0.0481283422459893	REAC:R-HSA-69306	REAC	DNA Replication	10916	445		0.7333333333333333	0.7362637362637363	187	10729	9	15	178	10714	10916	0.12946107450084615
M1	string	0	network_modules	28	TRUE	8.207235420387008e-8	406	24	11	0.4583333333333333	0.027093596059113302	REAC:R-HSA-68886	REAC	M Phase	10916	1343		0.7444444444444445	0.7472527472527473	406	10510	11	13	395	10497	10916	0.10446665255814025
M1	string	0	network_modules	28	TRUE	1.2283839901297538e-7	216	24	9	0.375	0.041666666666666664	REAC:R-HSA-8939211	REAC	ESR-mediated signaling	10916	830		0.7555555555555555	0.7582417582417582	216	10700	9	15	207	10685	10916	0.11972500024115301
M1	string	0	network_modules	28	TRUE	2.11642865779252e-7	327	24	10	0.4166666666666667	0.03058103975535168	REAC:R-HSA-195721	REAC	Signaling by WNT	10916	2314		0.7666666666666667	0.7692307692307693	327	10589	10	14	317	10575	10916	0.1064878604202481
M1	string	0	network_modules	28	TRUE	2.2460373929444638e-7	329	24	10	0.4166666666666667	0.030395136778115502	REAC:R-HSA-73894	REAC	DNA Repair	10916	444		0.7777777777777778	0.7802197802197802	329	10587	10	14	319	10573	10916	0.10612341957073276
M1	string	0	network_modules	28	TRUE	2.3175349973892969e-7	232	24	9	0.375	0.03879310344827586	REAC:R-HSA-157118	REAC	Signaling by NOTCH	10916	2274		0.7888888888888889	0.7912087912087912	232	10684	9	15	223	10669	10916	0.11513222866608253
M1	string	0	network_modules	28	TRUE	2.5007748679933415e-7	234	24	9	0.375	0.038461538461538464	REAC:R-HSA-8878171	REAC	Transcriptional regulation by RUNX1	10916	2552		0.8	0.8021978021978022	234	10682	9	15	225	10667	10916	0.11459050523783486
M1	string	0	network_modules	28	TRUE	1.656684277153143e-6	290	24	9	0.375	0.03103448275862069	REAC:R-HSA-9006931	REAC	Signaling by Nuclear Receptors	10916	2289		0.8111111111111111	0.8131868131868132	290	10626	9	15	281	10611	10916	0.10170711148346867
M1	string	0	network_modules	28	TRUE	1.7745997426797433e-6	68	24	6	0.25	0.08823529411764706	REAC:R-HSA-5693571	REAC	Nonhomologous End-Joining (NHEJ)	10916	1605		0.8222222222222222	0.8241758241758241	68	10848	6	18	62	10830	10916	0.14543448067558773
M1	string	0	network_modules	28	TRUE	3.70647261883476e-6	318	24	9	0.375	0.02830188679245283	REAC:R-HSA-195258	REAC	RHO GTPase Effectors	10916	1846		0.8333333333333334	0.8351648351648352	318	10598	9	15	309	10583	10916	0.09653854779387538
M1	string	0	network_modules	28	TRUE	3.795261567136433e-6	77	24	6	0.25	0.07792207792207792	REAC:R-HSA-5693565	REAC	Recruitment and ATM-mediated phosphorylation of repair and signaling proteins at DNA double strand breaks	10916	1949		0.8444444444444444	0.8461538461538461	77	10839	6	18	71	10821	10916	0.1362653241071648
M1	string	0	network_modules	28	TRUE	4.105698150437031e-6	78	24	6	0.25	0.07692307692307693	REAC:R-HSA-5693606	REAC	DNA Double Strand Break Response	10916	442		0.8555555555555555	0.8571428571428571	78	10838	6	18	72	10820	10916	0.1353442025531162
M1	string	0	network_modules	28	TRUE	4.271383369950367e-6	221	24	8	0.3333333333333333	0.03619909502262444	REAC:R-HSA-5689880	REAC	Ub-specific processing proteases	10916	2617		0.8666666666666667	0.8681318681318682	221	10695	8	16	213	10679	10916	0.10435060608961388
M1	string	0	network_modules	28	TRUE	8.195130151573108e-6	42	24	5	0.20833333333333334	0.11904761904761904	REAC:R-HSA-9821993	REAC	Replacement of protamines by nucleosomes in the male pronucleus	10916	2060		0.8777777777777778	0.8791208791208791	42	10874	5	19	37	10855	10916	0.1550454812696193
M1	string	0	network_modules	28	TRUE	1.2722479850733248e-5	94	24	6	0.25	0.06382978723404255	REAC:R-HSA-69473	REAC	G2/M DNA damage checkpoint	10916	1006		0.8888888888888888	0.8901098901098901	94	10822	6	18	88	10804	10916	0.12263508388218537
M1	string	0	network_modules	28	TRUE	1.5374902395946157e-5	97	24	6	0.25	0.061855670103092786	REAC:R-HSA-5693607	REAC	Processing of DNA double-strand break ends	10916	1798		0.9	0.9010989010989011	97	10819	6	18	91	10801	10916	0.1206030419099637
M1	string	0	network_modules	28	TRUE	4.3581882070681783e-5	298	24	8	0.3333333333333333	0.026845637583892617	REAC:R-HSA-5688426	REAC	Deubiquitination	10916	736		0.9111111111111111	0.9120879120879121	298	10618	8	16	290	10602	10916	0.08815672658138655
M1	string	0	network_modules	28	TRUE	7.494358281412371e-5	529	49	12	0.24489795918367346	0.022684310018903593	GO:0006325	GO:BP	chromatin organization	16175	2122		NA	1	529	15646	12	37	517	15609	16175	0.06576289132452012
M1	string	0	network_modules	28	TRUE	9.69195236738185e-5	132	24	6	0.25	0.045454545454545456	REAC:R-HSA-5693567	REAC	HDR through Homologous Recombination (HRR) or Single Strand Annealing (SSA)	10916	1098		0.9222222222222223	0.9230769230769231	132	10784	6	18	126	10766	10916	0.10217551819229564
M1	string	0	network_modules	28	TRUE	1.2610626402883681e-4	138	24	6	0.25	0.043478260869565216	REAC:R-HSA-5693538	REAC	Homology Directed Repair	10916	1130		0.9333333333333333	0.9340659340659341	138	10778	6	18	132	10760	10916	0.0997265016907602
M1	string	0	network_modules	28	TRUE	1.929997564362015e-4	78	24	5	0.20833333333333334	0.0641025641025641	REAC:R-HSA-3214858	REAC	RMTs methylate histone arginines	10916	1878		0.9444444444444444	0.945054945054945	78	10838	5	19	73	10819	10916	0.11212313322283492
M1	string	0	network_modules	28	TRUE	3.874440074634672e-4	167	24	6	0.25	0.03592814371257485	REAC:R-HSA-69481	REAC	G2/M Checkpoints	10916	1005		0.9555555555555556	0.9560439560439561	167	10749	6	18	161	10731	10916	0.08976120267955817
M1	string	0	network_modules	28	TRUE	4.01221002302648e-4	168	24	6	0.25	0.03571428571428571	REAC:R-HSA-5693532	REAC	DNA Double-Strand Break Repair	10916	443		0.9666666666666667	0.967032967032967	168	10748	6	18	162	10730	10916	0.08946288789456475
M1	string	0	network_modules	28	TRUE	9.478097114126047e-4	201	24	6	0.25	0.029850746268656716	KEGG:05203	KEGG	Viral carcinogenesis	8484	455		0.75	0.8	201	8283	6	18	195	8265	8484	0.0792555727224185
M1	string	0	network_modules	28	TRUE	0.00217388952341212	58	24	4	0.16666666666666666	0.06896551724137931	REAC:R-HSA-8866654	REAC	E3 ubiquitin ligases ubiquitinate target proteins	10916	811		0.9777777777777777	0.978021978021978	58	10858	4	20	54	10838	10916	0.10418481941685023
M1	string	0	network_modules	28	TRUE	0.004112628776123844	158	24	5	0.20833333333333334	0.03164556962025317	KEGG:04217	KEGG	Necroptosis	8484	294		1	1	158	8326	5	19	153	8307	8484	0.07474199290488306
M1	string	0	network_modules	28	TRUE	0.007097205217901353	78	24	4	0.16666666666666666	0.05128205128205128	REAC:R-HSA-8852135	REAC	Protein ubiquitination	10916	1818		0.9888888888888889	0.989010989010989	78	10838	4	20	74	10818	10916	0.08890206389255363
M1	string	0	network_modules	28	TRUE	0.009083371293049586	289	24	6	0.25	0.020761245674740483	REAC:R-HSA-69620	REAC	Cell Cycle Checkpoints	10916	321		1	1	289	10627	6	18	283	10609	10916	0.06535628669357146
M1	string	0	network_modules	29	TRUE	7.604707998568166e-21	170	39	19	0.48717948717948717	0.11176470588235295	KEGG:04530	KEGG	Tight junction	8484	317		0	0.2	170	8314	19	20	151	8294	8484	0.22654389689780466
M1	string	0	network_modules	29	TRUE	2.703720915662747e-19	87	42	15	0.35714285714285715	0.1724137931034483	REAC:R-HSA-421270	REAC	Cell-cell junction organization	10916	329		0	0.14285714285714285	87	10829	15	27	72	10802	10916	0.24405080276168745
M1	string	0	network_modules	29	TRUE	2.0097210801378035e-17	114	42	15	0.35714285714285715	0.13157894736842105	REAC:R-HSA-446728	REAC	Cell junction organization	10916	324		0.16666666666666666	0.2857142857142857	114	10802	15	27	99	10775	10916	0.21195427237180126
M1	string	0	network_modules	29	TRUE	1.4390857966196721e-15	150	42	15	0.35714285714285715	0.1	REAC:R-HSA-1500931	REAC	Cell-Cell communication	10916	328		0.3333333333333333	0.42857142857142855	150	10766	15	27	135	10739	10916	0.18332553213552888
M1	string	0	network_modules	29	TRUE	4.7824456613527965e-15	153	39	15	0.38461538461538464	0.09803921568627451	KEGG:04514	KEGG	Cell adhesion molecules	8484	315		0.25	0.4	153	8331	15	24	138	8307	8484	0.18720150016589196
M1	string	0	network_modules	29	TRUE	3.4604442889249864e-13	30	42	9	0.21428571428571427	0.3	REAC:R-HSA-420029	REAC	Tight junction interactions	10916	2510		0.5	0.5714285714285714	30	10886	9	33	21	10853	10916	0.2511227104914289
M1	string	0	network_modules	29	TRUE	8.267093329270751e-13	179	54	14	0.25925925925925924	0.0782122905027933	GO:0045216	GO:BP	cell-cell junction organization	16175	11328		0	0.027777777777777776	179	15996	14	40	165	15956	16175	0.137309992463167
M1	string	0	network_modules	29	TRUE	5.417940891643759e-12	7	42	6	0.14285714285714285	0.8571428571428571	REAC:R-HSA-420597	REAC	Nectin/Necl  trans heterodimerization	10916	1558		0.6666666666666666	0.7142857142857143	7	10909	6	36	1	10873	10916	0.349140409560753
M1	string	0	network_modules	29	TRUE	3.161632453453952e-11	69	54	10	0.18518518518518517	0.14492753623188406	GO:0120192	GO:BP	tight junction assembly	16175	19553		0.02857142857142857	0.05555555555555555	69	16106	10	44	59	16062	16175	0.16066148952557577
M1	string	0	network_modules	29	TRUE	4.271988961626679e-11	71	54	10	0.18518518518518517	0.14084507042253522	GO:0120193	GO:BP	tight junction organization	16175	19554		0.05714285714285714	0.08333333333333333	71	16104	10	44	61	16060	16175	0.1582840706388473
M1	string	0	network_modules	29	TRUE	5.399798802233713e-11	143	54	12	0.2222222222222222	0.08391608391608392	GO:0007043	GO:BP	cell-cell junction assembly	16175	2647		0.08571428571428572	0.1111111111111111	143	16032	12	42	131	15990	16175	0.13192888965686214
M1	string	0	network_modules	29	TRUE	7.242331467082521e-11	193	54	13	0.24074074074074073	0.06735751295336788	GO:0098742	GO:BP	cell-cell adhesion via plasma-membrane adhesion molecules	16175	18867		0.11428571428571428	0.1388888888888889	193	15982	13	41	180	15941	16175	0.12196173257698671
M1	string	0	network_modules	29	TRUE	1.5944330738142539e-10	745	54	20	0.37037037037037035	0.026845637583892617	GO:0098609	GO:BP	cell-cell adhesion	16175	18805		0.14285714285714285	0.16666666666666666	745	15430	20	34	725	15396	16175	0.08954608731349026
M1	string	0	network_modules	29	TRUE	1.7710011187283233e-10	33	54	8	0.14814814814814814	0.24242424242424243	GO:0035633	GO:BP	maintenance of blood-brain barrier	16175	9129		0.17142857142857143	0.19444444444444445	33	16142	8	46	25	16096	16175	0.1874059709508992
M1	string	0	network_modules	29	TRUE	9.147765125286784e-9	52	54	8	0.14814814814814814	0.15384615384615385	GO:0007157	GO:BP	heterophilic cell-cell adhesion via plasma membrane cell adhesion molecules	16175	2721		0.2	0.2222222222222222	52	16123	8	46	44	16077	16175	0.1481797280963561
M1	string	0	network_modules	29	TRUE	5.219167352718735e-8	64	54	8	0.14814814814814814	0.125	GO:0070830	GO:BP	bicellular tight junction assembly	16175	16327		0.22857142857142856	0.25	64	16111	8	46	56	16065	16175	0.13293317502465798
M1	string	0	network_modules	29	TRUE	6.627363820626507e-8	39	54	7	0.12962962962962962	0.1794871794871795	GO:0045197	GO:BP	establishment or maintenance of epithelial cell apical/basal polarity	16175	11321		0.2571428571428571	0.2777777777777778	39	16136	7	47	32	16089	16175	0.15012921348054062
M1	string	0	network_modules	29	TRUE	1.2324528444254762e-7	71	54	8	0.14814814814814814	0.11267605633802817	GO:0043297	GO:BP	apical junction assembly	16175	10606		0.2857142857142857	0.3055555555555556	71	16104	8	46	63	16058	16175	0.12585866925351138
M1	string	0	network_modules	29	TRUE	1.3743982373286883e-7	43	54	7	0.12962962962962962	0.16279069767441862	GO:0035088	GO:BP	establishment or maintenance of apical/basal cell polarity	16175	8802		0.3142857142857143	0.3611111111111111	43	16132	7	47	36	16085	16175	0.142715811366067
M1	string	0	network_modules	29	TRUE	1.3743982373286883e-7	43	54	7	0.12962962962962962	0.16279069767441862	GO:0061245	GO:BP	establishment or maintenance of bipolar cell polarity	16175	15338		0.3142857142857143	0.3611111111111111	43	16132	7	47	36	16085	16175	0.142715811366067
M1	string	0	network_modules	29	TRUE	3.068011984127683e-7	170	54	10	0.18518518518518517	0.058823529411764705	GO:0007163	GO:BP	establishment or maintenance of cell polarity	16175	2727		0.37142857142857144	0.3888888888888889	170	16005	10	44	160	15961	16175	0.09913430754955974
M1	string	0	network_modules	29	TRUE	1.7607517450609958e-6	346	54	12	0.2222222222222222	0.03468208092485549	GO:0034329	GO:BP	cell junction assembly	16175	8571		0.4	0.4166666666666667	346	15829	12	42	334	15787	16175	0.08033624819253117
M1	string	0	network_modules	29	TRUE	2.197845917340706e-6	533	54	14	0.25925925925925924	0.02626641651031895	GO:0034330	GO:BP	cell junction organization	16175	8572		0.42857142857142855	0.4444444444444444	533	15642	14	40	519	15602	16175	0.0733725738298173
M1	string	0	network_modules	29	TRUE	2.5305211837747243e-6	152	54	9	0.16666666666666666	0.05921052631578947	GO:0060249	GO:BP	anatomical structure homeostasis	16175	14466		0.45714285714285713	0.5	152	16023	9	45	143	15978	16175	0.09433999186130254
M1	string	0	network_modules	29	TRUE	2.5305211837747243e-6	152	54	9	0.16666666666666666	0.05921052631578947	GO:0001894	GO:BP	tissue homeostasis	16175	519		0.45714285714285713	0.5	152	16023	9	45	143	15978	16175	0.09433999186130254
M1	string	0	network_modules	29	TRUE	2.8735504548459216e-6	114	39	8	0.20512820512820512	0.07017543859649122	KEGG:04670	KEGG	Leukocyte transendothelial migration	8484	343		0.5	0.6	114	8370	8	31	106	8339	8484	0.11314100654759301
M1	string	0	network_modules	29	TRUE	3.99643125470663e-6	109	54	8	0.14814814814814814	0.07339449541284404	GO:0030010	GO:BP	establishment of cell polarity	16175	6650		0.5142857142857142	0.5277777777777778	109	16066	8	46	101	16020	16175	0.10003596994180448
M1	string	0	network_modules	29	TRUE	5.838813727039598e-6	7	54	4	0.07407407407407407	0.5714285714285714	GO:0090557	GO:BP	establishment of endothelial intestinal barrier	16175	18351		0.5428571428571428	0.5555555555555556	7	16168	4	50	3	16118	16175	0.20492243159891727
M1	string	0	network_modules	29	TRUE	1.9584235420641637e-5	55	42	6	0.14285714285714285	0.10909090909090909	REAC:R-HSA-418990	REAC	Adherens junctions interactions	10916	121		0.8333333333333334	0.8571428571428571	55	10861	6	36	49	10825	10916	0.12097212290520877
M1	string	0	network_modules	29	TRUE	3.4629265746713355e-5	157	39	8	0.20512820512820512	0.050955414012738856	KEGG:04390	KEGG	Hippo signaling pathway	8484	310		0.75	0.8	157	8327	8	31	149	8296	8484	0.09410304784861918
M1	string	0	network_modules	29	TRUE	9.253212369758928e-5	63	54	6	0.1111111111111111	0.09523809523809523	GO:0007156	GO:BP	homophilic cell adhesion via plasma membrane adhesion molecules	16175	2720		0.5714285714285714	0.5833333333333334	63	16112	6	48	57	16064	16175	0.09962323416329044
M1	string	0	network_modules	29	TRUE	1.2279454391641678e-4	66	54	6	0.1111111111111111	0.09090909090909091	GO:1902414	GO:BP	protein localization to cell junction	16175	22265		0.6	0.6111111111111112	66	16109	6	48	60	16061	16175	0.09717341163483334
M1	string	0	network_modules	29	TRUE	2.4432326351775375e-4	19	42	4	0.09523809523809523	0.21052631578947367	REAC:R-HSA-2028269	REAC	Signaling by Hippo	10916	2259		1	1	19	10897	4	38	15	10859	10916	0.13940019271875287
M1	string	0	network_modules	29	TRUE	2.8623692361740645e-4	93	39	6	0.15384615384615385	0.06451612903225806	KEGG:04520	KEGG	Adherens junction	8484	316		1	1	93	8391	6	33	87	8358	8484	0.09325442421607616
M1	string	0	network_modules	29	TRUE	3.129877452883025e-4	40	54	5	0.09259259259259259	0.125	GO:0061028	GO:BP	establishment of endothelial barrier	16175	15145		0.6285714285714286	0.6388888888888888	40	16135	5	49	35	16086	16175	0.10501471313232984
M1	string	0	network_modules	29	TRUE	5.304201518073479e-4	5	54	3	0.05555555555555555	0.6	GO:1905605	GO:BP	positive regulation of blood-brain barrier permeability	16175	24763		0.6571428571428571	0.6666666666666666	5	16170	3	51	2	16119	16175	0.18189025798365738
M1	string	0	network_modules	29	TRUE	5.738460273139927e-4	45	54	5	0.09259259259259259	0.1111111111111111	GO:0001885	GO:BP	endothelial cell development	16175	512		0.6857142857142857	0.6944444444444444	45	16130	5	49	40	16081	16175	0.09868450291288697
M1	string	0	network_modules	29	TRUE	6.276810870008065e-4	19	54	4	0.07407407407407407	0.21052631578947367	GO:0150105	GO:BP	protein localization to cell-cell junction	16175	20144		0.7142857142857143	0.7222222222222222	19	16156	4	50	15	16106	16175	0.12317584250519291
M1	string	0	network_modules	29	TRUE	0.0010583317504518038	6	54	3	0.05555555555555555	0.5	GO:0002860	GO:BP	positive regulation of natural killer cell mediated cytotoxicity directed against tumor cell target	16175	1370		0.7428571428571429	0.7777777777777778	6	16169	3	51	3	16118	16175	0.16586164707534398
M1	string	0	network_modules	29	TRUE	0.0010583317504518038	6	54	3	0.05555555555555555	0.5	GO:0002857	GO:BP	positive regulation of natural killer cell mediated immune response to tumor cell	16175	1367		0.7428571428571429	0.7777777777777778	6	16169	3	51	3	16118	16175	0.16586164707534398
M1	string	0	network_modules	29	TRUE	0.0011758327593077002	22	54	4	0.07407407407407407	0.18181818181818182	GO:0016338	GO:BP	calcium-independent cell-cell adhesion via plasma membrane cell-adhesion molecules	16175	5213		0.8	0.8055555555555556	22	16153	4	50	18	16103	16175	0.11418918757727899
M1	string	0	network_modules	29	TRUE	0.001419859010945228	23	54	4	0.07407407407407407	0.17391304347826086	GO:0045954	GO:BP	positive regulation of natural killer cell mediated cytotoxicity	16175	11746		0.8285714285714286	0.8333333333333334	23	16152	4	50	19	16102	16175	0.11158772937064303
M1	string	0	network_modules	29	TRUE	0.0018477014529953864	7	54	3	0.05555555555555555	0.42857142857142855	GO:1905603	GO:BP	regulation of blood-brain barrier permeability	16175	24761		0.8571428571428571	0.8611111111111112	7	16168	3	51	4	16117	16175	0.1533907576597909
M1	string	0	network_modules	29	TRUE	0.0027863526159391206	27	54	4	0.07407407407407407	0.14814814814814814	GO:0002717	GO:BP	positive regulation of natural killer cell mediated immunity	16175	1235		0.8857142857142857	0.8888888888888888	27	16148	4	50	23	16098	16175	0.10265295946117724
M1	string	0	network_modules	29	TRUE	0.002949333076835855	8	54	3	0.05555555555555555	0.375	GO:0002858	GO:BP	regulation of natural killer cell mediated cytotoxicity directed against tumor cell target	16175	1368		0.9142857142857143	0.9444444444444444	8	16167	3	51	5	16116	16175	0.1433274213078
M1	string	0	network_modules	29	TRUE	0.002949333076835855	8	54	3	0.05555555555555555	0.375	GO:0002855	GO:BP	regulation of natural killer cell mediated immune response to tumor cell	16175	1365		0.9142857142857143	0.9444444444444444	8	16167	3	51	5	16116	16175	0.1433274213078
M1	string	0	network_modules	29	TRUE	0.004413541670457669	9	54	3	0.05555555555555555	0.3333333333333333	GO:0002420	GO:BP	natural killer cell mediated cytotoxicity directed against tumor cell target	16175	944		0.9714285714285714	1	9	16166	3	51	6	16115	16175	0.13498283570613734
M1	string	0	network_modules	29	TRUE	0.004413541670457669	9	54	3	0.05555555555555555	0.3333333333333333	GO:0002423	GO:BP	natural killer cell mediated immune response to tumor cell	16175	946		0.9714285714285714	1	9	16166	3	51	6	16115	16175	0.13498283570613734
M1	string	0	network_modules	30	TRUE	2.9109441121290494e-8	449	37	14	0.3783783783783784	0.031180400890868598	REAC:R-HSA-9012999	REAC	RHO GTPase cycle	10916	1847		0	0.25	449	10467	14	23	435	10444	10916	0.09903359585815134
M1	string	0	network_modules	30	TRUE	1.9294695911736356e-6	43	37	6	0.16216216216216217	0.13953488372093023	REAC:R-HSA-9696270	REAC	RND2 GTPase cycle	10916	1906		0.3333333333333333	0.5	43	10873	6	31	37	10842	10916	0.14730943607524158
M1	string	0	network_modules	30	TRUE	1.5523854242347222e-4	37	49	5	0.10204081632653061	0.13513513513513514	GO:0000266	GO:BP	mitochondrial fission	16175	72		0	0.5	37	16138	5	44	32	16094	16175	0.11510142780403745
M1	string	0	network_modules	30	TRUE	1.958122712031527e-4	149	37	7	0.1891891891891892	0.04697986577181208	REAC:R-HSA-8980692	REAC	RHOA GTPase cycle	10916	1859		0.6666666666666666	0.75	149	10767	7	30	142	10737	10916	0.08822755997867693
M1	string	0	network_modules	30	TRUE	4.3483403690172077e-4	103	23	5	0.21739130434782608	0.04854368932038835	KEGG:04137	KEGG	Mitophagy - animal	8484	274		0	0.5	103	8381	5	18	98	8363	8484	0.09771743664016802
M1	string	0	network_modules	30	TRUE	0.003987125058610708	42	37	4	0.10810810810810811	0.09523809523809523	REAC:R-HSA-9696264	REAC	RND3 GTPase cycle	10916	1907		1	1	42	10874	4	33	38	10841	10916	0.09821336281129776
M1	string	0	network_modules	30	TRUE	0.004646119041411585	168	23	5	0.21739130434782608	0.02976190476190476	KEGG:04141	KEGG	Protein processing in endoplasmic reticulum	8484	278		1	1	168	8316	5	18	163	8298	8484	0.07394440605025407
M1	string	0	network_modules	30	TRUE	0.006876493009225105	808	49	12	0.24489795918367346	0.01485148514851485	GO:0033365	GO:BP	protein localization to organelle	16175	8175		1	1	808	15367	12	37	796	15330	16175	0.049327530882444307
M1	string	0	network_modules	31	TRUE	1.2045353832073575e-100	158	56	52	0.9285714285714286	0.3291139240506329	GO:0140053	GO:BP	mitochondrial gene expression	16175	19653		0	0.2	158	16017	52	4	106	16013	16175	0.5506462108615116
M1	string	0	network_modules	31	TRUE	3.54522255941412e-100	127	56	50	0.8928571428571429	0.3937007874015748	GO:0032543	GO:BP	mitochondrial translation	16175	7635		0.25	0.4	127	16048	50	6	77	16042	16175	0.5910210054344206
M1	string	0	network_modules	31	TRUE	4.461828594758433e-98	87	51	47	0.9215686274509803	0.5402298850574713	REAC:R-HSA-5389840	REAC	Mitochondrial translation elongation	10916	1474		0	0.2	87	10829	47	4	40	10825	10916	0.7039396171555387
M1	string	0	network_modules	31	TRUE	3.6230376401660237e-96	93	51	47	0.9215686274509803	0.5053763440860215	REAC:R-HSA-5368287	REAC	Mitochondrial translation	10916	1473		0.25	0.4	93	10823	47	4	46	10819	10916	0.6806322801540899
M1	string	0	network_modules	31	TRUE	2.1883458973322662e-91	87	51	45	0.8823529411764706	0.5172413793103449	REAC:R-HSA-5368286	REAC	Mitochondrial translation initiation	10916	1475		0.5	0.8	87	10829	45	6	42	10823	10916	0.6737234227418079
M1	string	0	network_modules	31	TRUE	2.1883458973322662e-91	87	51	45	0.8823529411764706	0.5172413793103449	REAC:R-HSA-5419276	REAC	Mitochondrial translation termination	10916	1476		0.5	0.8	87	10829	45	6	42	10823	10916	0.6737234227418079
M1	string	0	network_modules	31	TRUE	2.383301207059419e-68	292	51	47	0.9215686274509803	0.16095890410958905	REAC:R-HSA-72766	REAC	Translation	10916	2565		1	1	292	10624	47	4	245	10620	10916	0.379956118655021
M1	string	0	network_modules	31	TRUE	2.652522183846452e-66	566	56	51	0.9107142857142857	0.09010600706713781	GO:0006412	GO:BP	translation	16175	2170		0.5	0.6	566	15609	51	5	515	15604	16175	0.2808922561013488
M1	string	0	network_modules	31	TRUE	1.9628736466082582e-44	153	29	27	0.9310344827586207	0.17647058823529413	KEGG:03010	KEGG	Ribosome	8484	208		NA	1	153	8331	27	2	126	8329	8484	0.40180894704951686
M1	string	0	network_modules	31	TRUE	4.383630003839834e-5	27	56	5	0.08928571428571429	0.18518518518518517	GO:0062125	GO:BP	regulation of mitochondrial gene expression	16175	15832		0.75	0.8	27	16148	5	51	22	16097	16175	0.1265067686171573
M1	string	0	network_modules	31	TRUE	0.0018058444251513447	24	56	4	0.07142857142857142	0.16666666666666666	GO:0070129	GO:BP	regulation of mitochondrial translation	16175	15928		1	1	24	16151	4	52	20	16099	16175	0.1071073710203819
M1	string	0	network_modules	32	TRUE	7.164810713276686e-17	9	50	8	0.16	0.8888888888888888	GO:0090522	GO:BP	vesicle tethering involved in exocytosis	16175	18337		0	0.034482758620689655	9	16166	8	42	1	16124	16175	0.37649909854359587
M1	string	0	network_modules	32	TRUE	1.0750605173893487e-13	9	50	7	0.14	0.7777777777777778	GO:0000301	GO:BP	retrograde transport, vesicle recycling within Golgi	16175	87		0.03571428571428571	0.06896551724137931	9	16166	7	43	2	16123	16175	0.3292724764502057
M1	string	0	network_modules	32	TRUE	1.6497835656985908e-12	25	35	8	0.22857142857142856	0.32	REAC:R-HSA-264876	REAC	Insulin processing	10916	1209		0	0.08333333333333333	25	10891	8	27	17	10864	10916	0.2684774149958385
M1	string	0	network_modules	32	TRUE	1.8347125579972074e-12	36	50	9	0.18	0.25	GO:0006904	GO:BP	vesicle docking involved in exocytosis	16175	2556		0.07142857142857142	0.10344827586206896	36	16139	9	41	27	16098	16175	0.21006754078046344
M1	string	0	network_modules	32	TRUE	5.968610603015124e-11	31	50	8	0.16	0.25806451612903225	GO:0099022	GO:BP	vesicle tethering	16175	19011		0.10714285714285714	0.13793103448275862	31	16144	8	42	23	16102	16175	0.20127018564614674
M1	string	0	network_modules	32	TRUE	6.951796879727909e-11	21	35	7	0.2	0.3333333333333333	REAC:R-HSA-5620916	REAC	VxPx cargo-targeting to cilium	10916	2667		0.09090909090909091	0.16666666666666666	21	10895	7	28	14	10867	10916	0.2563729586648483
M1	string	0	network_modules	32	TRUE	1.1864458898315751e-10	55	50	9	0.18	0.16363636363636364	GO:0048278	GO:BP	vesicle docking	16175	12620		0.14285714285714285	0.1724137931034483	55	16120	9	41	46	16079	16175	0.16892950342213595
M1	string	0	network_modules	32	TRUE	1.4104060453628567e-10	56	50	9	0.18	0.16071428571428573	GO:0140029	GO:BP	exocytic process	16175	19642		0.17857142857142858	0.20689655172413793	56	16119	9	41	47	16078	16175	0.16736099295426782
M1	string	0	network_modules	32	TRUE	1.7648884916829595e-10	284	50	14	0.28	0.04929577464788732	GO:0048193	GO:BP	Golgi vesicle transport	16175	12570		0.21428571428571427	0.2413793103448276	284	15891	14	36	270	15855	16175	0.11126999057021737
M1	string	0	network_modules	32	TRUE	2.913259858054494e-10	72	35	9	0.2571428571428571	0.125	REAC:R-HSA-1445148	REAC	Translocation of SLC2A4 (GLUT4) to the plasma membrane	10916	2578		0.18181818181818182	0.25	72	10844	9	26	63	10818	10916	0.17554618999706514
M1	string	0	network_modules	32	TRUE	1.172531973333499e-9	70	50	9	0.18	0.12857142857142856	GO:0140056	GO:BP	organelle localization by membrane tethering	16175	19654		0.25	0.27586206896551724	70	16105	9	41	61	16064	16175	0.14902303922958804
M1	string	0	network_modules	32	TRUE	1.3012101779676353e-9	44	50	8	0.16	0.18181818181818182	GO:0090148	GO:BP	membrane fission	16175	18057		0.2857142857142857	0.3103448275862069	44	16131	8	42	36	16089	16175	0.16814937741567734
M1	string	0	network_modules	32	TRUE	4.086419197138416e-9	80	50	9	0.18	0.1125	GO:0022406	GO:BP	membrane docking	16175	6597		0.32142857142857145	0.3448275862068966	80	16095	9	41	71	16054	16175	0.13895085468771567
M1	string	0	network_modules	32	TRUE	1.5155821236499433e-8	34	50	7	0.14	0.20588235294117646	GO:0006891	GO:BP	intra-Golgi vesicle-mediated transport	16175	2546		0.35714285714285715	0.3793103448275862	34	16141	7	43	27	16098	16175	0.1676612465614472
M1	string	0	network_modules	32	TRUE	1.5724758065647954e-8	59	50	8	0.16	0.13559322033898305	GO:0006903	GO:BP	vesicle targeting	16175	2555		0.39285714285714285	0.41379310344827586	59	16116	8	42	51	16074	16175	0.14442066309189647
M1	string	0	network_modules	32	TRUE	2.175403706233039e-8	44	35	7	0.2	0.1590909090909091	REAC:R-HSA-6811438	REAC	Intra-Golgi traffic	10916	1263		0.2727272727272727	0.3333333333333333	44	10872	7	28	37	10844	10916	0.1754163002033745
M1	string	0	network_modules	32	TRUE	4.821843312046074e-8	49	35	7	0.2	0.14285714285714285	REAC:R-HSA-6811440	REAC	Retrograde transport at the Trans-Golgi-Network	10916	2096		0.36363636363636365	0.4166666666666667	49	10867	7	28	42	10839	10916	0.16587535259998176
M1	string	0	network_modules	32	TRUE	6.469570561640254e-8	51	35	7	0.2	0.13725490196078433	REAC:R-HSA-5620920	REAC	Cargo trafficking to the periciliary membrane	10916	310		0.45454545454545453	0.5	51	10865	7	28	44	10837	10916	0.1624529501911071
M1	string	0	network_modules	32	TRUE	8.531028674871453e-8	88	35	8	0.22857142857142856	0.09090909090909091	REAC:R-HSA-2980736	REAC	Peptide hormone metabolism	10916	1725		0.5454545454545454	0.5833333333333334	88	10828	8	27	80	10801	10916	0.13985426424089661
M1	string	0	network_modules	32	TRUE	2.6458280619106016e-7	83	50	8	0.16	0.0963855421686747	GO:0000281	GO:BP	mitotic cytokinesis	16175	79		0.42857142857142855	0.4482758620689655	83	16092	8	42	75	16050	16175	0.12069764949256746
M1	string	0	network_modules	32	TRUE	2.228461676360565e-6	108	50	8	0.16	0.07407407407407407	GO:0061640	GO:BP	cytoskeleton-dependent cytokinesis	16175	15599		0.4642857142857143	0.4827586206896552	108	16067	8	42	100	16025	16175	0.10483530107001687
M1	string	0	network_modules	32	TRUE	5.664394821157009e-6	178	50	9	0.18	0.05056179775280899	GO:0051650	GO:BP	establishment of vesicle localization	16175	13863		0.5	0.5172413793103449	178	15997	9	41	169	15956	16175	0.09020382322280347
M1	string	0	network_modules	32	TRUE	8.335006380585282e-6	186	50	9	0.18	0.04838709677419355	GO:0051648	GO:BP	vesicle localization	16175	13861		0.5357142857142857	0.5517241379310345	186	15989	9	41	177	15948	16175	0.08800638935235398
M1	string	0	network_modules	32	TRUE	9.198158226141796e-6	102	35	7	0.2	0.06862745098039216	REAC:R-HSA-6807878	REAC	COPI-mediated anterograde transport	10916	279		0.6363636363636364	0.6666666666666666	102	10814	7	28	95	10786	10916	0.1123880576955233
M1	string	0	network_modules	32	TRUE	1.0882396006213671e-5	263	50	10	0.2	0.03802281368821293	GO:0006887	GO:BP	exocytosis	16175	2543		0.5714285714285714	0.5862068965517241	263	15912	10	40	253	15872	16175	0.08089909928719889
M1	string	0	network_modules	32	TRUE	3.551576892104668e-5	57	50	6	0.12	0.10526315789473684	GO:0006893	GO:BP	Golgi to plasma membrane transport	16175	2548		0.6071428571428571	0.6206896551724138	57	16118	6	44	51	16074	16175	0.10945183206300065
M1	string	0	network_modules	32	TRUE	3.8663695860577336e-5	100	50	7	0.14	0.07	GO:0006892	GO:BP	post-Golgi vesicle-mediated transport	16175	2547		0.6428571428571429	0.6551724137931034	100	16075	7	43	93	16032	16175	0.09506425298575405
M1	string	0	network_modules	32	TRUE	1.005104167297801e-4	175	50	8	0.16	0.045714285714285714	GO:0000910	GO:BP	cytokinesis	16175	243		0.6785714285714286	0.6896551724137931	175	16000	8	42	167	15958	16175	0.08029961198843243
M1	string	0	network_modules	32	TRUE	1.6424209908562625e-4	155	35	7	0.2	0.04516129032258064	REAC:R-HSA-199977	REAC	ER to Golgi Anterograde Transport	10916	823		0.7272727272727273	0.75	155	10761	7	28	148	10733	10916	0.0890672883875729
M1	string	0	network_modules	32	TRUE	3.407490763542403e-4	137	50	7	0.14	0.051094890510948905	GO:0098876	GO:BP	vesicle-mediated transport to the plasma membrane	16175	18924		0.7142857142857143	0.7241379310344828	137	16038	7	43	130	15995	16175	0.07992254800001915
M1	string	0	network_modules	32	TRUE	4.7881658398584006e-4	144	50	7	0.14	0.04861111111111111	GO:0007030	GO:BP	Golgi organization	16175	2635		0.75	0.7586206896551724	144	16031	7	43	137	15988	16175	0.0777162549295057
M1	string	0	network_modules	32	TRUE	5.614737096563838e-4	186	35	7	0.2	0.03763440860215054	REAC:R-HSA-948021	REAC	Transport to the Golgi and subsequent modification	10916	2604		0.8181818181818182	0.8333333333333334	186	10730	7	28	179	10702	10916	0.08017977649811718
M1	string	0	network_modules	32	TRUE	9.113345260066291e-4	200	35	7	0.2	0.035	REAC:R-HSA-5617833	REAC	Cilium Assembly	10916	361		0.9090909090909091	0.9166666666666666	200	10716	7	28	193	10688	10916	0.0768306983100068
M1	string	0	network_modules	32	TRUE	9.736868974397859e-4	202	35	7	0.2	0.034653465346534656	REAC:R-HSA-6811442	REAC	Intra-Golgi and retrograde Golgi-to-ER traffic	10916	1262		1	1	202	10714	7	28	195	10686	10916	0.07637943309041938
M1	string	0	network_modules	32	TRUE	0.0021765326744188785	583	50	11	0.22	0.018867924528301886	GO:0032940	GO:BP	secretion by cell	16175	7926		0.7857142857142857	0.7931034482758621	583	15592	11	39	572	15553	16175	0.05495534070333416
M1	string	0	network_modules	32	TRUE	0.002383426090907125	265	50	8	0.16	0.03018867924528302	GO:0051301	GO:BP	cell division	16175	13632		0.8214285714285714	0.8275862068965517	265	15910	8	42	257	15868	16175	0.06299793637959515
M1	string	0	network_modules	32	TRUE	0.004980683115919833	204	50	7	0.14	0.03431372549019608	GO:0070085	GO:BP	glycosylation	16175	15903		0.8571428571428571	0.8620689655172413	204	15971	7	43	197	15928	16175	0.06356625427636646
M1	string	0	network_modules	32	TRUE	0.005887783074067901	646	50	11	0.22	0.017027863777089782	GO:0140352	GO:BP	export from cell	16175	19748		0.8928571428571429	0.896551724137931	646	15529	11	39	635	15490	16175	0.051205082544312726
M1	string	0	network_modules	32	TRUE	0.005919589749276561	519	50	10	0.2	0.019267822736030827	GO:0051640	GO:BP	organelle localization	16175	13853		0.9285714285714286	0.9310344827586207	519	15656	10	40	509	15616	16175	0.05305677164725151
M1	string	0	network_modules	32	TRUE	0.006156015063863655	649	50	11	0.22	0.01694915254237288	GO:0046903	GO:BP	secretion	16175	12430		0.9642857142857143	0.9655172413793104	649	15526	11	39	638	15487	16175	0.05103890668844084
M1	string	0	network_modules	32	TRUE	0.00680725712714779	410	50	9	0.18	0.02195121951219512	GO:0051656	GO:BP	establishment of organelle localization	16175	13869		1	1	410	15765	9	41	401	15724	16175	0.054789423634333936
M1	string	0	network_modules	33	TRUE	3.824985874285488e-32	42	53	18	0.33962264150943394	0.42857142857142855	GO:0007007	GO:BP	inner mitochondrial membrane organization	16175	2619		0	0.02564102564102564	42	16133	18	35	24	16098	16175	0.3797117299888665
M1	string	0	network_modules	33	TRUE	2.1880289061161943e-29	364	53	28	0.5283018867924528	0.07692307692307693	GO:0007005	GO:BP	mitochondrion organization	16175	2617		0.02631578947368421	0.05128205128205128	364	15811	28	25	336	15786	16175	0.1955327606282803
M1	string	0	network_modules	33	TRUE	7.657411605739123e-29	95	53	20	0.37735849056603776	0.21052631578947367	GO:0007006	GO:BP	mitochondrial membrane organization	16175	2618		0.05263157894736842	0.07692307692307693	95	16080	20	33	75	16047	16175	0.2787465438529518
M1	string	0	network_modules	33	TRUE	2.2899221295683444e-22	156	53	19	0.3584905660377358	0.12179487179487179	GO:0006839	GO:BP	mitochondrial transport	16175	2508		0.07894736842105263	0.10256410256410256	156	16019	19	34	137	15985	16175	0.20465698851285866
M1	string	0	network_modules	33	TRUE	4.937446253328283e-21	117	53	17	0.32075471698113206	0.1452991452991453	GO:0070585	GO:BP	protein localization to mitochondrion	16175	16190		0.10526315789473684	0.1282051282051282	117	16058	17	36	100	16022	16175	0.21212956619273252
M1	string	0	network_modules	33	TRUE	2.104129363041322e-20	99	53	16	0.3018867924528302	0.16161616161616163	GO:0006626	GO:BP	protein targeting to mitochondrion	16175	2340		0.13157894736842105	0.15384615384615385	99	16076	16	37	83	16039	16175	0.21742764609913803
M1	string	0	network_modules	33	TRUE	8.173887437705893e-20	65	39	14	0.358974358974359	0.2153846153846154	REAC:R-HSA-1268020	REAC	Mitochondrial protein import	10916	1468		0	0.09090909090909091	65	10851	14	25	51	10826	10916	0.2747570007005302
M1	string	0	network_modules	33	TRUE	1.2687107457623012e-19	110	53	16	0.3018867924528302	0.14545454545454545	GO:0072655	GO:BP	establishment of protein localization to mitochondrion	16175	17476		0.15789473684210525	0.1794871794871795	110	16065	16	37	94	16028	16175	0.2058661392728454
M1	string	0	network_modules	33	TRUE	2.952368579377815e-17	32	53	11	0.20754716981132076	0.34375	GO:0090151	GO:BP	establishment of protein localization to mitochondrial membrane	16175	18060		0.18421052631578946	0.20512820512820512	32	16143	11	42	21	16101	16175	0.26525456763136407
M1	string	0	network_modules	33	TRUE	4.199366912758042e-14	158	39	14	0.358974358974359	0.08860759493670886	REAC:R-HSA-9609507	REAC	Protein localization	10916	1815		0.1	0.18181818181818182	158	10758	14	25	144	10733	10916	0.17271753129131426
M1	string	0	network_modules	33	TRUE	2.574002740678599e-13	31	39	9	0.23076923076923078	0.2903225806451613	REAC:R-HSA-8949613	REAC	Cristae formation	10916	414		0.2	0.2727272727272727	31	10885	9	30	22	10855	10916	0.2564758505920049
M1	string	0	network_modules	33	TRUE	2.8381239189106253e-13	17	53	8	0.1509433962264151	0.47058823529411764	GO:0042407	GO:BP	cristae formation	16175	10152		0.21052631578947367	0.23076923076923078	17	16158	8	45	9	16113	16175	0.26523699084849184
M1	string	0	network_modules	33	TRUE	4.1589146247190716e-13	275	53	16	0.3018867924528302	0.05818181818181818	GO:0006605	GO:BP	protein targeting	16175	2322		0.23684210526315788	0.2564102564102564	275	15900	16	37	259	15863	16175	0.12635074761943196
M1	string	0	network_modules	33	TRUE	2.432441471895326e-12	373	53	17	0.32075471698113206	0.045576407506702415	GO:0072594	GO:BP	establishment of protein localization to organelle	16175	17458		0.2631578947368421	0.28205128205128205	373	15802	17	36	356	15766	16175	0.11371900281489368
M1	string	0	network_modules	33	TRUE	1.010031939885471e-11	657	53	20	0.37735849056603776	0.030441400304414	GO:0061024	GO:BP	membrane organization	16175	15141		0.2894736842105263	0.3076923076923077	657	15518	20	33	637	15485	16175	0.09780639245712551
M1	string	0	network_modules	33	TRUE	3.3787870355345456e-10	88	53	10	0.18867924528301888	0.11363636363636363	GO:1990542	GO:BP	mitochondrial transmembrane transport	16175	25201		0.3157894736842105	0.3333333333333333	88	16087	10	43	78	16044	16175	0.1428272981868563
M1	string	0	network_modules	33	TRUE	2.434148914322844e-9	13	53	6	0.11320754716981132	0.46153846153846156	GO:0045039	GO:BP	protein insertion into mitochondrial inner membrane	16175	11242		0.34210526315789475	0.358974358974359	13	16162	6	47	7	16115	16175	0.2274231537426375
M1	string	0	network_modules	33	TRUE	7.064266673018447e-9	15	53	6	0.11320754716981132	0.4	GO:0045040	GO:BP	protein insertion into mitochondrial outer membrane	16175	11243		0.3684210526315789	0.41025641025641024	15	16160	6	47	9	16113	16175	0.2114996229089592
M1	string	0	network_modules	33	TRUE	7.064266673018447e-9	15	53	6	0.11320754716981132	0.4	GO:0007008	GO:BP	outer mitochondrial membrane organization	16175	2620		0.3684210526315789	0.41025641025641024	15	16160	6	47	9	16113	16175	0.2114996229089592
M1	string	0	network_modules	33	TRUE	9.531344231891259e-9	92	39	9	0.23076923076923078	0.09782608695652174	REAC:R-HSA-1592230	REAC	Mitochondrial biogenesis	10916	1464		0.3	0.36363636363636365	92	10824	9	30	83	10794	10916	0.14563758701041762
M1	string	0	network_modules	33	TRUE	2.996856288249411e-8	103	26	8	0.3076923076923077	0.07766990291262135	KEGG:04137	KEGG	Mitophagy - animal	8484	274		0	0.25	103	8381	8	18	95	8363	8484	0.14963065638873682
M1	string	0	network_modules	33	TRUE	4.611283906642446e-8	99	53	9	0.16981132075471697	0.09090909090909091	GO:0022904	GO:BP	respiratory electron transport chain	16175	6631		0.42105263157894735	0.4358974358974359	99	16076	9	44	90	16032	16175	0.1203345522308939
M1	string	0	network_modules	33	TRUE	9.365142721415061e-8	107	53	9	0.16981132075471697	0.08411214953271028	GO:0022900	GO:BP	electron transport chain	16175	6630		0.4473684210526316	0.46153846153846156	107	16068	9	44	98	16024	16175	0.11542767235248189
M1	string	0	network_modules	33	TRUE	3.785110784805279e-7	12	53	5	0.09433962264150944	0.4166666666666667	GO:0034982	GO:BP	mitochondrial protein processing	16175	8747		0.47368421052631576	0.48717948717948717	12	16163	5	48	7	16115	16175	0.1970999457921303
M1	string	0	network_modules	33	TRUE	4.016374311612925e-7	239	53	11	0.20754716981132076	0.04602510460251046	GO:0090150	GO:BP	establishment of protein localization to membrane	16175	18059		0.5	0.5128205128205128	239	15936	11	42	228	15894	16175	0.09160654173456041
M1	string	0	network_modules	33	TRUE	5.889271211839182e-7	808	53	17	0.32075471698113206	0.02103960396039604	GO:0033365	GO:BP	protein localization to organelle	16175	8175		0.5263157894736842	0.5384615384615384	808	15367	17	36	791	15331	16175	0.0712726553901277
M1	string	0	network_modules	33	TRUE	7.28430736623531e-7	16	39	5	0.1282051282051282	0.3125	REAC:R-HSA-8949664	REAC	Processing of SMDT1	10916	1800		0.4	0.45454545454545453	16	10900	5	34	11	10866	10916	0.1983716647263259
M1	string	0	network_modules	33	TRUE	3.679255031678805e-6	38	53	6	0.11320754716981132	0.15789473684210525	GO:0017004	GO:BP	cytochrome complex assembly	16175	5266		0.5526315789473685	0.5641025641025641	38	16137	6	47	32	16090	16175	0.13129178649791007
M1	string	0	network_modules	33	TRUE	5.461730082100257e-6	19	53	5	0.09433962264150944	0.2631578947368421	GO:0006123	GO:BP	mitochondrial electron transport, cytochrome c to oxygen	16175	1981		0.5789473684210527	0.5897435897435898	19	16156	5	48	14	16108	16175	0.15594867649109104
M1	string	0	network_modules	33	TRUE	5.510268708420185e-6	23	39	5	0.1282051282051282	0.21739130434782608	REAC:R-HSA-8949215	REAC	Mitochondrial calcium ion transport	10916	1465		0.5	0.5454545454545454	23	10893	5	34	18	10859	10916	0.1646691486508669
M1	string	0	network_modules	33	TRUE	1.0667279420713377e-5	45	53	6	0.11320754716981132	0.13333333333333333	GO:0170036	GO:BP	import into the mitochondrion	16175	20284		0.6052631578947368	0.6153846153846154	45	16130	6	47	39	16083	16175	0.12020391298535815
M1	string	0	network_modules	33	TRUE	1.4241028403310038e-5	188	53	9	0.16981132075471697	0.047872340425531915	GO:0045333	GO:BP	cellular respiration	16175	11360		0.631578947368421	0.6410256410256411	188	15987	9	44	179	15943	16175	0.08462235612753453
M1	string	0	network_modules	33	TRUE	2.5028815745504506e-5	103	39	7	0.1794871794871795	0.06796116504854369	REAC:R-HSA-611105	REAC	Respiratory electron transport	10916	2081		0.6	0.6363636363636364	103	10813	7	32	96	10781	10916	0.10532464180431803
M1	string	0	network_modules	33	TRUE	2.8422130185907037e-5	62	39	6	0.15384615384615385	0.0967741935483871	REAC:R-HSA-9707564	REAC	Cytoprotection by HMOX1	10916	426		0.7	0.7272727272727273	62	10854	6	33	56	10821	10916	0.11805932440683091
M1	string	0	network_modules	33	TRUE	1.4637858534272976e-4	524	53	12	0.22641509433962265	0.022900763358778626	GO:0006886	GO:BP	intracellular protein transport	16175	2542		0.6578947368421053	0.6666666666666666	524	15651	12	41	512	15610	16175	0.0628320577342214
M1	string	0	network_modules	33	TRUE	1.774834506751146e-4	84	39	6	0.15384615384615385	0.07142857142857142	REAC:R-HSA-5628897	REAC	TP53 Regulates Metabolic Genes	10916	2452		0.8	0.8181818181818182	84	10832	6	33	78	10799	10916	0.10014958875615167
M1	string	0	network_modules	33	TRUE	1.7857272916396266e-4	252	53	9	0.16981132075471697	0.03571428571428571	GO:0015980	GO:BP	energy derivation by oxidation of organic compounds	16175	5060		0.6842105263157895	0.6923076923076923	252	15923	9	44	243	15879	16175	0.07140584404080241
M1	string	0	network_modules	33	TRUE	2.4964555284251607e-4	292	39	9	0.23076923076923078	0.030821917808219176	REAC:R-HSA-1852241	REAC	Organelle biogenesis and maintenance	10916	1646		0.9	0.9090909090909091	292	10624	9	30	283	10594	10916	0.07571422830765837
M1	string	0	network_modules	33	TRUE	2.779331667648438e-4	127	53	7	0.1320754716981132	0.05511811023622047	GO:0006119	GO:BP	oxidative phosphorylation	16175	1977		0.7105263157894737	0.717948717948718	127	16048	7	46	120	16002	16175	0.0806984936835664
M1	string	0	network_modules	33	TRUE	2.825994315056153e-4	232	26	7	0.2692307692307692	0.03017241379310345	KEGG:04714	KEGG	Thermogenesis	8484	349		0.3333333333333333	0.5	232	8252	7	19	225	8233	8484	0.08223167704076689
M1	string	0	network_modules	33	TRUE	3.781429318825189e-4	198	53	8	0.1509433962264151	0.04040404040404041	GO:0016485	GO:BP	protein processing	16175	5233		0.7368421052631579	0.7435897435897436	198	15977	8	45	190	15932	16175	0.07232295522325939
M1	string	0	network_modules	33	TRUE	4.1815705304012974e-4	82	53	6	0.11320754716981132	0.07317073170731707	GO:0019646	GO:BP	aerobic electron transport chain	16175	5967		0.7631578947368421	0.7692307692307693	82	16093	6	47	76	16046	16175	0.08730229256882287
M1	string	0	network_modules	33	TRUE	6.375495923982966e-4	88	53	6	0.11320754716981132	0.06818181818181818	GO:0042773	GO:BP	ATP synthesis coupled electron transport	16175	10358		0.7894736842105263	0.8205128205128205	88	16087	6	47	82	16040	16175	0.08400011949053962
M1	string	0	network_modules	33	TRUE	6.375495923982966e-4	88	53	6	0.11320754716981132	0.06818181818181818	GO:0042775	GO:BP	mitochondrial ATP synthesis coupled electron transport	16175	10360		0.7894736842105263	0.8205128205128205	88	16087	6	47	82	16040	16175	0.08400011949053962
M1	string	0	network_modules	33	TRUE	8.781109692814948e-4	504	53	11	0.20754716981132076	0.021825396825396824	GO:0072657	GO:BP	protein localization to membrane	16175	17478		0.8421052631578947	0.8461538461538461	504	15671	11	42	493	15629	16175	0.05820738823823372
M1	string	0	network_modules	33	TRUE	9.992434267794153e-4	177	39	7	0.1794871794871795	0.03954802259887006	REAC:R-HSA-1428517	REAC	Aerobic respiration and respiratory electron transport	10916	127		1	1	177	10739	7	32	170	10707	10916	0.07740795930651477
M1	string	0	network_modules	33	TRUE	0.0011367141443790719	97	53	6	0.11320754716981132	0.061855670103092786	GO:0033108	GO:BP	mitochondrial respiratory chain complex assembly	16175	8042		0.868421052631579	0.8717948717948718	97	16078	6	47	91	16031	16175	0.07961754249501275
M1	string	0	network_modules	33	TRUE	0.0014519909098821844	162	53	7	0.1320754716981132	0.043209876543209874	GO:0009060	GO:BP	aerobic respiration	16175	3236		0.8947368421052632	0.8974358974358975	162	16013	7	46	155	15967	16175	0.07028332971745631
M1	string	0	network_modules	33	TRUE	0.0029456048643369433	134	26	5	0.19230769230769232	0.03731343283582089	KEGG:00190	KEGG	Oxidative phosphorylation	8484	18		0.6666666666666666	0.75	134	8350	5	21	129	8329	8484	0.07849376882172526
M1	string	0	network_modules	33	TRUE	0.0031000220078105374	28	53	4	0.07547169811320754	0.14285714285714285	GO:0008535	GO:BP	respiratory chain complex IV assembly	16175	3189		0.9210526315789473	0.9230769230769231	28	16147	4	49	24	16098	16175	0.10170789846625296
M1	string	0	network_modules	33	TRUE	0.0035873190167149114	29	53	4	0.07547169811320754	0.13793103448275862	GO:0008053	GO:BP	mitochondrial fusion	16175	3106		0.9473684210526315	0.9487179487179487	29	16146	4	49	25	16097	16175	0.09985823438090378
M1	string	0	network_modules	33	TRUE	0.00437090789432671	594	53	11	0.20754716981132076	0.018518518518518517	GO:0051668	GO:BP	localization within membrane	16175	13880		0.9736842105263158	0.9743589743589743	594	15581	11	42	583	15539	16175	0.052075126989081025
M1	string	0	network_modules	33	TRUE	0.004629454506243151	372	53	9	0.16981132075471697	0.024193548387096774	GO:0006091	GO:BP	generation of precursor metabolites and energy	16175	1954		1	1	372	15803	9	44	363	15759	16175	0.05615593253123158
M1	string	0	network_modules	33	TRUE	0.00832176907870453	87	26	4	0.15384615384615385	0.04597701149425287	KEGG:04260	KEGG	Cardiac muscle contraction	8484	296		1	1	87	8397	4	22	83	8375	8484	0.07902430683415375
M1	string	0	network_modules	34	TRUE	1.9126669031578446e-4	4	50	3	0.06	0.75	GO:0006556	GO:BP	S-adenosylmethionine biosynthetic process	16175	2276		0	0.5	4	16171	3	47	1	16124	16175	0.21161115842339367
M1	string	0	network_modules	34	TRUE	2.726258709446465e-4	153	25	6	0.24	0.0392156862745098	KEGG:01240	KEGG	Biosynthesis of cofactors	8484	190		0	0.25	153	8331	6	19	147	8312	8484	0.09067831262229724
M1	string	0	network_modules	34	TRUE	2.78225687646457e-4	215	39	8	0.20512820512820512	0.037209302325581395	REAC:R-HSA-211859	REAC	Biological oxidations	10916	227		0	0.3333333333333333	215	10701	8	31	207	10670	10916	0.07990893576158382
M1	string	0	network_modules	34	TRUE	7.034200235423244e-4	106	39	6	0.15384615384615385	0.05660377358490566	REAC:R-HSA-156580	REAC	Phase II - Conjugation of compounds	10916	1738		0.5	0.6666666666666666	106	10810	6	33	100	10777	10916	0.08801300696987836
M1	string	0	network_modules	34	TRUE	8.078211229569186e-4	50	25	4	0.16	0.08	KEGG:00270	KEGG	Cysteine and methionine metabolism	8484	30		0.3333333333333333	0.75	50	8434	4	21	46	8413	8484	0.10945370299833476
M1	string	0	network_modules	34	TRUE	8.078211229569186e-4	50	25	4	0.16	0.08	KEGG:00565	KEGG	Ether lipid metabolism	8484	89		0.3333333333333333	0.75	50	8434	4	21	46	8413	8484	0.10945370299833476
M1	string	0	network_modules	34	TRUE	0.003848300822348754	74	25	4	0.16	0.05405405405405406	KEGG:01230	KEGG	Biosynthesis of amino acids	8484	188		1	1	74	8410	4	21	70	8389	8484	0.0884447797126122
M1	string	0	network_modules	34	TRUE	0.005663390992292215	10	50	3	0.06	0.3	GO:0046500	GO:BP	S-adenosylmethionine metabolic process	16175	12203		1	1	10	16165	3	47	7	16118	16175	0.13302848809606627
M1	string	0	network_modules	34	TRUE	0.005744842817430521	14	39	3	0.07692307692307693	0.21428571428571427	REAC:R-HSA-156581	REAC	Methylation	10916	1447		1	1	14	10902	3	36	11	10866	10916	0.12655487266926044
M1	string	0	network_modules	35	TRUE	3.610224520709647e-32	270	50	27	0.54	0.1	GO:0016197	GO:BP	endosomal transport	16175	5169		0	0.041666666666666664	270	15905	27	23	243	15882	16175	0.22745093739951036
M1	string	0	network_modules	35	TRUE	7.686658555328376e-30	248	31	24	0.7741935483870968	0.0967741935483871	KEGG:04144	KEGG	Endocytosis	8484	280		NA	1	248	8236	24	7	224	8229	8484	0.26780964543180663
M1	string	0	network_modules	35	TRUE	2.978080610091946e-19	94	50	15	0.3	0.1595744680851064	GO:0042147	GO:BP	retrograde transport, endosome to Golgi	16175	9990		0.043478260869565216	0.08333333333333333	94	16081	15	35	79	16046	16175	0.21551860206693205
M1	string	0	network_modules	35	TRUE	5.032909761505324e-17	130	50	15	0.3	0.11538461538461539	GO:0016482	GO:BP	cytosolic transport	16175	5232		0.08695652173913043	0.125	130	16045	15	35	115	16010	16175	0.1820813942469139
M1	string	0	network_modules	35	TRUE	1.3893442116121223e-14	79	50	12	0.24	0.1518987341772152	GO:0032456	GO:BP	endocytic recycling	16175	7571		0.13043478260869565	0.16666666666666666	79	16096	12	38	67	16058	16175	0.18779712467913906
M1	string	0	network_modules	35	TRUE	1.3288503592976744e-11	137	50	12	0.24	0.08759124087591241	GO:0098876	GO:BP	vesicle-mediated transport to the plasma membrane	16175	18924		0.17391304347826086	0.20833333333333334	137	16038	12	38	125	16000	16175	0.14068622432905836
M1	string	0	network_modules	35	TRUE	1.1392407276802055e-8	309	50	13	0.26	0.042071197411003236	GO:0016236	GO:BP	macroautophagy	16175	5179		0.21739130434782608	0.25	309	15866	13	37	296	15829	16175	0.0979934067913449
M1	string	0	network_modules	35	TRUE	3.323612789825067e-6	594	50	14	0.28	0.02356902356902357	GO:0051668	GO:BP	localization within membrane	16175	13880		0.2608695652173913	0.2916666666666667	594	15581	14	36	580	15545	16175	0.0720259492925244
M1	string	0	network_modules	35	TRUE	3.4794680432710053e-6	491	50	13	0.26	0.026476578411405296	GO:0061919	GO:BP	process utilizing autophagic mechanism	16175	15723		0.30434782608695654	0.375	491	15684	13	37	478	15647	16175	0.07453604425237838
M1	string	0	network_modules	35	TRUE	3.4794680432710053e-6	491	50	13	0.26	0.026476578411405296	GO:0006914	GO:BP	autophagy	16175	2563		0.30434782608695654	0.375	491	15684	13	37	478	15647	16175	0.07453604425237838
M1	string	0	network_modules	35	TRUE	1.7349418015930805e-5	9	50	4	0.08	0.4444444444444444	GO:0034498	GO:BP	early endosome to Golgi transport	16175	8665		0.391304347826087	0.4166666666666667	9	16166	4	46	5	16120	16175	0.18759261017003515
M1	string	0	network_modules	35	TRUE	3.903673176033794e-5	155	50	8	0.16	0.05161290322580645	GO:0007034	GO:BP	vacuolar transport	16175	2639		0.43478260869565216	0.4583333333333333	155	16020	8	42	147	15978	16175	0.08597657581226831
M1	string	0	network_modules	35	TRUE	4.105144863761315e-5	156	50	8	0.16	0.05128205128205128	GO:0016241	GO:BP	regulation of macroautophagy	16175	5183		0.4782608695652174	0.5	156	16019	8	42	148	15977	16175	0.08566801641968276
M1	string	0	network_modules	35	TRUE	3.4631813863488414e-4	31	28	4	0.14285714285714285	0.12903225806451613	REAC:R-HSA-917729	REAC	Endosomal Sorting Complex Required For Transport (ESCRT)	10916	841		NA	1	31	10885	4	24	27	10861	10916	0.13343047850167372
M1	string	0	network_modules	35	TRUE	4.933449594582067e-4	88	50	6	0.12	0.06818181818181818	GO:0007032	GO:BP	endosome organization	16175	2637		0.5217391304347826	0.5416666666666666	88	16087	6	44	82	16043	16175	0.08672248079324367
M1	string	0	network_modules	35	TRUE	7.60967176576923e-4	524	50	11	0.22	0.02099236641221374	GO:0006886	GO:BP	intracellular protein transport	16175	2542		0.5652173913043478	0.5833333333333334	524	15651	11	39	513	15612	16175	0.059004562305875974
M1	string	0	network_modules	35	TRUE	0.002319488071592095	27	50	4	0.08	0.14814814814814814	GO:0032511	GO:BP	late endosome to vacuole transport via multivesicular body sorting pathway	16175	7618		0.6086956521739131	0.6666666666666666	27	16148	4	46	23	16102	16175	0.10684901008545478
M1	string	0	network_modules	35	TRUE	0.002319488071592095	27	50	4	0.08	0.14814814814814814	GO:0034315	GO:BP	regulation of Arp2/3 complex-mediated actin nucleation	16175	8569		0.6086956521739131	0.6666666666666666	27	16148	4	46	23	16102	16175	0.10684901008545478
M1	string	0	network_modules	35	TRUE	0.004698865240119104	32	50	4	0.08	0.125	GO:0036258	GO:BP	multivesicular body assembly	16175	9519		0.6956521739130435	0.7083333333333334	32	16143	4	46	28	16097	16175	0.09777490054773767
M1	string	0	network_modules	35	TRUE	0.005334831701539784	33	50	4	0.08	0.12121212121212122	GO:0051125	GO:BP	regulation of actin nucleation	16175	13509		0.7391304347826086	0.7916666666666666	33	16142	4	46	29	16096	16175	0.09620875300915999
M1	string	0	network_modules	35	TRUE	0.005334831701539784	33	50	4	0.08	0.12121212121212122	GO:0036257	GO:BP	multivesicular body organization	16175	9518		0.7391304347826086	0.7916666666666666	33	16142	4	46	29	16096	16175	0.09620875300915999
M1	string	0	network_modules	35	TRUE	0.006230941107854112	522	50	10	0.2	0.019157088122605363	GO:0010256	GO:BP	endomembrane system organization	16175	4029		0.8260869565217391	0.8333333333333334	522	15653	10	40	512	15613	16175	0.05285071780413963
M1	string	0	network_modules	35	TRUE	0.006795297165863416	35	50	4	0.08	0.11428571428571428	GO:0043162	GO:BP	ubiquitin-dependent protein catabolic process via the multivesicular body sorting pathway	16175	10562		0.8695652173913043	0.875	35	16140	4	46	31	16094	16175	0.09327711029096598
M1	string	0	network_modules	35	TRUE	0.0077702004539302654	11	50	3	0.06	0.2727272727272727	GO:0007175	GO:BP	negative regulation of epidermal growth factor-activated receptor activity	16175	2738		0.9130434782608695	0.9166666666666666	11	16164	3	47	8	16117	16175	0.12670955220800525
M1	string	0	network_modules	35	TRUE	0.008532428512207707	37	50	4	0.08	0.10810810810810811	GO:0045324	GO:BP	late endosome to vacuole transport	16175	11357		0.9565217391304348	0.9583333333333334	37	16138	4	46	33	16092	16175	0.09058258299799783
M1	string	0	network_modules	35	TRUE	0.008601617309420165	315	50	8	0.16	0.025396825396825397	GO:0016050	GO:BP	vesicle organization	16175	5082		1	1	315	15860	8	42	307	15818	16175	0.0566275416082343
M1	string	0	network_modules	36	TRUE	1.1725840238259254e-13	10	37	7	0.1891891891891892	0.7	REAC:R-HSA-164940	REAC	Nef mediated downregulation of MHC class I complex cell surface expression	10916	1564		0	0.06666666666666667	10	10906	7	30	3	10876	10916	0.3629321435465902
M1	string	0	network_modules	36	TRUE	4.784130387749781e-13	35	37	9	0.24324324324324326	0.2571428571428571	REAC:R-HSA-432720	REAC	Lysosome Vesicle Biogenesis	10916	1341		0.07142857142857142	0.13333333333333333	35	10881	9	28	26	10853	10916	0.2476164859898811
M1	string	0	network_modules	36	TRUE	5.340954362048527e-13	21	37	8	0.21621621621621623	0.38095238095238093	REAC:R-HSA-164938	REAC	Nef-mediates down modulation of cell surface receptors by recruiting them to clathrin adapters	10916	1565		0.14285714285714285	0.2	21	10895	8	29	13	10866	10916	0.2852025964472074
M1	string	0	network_modules	36	TRUE	5.744776743366912e-12	27	37	8	0.21621621621621623	0.2962962962962963	REAC:R-HSA-164952	REAC	The role of Nef in HIV-1 replication and disease pathogenesis	10916	2504		0.21428571428571427	0.26666666666666666	27	10889	8	29	19	10860	10916	0.25094900545625504
M1	string	0	network_modules	36	TRUE	8.611716243010484e-12	72	37	10	0.2702702702702703	0.1388888888888889	REAC:R-HSA-199992	REAC	trans-Golgi Network Vesicle Budding	10916	2749		0.2857142857142857	0.3333333333333333	72	10844	10	27	62	10817	10916	0.18996646572006323
M1	string	0	network_modules	36	TRUE	9.685670140979717e-12	284	51	15	0.29411764705882354	0.0528169014084507	GO:0048193	GO:BP	Golgi vesicle transport	16175	12570		0	0.045454545454545456	284	15891	15	36	269	15855	16175	0.11842600369762685
M1	string	0	network_modules	36	TRUE	2.3671139851861006e-11	131	30	11	0.36666666666666664	0.08396946564885496	KEGG:04142	KEGG	Lysosome	8484	279		0	0.3333333333333333	131	8353	11	19	120	8334	8484	0.16969136099389132
M1	string	0	network_modules	36	TRUE	8.887038173777074e-10	100	51	10	0.19607843137254902	0.1	GO:0006892	GO:BP	post-Golgi vesicle-mediated transport	16175	2547		0.047619047619047616	0.09090909090909091	100	16075	10	41	90	16034	16175	0.13624903205502664
M1	string	0	network_modules	36	TRUE	2.525474091089799e-9	54	37	8	0.21621621621621623	0.14814814814814814	REAC:R-HSA-432722	REAC	Golgi Associated Vesicle Biogenesis	10916	1082		0.35714285714285715	0.4	54	10862	8	29	46	10833	10916	0.17561217269773352
M1	string	0	network_modules	36	TRUE	4.790598843597028e-8	39	51	7	0.13725490196078433	0.1794871794871795	GO:0032438	GO:BP	melanosome organization	16175	7566		0.09523809523809523	0.18181818181818182	39	16136	7	44	32	16092	16175	0.1546299567879197
M1	string	0	network_modules	36	TRUE	4.790598843597028e-8	39	51	7	0.13725490196078433	0.1794871794871795	GO:0048753	GO:BP	pigment granule organization	16175	13004		0.09523809523809523	0.18181818181818182	39	16136	7	44	32	16092	16175	0.1546299567879197
M1	string	0	network_modules	36	TRUE	1.4608653899589745e-7	4	51	4	0.0784313725490196	1	GO:0110010	GO:BP	basolateral protein secretion	16175	19342		0.19047619047619047	0.22727272727272727	4	16171	4	47	0	16124	16175	0.2796487380100389
M1	string	0	network_modules	36	TRUE	4.877825407962042e-7	248	30	10	0.3333333333333333	0.04032258064516129	KEGG:04144	KEGG	Endocytosis	8484	280		0.5	0.6666666666666666	248	8236	10	20	238	8216	8484	0.10753880401426766
M1	string	0	network_modules	36	TRUE	8.949876689167189e-7	58	51	7	0.13725490196078433	0.1206896551724138	GO:0033059	GO:BP	cellular pigmentation	16175	8013		0.23809523809523808	0.2727272727272727	58	16117	7	44	51	16073	16175	0.12576736921359474
M1	string	0	network_modules	36	TRUE	2.22867566840464e-6	44	37	6	0.16216216216216217	0.13636363636363635	REAC:R-HSA-8854214	REAC	TBC/RABGAPs	10916	2420		0.42857142857142855	0.4666666666666667	44	10872	6	31	38	10841	10916	0.14554822253137623
M1	string	0	network_modules	36	TRUE	2.5690716970632944e-6	126	37	8	0.21621621621621623	0.06349206349206349	REAC:R-HSA-162909	REAC	Host Interactions of HIV factors	10916	1132		0.5	0.5333333333333333	126	10790	8	29	118	10761	10916	0.1117469242671028
M1	string	0	network_modules	36	TRUE	4.775806200932982e-6	19	51	5	0.09803921568627451	0.2631578947368421	GO:1903232	GO:BP	melanosome assembly	16175	22844		0.2857142857142857	0.3181818181818182	19	16156	5	46	14	16110	16175	0.15904286313869703
M1	string	0	network_modules	36	TRUE	5.915463953574949e-6	202	37	9	0.24324324324324326	0.04455445544554455	REAC:R-HSA-6811442	REAC	Intra-Golgi and retrograde Golgi-to-ER traffic	10916	1262		0.5714285714285714	0.6	202	10714	9	28	193	10686	10916	0.09725131429892162
M1	string	0	network_modules	36	TRUE	9.797480563986931e-6	81	51	7	0.13725490196078433	0.08641975308641975	GO:0043473	GO:BP	pigmentation	16175	10719		0.3333333333333333	0.36363636363636365	81	16094	7	44	74	16050	16175	0.10536706307267374
M1	string	0	network_modules	36	TRUE	1.1126826593546758e-5	130	51	8	0.1568627450980392	0.06153846153846154	GO:0016482	GO:BP	cytosolic transport	16175	5232		0.38095238095238093	0.4090909090909091	130	16045	8	43	122	16002	16175	0.09374092532916788
M1	string	0	network_modules	36	TRUE	1.6839801827264767e-5	137	51	8	0.1568627450980392	0.058394160583941604	GO:0098876	GO:BP	vesicle-mediated transport to the plasma membrane	16175	18924		0.42857142857142855	0.45454545454545453	137	16038	8	43	129	15995	16175	0.09106902153962004
M1	string	0	network_modules	36	TRUE	1.7251181005419784e-5	24	51	5	0.09803921568627451	0.20833333333333334	GO:0060155	GO:BP	platelet dense granule organization	16175	14393		0.47619047619047616	0.5	24	16151	5	46	19	16105	16175	0.14107966522144488
M1	string	0	network_modules	36	TRUE	3.8804317694938644e-5	57	51	6	0.11764705882352941	0.10526315789473684	GO:0006893	GO:BP	Golgi to plasma membrane transport	16175	2548		0.5238095238095238	0.5454545454545454	57	16118	6	45	51	16073	16175	0.10831124483273841
M1	string	0	network_modules	36	TRUE	4.439508699421421e-5	155	51	8	0.1568627450980392	0.05161290322580645	GO:0007034	GO:BP	vacuolar transport	16175	2639		0.5714285714285714	0.5909090909090909	155	16020	8	43	147	15977	16175	0.08502366422437814
M1	string	0	network_modules	36	TRUE	5.2826479370506654e-5	123	37	7	0.1891891891891892	0.056910569105691054	REAC:R-HSA-2132295	REAC	MHC class II antigen presentation	10916	1371		0.6428571428571429	0.6666666666666666	123	10793	7	30	116	10763	10916	0.09830469538370307
M1	string	0	network_modules	36	TRUE	7.145142985016034e-5	315	51	10	0.19607843137254902	0.031746031746031744	GO:0016050	GO:BP	vesicle organization	16175	5082		0.6190476190476191	0.6363636363636364	315	15860	10	41	305	15819	16175	0.07187642816974979
M1	string	0	network_modules	36	TRUE	9.856133760234537e-5	524	51	12	0.23529411764705882	0.022900763358778626	GO:0006886	GO:BP	intracellular protein transport	16175	2542		0.6666666666666666	0.6818181818181818	524	15651	12	39	512	15612	16175	0.06445179435770751
M1	string	0	network_modules	36	TRUE	1.715449555407325e-4	37	51	5	0.09803921568627451	0.13513513513513514	GO:0043001	GO:BP	Golgi to plasma membrane protein transport	16175	10477		0.7142857142857143	0.7272727272727273	37	16138	5	46	32	16092	16175	0.1127233578167075
M1	string	0	network_modules	36	TRUE	2.0227164472660697e-4	125	51	7	0.13725490196078433	0.056	GO:0007041	GO:BP	lysosomal transport	16175	2645		0.7619047619047619	0.7727272727272727	125	16050	7	44	118	16006	16175	0.08318796852689375
M1	string	0	network_modules	36	TRUE	2.3200143996645806e-4	225	37	8	0.21621621621621623	0.035555555555555556	REAC:R-HSA-162906	REAC	HIV Infection	10916	1102		0.7142857142857143	0.7333333333333333	225	10691	8	29	217	10662	10916	0.08028747668999665
M1	string	0	network_modules	36	TRUE	4.615074691587025e-4	210	30	7	0.23333333333333334	0.03333333333333333	KEGG:05170	KEGG	Human immunodeficiency virus 1 infection	8484	451		1	1	210	8274	7	23	203	8251	8484	0.07997186231223526
M1	string	0	network_modules	36	TRUE	9.57776414234608e-4	120	37	6	0.16216216216216217	0.05	REAC:R-HSA-9007101	REAC	Rab regulation of trafficking	10916	1939		0.7857142857142857	0.8	120	10796	6	31	114	10765	10916	0.08454947929644456
M1	string	0	network_modules	36	TRUE	9.870553189033704e-4	52	51	5	0.09803921568627451	0.09615384615384616	GO:0033363	GO:BP	secretory granule organization	16175	8173		0.8095238095238095	0.8181818181818182	52	16123	5	46	47	16077	16175	0.09420813066647839
M1	string	0	network_modules	36	TRUE	0.0014370253276707297	56	51	5	0.09803921568627451	0.08928571428571429	GO:0061951	GO:BP	establishment of protein localization to plasma membrane	16175	15744		0.8571428571428571	0.8636363636363636	56	16119	5	46	51	16073	16175	0.090555709072972
M1	string	0	network_modules	36	TRUE	0.0031139326731647625	594	51	11	0.21568627450980393	0.018518518518518517	GO:0051668	GO:BP	localization within membrane	16175	13880		0.9047619047619048	0.9090909090909091	594	15581	11	40	583	15541	16175	0.053513726222835366
M1	string	0	network_modules	36	TRUE	0.0046324957334879045	285	51	8	0.1568627450980392	0.028070175438596492	GO:1990778	GO:BP	protein localization to cell periphery	16175	25286		0.9523809523809523	0.9545454545454546	285	15890	8	43	277	15847	16175	0.05952259481924487
M1	string	0	network_modules	36	TRUE	0.006711163152873525	99	37	5	0.13513513513513514	0.050505050505050504	REAC:R-HSA-6811434	REAC	COPI-dependent Golgi-to-ER retrograde traffic	10916	277		0.8571428571428571	0.8666666666666667	99	10817	5	32	94	10785	10916	0.07755261471473258
M1	string	0	network_modules	36	TRUE	0.007420602784421835	49	37	4	0.10810810810810811	0.08163265306122448	REAC:R-HSA-6811440	REAC	Retrograde transport at the Trans-Golgi-Network	10916	2096		0.9285714285714286	0.9333333333333333	49	10867	4	33	45	10834	10916	0.09039774888355513
M1	string	0	network_modules	36	TRUE	0.007758231965401377	102	37	5	0.13513513513513514	0.049019607843137254	REAC:R-HSA-6807878	REAC	COPI-mediated anterograde transport	10916	279		1	1	102	10814	5	32	97	10782	10916	0.07624763630014737
M1	string	0	network_modules	36	TRUE	0.00875297456451514	533	51	10	0.19607843137254902	0.01876172607879925	GO:0006897	GO:BP	endocytosis	16175	2551		1	1	533	15642	10	41	523	15601	16175	0.05139339910304499
M1	string	0	network_modules	37	TRUE	1.1015400461478831e-30	66	50	19	0.38	0.2878787878787879	GO:0036503	GO:BP	ERAD pathway	16175	9635		0	0.03125	66	16109	19	31	47	16078	16175	0.32837355507679183
M1	string	0	network_modules	37	TRUE	2.5111402430136884e-24	200	50	21	0.42	0.105	GO:0034976	GO:BP	response to endoplasmic reticulum stress	16175	8746		0.03225806451612903	0.0625	200	15975	21	29	179	15946	16175	0.2054072270687585
M1	string	0	network_modules	37	TRUE	1.0146273034527503e-21	168	31	18	0.5806451612903226	0.10714285714285714	KEGG:04141	KEGG	Protein processing in endoplasmic reticulum	8484	278		NA	1	168	8316	18	13	150	8303	8484	0.24378424495255124
M1	string	0	network_modules	37	TRUE	9.222532368734056e-21	28	50	12	0.24	0.42857142857142855	GO:0030970	GO:BP	retrograde protein transport, ER to cytosol	16175	6980		0.06451612903225806	0.125	28	16147	12	38	16	16109	16175	0.3191698889651612
M1	string	0	network_modules	37	TRUE	9.222532368734056e-21	28	50	12	0.24	0.42857142857142855	GO:1903513	GO:BP	endoplasmic reticulum to cytosol transport	16175	23063		0.06451612903225806	0.125	28	16147	12	38	16	16109	16175	0.3191698889651612
M1	string	0	network_modules	37	TRUE	1.5199063928753602e-17	47	50	12	0.24	0.2553191489361702	GO:0032527	GO:BP	protein exit from endoplasmic reticulum	16175	7621		0.12903225806451613	0.15625	47	16128	12	38	35	16090	16175	0.24527953967155966
M1	string	0	network_modules	37	TRUE	2.873833952483965e-15	21	38	9	0.23684210526315788	0.42857142857142855	REAC:R-HSA-901032	REAC	ER Quality Control Compartment (ERQC)	10916	822		0	0.09090909090909091	21	10895	9	29	12	10866	10916	0.31686511353813784
M1	string	0	network_modules	37	TRUE	4.632698708166479e-15	35	38	10	0.2631578947368421	0.2857142857142857	REAC:R-HSA-532668	REAC	N-glycan trimming in the ER and Calnexin/Calreticulin cycle	10916	1508		0.1	0.18181818181818182	35	10881	10	28	25	10853	10916	0.2717720888143349
M1	string	0	network_modules	37	TRUE	3.018550579355447e-14	26	38	9	0.23684210526315788	0.34615384615384615	REAC:R-HSA-901042	REAC	Calnexin/calreticulin cycle	10916	302		0.2	0.2727272727272727	26	10890	9	29	17	10861	10916	0.2842820668454057
M1	string	0	network_modules	37	TRUE	1.0093055293977482e-13	470	50	19	0.38	0.04042553191489362	GO:0010498	GO:BP	proteasomal protein catabolic process	16175	4177		0.16129032258064516	0.1875	470	15705	19	31	451	15674	16175	0.11634504270926557
M1	string	0	network_modules	37	TRUE	9.309967776750521e-13	619	50	20	0.4	0.03231017770597738	GO:1901698	GO:BP	response to nitrogen compound	16175	21651		0.1935483870967742	0.21875	619	15556	20	30	599	15526	16175	0.10499556305780368
M1	string	0	network_modules	37	TRUE	7.069670075475006e-11	673	50	19	0.38	0.02823179791976226	GO:0051603	GO:BP	proteolysis involved in protein catabolic process	16175	13820		0.22580645161290322	0.25	673	15502	19	31	654	15471	16175	0.09436237531891112
M1	string	0	network_modules	37	TRUE	2.238666492435068e-9	75	50	9	0.18	0.12	GO:1905897	GO:BP	regulation of response to endoplasmic reticulum stress	16175	24995		0.25806451612903225	0.28125	75	16100	9	41	66	16059	16175	0.14373891380923737
M1	string	0	network_modules	37	TRUE	3.6000747586170744e-9	524	50	16	0.32	0.030534351145038167	GO:0006886	GO:BP	intracellular protein transport	16175	2542		0.2903225806451613	0.3125	524	15651	16	34	508	15617	16175	0.09045616208500083
M1	string	0	network_modules	37	TRUE	4.007464496817173e-8	66	50	8	0.16	0.12121212121212122	GO:0030968	GO:BP	endoplasmic reticulum unfolded protein response	16175	6979		0.3225806451612903	0.34375	66	16109	8	42	58	16067	16175	0.1361990142099612
M1	string	0	network_modules	37	TRUE	1.7663096467470588e-7	79	50	8	0.16	0.10126582278481013	GO:0034620	GO:BP	cellular response to unfolded protein	16175	8693		0.3548387096774194	0.375	79	16096	8	42	71	16054	16175	0.12389770860372334
M1	string	0	network_modules	37	TRUE	4.90977271101721e-7	61	38	7	0.18421052631578946	0.11475409836065574	REAC:R-HSA-5678895	REAC	Defective CFTR causes cystic fibrosis	10916	505		0.3	0.36363636363636365	61	10855	7	31	54	10824	10916	0.14162400903667927
M1	string	0	network_modules	37	TRUE	6.114973193921268e-7	92	50	8	0.16	0.08695652173913043	GO:0035967	GO:BP	cellular response to topologically incorrect protein	16175	9370		0.3870967741935484	0.40625	92	16083	8	42	84	16041	16175	0.11426211980373407
M1	string	0	network_modules	37	TRUE	9.402308380580435e-7	32	50	6	0.12	0.1875	GO:1905898	GO:BP	positive regulation of response to endoplasmic reticulum stress	16175	24996		0.41935483870967744	0.4375	32	16143	6	44	26	16099	16175	0.1479019692120691
M1	string	0	network_modules	37	TRUE	1.29796136402157e-6	62	50	7	0.14	0.11290322580645161	GO:0070972	GO:BP	protein localization to endoplasmic reticulum	16175	16407		0.45161290322580644	0.46875	62	16113	7	43	55	16070	16175	0.12270634193159444
M1	string	0	network_modules	37	TRUE	1.551514885045034e-6	305	38	11	0.2894736842105263	0.036065573770491806	REAC:R-HSA-446203	REAC	Asparagine N-linked glycosylation	10916	169		0.4	0.45454545454545453	305	10611	11	27	294	10584	10916	0.09379491498226471
M1	string	0	network_modules	37	TRUE	1.6457424835725054e-6	104	50	8	0.16	0.07692307692307693	GO:0006986	GO:BP	response to unfolded protein	16175	2608		0.4838709677419355	0.5	104	16071	8	42	96	16029	16175	0.10699133630508456
M1	string	0	network_modules	37	TRUE	2.849668762828758e-6	78	38	7	0.18421052631578946	0.08974358974358974	REAC:R-HSA-5619084	REAC	ABC transporter disorders	10916	7		0.5	0.5454545454545454	78	10838	7	31	71	10807	10916	0.12424867731192339
M1	string	0	network_modules	37	TRUE	4.568241858075048e-6	41	50	6	0.12	0.14634146341463414	GO:0006984	GO:BP	ER-nucleus signaling pathway	16175	2607		0.5161290322580645	0.53125	41	16134	6	44	35	16090	16175	0.13008457032643955
M1	string	0	network_modules	37	TRUE	4.839579523593211e-6	119	50	8	0.16	0.06722689075630252	GO:0035966	GO:BP	response to topologically incorrect protein	16175	9369		0.5483870967741935	0.5625	119	16056	8	42	111	16014	16175	0.09946357616141653
M1	string	0	network_modules	37	TRUE	9.124815088062076e-6	92	38	7	0.18421052631578946	0.07608695652173914	REAC:R-HSA-381119	REAC	Unfolded Protein Response (UPR)	10916	2624		0.6	0.6363636363636364	92	10824	7	31	85	10793	10916	0.11364980770799027
M1	string	0	network_modules	37	TRUE	1.0746390361045514e-5	437	50	12	0.24	0.02745995423340961	GO:0080135	GO:BP	regulation of cellular response to stress	16175	17817		0.5806451612903226	0.59375	437	15738	12	38	425	15700	16175	0.07314908158927108
M1	string	0	network_modules	37	TRUE	2.007782074736503e-5	103	38	7	0.18421052631578946	0.06796116504854369	REAC:R-HSA-382556	REAC	ABC-family proteins mediated transport	10916	9		0.7	0.7272727272727273	103	10813	7	31	96	10782	10916	0.10684839096118265
M1	string	0	network_modules	37	TRUE	9.755819800373791e-5	13	50	4	0.08	0.3076923076923077	GO:1904152	GO:BP	regulation of retrograde protein transport, ER to cytosol	16175	23573		0.6129032258064516	0.625	13	16162	4	46	9	16116	16175	0.15561986810350148
M1	string	0	network_modules	37	TRUE	2.4767141508959197e-4	49	38	5	0.13157894736842105	0.10204081632653061	REAC:R-HSA-381070	REAC	IRE1alpha activates chaperones	10916	1160		0.8	0.8181818181818182	49	10867	5	33	44	10834	10916	0.11236724335169734
M1	string	0	network_modules	37	TRUE	4.1279491590316697e-4	18	50	4	0.08	0.2222222222222222	GO:0006613	GO:BP	cotranslational protein targeting to membrane	16175	2328		0.6451612903225806	0.65625	18	16157	4	46	14	16111	16175	0.13175563543178095
M1	string	0	network_modules	37	TRUE	6.506224970306233e-4	20	50	4	0.08	0.2	GO:1904292	GO:BP	regulation of ERAD pathway	16175	23682		0.6774193548387096	0.6875	20	16155	4	46	16	16109	16175	0.12480617964429956
M1	string	0	network_modules	37	TRUE	6.921056475112575e-4	173	38	7	0.18421052631578946	0.04046242774566474	REAC:R-HSA-5619115	REAC	Disorders of transmembrane transporters	10916	778		0.9	0.9090909090909091	173	10743	7	31	166	10712	10916	0.0796782209637143
M1	string	0	network_modules	37	TRUE	0.0010170253198661947	53	50	5	0.1	0.09433962264150944	GO:0042987	GO:BP	amyloid precursor protein catabolic process	16175	10471		0.7096774193548387	0.71875	53	16122	5	45	48	16077	16175	0.09424608417737214
M1	string	0	network_modules	37	TRUE	0.0014140032217889455	24	50	4	0.08	0.16666666666666666	GO:0070861	GO:BP	regulation of protein exit from endoplasmic reticulum	16175	16345		0.7419354838709677	0.75	24	16151	4	46	20	16105	16175	0.11358828228005226
M1	string	0	network_modules	37	TRUE	0.0031247847166765105	29	50	4	0.08	0.13793103448275862	GO:0045047	GO:BP	protein targeting to ER	16175	11246		0.7741935483870968	0.78125	29	16146	4	46	25	16100	16175	0.10294237720342161
M1	string	0	network_modules	37	TRUE	0.0033133195448959503	67	50	5	0.1	0.07462686567164178	GO:0042982	GO:BP	amyloid precursor protein metabolic process	16175	10466		0.8064516129032258	0.8125	67	16108	5	45	62	16063	16175	0.08310912295798195
M1	string	0	network_modules	37	TRUE	0.003973028667071805	9	50	3	0.06	0.3333333333333333	GO:1904153	GO:BP	negative regulation of retrograde protein transport, ER to cytosol	16175	23574		0.8387096774193549	0.84375	9	16166	3	47	6	16119	16175	0.140365988076645
M1	string	0	network_modules	37	TRUE	0.005334831701539784	33	50	4	0.08	0.12121212121212122	GO:0072599	GO:BP	establishment of protein localization to endoplasmic reticulum	16175	17463		0.8709677419354839	0.875	33	16142	4	46	29	16096	16175	0.09620875300915999
M1	string	0	network_modules	37	TRUE	0.005663390992292215	10	50	3	0.06	0.3	GO:0070862	GO:BP	negative regulation of protein exit from endoplasmic reticulum	16175	16346		0.9032258064516129	0.90625	10	16165	3	47	7	16118	16175	0.13302848809606627
M1	string	0	network_modules	37	TRUE	0.0062073529135414016	76	50	5	0.1	0.06578947368421052	GO:0051224	GO:BP	negative regulation of protein transport	16175	13577		0.9354838709677419	0.9375	76	16099	5	45	71	16054	16175	0.07760191226114785
M1	string	0	network_modules	37	TRUE	0.007463385239393706	47	38	4	0.10526315789473684	0.0851063829787234	REAC:R-HSA-381038	REAC	XBP1(S) activates chaperone genes	10916	2676		1	1	47	10869	4	34	43	10835	10916	0.09113304546376406
M1	string	0	network_modules	37	TRUE	0.0077702004539302654	11	50	3	0.06	0.2727272727272727	GO:0006614	GO:BP	SRP-dependent cotranslational protein targeting to membrane	16175	2329		0.967741935483871	0.96875	11	16164	3	47	8	16117	16175	0.12670955220800525
M1	string	0	network_modules	37	TRUE	0.008207726373219692	313	50	8	0.16	0.025559105431309903	GO:0051223	GO:BP	regulation of protein transport	16175	13576		1	1	313	15862	8	42	305	15820	16175	0.0568545727124515
M1	string	0	network_modules	39	TRUE	5.6057549776971704e-42	329	43	34	0.7906976744186046	0.1033434650455927	REAC:R-HSA-73894	REAC	DNA Repair	10916	444		0	0.02631578947368421	329	10587	34	9	295	10578	10916	0.2797507369338611
M1	string	0	network_modules	39	TRUE	2.307362403198965e-40	798	53	41	0.7735849056603774	0.05137844611528822	GO:0006974	GO:BP	DNA damage response	16175	2601		0	0.020833333333333332	798	15377	41	12	757	15365	16175	0.19174485689258566
M1	string	0	network_modules	39	TRUE	4.203333175593568e-40	528	53	37	0.6981132075471698	0.07007575757575757	GO:0006281	GO:BP	DNA repair	16175	2095		0.02127659574468085	0.041666666666666664	528	15647	37	16	491	15631	16175	0.2147182217008867
M1	string	0	network_modules	39	TRUE	5.6336560784633964e-39	54	38	22	0.5789473684210527	0.4074074074074074	KEGG:03460	KEGG	Fanconi anemia pathway	8484	242		0	0.3333333333333333	54	8430	22	16	32	8414	8484	0.4829412279257545
M1	string	0	network_modules	39	TRUE	1.77425257723828e-27	39	43	16	0.37209302325581395	0.41025641025641024	REAC:R-HSA-6783310	REAC	Fanconi Anemia Pathway	10916	932		0.02702702702702703	0.05263157894736842	39	10877	16	27	23	10850	10916	0.38841643022533234
M1	string	0	network_modules	39	TRUE	2.258099158129403e-25	39	53	15	0.2830188679245283	0.38461538461538464	GO:0036297	GO:BP	interstrand cross-link repair	16175	9548		0.0425531914893617	0.0625	39	16136	15	38	24	16098	16175	0.3280516036124618
M1	string	0	network_modules	39	TRUE	6.2303331759884696e-21	50	43	14	0.32558139534883723	0.28	REAC:R-HSA-9675135	REAC	Diseases of DNA repair	10916	758		0.05405405405405406	0.07894736842105263	50	10866	14	29	36	10837	10916	0.2989575622056744
M1	string	0	network_modules	39	TRUE	2.851794461200772e-16	75	43	13	0.3023255813953488	0.17333333333333334	REAC:R-HSA-9833482	REAC	PKR-mediated signaling	10916	1692		0.08108108108108109	0.10526315789473684	75	10841	13	30	62	10811	10916	0.22493083841684283
M1	string	0	network_modules	39	TRUE	1.7925299416678627e-14	35	43	10	0.23255813953488372	0.2857142857142857	REAC:R-HSA-9709570	REAC	Impaired BRCA2 binding to RAD51	10916	1173		0.10810810810810811	0.13157894736842105	35	10881	10	33	25	10848	10916	0.25512725488598254
M1	string	0	network_modules	39	TRUE	3.382495415821185e-14	37	43	10	0.23255813953488372	0.2702702702702703	REAC:R-HSA-5685938	REAC	HDR through Single Strand Annealing (SSA)	10916	1100		0.13513513513513514	0.15789473684210525	37	10879	10	33	27	10846	10916	0.24796070306200865
M1	string	0	network_modules	39	TRUE	5.443785499260065e-14	114	53	13	0.24528301886792453	0.11403508771929824	GO:0000077	GO:BP	DNA damage checkpoint signaling	16175	28		0.06382978723404255	0.08333333333333333	114	16061	13	40	101	16021	16175	0.16328256228794438
M1	string	0	network_modules	39	TRUE	8.163438183001129e-14	40	43	10	0.23255813953488372	0.25	REAC:R-HSA-5693616	REAC	Presynaptic phase of homologous DNA pairing and strand exchange	10916	1793		0.16216216216216217	0.18421052631578946	40	10876	10	33	30	10843	10916	0.23822782337991122
M1	string	0	network_modules	39	TRUE	1.0767051384349861e-13	41	43	10	0.23255813953488372	0.24390243902439024	REAC:R-HSA-9701190	REAC	Defective homologous recombination repair (HRR) due to BRCA2 loss of function	10916	698		0.1891891891891892	0.23684210526315788	41	10875	10	33	31	10842	10916	0.23522131149367004
M1	string	0	network_modules	39	TRUE	1.0767051384349861e-13	41	43	10	0.23255813953488372	0.24390243902439024	REAC:R-HSA-9675136	REAC	Diseases of DNA Double-Strand Break Repair	10916	757		0.1891891891891892	0.23684210526315788	41	10875	10	33	31	10842	10916	0.23522131149367004
M1	string	0	network_modules	39	TRUE	1.5110337530187923e-13	123	53	13	0.24528301886792453	0.10569105691056911	GO:0031570	GO:BP	DNA integrity checkpoint signaling	16175	7220		0.0851063829787234	0.10416666666666667	123	16052	13	40	110	16012	16175	0.15687216192803133
M1	string	0	network_modules	39	TRUE	1.8312743959562006e-13	43	43	10	0.23255813953488372	0.23255813953488372	REAC:R-HSA-5693579	REAC	Homologous DNA Pairing and Strand Exchange	10916	1129		0.24324324324324326	0.2631578947368421	43	10873	10	33	33	10840	10916	0.22952309860781667
M1	string	0	network_modules	39	TRUE	4.16081428694525e-13	68	43	11	0.2558139534883721	0.16176470588235295	REAC:R-HSA-5685942	REAC	HDR through Homologous Recombination (HRR)	10916	1097		0.2702702702702703	0.2894736842105263	68	10848	11	32	57	10816	10916	0.1994855721926361
M1	string	0	network_modules	39	TRUE	5.854157456035412e-13	281	53	16	0.3018867924528302	0.05693950177935943	GO:0006310	GO:BP	DNA recombination	16175	2115		0.10638297872340426	0.125	281	15894	16	37	265	15857	16175	0.12485533579360258
M1	string	0	network_modules	39	TRUE	2.6043518040237047e-12	147	43	13	0.3023255813953488	0.08843537414965986	REAC:R-HSA-1169410	REAC	Antiviral mechanism by IFN-stimulated genes	10916	157		0.2972972972972973	0.3157894736842105	147	10769	13	30	134	10739	10916	0.15760238085675468
M1	string	0	network_modules	39	TRUE	1.2777748514921817e-11	172	53	13	0.24528301886792453	0.0755813953488372	GO:0042770	GO:BP	signal transduction in response to DNA damage	16175	10355		0.1276595744680851	0.14583333333333334	172	16003	13	40	159	15963	16175	0.1311677741077764
M1	string	0	network_modules	39	TRUE	1.7255420409997634e-11	176	53	13	0.24528301886792453	0.07386363636363637	GO:0000075	GO:BP	cell cycle checkpoint signaling	16175	26		0.14893617021276595	0.16666666666666666	176	15999	13	40	163	15959	16175	0.1295481992418415
M1	string	0	network_modules	39	TRUE	2.361774444506328e-11	132	43	12	0.27906976744186046	0.09090909090909091	REAC:R-HSA-5693567	REAC	HDR through Homologous Recombination (HRR) or Single Strand Annealing (SSA)	10916	1098		0.32432432432432434	0.34210526315789475	132	10784	12	31	120	10753	10916	0.1536104272320543
M1	string	0	network_modules	39	TRUE	2.495875207182779e-11	97	43	11	0.2558139534883721	0.1134020618556701	REAC:R-HSA-5693607	REAC	Processing of DNA double-strand break ends	10916	1798		0.35135135135135137	0.3684210526315789	97	10819	11	32	86	10787	10916	0.1654679254449664
M1	string	0	network_modules	39	TRUE	4.055168204657396e-11	138	43	12	0.27906976744186046	0.08695652173913043	REAC:R-HSA-5693538	REAC	Homology Directed Repair	10916	1130		0.3783783783783784	0.39473684210526316	138	10778	12	31	126	10747	10916	0.14996638552470012
M1	string	0	network_modules	39	TRUE	6.099590901066054e-11	147	53	12	0.22641509433962265	0.08163265306122448	GO:0006261	GO:BP	DNA-templated DNA replication	16175	2078		0.1702127659574468	0.1875	147	16028	12	41	135	15987	16175	0.1313070690290559
M1	string	0	network_modules	39	TRUE	3.919101074918535e-10	224	53	13	0.24528301886792453	0.05803571428571429	GO:1901988	GO:BP	negative regulation of cell cycle phase transition	16175	21921		0.19148936170212766	0.20833333333333334	224	15951	13	40	211	15911	16175	0.11354888521759658
M1	string	0	network_modules	39	TRUE	4.3419046994033753e-10	168	43	12	0.27906976744186046	0.07142857142857142	REAC:R-HSA-5693532	REAC	DNA Double-Strand Break Repair	10916	443		0.40540540540540543	0.42105263157894735	168	10748	12	31	156	10717	10916	0.134704151794084
M1	string	0	network_modules	39	TRUE	6.014627223861944e-10	92	43	10	0.23255813953488372	0.10869565217391304	REAC:R-HSA-6804756	REAC	Regulation of TP53 Activity through Phosphorylation	10916	2016		0.43243243243243246	0.4473684210526316	92	10824	10	33	82	10791	10916	0.15418265693469485
M1	string	0	network_modules	39	TRUE	7.499935504312941e-10	94	43	10	0.23255813953488372	0.10638297872340426	REAC:R-HSA-69473	REAC	G2/M DNA damage checkpoint	10916	1006		0.4594594594594595	0.47368421052631576	94	10822	10	33	84	10789	10916	0.15242298972085952
M1	string	0	network_modules	39	TRUE	7.546166583620444e-10	298	53	14	0.2641509433962264	0.04697986577181208	GO:0006302	GO:BP	double-strand break repair	16175	2109		0.2127659574468085	0.22916666666666666	298	15877	14	39	284	15838	16175	0.1047693104999582
M1	string	0	network_modules	39	TRUE	2.8988748432559326e-9	262	53	13	0.24528301886792453	0.04961832061068702	GO:0010948	GO:BP	negative regulation of cell cycle process	16175	4526		0.23404255319148937	0.25	262	15913	13	40	249	15873	16175	0.10405024052708253
M1	string	0	network_modules	39	TRUE	4.739044742671599e-9	263	43	13	0.3023255813953488	0.049429657794676805	REAC:R-HSA-913531	REAC	Interferon Signaling	10916	1227		0.4864864864864865	0.5	263	10653	13	30	250	10623	10916	0.11410826236015437
M1	string	0	network_modules	39	TRUE	1.0461714137001542e-8	167	43	11	0.2558139534883721	0.0658682634730539	REAC:R-HSA-69481	REAC	G2/M Checkpoints	10916	1005		0.5135135135135135	0.5263157894736842	167	10749	11	32	156	10717	10916	0.12323200628316872
M1	string	0	network_modules	39	TRUE	1.3450793573747226e-8	231	53	12	0.22641509433962265	0.05194805194805195	GO:0006260	GO:BP	DNA replication	16175	2077		0.2553191489361702	0.2708333333333333	231	15944	12	41	219	15903	16175	0.10251277654347785
M1	string	0	network_modules	39	TRUE	1.4818153210939265e-8	176	53	11	0.20754716981132076	0.0625	GO:0000725	GO:BP	recombinational repair	16175	204		0.2765957446808511	0.2916666666666667	176	15999	11	42	165	15957	16175	0.10869252961017956
M1	string	0	network_modules	39	TRUE	5.402933185458358e-8	20	53	6	0.11320754716981132	0.3	GO:0000076	GO:BP	DNA replication checkpoint signaling	16175	27		0.2978723404255319	0.3125	20	16155	6	47	14	16108	16175	0.18268804127904192
M1	string	0	network_modules	39	TRUE	7.13197394567688e-8	338	53	13	0.24528301886792453	0.038461538461538464	GO:0045786	GO:BP	negative regulation of cell cycle	16175	11618		0.3191489361702128	0.3333333333333333	338	15837	13	40	325	15797	16175	0.08994454401115849
M1	string	0	network_modules	39	TRUE	1.5707748147624716e-7	160	43	10	0.23255813953488372	0.0625	REAC:R-HSA-5633007	REAC	Regulation of TP53 Activity	10916	2012		0.5405405405405406	0.5526315789473685	160	10756	10	33	150	10723	10916	0.11402403605183843
M1	string	0	network_modules	39	TRUE	2.50437240333273e-7	289	43	12	0.27906976744186046	0.04152249134948097	REAC:R-HSA-69620	REAC	Cell Cycle Checkpoints	10916	321		0.5675675675675675	0.5789473684210527	289	10627	12	31	277	10596	10916	0.09894487909653263
M1	string	0	network_modules	39	TRUE	2.670164782146918e-7	376	53	13	0.24528301886792453	0.034574468085106384	GO:1901987	GO:BP	regulation of cell cycle phase transition	16175	21920		0.3404255319148936	0.3541666666666667	376	15799	13	40	363	15759	16175	0.08448700621185086
M1	string	0	network_modules	39	TRUE	2.9192435995521453e-7	172	53	10	0.18867924528301888	0.05813953488372093	GO:0000724	GO:BP	double-strand break repair via homologous recombination	16175	203		0.3617021276595745	0.375	172	16003	10	43	162	15960	16175	0.09952655378663815
M1	string	0	network_modules	39	TRUE	1.424564949494244e-6	15	53	5	0.09433962264150944	0.3333333333333333	GO:0000712	GO:BP	resolution of meiotic recombination intermediates	16175	192		0.3829787234042553	0.4166666666666667	15	16160	5	48	10	16112	16175	0.17595854555658877
M1	string	0	network_modules	39	TRUE	1.424564949494244e-6	15	53	5	0.09433962264150944	0.3333333333333333	GO:0031573	GO:BP	mitotic intra-S DNA damage checkpoint signaling	16175	7222		0.3829787234042553	0.4166666666666667	15	16160	5	48	10	16112	16175	0.17595854555658877
M1	string	0	network_modules	39	TRUE	1.5084950265280632e-6	630	53	15	0.2830188679245283	0.023809523809523808	GO:0010564	GO:BP	regulation of cell cycle process	16175	4217		0.425531914893617	0.4375	630	15545	15	38	615	15507	16175	0.07233047251016789
M1	string	0	network_modules	39	TRUE	2.932589175481207e-6	359	43	12	0.27906976744186046	0.033426183844011144	REAC:R-HSA-3700989	REAC	Transcriptional Regulation by TP53	10916	2546		0.5945945945945946	0.6052631578947368	359	10557	12	31	347	10526	10916	0.08680851660957921
M1	string	0	network_modules	39	TRUE	3.483444293965832e-6	23	38	5	0.13157894736842105	0.21739130434782608	KEGG:03430	KEGG	Mismatch repair	8484	239		0.5	0.6666666666666666	23	8461	5	33	18	8428	8484	0.16624060639290653
M1	string	0	network_modules	39	TRUE	3.572659259044603e-6	465	53	13	0.24528301886792453	0.02795698924731183	GO:0044770	GO:BP	cell cycle phase transition	16175	11146		0.44680851063829785	0.4583333333333333	465	15710	13	40	452	15670	16175	0.07429955326110231
M1	string	0	network_modules	39	TRUE	6.921821027186148e-6	42	53	6	0.11320754716981132	0.14285714285714285	GO:0006284	GO:BP	base-excision repair	16175	2098		0.46808510638297873	0.4791666666666667	42	16133	6	47	36	16086	16175	0.12462026375262795
M1	string	0	network_modules	39	TRUE	8.474106165766832e-6	77	53	7	0.1320754716981132	0.09090909090909091	GO:0044773	GO:BP	mitotic DNA damage checkpoint signaling	16175	11149		0.48936170212765956	0.5	77	16098	7	46	70	16052	16175	0.10605255814378134
M1	string	0	network_modules	39	TRUE	1.0163832301406173e-5	79	53	7	0.1320754716981132	0.08860759493670886	GO:0006289	GO:BP	nucleotide-excision repair	16175	2102		0.5106382978723404	0.5208333333333334	79	16096	7	46	72	16050	16175	0.10460632778843368
M1	string	0	network_modules	39	TRUE	1.2131390951558839e-5	81	53	7	0.1320754716981132	0.08641975308641975	GO:0044774	GO:BP	mitotic DNA integrity checkpoint signaling	16175	11150		0.5319148936170213	0.5416666666666666	81	16094	7	46	74	16048	16175	0.10321280387604591
M1	string	0	network_modules	39	TRUE	1.59517024255528e-5	48	53	6	0.11320754716981132	0.125	GO:0031297	GO:BP	replication fork processing	16175	7119		0.5531914893617021	0.5625	48	16127	6	47	42	16080	16175	0.1162022606293212
M1	string	0	network_modules	39	TRUE	2.778733011409753e-5	203	53	9	0.16981132075471697	0.04433497536945813	GO:0051321	GO:BP	meiotic cell cycle	16175	13648		0.574468085106383	0.5833333333333334	203	15972	9	44	194	15928	16175	0.08099652272667138
M1	string	0	network_modules	39	TRUE	4.6123654993705926e-5	57	53	6	0.11320754716981132	0.10526315789473684	GO:0045005	GO:BP	DNA-templated DNA replication maintenance of fidelity	16175	11223		0.5957446808510638	0.6041666666666666	57	16118	6	47	51	16071	16175	0.10612590839187346
M1	string	0	network_modules	39	TRUE	5.206670336231187e-5	11	53	4	0.07547169811320754	0.36363636363636365	GO:0033314	GO:BP	mitotic DNA replication checkpoint signaling	16175	8127		0.6170212765957447	0.625	11	16164	4	49	7	16115	16175	0.16449588457988273
M1	string	0	network_modules	39	TRUE	5.441570215816086e-5	29	53	5	0.09433962264150944	0.1724137931034483	GO:0006298	GO:BP	mismatch repair	16175	2107		0.6382978723404256	0.6458333333333334	29	16146	5	48	24	16098	16175	0.12543027720836794
M1	string	0	network_modules	39	TRUE	6.862826564938131e-5	34	43	5	0.11627906976744186	0.14705882352941177	REAC:R-HSA-5693568	REAC	Resolution of D-loop Structures through Holliday Junction Intermediates	10916	2077		0.6216216216216216	0.631578947368421	34	10882	5	38	29	10844	10916	0.12771413712216834
M1	string	0	network_modules	39	TRUE	6.987393816891674e-5	61	53	6	0.11320754716981132	0.09836065573770492	GO:0035825	GO:BP	homologous recombination	16175	9273		0.6595744680851063	0.6666666666666666	61	16114	6	47	55	16067	16175	0.10236878552475015
M1	string	0	network_modules	39	TRUE	7.303022546777483e-5	14	43	4	0.09302325581395349	0.2857142857142857	REAC:R-HSA-5358606	REAC	Mismatch repair (MMR) directed by MSH2:MSH3 (MutSbeta)	10916	1458		0.6486486486486487	0.6578947368421053	14	10902	4	39	10	10863	10916	0.16120116203088514
M1	string	0	network_modules	39	TRUE	7.6627049498413e-5	161	53	8	0.1509433962264151	0.049689440993788817	GO:1903046	GO:BP	meiotic cell cycle process	16175	22726		0.6808510638297872	0.6875	161	16014	8	45	153	15969	16175	0.08143244965381237
M1	string	0	network_modules	39	TRUE	7.791079950422776e-5	12	53	4	0.07547169811320754	0.3333333333333333	GO:0006285	GO:BP	base-excision repair, AP site formation	16175	2099		0.7021276595744681	0.7083333333333334	12	16163	4	49	8	16114	16175	0.157367501180561
M1	string	0	network_modules	39	TRUE	7.983397385896615e-5	35	43	5	0.11627906976744186	0.14285714285714285	REAC:R-HSA-5693537	REAC	Resolution of D-Loop Structures	10916	2076		0.6756756756756757	0.6842105263157895	35	10881	5	38	30	10843	10916	0.12578030795665343
M1	string	0	network_modules	39	TRUE	9.93020534183317e-5	15	43	4	0.09302325581395349	0.26666666666666666	REAC:R-HSA-5358508	REAC	Mismatch Repair	10916	1457		0.7027027027027027	0.7105263157894737	15	10901	4	39	11	10862	10916	0.15558674302871903
M1	string	0	network_modules	39	TRUE	1.0501140244180059e-4	44	38	5	0.13157894736842105	0.11363636363636363	KEGG:03410	KEGG	Base excision repair	8484	237		1	1	44	8440	5	33	39	8407	8484	0.11802972603933251
M1	string	0	network_modules	39	TRUE	1.0657520925471565e-4	37	43	5	0.11627906976744186	0.13513513513513514	REAC:R-HSA-176187	REAC	Activation of ATR in response to replication stress	10916	75		0.7297297297297297	0.7368421052631579	37	10879	5	38	32	10841	10916	0.12214661932854982
M1	string	0	network_modules	39	TRUE	4.011789917299139e-4	134	53	7	0.1320754716981132	0.05223880597014925	GO:0007093	GO:BP	mitotic cell cycle checkpoint signaling	16175	2676		0.723404255319149	0.7291666666666666	134	16041	7	46	127	15995	16175	0.0783058136963266
M1	string	0	network_modules	39	TRUE	7.288231578754822e-4	90	53	6	0.11320754716981132	0.06666666666666667	GO:0010212	GO:BP	response to ionizing radiation	16175	3993		0.7446808510638298	0.75	90	16085	6	47	84	16038	16175	0.08297139754966379
M1	string	0	network_modules	39	TRUE	7.533746613945607e-4	24	43	4	0.09302325581395349	0.16666666666666666	REAC:R-HSA-9709603	REAC	Impaired BRCA2 binding to PALB2	10916	1172		0.7567567567567568	0.7631578947368421	24	10892	4	39	20	10853	10916	0.12194594070332289
M1	string	0	network_modules	39	TRUE	8.943124858016301e-4	25	43	4	0.09302325581395349	0.16	REAC:R-HSA-9704331	REAC	Defective HDR through Homologous Recombination Repair (HRR) due to PALB2 loss of BRCA1 binding function	10916	562		0.7837837837837838	0.868421052631579	25	10891	4	39	21	10852	10916	0.11936709856944672
M1	string	0	network_modules	39	TRUE	8.943124858016301e-4	25	43	4	0.09302325581395349	0.16	REAC:R-HSA-9704646	REAC	Defective HDR through Homologous Recombination Repair (HRR) due to PALB2 loss of BRCA2/RAD51/RAD51C binding function	10916	563		0.7837837837837838	0.868421052631579	25	10891	4	39	21	10852	10916	0.11936709856944672
M1	string	0	network_modules	39	TRUE	8.943124858016301e-4	25	43	4	0.09302325581395349	0.16	REAC:R-HSA-9701192	REAC	Defective homologous recombination repair (HRR) due to BRCA1 loss of function	10916	697		0.7837837837837838	0.868421052631579	25	10891	4	39	21	10852	10916	0.11936709856944672
M1	string	0	network_modules	39	TRUE	8.943124858016301e-4	25	43	4	0.09302325581395349	0.16	REAC:R-HSA-9701193	REAC	Defective homologous recombination repair (HRR) due to PALB2 loss of function	10916	699		0.7837837837837838	0.868421052631579	25	10891	4	39	21	10852	10916	0.11936709856944672
M1	string	0	network_modules	39	TRUE	0.0010309147469754142	6	53	3	0.05660377358490566	0.5	GO:0071139	GO:BP	resolution of DNA recombination intermediates	16175	16460		0.7659574468085106	0.7708333333333334	6	16169	3	50	3	16119	16175	0.167434714734746
M1	string	0	network_modules	39	TRUE	0.001233647834575845	27	43	4	0.09302325581395349	0.14814814814814814	REAC:R-HSA-5693554	REAC	Resolution of D-loop Structures through Synthesis-Dependent Strand Annealing (SDSA)	10916	2078		0.8918918918918919	0.8947368421052632	27	10889	4	39	23	10850	10916	0.11463963173081933
M1	string	0	network_modules	39	TRUE	0.0012391050054303217	53	53	5	0.09433962264150944	0.09433962264150944	GO:0140527	GO:BP	reciprocal homologous recombination	16175	19808		0.7872340425531915	0.8333333333333334	53	16122	5	48	48	16074	16175	0.09136232453953698
M1	string	0	network_modules	39	TRUE	0.0012391050054303217	53	53	5	0.09433962264150944	0.09433962264150944	GO:0007131	GO:BP	reciprocal meiotic recombination	16175	2702		0.7872340425531915	0.8333333333333334	53	16122	5	48	48	16074	16175	0.09136232453953698
M1	string	0	network_modules	39	TRUE	0.0012391050054303217	53	53	5	0.09433962264150944	0.09433962264150944	GO:0071479	GO:BP	cellular response to ionizing radiation	16175	16712		0.7872340425531915	0.8333333333333334	53	16122	5	48	48	16074	16175	0.09136232453953698
M1	string	0	network_modules	39	TRUE	0.001894409254301937	545	53	11	0.20754716981132076	0.02018348623853211	GO:0051276	GO:BP	chromosome organization	16175	13613		0.851063829787234	0.8541666666666666	545	15630	11	42	534	15588	16175	0.05524305767271826
M1	string	0	network_modules	39	TRUE	0.0026636110515482806	27	53	4	0.07547169811320754	0.14814814814814814	GO:0006304	GO:BP	DNA modification	16175	2111		0.8723404255319149	0.875	27	16148	4	49	23	16099	16175	0.10365788051376347
M1	string	0	network_modules	39	TRUE	0.002873194904066899	8	53	3	0.05660377358490566	0.375	GO:0045008	GO:BP	depyrimidination	16175	11226		0.8936170212765957	0.8958333333333334	8	16167	3	50	5	16117	16175	0.1446928261550928
M1	string	0	network_modules	39	TRUE	0.00319530818197507	34	43	4	0.09302325581395349	0.11764705882352941	REAC:R-HSA-174417	REAC	Telomere C-strand (Lagging Strand) Synthesis	10916	2486		0.918918918918919	0.9210526315789473	34	10882	4	39	30	10843	10916	0.10146827845230898
M1	string	0	network_modules	39	TRUE	0.004035412786192753	36	43	4	0.09302325581395349	0.1111111111111111	REAC:R-HSA-73933	REAC	Resolution of Abasic Sites (AP sites)	10916	2075		0.9459459459459459	0.9473684210526315	36	10880	4	39	32	10841	10916	0.098417538127546
M1	string	0	network_modules	39	TRUE	0.0042998039956307224	9	53	3	0.05660377358490566	0.3333333333333333	GO:1900262	GO:BP	regulation of DNA-directed DNA polymerase activity	16175	20524		0.9148936170212766	0.9583333333333334	9	16166	3	50	6	16116	16175	0.13627160771349767
M1	string	0	network_modules	39	TRUE	0.0042998039956307224	9	53	3	0.05660377358490566	0.3333333333333333	GO:0033313	GO:BP	meiotic cell cycle checkpoint signaling	16175	8126		0.9148936170212766	0.9583333333333334	9	16166	3	50	6	16116	16175	0.13627160771349767
M1	string	0	network_modules	39	TRUE	0.0042998039956307224	9	53	3	0.05660377358490566	0.3333333333333333	GO:1900264	GO:BP	positive regulation of DNA-directed DNA polymerase activity	16175	20525		0.9148936170212766	0.9583333333333334	9	16166	3	50	6	16116	16175	0.13627160771349767
M1	string	0	network_modules	39	TRUE	0.005465130579294894	138	43	6	0.13953488372093023	0.043478260869565216	REAC:R-HSA-73886	REAC	Chromosome Maintenance	10916	357		0.972972972972973	0.9736842105263158	138	10778	6	37	132	10741	10916	0.07142524152490995
M1	string	0	network_modules	39	TRUE	0.006321809188025304	202	53	7	0.1320754716981132	0.034653465346534656	GO:0045930	GO:BP	negative regulation of mitotic cell cycle	16175	11724		0.9787234042553191	0.9791666666666666	202	15973	7	46	195	15927	16175	0.06174304409479307
M1	string	0	network_modules	39	TRUE	0.007233416933392103	14	43	3	0.06976744186046512	0.21428571428571427	REAC:R-HSA-5358565	REAC	Mismatch repair (MMR) directed by MSH2:MSH6 (MutSalpha)	10916	1459		1	1	14	10902	3	40	11	10862	10916	0.1203374797883246
M1	string	0	network_modules	39	TRUE	0.008556557444500951	300	53	8	0.1509433962264151	0.02666666666666667	GO:0009314	GO:BP	response to radiation	16175	3460		1	1	300	15875	8	45	292	15830	16175	0.0562640478792009
M1	string	0	network_modules	40	TRUE	4.8399670751261336e-61	345	52	43	0.8269230769230769	0.1246376811594203	GO:0016055	GO:BP	Wnt signaling pathway	16175	5087		0	0.0136986301369863	345	15830	43	9	302	15821	16175	0.31665706308840225
M1	string	0	network_modules	40	TRUE	9.38185917161346e-60	174	45	39	0.8666666666666667	0.22413793103448276	KEGG:04310	KEGG	Wnt signaling pathway	8484	299		0	0.07692307692307693	174	8310	39	6	135	8304	8484	0.4359508026010803
M1	string	0	network_modules	40	TRUE	1.8563637974349088e-50	257	52	36	0.6923076923076923	0.14007782101167315	GO:0060070	GO:BP	canonical Wnt signaling pathway	16175	14332		0.013888888888888888	0.0273972602739726	257	15918	36	16	221	15902	16175	0.30720480512365494
M1	string	0	network_modules	40	TRUE	6.747089235866524e-43	327	45	35	0.7777777777777778	0.10703363914373089	REAC:R-HSA-195721	REAC	Signaling by WNT	10916	2314		0	0.06666666666666667	327	10589	35	10	292	10579	10916	0.2822485878388899
M1	string	0	network_modules	40	TRUE	6.686937765606595e-35	63	45	22	0.4888888888888889	0.3492063492063492	KEGG:05217	KEGG	Basal cell carcinoma	8484	468		0.08333333333333333	0.15384615384615385	63	8421	22	23	41	8398	8484	0.40951740492657124
M1	string	0	network_modules	40	TRUE	1.9212958679676533e-33	61	52	20	0.38461538461538464	0.32786885245901637	GO:0035567	GO:BP	non-canonical Wnt signaling pathway	16175	9097		0.027777777777777776	0.0410958904109589	61	16114	20	32	41	16082	16175	0.35286103708405947
M1	string	0	network_modules	40	TRUE	6.316376387219895e-31	26	45	16	0.35555555555555557	0.6153846153846154	REAC:R-HSA-3238698	REAC	WNT ligand biogenesis and trafficking	10916	2668		0.07142857142857142	0.13333333333333333	26	10890	16	29	10	10861	10916	0.4661469158446519
M1	string	0	network_modules	40	TRUE	3.590178216085924e-30	93	45	21	0.4666666666666667	0.22580645161290322	REAC:R-HSA-373080	REAC	Class B/2 (Secretin family receptors)	10916	366		0.14285714285714285	0.2	93	10823	21	24	72	10799	10916	0.3207189628267894
M1	string	0	network_modules	40	TRUE	1.0761327225179959e-29	101	45	22	0.4888888888888889	0.21782178217821782	KEGG:04916	KEGG	Melanogenesis	8484	373		0.16666666666666666	0.23076923076923078	101	8383	22	23	79	8360	8484	0.3211477844320769
M1	string	0	network_modules	40	TRUE	1.701343101388869e-29	147	45	24	0.5333333333333333	0.16326530612244897	KEGG:05224	KEGG	Breast cancer	8484	475		0.25	0.3076923076923077	147	8337	24	21	123	8316	8484	0.28877069110427017
M1	string	0	network_modules	40	TRUE	2.0257301495295328e-29	148	45	24	0.5333333333333333	0.16216216216216217	KEGG:05226	KEGG	Gastric cancer	8484	477		0.3333333333333333	0.38461538461538464	148	8336	24	21	124	8315	8484	0.28774497925441705
M1	string	0	network_modules	40	TRUE	6.633904626903669e-29	155	45	24	0.5333333333333333	0.15483870967741936	KEGG:04150	KEGG	mTOR signaling pathway	8484	284		0.4166666666666667	0.46153846153846156	155	8329	24	21	131	8308	8484	0.2808406979342959
M1	string	0	network_modules	40	TRUE	3.8168803095793967e-28	166	45	24	0.5333333333333333	0.14457831325301204	KEGG:05225	KEGG	Hepatocellular carcinoma	8484	476		0.5	0.5384615384615384	166	8318	24	21	142	8297	8484	0.2708720556602332
M1	string	0	network_modules	40	TRUE	6.236336516761724e-27	157	45	23	0.5111111111111111	0.1464968152866242	KEGG:04390	KEGG	Hippo signaling pathway	8484	310		0.5833333333333334	0.6153846153846154	157	8327	23	22	134	8305	8484	0.26691116322370617
M1	string	0	network_modules	40	TRUE	4.3546287904443874e-26	143	45	22	0.4888888888888889	0.15384615384615385	KEGG:04550	KEGG	Signaling pathways regulating pluripotency of stem cells	8484	319		0.6666666666666666	0.6923076923076923	143	8341	22	23	121	8318	8484	0.2677671441952604
M1	string	0	network_modules	40	TRUE	6.640830333338804e-26	277	52	24	0.46153846153846156	0.08664259927797834	GO:0030111	GO:BP	regulation of Wnt signaling pathway	16175	6681		0.041666666666666664	0.0547945205479452	277	15898	24	28	253	15870	16175	0.19453552439514873
M1	string	0	network_modules	40	TRUE	2.1093869159339316e-25	153	45	22	0.4888888888888889	0.1437908496732026	KEGG:04934	KEGG	Cushing syndrome	8484	391		0.75	0.7692307692307693	153	8331	22	23	131	8308	8484	0.2583772516112295
M1	string	0	network_modules	40	TRUE	1.0066265055780061e-24	231	45	23	0.5111111111111111	0.09956709956709957	REAC:R-HSA-201681	REAC	TCF dependent signaling in response to WNT	10916	2421		0.21428571428571427	0.26666666666666666	231	10685	23	22	208	10663	10916	0.21902470978223343
M1	string	0	network_modules	40	TRUE	1.0569844610108294e-24	21	45	13	0.28888888888888886	0.6190476190476191	REAC:R-HSA-4641263	REAC	Regulation of FZD by ubiquitination	10916	1974		0.2857142857142857	0.3333333333333333	21	10895	13	32	8	10863	10916	0.4213479298292973
M1	string	0	network_modules	40	TRUE	3.853166805415376e-24	205	45	23	0.5111111111111111	0.11219512195121951	KEGG:05205	KEGG	Proteoglycans in cancer	8484	457		0.8333333333333334	0.8461538461538461	205	8279	23	22	182	8257	8484	0.2315677737900832
M1	string	0	network_modules	40	TRUE	1.1638079726414795e-23	382	45	27	0.6	0.07068062827225131	KEGG:05010	KEGG	Alzheimer disease	8484	411		0.9166666666666666	0.9230769230769231	382	8102	27	18	355	8084	8484	0.19543678673728687
M1	string	0	network_modules	40	TRUE	5.188427705092733e-19	15	45	10	0.2222222222222222	0.6666666666666666	REAC:R-HSA-3772470	REAC	Negative regulation of TCF-dependent signaling by WNT ligand antagonists	10916	1578		0.35714285714285715	0.4	15	10901	10	35	5	10866	10916	0.38357464274067277
M1	string	0	network_modules	40	TRUE	4.4071251796579216e-18	175	52	17	0.3269230769230769	0.09714285714285714	GO:0045165	GO:BP	cell fate commitment	16175	11307		0.05555555555555555	0.0684931506849315	175	16000	17	35	158	15965	16175	0.17352972895276592
M1	string	0	network_modules	40	TRUE	6.937686312569561e-18	330	45	22	0.4888888888888889	0.06666666666666667	KEGG:05165	KEGG	Human papillomavirus infection	8484	446		1	1	330	8154	22	23	308	8131	8484	0.16995111954540318
M1	string	0	network_modules	40	TRUE	1.5659285013424937e-17	8	45	8	0.17777777777777778	1	REAC:R-HSA-5340588	REAC	Signaling by RNF43 mutants	10916	2300		0.42857142857142855	0.4666666666666667	8	10908	8	37	0	10871	10916	0.42092131629615565
M1	string	0	network_modules	40	TRUE	1.2289255809027678e-16	212	52	17	0.3269230769230769	0.08018867924528301	GO:0060828	GO:BP	regulation of canonical Wnt signaling pathway	16175	14976		0.06944444444444445	0.0821917808219178	212	15963	17	35	195	15928	16175	0.15670163418898334
M1	string	0	network_modules	40	TRUE	1.5070700376610848e-16	34	45	11	0.24444444444444444	0.3235294117647059	REAC:R-HSA-4791275	REAC	Signaling by WNT in cancer	10916	2315		0.5	0.5333333333333333	34	10882	11	34	23	10848	10916	0.2786455299423597
M1	string	0	network_modules	40	TRUE	4.4946559984766586e-15	460	45	21	0.4666666666666667	0.04565217391304348	REAC:R-HSA-500792	REAC	GPCR ligand binding	10916	1019		0.5714285714285714	0.6	460	10456	21	24	439	10432	10916	0.1359497242542609
M1	string	0	network_modules	40	TRUE	2.6859942297017358e-14	146	52	14	0.2692307692307692	0.0958904109589041	GO:0030178	GO:BP	negative regulation of Wnt signaling pathway	16175	6698		0.08333333333333333	0.0958904109589041	146	16029	14	38	132	15991	16175	0.15624573991662427
M1	string	0	network_modules	40	TRUE	4.7986878375590744e-14	115	52	13	0.25	0.11304347826086956	GO:0030177	GO:BP	positive regulation of Wnt signaling pathway	16175	6697		0.09722222222222222	0.1095890410958904	115	16060	13	39	102	16021	16175	0.1641766721134417
M1	string	0	network_modules	40	TRUE	1.2933515825202612e-13	64	52	11	0.21153846153846154	0.171875	GO:0032526	GO:BP	response to retinoic acid	16175	7620		0.1111111111111111	0.1232876712328767	64	16111	11	41	53	16070	16175	0.18778501906279416
M1	string	0	network_modules	40	TRUE	1.7341067813912665e-13	44	52	10	0.19230769230769232	0.22727272727272727	GO:0071300	GO:BP	cellular response to retinoic acid	16175	16557		0.125	0.136986301369863	44	16131	10	42	34	16089	16175	0.20671672893521345
M1	string	0	network_modules	40	TRUE	2.0631036223476672e-12	21	52	8	0.15384615384615385	0.38095238095238093	GO:2000050	GO:BP	regulation of non-canonical Wnt signaling pathway	16175	25410		0.1388888888888889	0.1506849315068493	21	16154	8	44	13	16110	16175	0.2405910403008063
M1	string	0	network_modules	40	TRUE	1.9249000108727278e-11	512	52	18	0.34615384615384615	0.03515625	GO:0009790	GO:BP	embryo development	16175	3677		0.1527777777777778	0.1643835616438356	512	15663	18	34	494	15629	16175	0.10201670952874768
M1	string	0	network_modules	40	TRUE	5.295579466462968e-11	543	52	18	0.34615384615384615	0.03314917127071823	GO:0009887	GO:BP	animal organ morphogenesis	16175	3747		0.16666666666666666	0.1780821917808219	543	15632	18	34	525	15598	16175	0.09855574060513965
M1	string	0	network_modules	40	TRUE	2.9584557587235693e-10	36	52	8	0.15384615384615385	0.2222222222222222	GO:0060071	GO:BP	Wnt signaling pathway, planar cell polarity pathway	16175	14333		0.18055555555555555	0.1917808219178082	36	16139	8	44	28	16095	16175	0.18272223080727576
M1	string	0	network_modules	40	TRUE	9.942603508921159e-10	92	45	10	0.2222222222222222	0.10869565217391304	REAC:R-HSA-4086400	REAC	PCP/CE pathway	10916	1659		0.6428571428571429	0.6666666666666666	92	10824	10	35	82	10789	10916	0.1504676726934237
M1	string	0	network_modules	40	TRUE	1.2611422988871292e-9	250	52	13	0.25	0.052	GO:0007389	GO:BP	pattern specification process	16175	2889		0.19444444444444445	0.2054794520547945	250	15925	13	39	237	15886	16175	0.10797860897359976
M1	string	0	network_modules	40	TRUE	1.8653699338762693e-9	199	52	12	0.23076923076923078	0.06030150753768844	GO:0001654	GO:BP	eye development	16175	368		0.20833333333333334	0.2191780821917808	199	15976	12	40	187	15936	16175	0.1125503660487983
M1	string	0	network_modules	40	TRUE	2.228255186979117e-9	202	52	12	0.23076923076923078	0.0594059405940594	GO:0150063	GO:BP	visual system development	16175	20119		0.2222222222222222	0.2328767123287671	202	15973	12	40	190	15933	16175	0.11162711116752988
M1	string	0	network_modules	40	TRUE	2.6343967365407847e-9	153	52	11	0.21153846153846154	0.0718954248366013	GO:0043010	GO:BP	camera-type eye development	16175	10480		0.2361111111111111	0.2465753424657534	153	16022	11	41	142	15981	16175	0.11856077823524698
M1	string	0	network_modules	40	TRUE	3.1532033580131423e-9	208	52	12	0.23076923076923078	0.057692307692307696	GO:0048880	GO:BP	sensory system development	16175	13120		0.25	0.2602739726027397	208	15967	12	40	196	15927	16175	0.10983901393222814
M1	string	0	network_modules	40	TRUE	4.0468831981313425e-9	701	52	18	0.34615384615384615	0.025677603423680456	GO:0060429	GO:BP	epithelium development	16175	14627		0.2638888888888889	0.273972602739726	701	15474	18	34	683	15440	16175	0.08445796843990573
M1	string	0	network_modules	40	TRUE	5.085856564088318e-9	279	52	13	0.25	0.04659498207885305	GO:0007423	GO:BP	sensory organ development	16175	2918		0.2777777777777778	0.2876712328767123	279	15896	13	39	266	15857	16175	0.10152403218293446
M1	string	0	network_modules	40	TRUE	5.71494218800991e-9	118	52	10	0.19230769230769232	0.0847457627118644	GO:0090090	GO:BP	negative regulation of canonical Wnt signaling pathway	16175	18011		0.2916666666666667	0.3013698630136986	118	16057	10	42	108	16015	16175	0.12346698984973324
M1	string	0	network_modules	40	TRUE	1.0985743144284002e-8	31	45	7	0.15555555555555556	0.22580645161290322	REAC:R-HSA-4641262	REAC	Disassembly of the destruction complex and recruitment of AXIN to the membrane	10916	746		0.7142857142857143	0.7333333333333333	31	10885	7	38	24	10847	10916	0.18463907848223773
M1	string	0	network_modules	40	TRUE	8.47618234100697e-8	143	45	10	0.2222222222222222	0.06993006993006994	REAC:R-HSA-3858494	REAC	Beta-catenin independent WNT signaling	10916	216		0.7857142857142857	0.8	143	10773	10	35	133	10738	10916	0.1183310713378172
M1	string	0	network_modules	40	TRUE	1.5315524249569914e-7	4	52	4	0.07692307692307693	1	GO:0061054	GO:BP	dermatome development	16175	15170		0.3055555555555556	0.3287671232876712	4	16171	4	48	0	16123	16175	0.2769381663081502
M1	string	0	network_modules	40	TRUE	1.5315524249569914e-7	4	52	4	0.07692307692307693	1	GO:0061183	GO:BP	regulation of dermatome development	16175	15280		0.3055555555555556	0.3287671232876712	4	16171	4	48	0	16123	16175	0.2769381663081502
M1	string	0	network_modules	40	TRUE	1.7447627576793616e-7	225	52	11	0.21153846153846154	0.04888888888888889	GO:0003002	GO:BP	regionalization	16175	1453		0.3333333333333333	0.3424657534246575	225	15950	11	41	214	15909	16175	0.09582970253607595
M1	string	0	network_modules	40	TRUE	2.069946724645902e-7	11	52	5	0.09615384615384616	0.45454545454545453	GO:2000052	GO:BP	positive regulation of non-canonical Wnt signaling pathway	16175	25412		0.3472222222222222	0.3561643835616438	11	16164	5	47	6	16117	16175	0.2079871040144157
M1	string	0	network_modules	40	TRUE	4.3744845844712784e-7	129	52	9	0.17307692307692307	0.06976744186046512	GO:0061448	GO:BP	connective tissue development	16175	15483		0.3611111111111111	0.3698630136986301	129	16046	9	43	120	16003	16175	0.10541349325324773
M1	string	0	network_modules	40	TRUE	4.595118978374185e-7	86	52	8	0.15384615384615385	0.09302325581395349	GO:0090263	GO:BP	positive regulation of canonical Wnt signaling pathway	16175	18152		0.375	0.3835616438356164	86	16089	8	44	78	16045	16175	0.11599023732694186
M1	string	0	network_modules	40	TRUE	5.738383035641766e-7	13	52	5	0.09615384615384616	0.38461538461538464	GO:1904948	GO:BP	midbrain dopaminergic neuron differentiation	16175	24239		0.3888888888888889	0.3972602739726027	13	16162	5	47	8	16115	16175	0.1910843533314604
M1	string	0	network_modules	40	TRUE	5.93399958947836e-7	29	52	6	0.11538461538461539	0.20689655172413793	GO:0061053	GO:BP	somite development	16175	15169		0.4027777777777778	0.410958904109589	29	16146	6	46	23	16100	16175	0.15248890870573134
M1	string	0	network_modules	40	TRUE	7.399410528563906e-7	30	52	6	0.11538461538461539	0.2	GO:0071542	GO:BP	dopaminergic neuron differentiation	16175	16752		0.4166666666666667	0.4246575342465753	30	16145	6	46	24	16099	16175	0.14984892872076433
M1	string	0	network_modules	40	TRUE	8.671074798614273e-7	93	52	8	0.15384615384615385	0.08602150537634409	GO:0051216	GO:BP	cartilage development	16175	13573		0.4305555555555556	0.4383561643835616	93	16082	8	44	85	16038	16175	0.11123883807571022
M1	string	0	network_modules	40	TRUE	1.9978104113233963e-6	283	52	11	0.21153846153846154	0.038869257950530034	GO:0001501	GO:BP	skeletal system development	16175	318		0.4444444444444444	0.4520547945205479	283	15892	11	41	272	15851	16175	0.08404986284030284
M1	string	0	network_modules	40	TRUE	7.554435446170129e-6	408	52	12	0.23076923076923078	0.029411764705882353	GO:0071396	GO:BP	cellular response to lipid	16175	16648		0.4583333333333333	0.4657534246575342	408	15767	12	40	396	15727	16175	0.07444329508241787
M1	string	0	network_modules	40	TRUE	9.993777210366905e-6	80	52	7	0.1346153846153846	0.0875	GO:0048592	GO:BP	eye morphogenesis	16175	12861		0.4722222222222222	0.4794520547945205	80	16095	7	45	73	16050	16175	0.10497123841299938
M1	string	0	network_modules	40	TRUE	1.0290490903491845e-5	331	52	11	0.21153846153846154	0.03323262839879154	GO:0048729	GO:BP	tissue morphogenesis	16175	12986		0.4861111111111111	0.4931506849315068	331	15844	11	41	320	15803	16175	0.07664432353922716
M1	string	0	network_modules	40	TRUE	1.0969292892787775e-5	520	52	13	0.25	0.025	GO:0033993	GO:BP	response to lipid	16175	8371		0.5	0.5068493150684932	520	15655	13	39	507	15616	16175	0.07013836308050862
M1	string	0	network_modules	40	TRUE	1.66361501404823e-5	49	52	6	0.11538461538461539	0.12244897959183673	GO:0072089	GO:BP	stem cell proliferation	16175	17122		0.5138888888888888	0.5205479452054794	49	16126	6	46	43	16080	16175	0.11610609890560405
M1	string	0	network_modules	40	TRUE	4.2335973788730804e-5	57	52	6	0.11538461538461539	0.10526315789473684	GO:0009798	GO:BP	axis specification	16175	3682		0.5277777777777778	0.5342465753424658	57	16118	6	46	51	16072	16175	0.10720311450780744
M1	string	0	network_modules	40	TRUE	5.054748125796833e-5	3	52	3	0.057692307692307696	1	GO:0061184	GO:BP	positive regulation of dermatome development	16175	15281		0.5416666666666666	0.547945205479452	3	16172	3	49	0	16123	16175	0.23982807203954792
M1	string	0	network_modules	40	TRUE	5.231056635656554e-5	59	52	6	0.11538461538461539	0.1016949152542373	GO:0002062	GO:BP	chondrocyte differentiation	16175	653		0.5555555555555556	0.5616438356164384	59	16116	6	46	53	16070	16175	0.10526050490495305
M1	string	0	network_modules	40	TRUE	7.08494239737147e-5	62	52	6	0.11538461538461539	0.0967741935483871	GO:0048593	GO:BP	camera-type eye morphogenesis	16175	12862		0.5694444444444444	0.5753424657534246	62	16113	6	46	56	16067	16175	0.10252140627555519
M1	string	0	network_modules	40	TRUE	8.304632100441825e-5	617	52	13	0.25	0.02106969205834684	GO:0051093	GO:BP	negative regulation of developmental process	16175	13488		0.5833333333333334	0.589041095890411	617	15558	13	39	604	15519	16175	0.06281186674722888
M1	string	0	network_modules	40	TRUE	1.3581741203591991e-4	69	52	6	0.11538461538461539	0.08695652173913043	GO:0030901	GO:BP	midbrain development	16175	6957		0.5972222222222222	0.6027397260273972	69	16106	6	46	63	16060	16175	0.096826019561679
M1	string	0	network_modules	40	TRUE	1.6022031360285677e-4	119	52	7	0.1346153846153846	0.058823529411764705	GO:0090596	GO:BP	sensory organ morphogenesis	16175	18358		0.6111111111111112	0.6164383561643836	119	16056	7	45	112	16011	16175	0.08457016327819109
M1	string	0	network_modules	40	TRUE	1.6538304952115043e-4	434	52	11	0.21153846153846154	0.02534562211981567	GO:0045596	GO:BP	negative regulation of cell differentiation	16175	11447		0.625	0.6301369863013698	434	15741	11	41	423	15700	16175	0.06491502119596707
M1	string	0	network_modules	40	TRUE	1.7160503327469365e-4	255	52	9	0.17307692307692307	0.03529411764705882	GO:0002009	GO:BP	morphogenesis of an epithelium	16175	612		0.6388888888888888	0.6438356164383562	255	15920	9	43	246	15877	16175	0.0717204259861639
M1	string	0	network_modules	40	TRUE	2.5816162765350916e-4	418	45	11	0.24444444444444444	0.02631578947368421	REAC:R-HSA-5663202	REAC	Diseases of signal transduction by growth factor receptors and second messengers	10916	773		0.8571428571428571	0.8666666666666667	418	10498	11	34	407	10464	10916	0.06911641853674108
M1	string	0	network_modules	40	TRUE	4.533176692144989e-4	18	52	4	0.07692307692307693	0.2222222222222222	GO:0062009	GO:BP	secondary palate development	16175	15779		0.6527777777777778	0.6575342465753424	18	16157	4	48	14	16109	16175	0.12913213731521145
M1	string	0	network_modules	40	TRUE	4.7034618780663554e-4	6	45	3	0.06666666666666667	0.5	REAC:R-HSA-5339717	REAC	Signaling by LRP5 mutants 	10916	2263		0.9285714285714286	0.9333333333333333	6	10910	3	42	3	10868	10916	0.18149316416491693
M1	string	0	network_modules	40	TRUE	5.031802115849311e-4	5	52	3	0.057692307692307696	0.6	GO:0007223	GO:BP	Wnt signaling pathway, calcium modulating pathway	16175	2776		0.6666666666666666	0.6712328767123288	5	16170	3	49	2	16121	16175	0.18538205820065337
M1	string	0	network_modules	40	TRUE	5.307368998654669e-4	384	52	10	0.19230769230769232	0.026041666666666668	GO:0007420	GO:BP	brain development	16175	2915		0.6805555555555556	0.684931506849315	384	15791	10	42	374	15749	16175	0.0628819600776737
M1	string	0	network_modules	40	TRUE	5.475256683992889e-4	87	52	6	0.11538461538461539	0.06896551724137931	GO:0021953	GO:BP	central nervous system neuron differentiation	16175	6508		0.6944444444444444	0.6986301369863014	87	16088	6	46	81	16042	16175	0.08541389634648017
M1	string	0	network_modules	40	TRUE	5.641941811932396e-4	46	52	5	0.09615384615384616	0.10869565217391304	GO:0002088	GO:BP	lens development in camera-type eye	16175	674		0.7083333333333334	0.7123287671232876	46	16129	5	47	41	16082	16175	0.09951037432624474
M1	string	0	network_modules	40	TRUE	8.079890208627175e-4	402	52	10	0.19230769230769232	0.024875621890547265	GO:0060322	GO:BP	head development	16175	14534		0.7222222222222222	0.726027397260274	402	15773	10	42	392	15731	16175	0.06108713267923363
M1	string	0	network_modules	40	TRUE	8.700706576408457e-4	309	52	9	0.17307692307692307	0.02912621359223301	GO:0048598	GO:BP	embryonic morphogenesis	16175	12865		0.7361111111111112	0.7397260273972602	309	15866	9	43	300	15823	16175	0.06387864270481597
M1	string	0	network_modules	40	TRUE	0.0010040739918894734	6	52	3	0.057692307692307696	0.5	GO:0009950	GO:BP	dorsal/ventral axis specification	16175	3788		0.75	0.7808219178082192	6	16169	3	49	3	16120	16175	0.16905279336959259
M1	string	0	network_modules	40	TRUE	0.0010040739918894734	6	52	3	0.057692307692307696	0.5	GO:0061072	GO:BP	iris morphogenesis	16175	15188		0.75	0.7808219178082192	6	16169	3	49	3	16120	16175	0.16905279336959259
M1	string	0	network_modules	40	TRUE	0.0010040739918894734	6	52	3	0.057692307692307696	0.5	GO:2000096	GO:BP	positive regulation of Wnt signaling pathway, planar cell polarity pathway	16175	25447		0.75	0.7808219178082192	6	16169	3	49	3	16120	16175	0.16905279336959259
M1	string	0	network_modules	40	TRUE	0.001179848831524009	99	52	6	0.11538461538461539	0.06060606060606061	GO:0009952	GO:BP	anterior/posterior pattern specification	16175	3790		0.7916666666666666	0.7945205479452054	99	16076	6	46	93	16030	16175	0.0795598156011813
M1	string	0	network_modules	40	TRUE	0.0014428915840520057	791	52	13	0.25	0.01643489254108723	GO:1901701	GO:BP	cellular response to oxygen-containing compound	16175	21654		0.8055555555555556	0.8082191780821918	791	15384	13	39	778	15345	16175	0.05295494886460079
M1	string	0	network_modules	40	TRUE	0.0018431051095676027	25	52	4	0.07692307692307693	0.16	GO:0061180	GO:BP	mammary gland epithelium development	16175	15277		0.8194444444444444	0.821917808219178	25	16150	4	48	21	16102	16175	0.10897036144172943
M1	string	0	network_modules	40	TRUE	0.0021836057925417166	64	45	5	0.1111111111111111	0.078125	REAC:R-HSA-4608870	REAC	Asymmetric localization of PCP proteins	10916	184		1	1	64	10852	5	40	59	10812	10916	0.08869612749635196
M1	string	0	network_modules	40	TRUE	0.002212663427460604	254	52	8	0.15384615384615385	0.031496062992125984	GO:0001503	GO:BP	ossification	16175	320		0.8333333333333334	0.8356164383561644	254	15921	8	44	246	15877	16175	0.06310294075689454
M1	string	0	network_modules	40	TRUE	0.0027986487279800213	8	52	3	0.057692307692307696	0.375	GO:0070307	GO:BP	lens fiber cell development	16175	16050		0.8472222222222222	0.8493150684931506	8	16167	3	49	5	16118	16175	0.14609724225560775
M1	string	0	network_modules	40	TRUE	0.0028491645560169963	115	52	6	0.11538461538461539	0.05217391304347826	GO:0007369	GO:BP	gastrulation	16175	2871		0.8611111111111112	0.863013698630137	115	16060	6	46	109	16014	16175	0.07318617454842818
M1	string	0	network_modules	40	TRUE	0.0037778333598430533	67	52	5	0.09615384615384616	0.07462686567164178	GO:0048736	GO:BP	appendage development	16175	12993		0.875	0.8904109589041096	67	16108	5	47	62	16061	16175	0.08135938325572224
M1	string	0	network_modules	40	TRUE	0.0037778333598430533	67	52	5	0.09615384615384616	0.07462686567164178	GO:0060173	GO:BP	limb development	16175	14409		0.875	0.8904109589041096	67	16108	5	47	62	16061	16175	0.08135938325572224
M1	string	0	network_modules	40	TRUE	0.004188438319062291	9	52	3	0.057692307692307696	0.3333333333333333	GO:0061303	GO:BP	cornea development in camera-type eye	16175	15391		0.9027777777777778	0.9178082191780822	9	16166	3	49	6	16117	16175	0.13759717431186397
M1	string	0	network_modules	40	TRUE	0.004188438319062291	9	52	3	0.057692307692307696	0.3333333333333333	GO:2000095	GO:BP	regulation of Wnt signaling pathway, planar cell polarity pathway	16175	25446		0.9027777777777778	0.9178082191780822	9	16166	3	49	6	16117	16175	0.13759717431186397
M1	string	0	network_modules	40	TRUE	0.004952746907081052	283	52	8	0.15384615384615385	0.028268551236749116	GO:0050808	GO:BP	synapse organization	16175	13274		0.9305555555555556	0.9315068493150684	283	15892	8	44	275	15848	16175	0.05906031205373044
M1	string	0	network_modules	40	TRUE	0.005006172148362138	744	52	12	0.23076923076923078	0.016129032258064516	GO:0072359	GO:BP	circulatory system development	16175	17370		0.9444444444444444	0.9452054794520548	744	15431	12	40	732	15391	16175	0.05009293142267396
M1	string	0	network_modules	40	TRUE	0.007131567746789171	770	52	12	0.23076923076923078	0.015584415584415584	GO:0048646	GO:BP	anatomical structure formation involved in morphogenesis	16175	12904		0.9583333333333334	0.958904109589041	770	15405	12	40	758	15365	16175	0.048852757303145804
M1	string	0	network_modules	40	TRUE	0.008041011395888661	78	52	5	0.09615384615384616	0.0641025641025641	GO:0046330	GO:BP	positive regulation of JNK cascade	16175	12063		0.9722222222222222	0.9726027397260274	78	16097	5	47	73	16050	16175	0.07487283492317769
M1	string	0	network_modules	40	TRUE	0.009112365927696077	80	52	5	0.09615384615384616	0.0625	GO:0030278	GO:BP	regulation of ossification	16175	6755		0.9861111111111112	0.9863013698630136	80	16095	5	47	75	16048	16175	0.07383549768352127
M1	string	0	network_modules	40	TRUE	0.009352449335266688	37	52	4	0.07692307692307693	0.10810810810810811	GO:0060021	GO:BP	roof of mouth development	16175	14284		1	1	37	16138	4	48	33	16090	16175	0.0887244515000158
M1	string	0	network_modules	41	TRUE	2.8932399355068457e-11	558	49	18	0.3673469387755102	0.03225806451612903	GO:0055086	GO:BP	nucleobase-containing small molecule metabolic process	16175	14237		0	0.02127659574468085	558	15617	18	31	540	15586	16175	0.10053347374976025
M1	string	0	network_modules	41	TRUE	4.679879537555199e-10	126	39	11	0.28205128205128205	0.0873015873015873	KEGG:00230	KEGG	Purine metabolism	8484	22		0	0.1111111111111111	126	8358	11	28	115	8330	8484	0.15011801189139745
M1	string	0	network_modules	41	TRUE	1.1770831858623487e-9	13	41	6	0.14634146341463414	0.46153846153846156	REAC:R-HSA-74217	REAC	Purine salvage	10916	1825		0	0.1	13	10903	6	35	7	10868	10916	0.25841328034267314
M1	string	0	network_modules	41	TRUE	5.129181379111861e-9	115	39	10	0.2564102564102564	0.08695652173913043	KEGG:01200	KEGG	Carbon metabolism	8484	184		0.125	0.2222222222222222	115	8369	10	29	105	8340	8484	0.14272336312935222
M1	string	0	network_modules	41	TRUE	1.3340786704880195e-8	91	41	9	0.21951219512195122	0.0989010989010989	REAC:R-HSA-15869	REAC	Metabolism of nucleotides	10916	1432		0.1111111111111111	0.2	91	10825	9	32	82	10793	10916	0.14261011784826677
M1	string	0	network_modules	41	TRUE	2.1300468708030783e-8	8	49	5	0.10204081632653061	0.625	GO:0043101	GO:BP	purine-containing compound salvage	16175	10530		0.021739130434782608	0.0425531914893617	8	16167	5	44	3	16123	16175	0.2517578817980133
M1	string	0	network_modules	41	TRUE	3.630393662286412e-8	521	49	15	0.30612244897959184	0.028790786948176585	GO:0006753	GO:BP	nucleoside phosphate metabolic process	16175	2450		0.043478260869565216	0.06382978723404255	521	15654	15	34	506	15620	16175	0.08551827409861766
M1	string	0	network_modules	41	TRUE	4.461483824243131e-8	742	49	17	0.3469387755102041	0.022911051212938006	GO:0019752	GO:BP	carboxylic acid metabolic process	16175	6036		0.06521739130434782	0.0851063829787234	742	15433	17	32	725	15401	16175	0.07932551179552982
M1	string	0	network_modules	41	TRUE	6.250663465143314e-8	4	41	4	0.0975609756097561	1	REAC:R-HSA-9735804	REAC	Diseases of nucleotide metabolism	10916	770		0.2222222222222222	0.3	4	10912	4	37	0	10875	10916	0.31181752599199963
M1	string	0	network_modules	41	TRUE	6.639039018542683e-8	761	49	17	0.3469387755102041	0.022339027595269383	GO:0043436	GO:BP	oxoacid metabolic process	16175	10693		0.08695652173913043	0.10638297872340426	761	15414	17	32	744	15382	16175	0.07807144695621325
M1	string	0	network_modules	41	TRUE	6.736303394107226e-8	23	41	6	0.14634146341463414	0.2608695652173913	REAC:R-HSA-8956321	REAC	Nucleotide salvage	10916	1626		0.3333333333333333	0.4	23	10893	6	35	17	10858	10916	0.19313998762013437
M1	string	0	network_modules	41	TRUE	7.509777693025331e-8	767	49	17	0.3469387755102041	0.02216427640156454	GO:0006082	GO:BP	organic acid metabolic process	16175	1947		0.10869565217391304	0.1276595744680851	767	15408	17	32	750	15376	16175	0.07768441412123382
M1	string	0	network_modules	41	TRUE	1.209847319328868e-7	469	49	14	0.2857142857142857	0.029850746268656716	GO:0072521	GO:BP	purine-containing compound metabolic process	16175	17423		0.13043478260869565	0.14893617021276595	469	15706	14	35	455	15671	16175	0.08433690612007524
M1	string	0	network_modules	41	TRUE	1.5863159808025906e-7	388	49	13	0.2653061224489796	0.03350515463917526	GO:0009117	GO:BP	nucleotide metabolic process	16175	3286		0.15217391304347827	0.1702127659574468	388	15787	13	36	375	15751	16175	0.08693685564581101
M1	string	0	network_modules	41	TRUE	1.6941008763650633e-7	50	39	7	0.1794871794871795	0.14	KEGG:00270	KEGG	Cysteine and methionine metabolism	8484	30		0.25	0.3333333333333333	50	8434	7	32	43	8402	8484	0.15412226339912674
M1	string	0	network_modules	41	TRUE	1.767209525281875e-7	25	49	6	0.12244897959183673	0.24	GO:0043094	GO:BP	cellular metabolic compound salvage	16175	10523		0.17391304347826086	0.19148936170212766	25	16150	6	43	19	16107	16175	0.16965286279382732
M1	string	0	network_modules	41	TRUE	2.511306549240116e-7	84	39	8	0.20512820512820512	0.09523809523809523	KEGG:01232	KEGG	Nucleotide metabolism	8484	189		0.375	0.4444444444444444	84	8400	8	31	76	8369	8484	0.13399673283267519
M1	string	0	network_modules	41	TRUE	3.7336838342253325e-7	28	49	6	0.12244897959183673	0.21428571428571427	GO:0009161	GO:BP	ribonucleoside monophosphate metabolic process	16175	3327		0.1956521739130435	0.2127659574468085	28	16147	6	43	22	16104	16175	0.16007583740686243
M1	string	0	network_modules	41	TRUE	7.034188478606608e-7	349	49	12	0.24489795918367346	0.034383954154727794	GO:0006163	GO:BP	purine nucleotide metabolic process	16175	1998		0.21739130434782608	0.23404255319148937	349	15826	12	37	337	15789	16175	0.08472491675331714
M1	string	0	network_modules	41	TRUE	7.511905586502323e-7	14	49	5	0.10204081632653061	0.35714285714285715	GO:0006144	GO:BP	purine nucleobase metabolic process	16175	1988		0.2391304347826087	0.2553191489361702	14	16161	5	44	9	16117	16175	0.18965106982396984
M1	string	0	network_modules	41	TRUE	1.0852004396489128e-6	33	49	6	0.12244897959183673	0.18181818181818182	GO:0009123	GO:BP	nucleoside monophosphate metabolic process	16175	3290		0.2608695652173913	0.2765957446808511	33	16142	6	43	27	16099	16175	0.1470962384942516
M1	string	0	network_modules	41	TRUE	5.738721627318158e-6	20	49	5	0.10204081632653061	0.25	GO:0009156	GO:BP	ribonucleoside monophosphate biosynthetic process	16175	3323		0.2826086956521739	0.2978723404255319	20	16155	5	44	15	16111	16175	0.15812107356619148
M1	string	0	network_modules	41	TRUE	8.496510633723117e-6	260	49	10	0.20408163265306123	0.038461538461538464	GO:1901293	GO:BP	nucleoside phosphate biosynthetic process	16175	21368		0.30434782608695654	0.3191489361702128	260	15915	10	39	250	15876	16175	0.08240699002417337
M1	string	0	network_modules	41	TRUE	9.703240127311647e-6	22	49	5	0.10204081632653061	0.22727272727272727	GO:0009112	GO:BP	nucleobase metabolic process	16175	3281		0.32608695652173914	0.3617021276595745	22	16153	5	44	17	16109	16175	0.15058692307352758
M1	string	0	network_modules	41	TRUE	9.703240127311647e-6	22	49	5	0.10204081632653061	0.22727272727272727	GO:0009167	GO:BP	purine ribonucleoside monophosphate metabolic process	16175	3333		0.32608695652173914	0.3617021276595745	22	16153	5	44	17	16109	16175	0.15058692307352758
M1	string	0	network_modules	41	TRUE	1.2370475773817179e-5	23	49	5	0.10204081632653061	0.21739130434782608	GO:0009124	GO:BP	nucleoside monophosphate biosynthetic process	16175	3291		0.3695652173913043	0.40425531914893614	23	16152	5	44	18	16108	16175	0.14719103579463644
M1	string	0	network_modules	41	TRUE	1.2370475773817179e-5	23	49	5	0.10204081632653061	0.21739130434782608	GO:0009126	GO:BP	purine nucleoside monophosphate metabolic process	16175	3293		0.3695652173913043	0.40425531914893614	23	16152	5	44	18	16108	16175	0.14719103579463644
M1	string	0	network_modules	41	TRUE	1.714804483988547e-5	9	49	4	0.08163265306122448	0.4444444444444444	GO:0009113	GO:BP	purine nucleobase biosynthetic process	16175	3282		0.41304347826086957	0.425531914893617	9	16166	4	45	5	16121	16175	0.18951782042020504
M1	string	0	network_modules	41	TRUE	1.79509185250287e-5	3	41	3	0.07317073170731707	1	REAC:R-HSA-9734207	REAC	Nucleotide salvage defects	10916	1627		0.4444444444444444	0.5	3	10913	3	38	0	10875	10916	0.2700295260839489
M1	string	0	network_modules	41	TRUE	1.885083675021395e-5	143	49	8	0.16326530612244897	0.055944055944055944	GO:0072524	GO:BP	pyridine-containing compound metabolic process	16175	17426		0.43478260869565216	0.44680851063829785	143	16032	8	41	135	15991	16175	0.09093547536719268
M1	string	0	network_modules	41	TRUE	1.9514779106545165e-5	31	39	5	0.1282051282051282	0.16129032258064516	KEGG:00030	KEGG	Pentose phosphate pathway	8484	4		0.5	0.5555555555555556	31	8453	5	34	26	8419	8484	0.14027967178876394
M1	string	0	network_modules	41	TRUE	2.682823762685132e-5	482	49	12	0.24489795918367346	0.024896265560165973	GO:0044283	GO:BP	small molecule biosynthetic process	16175	10950		0.45652173913043476	0.46808510638297873	482	15693	12	37	470	15656	16175	0.06973337057248596
M1	string	0	network_modules	41	TRUE	2.7751150462492006e-5	288	41	10	0.24390243902439024	0.034722222222222224	REAC:R-HSA-71387	REAC	Metabolism of carbohydrates	10916	1422		0.5555555555555556	0.6	288	10628	10	31	278	10597	10916	0.0833328624985147
M1	string	0	network_modules	41	TRUE	3.330006043163758e-5	300	49	10	0.20408163265306123	0.03333333333333333	GO:0044282	GO:BP	small molecule catabolic process	16175	10949		0.4782608695652174	0.48936170212765956	300	15875	10	39	290	15836	16175	0.075802960383572
M1	string	0	network_modules	41	TRUE	4.0885115693778585e-5	67	39	6	0.15384615384615385	0.08955223880597014	KEGG:00010	KEGG	Glycolysis / Gluconeogenesis	8484	2		0.625	0.6666666666666666	67	8417	6	33	61	8384	8484	0.11205158480410803
M1	string	0	network_modules	41	TRUE	4.838258863013408e-5	3	49	3	0.061224489795918366	1	GO:0043096	GO:BP	purine nucleobase salvage	16175	10525		0.5	0.5106382978723404	3	16172	3	46	0	16126	16175	0.24708367303836232
M1	string	0	network_modules	41	TRUE	1.347224644819617e-4	14	49	4	0.08163265306122448	0.2857142857142857	GO:0046112	GO:BP	nucleobase biosynthetic process	16175	11888		0.5217391304347826	0.574468085106383	14	16161	4	45	10	16116	16175	0.15139637087021418
M1	string	0	network_modules	41	TRUE	1.347224644819617e-4	14	49	4	0.08163265306122448	0.2857142857142857	GO:0046128	GO:BP	purine ribonucleoside metabolic process	16175	11904		0.5217391304347826	0.574468085106383	14	16161	4	45	10	16116	16175	0.15139637087021418
M1	string	0	network_modules	41	TRUE	1.347224644819617e-4	14	49	4	0.08163265306122448	0.2857142857142857	GO:0009168	GO:BP	purine ribonucleoside monophosphate biosynthetic process	16175	3334		0.5217391304347826	0.574468085106383	14	16161	4	45	10	16116	16175	0.15139637087021418
M1	string	0	network_modules	41	TRUE	1.6698934389181185e-4	47	39	5	0.1282051282051282	0.10638297872340426	KEGG:00620	KEGG	Pyruvate metabolism	8484	99		0.75	0.7777777777777778	47	8437	5	34	42	8403	8484	0.11230830364382943
M1	string	0	network_modules	41	TRUE	1.8330364027662152e-4	15	49	4	0.08163265306122448	0.26666666666666666	GO:0009127	GO:BP	purine nucleoside monophosphate biosynthetic process	16175	3294		0.5869565217391305	0.5957446808510638	15	16160	4	45	11	16115	16175	0.14615535385164427
M1	string	0	network_modules	41	TRUE	4.0818552644085893e-4	18	49	4	0.08163265306122448	0.2222222222222222	GO:0042278	GO:BP	purine nucleoside metabolic process	16175	10074		0.6086956521739131	0.6170212765957447	18	16157	4	45	14	16112	16175	0.1331267123255769
M1	string	0	network_modules	41	TRUE	4.817638762644785e-4	5	49	3	0.061224489795918366	0.6	GO:0042451	GO:BP	purine nucleoside biosynthetic process	16175	10190		0.6304347826086957	0.6808510638297872	5	16170	3	46	2	16124	16175	0.19101430012590817
M1	string	0	network_modules	41	TRUE	4.817638762644785e-4	5	49	3	0.061224489795918366	0.6	GO:0042455	GO:BP	ribonucleoside biosynthetic process	16175	10194		0.6304347826086957	0.6808510638297872	5	16170	3	46	2	16124	16175	0.19101430012590817
M1	string	0	network_modules	41	TRUE	4.817638762644785e-4	5	49	3	0.061224489795918366	0.6	GO:0046129	GO:BP	purine ribonucleoside biosynthetic process	16175	11905		0.6304347826086957	0.6808510638297872	5	16170	3	46	2	16124	16175	0.19101430012590817
M1	string	0	network_modules	41	TRUE	5.21138192635647e-4	512	49	11	0.22448979591836735	0.021484375	GO:0090407	GO:BP	organophosphate biosynthetic process	16175	18274		0.6956521739130435	0.7021276595744681	512	15663	11	38	501	15625	16175	0.06071481586614248
M1	string	0	network_modules	41	TRUE	5.331658837632191e-4	220	49	8	0.16326530612244897	0.03636363636363636	GO:0072522	GO:BP	purine-containing compound biosynthetic process	16175	17424		0.717391304347826	0.723404255319149	220	15955	8	41	212	15914	16175	0.07122571330632951
M1	string	0	network_modules	41	TRUE	6.434211293061972e-4	20	49	4	0.08163265306122448	0.2	GO:0009119	GO:BP	ribonucleoside metabolic process	16175	3288		0.7391304347826086	0.7446808510638298	20	16155	4	45	16	16110	16175	0.12610895309641054
M1	string	0	network_modules	41	TRUE	9.614726254373461e-4	6	49	3	0.061224489795918366	0.5	GO:0032261	GO:BP	purine nucleotide salvage	16175	7447		0.7608695652173914	0.7659574468085106	6	16169	3	46	3	16123	16175	0.17419981643389795
M1	string	0	network_modules	41	TRUE	0.0016087380610610325	36	39	4	0.10256410256410256	0.1111111111111111	KEGG:00350	KEGG	Tyrosine metabolism	8484	41		0.875	0.8888888888888888	36	8448	4	35	32	8413	8484	0.10278989683560039
M1	string	0	network_modules	41	TRUE	0.0018015279377911768	177	49	7	0.14285714285714285	0.03954802259887006	GO:1901605	GO:BP	alpha-amino acid metabolic process	16175	21589		0.782608695652174	0.7872340425531915	177	15998	7	42	170	15956	16175	0.0698958672392527
M1	string	0	network_modules	41	TRUE	0.0020064194390900084	61	49	5	0.10204081632653061	0.08196721311475409	GO:1901657	GO:BP	glycosyl compound metabolic process	16175	21624		0.8043478260869565	0.8085106382978723	61	16114	5	44	56	16070	16175	0.08837540873120424
M1	string	0	network_modules	41	TRUE	0.0023641194937113344	33	41	4	0.0975609756097561	0.12121212121212122	REAC:R-HSA-70263	REAC	Gluconeogenesis	10916	1052		0.6666666666666666	0.7	33	10883	4	37	29	10846	10916	0.10573419035695973
M1	string	0	network_modules	41	TRUE	0.0025121881375483085	186	49	7	0.14285714285714285	0.03763440860215054	GO:0009165	GO:BP	nucleotide biosynthetic process	16175	3331		0.8260869565217391	0.8297872340425532	186	15989	7	42	179	15947	16175	0.06791537872419662
M1	string	0	network_modules	41	TRUE	0.0029006042806121743	11	41	3	0.07317073170731707	0.2727272727272727	REAC:R-HSA-9755088	REAC	Ribavirin ADME	10916	2105		0.7777777777777778	0.8	11	10905	3	38	8	10867	10916	0.13965177010059973
M1	string	0	network_modules	41	TRUE	0.00401240553524907	9	49	3	0.061224489795918366	0.3333333333333333	GO:0043173	GO:BP	nucleotide salvage	16175	10568		0.8478260869565217	0.851063829787234	9	16166	3	46	6	16120	16175	0.14181320713184362
M1	string	0	network_modules	41	TRUE	0.005543352711497679	49	39	4	0.10256410256410256	0.08163265306122448	KEGG:00520	KEGG	Amino sugar and nucleotide sugar metabolism	8484	69		1	1	49	8435	4	35	45	8400	8484	0.0867993403094562
M1	string	0	network_modules	41	TRUE	0.0058155660933835495	211	49	7	0.14285714285714285	0.03317535545023697	GO:0016054	GO:BP	organic acid catabolic process	16175	5086		0.8695652173913043	0.8936170212765957	211	15964	7	42	204	15922	16175	0.06306419088672507
M1	string	0	network_modules	41	TRUE	0.0058155660933835495	211	49	7	0.14285714285714285	0.03317535545023697	GO:0046395	GO:BP	carboxylic acid catabolic process	16175	12121		0.8695652173913043	0.8936170212765957	211	15964	7	42	204	15922	16175	0.06306419088672507
M1	string	0	network_modules	41	TRUE	0.00590585854248801	86	41	5	0.12195121951219512	0.05813953488372093	REAC:R-HSA-70326	REAC	Glucose metabolism	10916	1053		0.8888888888888888	0.9	86	10830	5	36	81	10794	10916	0.07922454596503613
M1	string	0	network_modules	41	TRUE	0.0059697616602963285	34	49	4	0.08163265306122448	0.11764705882352941	GO:0009066	GO:BP	aspartate family amino acid metabolic process	16175	3242		0.9130434782608695	0.9148936170212766	34	16141	4	45	30	16096	16175	0.09572135161485779
M1	string	0	network_modules	41	TRUE	0.0066241050077105405	138	49	6	0.12244897959183673	0.043478260869565216	GO:0170039	GO:BP	proteinogenic amino acid metabolic process	16175	20287		0.9347826086956522	0.9787234042553191	138	16037	6	43	132	15994	16175	0.06827591945335973
M1	string	0	network_modules	41	TRUE	0.0066241050077105405	138	49	6	0.12244897959183673	0.043478260869565216	GO:0019362	GO:BP	pyridine nucleotide metabolic process	16175	5724		0.9347826086956522	0.9787234042553191	138	16037	6	43	132	15994	16175	0.06827591945335973
M1	string	0	network_modules	41	TRUE	0.0066241050077105405	138	49	6	0.12244897959183673	0.043478260869565216	GO:0046496	GO:BP	nicotinamide nucleotide metabolic process	16175	12199		0.9347826086956522	0.9787234042553191	138	16037	6	43	132	15994	16175	0.06827591945335973
M1	string	0	network_modules	41	TRUE	0.007915487303517378	15	41	3	0.07317073170731707	0.2	REAC:R-HSA-71336	REAC	Pentose phosphate pathway	10916	1721		1	1	15	10901	3	38	12	10863	10916	0.11900519313734895
M1	string	0	network_modules	41	TRUE	0.008474166460597876	144	49	6	0.12244897959183673	0.041666666666666664	GO:0170033	GO:BP	L-amino acid metabolic process	16175	20281		1	1	144	16031	6	43	138	15988	16175	0.06663319452003089
M1	string	0	network_modules	42	TRUE	2.4453118223162304e-40	226	45	29	0.6444444444444445	0.12831858407079647	GO:0006402	GO:BP	mRNA catabolic process	16175	2163		0	0.02127659574468085	226	15949	29	16	197	15933	16175	0.2837124540986607
M1	string	0	network_modules	42	TRUE	1.5132489662766569e-37	279	45	29	0.6444444444444445	0.1039426523297491	GO:0006401	GO:BP	RNA catabolic process	16175	2162		0.021739130434782608	0.0425531914893617	279	15896	29	16	250	15880	16175	0.25444290148943965
M1	string	0	network_modules	42	TRUE	1.2265320785748997e-36	299	45	29	0.6444444444444445	0.09698996655518395	GO:0141188	GO:BP	nucleic acid catabolic process	16175	20075		0.043478260869565216	0.06382978723404255	299	15876	29	16	270	15860	16175	0.24545574412110374
M1	string	0	network_modules	42	TRUE	2.7640905221136098e-33	113	45	22	0.4888888888888889	0.19469026548672566	GO:0000956	GO:BP	nuclear-transcribed mRNA catabolic process	16175	264		0.06521739130434782	0.0851063829787234	113	16062	22	23	91	16039	16175	0.3056003019535449
M1	string	0	network_modules	42	TRUE	1.286059563587545e-32	97	45	21	0.4666666666666667	0.21649484536082475	GO:0061014	GO:BP	positive regulation of mRNA catabolic process	16175	15137		0.08695652173913043	0.10638297872340426	97	16078	21	24	76	16054	16175	0.3151528114437412
M1	string	0	network_modules	42	TRUE	2.1143218474963707e-31	448	45	29	0.6444444444444445	0.06473214285714286	GO:0034655	GO:BP	nucleobase-containing compound catabolic process	16175	8711		0.10869565217391304	0.1276595744680851	448	15727	29	16	419	15711	16175	0.1985083255987651
M1	string	0	network_modules	42	TRUE	5.412072011559489e-31	172	45	23	0.5111111111111111	0.13372093023255813	GO:0061013	GO:BP	regulation of mRNA catabolic process	16175	15136		0.13043478260869565	0.14893617021276595	172	16003	23	22	149	15981	16175	0.257722848164569
M1	string	0	network_modules	42	TRUE	6.960328934443404e-31	92	45	20	0.4444444444444444	0.21739130434782608	GO:0061157	GO:BP	mRNA destabilization	16175	15262		0.15217391304347827	0.1702127659574468	92	16083	20	25	72	16058	16175	0.30816239048666183
M1	string	0	network_modules	42	TRUE	1.4204267681018961e-30	95	45	20	0.4444444444444444	0.21052631578947367	GO:0050779	GO:BP	RNA destabilization	16175	13253		0.17391304347826086	0.19148936170212766	95	16080	20	25	75	16055	16175	0.30315771864459434
M1	string	0	network_modules	42	TRUE	4.427710561686241e-30	125	45	21	0.4666666666666667	0.168	GO:1903313	GO:BP	positive regulation of mRNA metabolic process	16175	22897		0.1956521739130435	0.2127659574468085	125	16050	21	24	104	16026	16175	0.2768187547258678
M1	string	0	network_modules	42	TRUE	5.919231507048769e-30	156	45	22	0.4888888888888889	0.14102564102564102	GO:0043488	GO:BP	regulation of mRNA stability	16175	10733		0.21739130434782608	0.23404255319148937	156	16019	22	23	134	15996	16175	0.2590063355684326
M1	string	0	network_modules	42	TRUE	2.9058164700563213e-29	167	45	22	0.4888888888888889	0.1317365269461078	GO:0043487	GO:BP	regulation of RNA stability	16175	10732		0.2391304347826087	0.2553191489361702	167	16008	22	23	145	15985	16175	0.2500615390042125
M1	string	0	network_modules	42	TRUE	2.602129543533791e-28	57	45	17	0.37777777777777777	0.2982456140350877	GO:0000288	GO:BP	nuclear-transcribed mRNA catabolic process, deadenylation-dependent decay	16175	81		0.2608695652173913	0.2765957446808511	57	16118	17	28	40	16090	16175	0.33358506772981983
M1	string	0	network_modules	42	TRUE	3.297287848813419e-28	434	45	27	0.6	0.06221198156682028	GO:0010608	GO:BP	post-transcriptional regulation of gene expression	16175	4255		0.2826086956521739	0.2978723404255319	434	15741	27	18	407	15723	16175	0.1873504023246916
M1	string	0	network_modules	42	TRUE	6.766688673526431e-28	590	45	29	0.6444444444444445	0.04915254237288136	GO:0016071	GO:BP	mRNA metabolic process	16175	5098		0.30434782608695654	0.3191489361702128	590	15585	29	16	561	15569	16175	0.17129116417407944
M1	string	0	network_modules	42	TRUE	3.0778103357960847e-26	56	27	15	0.5555555555555556	0.26785714285714285	REAC:R-HSA-429914	REAC	Deadenylation-dependent mRNA decay	10916	454		0	0.09090909090909091	56	10860	15	12	41	10848	10916	0.3836551276025053
M1	string	0	network_modules	42	TRUE	3.5045587929697337e-26	273	45	23	0.5111111111111111	0.08424908424908426	GO:1903311	GO:BP	regulation of mRNA metabolic process	16175	22895		0.32608695652173914	0.3404255319148936	273	15902	23	22	250	15880	16175	0.2026553585262973
M1	string	0	network_modules	42	TRUE	8.008217264568412e-26	31	45	14	0.3111111111111111	0.45161290322580644	GO:0000289	GO:BP	nuclear-transcribed mRNA poly(A) tail shortening	16175	82		0.34782608695652173	0.3617021276595745	31	16144	14	31	17	16113	16175	0.3734038608451899
M1	string	0	network_modules	42	TRUE	4.797823837082281e-24	25	27	12	0.4444444444444444	0.48	REAC:R-HSA-429947	REAC	Deadenylation of mRNA	10916	453		0.1	0.18181818181818182	25	10891	12	15	13	10876	10916	0.4605972166954403
M1	string	0	network_modules	42	TRUE	5.3922127095897075e-22	79	23	14	0.6086956521739131	0.17721518987341772	KEGG:03018	KEGG	RNA degradation	8484	211		0	0.5	79	8405	14	9	65	8396	8484	0.3253692276062462
M1	string	0	network_modules	42	TRUE	1.4241754641428192e-19	21	27	10	0.37037037037037035	0.47619047619047616	REAC:R-HSA-6804115	REAC	TP53 regulates transcription of additional cell cycle genes whose exact role in the p53 pathway remain uncertain	10916	2461		0.2	0.2727272727272727	21	10895	10	17	11	10878	10916	0.4186997345080272
M1	string	0	network_modules	42	TRUE	1.3123682092673653e-18	25	27	10	0.37037037037037035	0.4	REAC:R-HSA-9820841	REAC	M-decay: degradation of maternal mRNAs by maternally stored factors	10916	1344		0.3	0.36363636363636365	25	10891	10	17	15	10874	10916	0.38343338975885605
M1	string	0	network_modules	42	TRUE	1.654494593665371e-17	477	45	21	0.4666666666666667	0.0440251572327044	GO:0009896	GO:BP	positive regulation of catabolic process	16175	3756		0.3695652173913043	0.3829787234042553	477	15698	21	24	456	15674	16175	0.1364925762797955
M1	string	0	network_modules	42	TRUE	3.1887495486499585e-15	49	27	10	0.37037037037037035	0.20408163265306123	REAC:R-HSA-6791312	REAC	TP53 Regulates Transcription of Cell Cycle Genes	10916	2454		0.4	0.45454545454545453	49	10867	10	17	39	10850	10916	0.2725455169921967
M1	string	0	network_modules	42	TRUE	4.450795722981005e-15	112	45	13	0.28888888888888886	0.11607142857142858	GO:0031047	GO:BP	regulatory ncRNA-mediated gene silencing	16175	7011		0.391304347826087	0.40425531914893614	112	16063	13	32	99	16031	16175	0.1795997153843535
M1	string	0	network_modules	42	TRUE	1.686359546444988e-14	62	45	11	0.24444444444444444	0.1774193548387097	GO:0035194	GO:BP	regulatory ncRNA-mediated post-transcriptional gene silencing	16175	8883		0.41304347826086957	0.425531914893617	62	16113	11	34	51	16079	16175	0.20566739998681688
M1	string	0	network_modules	42	TRUE	4.2225854446590114e-14	67	45	11	0.24444444444444444	0.16417910447761194	GO:0016441	GO:BP	post-transcriptional gene silencing	16175	5222		0.43478260869565216	0.44680851063829785	67	16108	11	34	56	16074	16175	0.19762095213357364
M1	string	0	network_modules	42	TRUE	1.605348912655788e-13	50	45	10	0.2222222222222222	0.2	GO:0035195	GO:BP	miRNA-mediated post-transcriptional gene silencing	16175	8884		0.45652173913043476	0.46808510638297873	50	16125	10	35	40	16090	16175	0.2084982350465198
M1	string	0	network_modules	42	TRUE	5.824735578366695e-13	119	27	11	0.4074074074074074	0.09243697478991597	REAC:R-HSA-9816359	REAC	Maternal to zygotic transition (MZT)	10916	1394		0.5	0.5454545454545454	119	10797	11	16	108	10781	10916	0.19014115101019438
M1	string	0	network_modules	42	TRUE	4.766359896044852e-9	359	27	12	0.4444444444444444	0.033426183844011144	REAC:R-HSA-3700989	REAC	Transcriptional Regulation by TP53	10916	2546		0.6	0.6363636363636364	359	10557	12	15	347	10542	10916	0.11491159544145128
M1	string	0	network_modules	42	TRUE	7.080577107323699e-9	17	45	6	0.13333333333333333	0.35294117647058826	GO:0033962	GO:BP	P-body assembly	16175	8367		0.4782608695652174	0.48936170212765956	17	16158	6	39	11	16119	16175	0.21563384730064772
M1	string	0	network_modules	42	TRUE	2.8782519423674713e-8	110	45	9	0.2	0.08181818181818182	GO:0017148	GO:BP	negative regulation of translation	16175	5285		0.5	0.5106382978723404	110	16065	9	36	101	16029	16175	0.12416591330700749
M1	string	0	network_modules	42	TRUE	9.332088783096287e-8	4	45	4	0.08888888888888889	1	GO:0010606	GO:BP	positive regulation of cytoplasmic mRNA processing body assembly	16175	4253		0.5217391304347826	0.5319148936170213	4	16171	4	41	0	16130	16175	0.29776420158213907
M1	string	0	network_modules	42	TRUE	2.9952633035281687e-7	13	45	5	0.1111111111111111	0.38461538461538464	GO:0060213	GO:BP	positive regulation of nuclear-transcribed mRNA poly(A) tail shortening	16175	14437		0.5434782608695652	0.5531914893617021	13	16162	5	40	8	16122	16175	0.20559795470293687
M1	string	0	network_modules	42	TRUE	4.65658014963095e-7	5	45	4	0.08888888888888889	0.8	GO:0010603	GO:BP	regulation of cytoplasmic mRNA processing body assembly	16175	4250		0.5652173913043478	0.574468085106383	5	16170	4	41	1	16129	16175	0.26615087488053646
M1	string	0	network_modules	42	TRUE	5.373066563390537e-7	290	45	11	0.24444444444444444	0.03793103448275862	GO:0006417	GO:BP	regulation of translation	16175	2174		0.5869565217391305	0.5957446808510638	290	15885	11	34	279	15851	16175	0.09016516036361391
M1	string	0	network_modules	42	TRUE	6.960164452138338e-7	15	45	5	0.1111111111111111	0.3333333333333333	GO:0110156	GO:BP	mRNA methylguanosine-cap decapping	16175	19450		0.6086956521739131	0.6595744680851063	15	16160	5	40	10	16120	16175	0.1911985612609776
M1	string	0	network_modules	42	TRUE	6.960164452138338e-7	15	45	5	0.1111111111111111	0.3333333333333333	GO:0060211	GO:BP	regulation of nuclear-transcribed mRNA poly(A) tail shortening	16175	14435		0.6086956521739131	0.6595744680851063	15	16160	5	40	10	16120	16175	0.1911985612609776
M1	string	0	network_modules	42	TRUE	6.960164452138338e-7	15	45	5	0.1111111111111111	0.3333333333333333	GO:1900153	GO:BP	positive regulation of nuclear-transcribed mRNA catabolic process, deadenylation-dependent decay	16175	20437		0.6086956521739131	0.6595744680851063	15	16160	5	40	10	16120	16175	0.1911985612609776
M1	string	0	network_modules	42	TRUE	1.9735822679968767e-6	18	45	5	0.1111111111111111	0.2777777777777778	GO:0110154	GO:BP	RNA decapping	16175	19448		0.6739130434782609	0.6808510638297872	18	16157	5	40	13	16117	16175	0.1742619832476669
M1	string	0	network_modules	42	TRUE	1.4903931883179785e-5	26	45	5	0.1111111111111111	0.19230769230769232	GO:1900151	GO:BP	regulation of nuclear-transcribed mRNA catabolic process, deadenylation-dependent decay	16175	20435		0.6956521739130435	0.7021276595744681	26	16149	5	40	21	16109	16175	0.1443785361774111
M1	string	0	network_modules	42	TRUE	1.936011328754194e-5	10	45	4	0.08888888888888889	0.4	GO:0000290	GO:BP	deadenylation-dependent decapping of nuclear-transcribed mRNA	16175	83		0.717391304347826	0.723404255319149	10	16165	4	41	6	16124	16175	0.18756933424880984
M1	string	0	network_modules	42	TRUE	5.362569167758491e-5	566	45	12	0.26666666666666666	0.02120141342756184	GO:0006412	GO:BP	translation	16175	2170		0.7391304347826086	0.7446808510638298	566	15609	12	33	554	15576	16175	0.06659101637080996
M1	string	0	network_modules	42	TRUE	1.1069403541337233e-4	76	45	6	0.13333333333333333	0.07894736842105263	GO:0051028	GO:BP	mRNA transport	16175	13445		0.7608695652173914	0.7659574468085106	76	16099	6	39	70	16060	16175	0.09935399541159093
M1	string	0	network_modules	42	TRUE	1.448417360916878e-4	40	45	5	0.1111111111111111	0.125	GO:0035196	GO:BP	miRNA processing	16175	8885		0.782608695652174	0.7872340425531915	40	16135	5	40	35	16095	16175	0.11553173075822115
M1	string	0	network_modules	42	TRUE	2.775607152133721e-4	18	45	4	0.08888888888888889	0.2222222222222222	GO:0035278	GO:BP	miRNA-mediated gene silencing by inhibition of translation	16175	8938		0.8043478260869565	0.8085106382978723	18	16157	4	41	14	16116	16175	0.13905699256470916
M1	string	0	network_modules	42	TRUE	0.001248138211377561	114	45	6	0.13333333333333333	0.05263157894736842	GO:0050658	GO:BP	RNA transport	16175	13198		0.8260869565217391	0.851063829787234	114	16061	6	39	108	16022	16175	0.0797347906665059
M1	string	0	network_modules	42	TRUE	0.001248138211377561	114	45	6	0.13333333333333333	0.05263157894736842	GO:0050657	GO:BP	nucleic acid transport	16175	13197		0.8260869565217391	0.851063829787234	114	16061	6	39	108	16022	16175	0.0797347906665059
M1	string	0	network_modules	42	TRUE	0.0014546648145467229	117	45	6	0.13333333333333333	0.05128205128205128	GO:0051236	GO:BP	establishment of RNA localization	16175	13586		0.8695652173913043	0.8723404255319149	117	16058	6	39	111	16019	16175	0.07859765955445173
M1	string	0	network_modules	42	TRUE	0.0017267884840696396	65	45	5	0.1111111111111111	0.07692307692307693	GO:0070918	GO:BP	regulatory ncRNA processing	16175	16370		0.8913043478260869	0.8936170212765957	65	16110	5	40	60	16070	16175	0.08941043965175227
M1	string	0	network_modules	42	TRUE	0.0019295739015912658	15	27	3	0.1111111111111111	0.2	REAC:R-HSA-430039	REAC	mRNA decay by 5' to 3' exoribonuclease	10916	2710		0.7	0.7272727272727273	15	10901	3	24	12	10877	10916	0.14751141209150873
M1	string	0	network_modules	42	TRUE	0.00266758226061504	116	27	5	0.18518518518518517	0.04310344827586207	REAC:R-HSA-975957	REAC	Nonsense Mediated Decay (NMD) enhanced by the Exon Junction Complex (EJC)	10916	1606		0.8	0.9090909090909091	116	10800	5	22	111	10778	10916	0.08477186605339246
M1	string	0	network_modules	42	TRUE	0.00266758226061504	116	27	5	0.18518518518518517	0.04310344827586207	REAC:R-HSA-927802	REAC	Nonsense-Mediated Decay (NMD)	10916	1608		0.8	0.9090909090909091	116	10800	5	22	111	10778	10916	0.08477186605339246
M1	string	0	network_modules	42	TRUE	0.0028742580728184997	17	27	3	0.1111111111111111	0.17647058823529413	REAC:R-HSA-450513	REAC	Tristetraprolin (TTP, ZFP36) binds and destabilizes mRNA	10916	2608		1	1	17	10899	3	24	14	10875	10916	0.13834419067177614
M1	string	0	network_modules	42	TRUE	0.004253522642433303	10	45	3	0.06666666666666667	0.3	GO:0033147	GO:BP	negative regulation of intracellular estrogen receptor signaling pathway	16175	8061		0.9130434782608695	0.9148936170212766	10	16165	3	42	7	16123	16175	0.14034857189123007
M1	string	0	network_modules	42	TRUE	0.004588355241707472	35	45	4	0.08888888888888889	0.11428571428571428	GO:0000184	GO:BP	nuclear-transcribed mRNA catabolic process, nonsense-mediated decay	16175	57		0.9347826086956522	0.9361702127659575	35	16140	4	41	31	16099	16175	0.09858076026974474
M1	string	0	network_modules	42	TRUE	0.005837208130928911	11	45	3	0.06666666666666667	0.2727272727272727	GO:1900246	GO:BP	positive regulation of RIG-I signaling pathway	16175	20518		0.9565217391304348	0.9574468085106383	11	16164	3	42	8	16122	16175	0.13369599034230295
M1	string	0	network_modules	42	TRUE	0.005974097101223933	149	45	6	0.13333333333333333	0.040268456375838924	GO:0006403	GO:BP	RNA localization	16175	2164		0.9782608695652174	0.9787234042553191	149	16026	6	39	143	15987	16175	0.06862383398275673
M1	string	0	network_modules	42	TRUE	0.007429088058733668	96	23	4	0.17391304347826086	0.041666666666666664	KEGG:03015	KEGG	mRNA surveillance pathway	8484	210		1	1	96	8388	4	19	92	8369	8484	0.08014992197517544
M1	string	0	network_modules	42	TRUE	0.0074849380646177435	595	45	10	0.2222222222222222	0.01680672268907563	GO:0051248	GO:BP	negative regulation of protein metabolic process	16175	13595		1	1	595	15580	10	35	585	15545	16175	0.05203405672061078
M1	string	0	network_modules	43	TRUE	1.679733685752247e-47	92	37	27	0.7297297297297297	0.29347826086956524	REAC:R-HSA-141444	REAC	Amplification  of signal from unattached  kinetochores via a MAD2  inhibitory signal	10916	143		0	0.125	92	10824	27	10	65	10814	10916	0.46014962400267284
M1	string	0	network_modules	43	TRUE	1.679733685752247e-47	92	37	27	0.7297297297297297	0.29347826086956524	REAC:R-HSA-141424	REAC	Amplification of signal from the kinetochores	10916	144		0	0.125	92	10824	27	10	65	10814	10916	0.46014962400267284
M1	string	0	network_modules	43	TRUE	3.332122601761102e-45	109	37	27	0.7297297297297297	0.24770642201834864	REAC:R-HSA-69618	REAC	Mitotic Spindle Checkpoint	10916	1486		0.13333333333333333	0.1875	109	10807	27	10	82	10797	10916	0.42216513398419564
M1	string	0	network_modules	43	TRUE	1.7208115851328352e-44	115	37	27	0.7297297297297297	0.23478260869565218	REAC:R-HSA-9648025	REAC	EML4 and NUDC in mitotic spindle formation	10916	817		0.2	0.25	115	10801	27	10	88	10791	10916	0.4108047882328858
M1	string	0	network_modules	43	TRUE	1.3269890833228438e-43	123	37	27	0.7297297297297297	0.21951219512195122	REAC:R-HSA-2500257	REAC	Resolution of Sister Chromatid Cohesion	10916	2079		0.26666666666666666	0.3125	123	10793	27	10	96	10783	10916	0.3969629536346327
M1	string	0	network_modules	43	TRUE	2.7138720698095125e-42	136	37	27	0.7297297297297297	0.19852941176470587	REAC:R-HSA-5663220	REAC	RHO GTPases Activate Formins	10916	1848		0.3333333333333333	0.375	136	10780	27	10	109	10770	10916	0.3771154368452809
M1	string	0	network_modules	43	TRUE	3.6298857180446194e-38	188	37	27	0.7297297297297297	0.14361702127659576	REAC:R-HSA-2467813	REAC	Separation of Sister Chromatids	10916	2204		0.4	0.4375	188	10728	27	10	161	10718	10916	0.3193897057400694
M1	string	0	network_modules	43	TRUE	1.8696396391084527e-37	199	37	27	0.7297297297297297	0.135678391959799	REAC:R-HSA-68877	REAC	Mitotic Prometaphase	10916	1484		0.4666666666666667	0.5	199	10717	27	10	172	10707	10916	0.3101568753313676
M1	string	0	network_modules	43	TRUE	9.162153730515226e-36	228	37	27	0.7297297297297297	0.11842105263157894	REAC:R-HSA-68882	REAC	Mitotic Anaphase	10916	1479		0.5333333333333333	0.5625	228	10688	27	10	201	10678	10916	0.2890708395755031
M1	string	0	network_modules	43	TRUE	1.0377435224065615e-35	229	37	27	0.7297297297297297	0.11790393013100436	REAC:R-HSA-2555396	REAC	Mitotic Metaphase and Anaphase	10916	1482		0.6	0.625	229	10687	27	10	202	10677	10916	0.28841520583041264
M1	string	0	network_modules	43	TRUE	7.409355277351485e-33	289	37	27	0.7297297297297297	0.09342560553633218	REAC:R-HSA-69620	REAC	Cell Cycle Checkpoints	10916	321		0.6666666666666666	0.6875	289	10627	27	10	262	10617	10916	0.25546320878966017
M1	string	0	network_modules	43	TRUE	1.0733546750510405e-31	318	37	27	0.7297297297297297	0.08490566037735849	REAC:R-HSA-195258	REAC	RHO GTPase Effectors	10916	1846		0.7333333333333333	0.75	318	10598	27	10	291	10588	10916	0.24294803326604958
M1	string	0	network_modules	43	TRUE	4.947059257334252e-30	361	46	27	0.5869565217391305	0.07479224376731301	GO:0007059	GO:BP	chromosome segregation	16175	2658		0	0.0136986301369863	361	15814	27	19	334	15795	16175	0.2041339400477495
M1	string	0	network_modules	43	TRUE	9.330132026774808e-29	406	37	27	0.7297297297297297	0.0665024630541872	REAC:R-HSA-68886	REAC	M Phase	10916	1343		0.8	0.8125	406	10510	27	10	379	10500	10916	0.21342646345165295
M1	string	0	network_modules	43	TRUE	8.710776930285409e-24	72	37	16	0.43243243243243246	0.2222222222222222	REAC:R-HSA-774815	REAC	Nucleosome assembly	10916	1621		0.8666666666666667	0.9375	72	10844	16	21	56	10823	10916	0.30679755457599456
M1	string	0	network_modules	43	TRUE	8.710776930285409e-24	72	37	16	0.43243243243243246	0.2222222222222222	REAC:R-HSA-606279	REAC	Deposition of new CENPA-containing nucleosomes at the centromere	10916	730		0.8666666666666667	0.9375	72	10844	16	21	56	10823	10916	0.30679755457599456
M1	string	0	network_modules	43	TRUE	6.280055277992147e-19	138	37	16	0.43243243243243246	0.11594202898550725	REAC:R-HSA-73886	REAC	Chromosome Maintenance	10916	357		1	1	138	10778	16	21	122	10757	10916	0.21912594945677766
M1	string	0	network_modules	43	TRUE	9.199451569680898e-18	96	46	14	0.30434782608695654	0.14583333333333334	GO:0051310	GO:BP	metaphase chromosome alignment	16175	13641		0.013888888888888888	0.0273972602739726	96	16079	14	32	82	16047	16175	0.20747783712989235
M1	string	0	network_modules	43	TRUE	1.989434577200606e-17	52	46	12	0.2608695652173913	0.23076923076923078	GO:0008608	GO:BP	attachment of spindle microtubules to kinetochore	16175	3205		0.027777777777777776	0.0410958904109589	52	16123	12	34	40	16089	16175	0.24307091779539167
M1	string	0	network_modules	43	TRUE	2.6111975841551152e-17	103	46	14	0.30434782608695654	0.13592233009708737	GO:0051303	GO:BP	establishment of chromosome localization	16175	13634		0.041666666666666664	0.0547945205479452	103	16072	14	32	89	16040	16175	0.20005664836252884
M1	string	0	network_modules	43	TRUE	5.2536151705876254e-17	108	46	14	0.30434782608695654	0.12962962962962962	GO:0050000	GO:BP	chromosome localization	16175	13183		0.05555555555555555	0.0684931506849315	108	16067	14	32	94	16035	16175	0.1951985221021034
M1	string	0	network_modules	43	TRUE	1.1474675280139057e-15	277	46	17	0.3695652173913043	0.061371841155234655	GO:0098813	GO:BP	nuclear chromosome segregation	16175	18900		0.06944444444444445	0.0821917808219178	277	15898	17	29	260	15869	16175	0.14507533288337873
M1	string	0	network_modules	43	TRUE	5.083584039693632e-14	16	46	8	0.17391304347826086	0.5	GO:0051383	GO:BP	kinetochore organization	16175	13687		0.08333333333333333	0.0958904109589041	16	16159	8	38	8	16121	16175	0.29376982215210745
M1	string	0	network_modules	43	TRUE	7.180548119124812e-14	178	46	14	0.30434782608695654	0.07865168539325842	GO:0000070	GO:BP	mitotic sister chromatid segregation	16175	24		0.09722222222222222	0.1095890410958904	178	15997	14	32	164	15965	16175	0.15016413546967042
M1	string	0	network_modules	43	TRUE	1.1774355865813616e-12	217	46	14	0.30434782608695654	0.06451612903225806	GO:0000819	GO:BP	sister chromatid segregation	16175	237		0.1111111111111111	0.1232876712328767	217	15958	14	32	203	15926	16175	0.13504918589832615
M1	string	0	network_modules	43	TRUE	4.979460819763935e-12	545	46	18	0.391304347826087	0.03302752293577982	GO:0051276	GO:BP	chromosome organization	16175	13613		0.125	0.136986301369863	545	15630	18	28	527	15602	16175	0.10584049320069655
M1	string	0	network_modules	43	TRUE	6.2266535488011e-12	44	46	9	0.1956521739130435	0.20454545454545456	GO:0007094	GO:BP	mitotic spindle assembly checkpoint signaling	16175	2677		0.1388888888888889	0.1780821917808219	44	16131	9	37	35	16094	16175	0.19781836205878106
M1	string	0	network_modules	43	TRUE	6.2266535488011e-12	44	46	9	0.1956521739130435	0.20454545454545456	GO:0071174	GO:BP	mitotic spindle checkpoint signaling	16175	16470		0.1388888888888889	0.1780821917808219	44	16131	9	37	35	16094	16175	0.19781836205878106
M1	string	0	network_modules	43	TRUE	6.2266535488011e-12	44	46	9	0.1956521739130435	0.20454545454545456	GO:0071173	GO:BP	spindle assembly checkpoint signaling	16175	16469		0.1388888888888889	0.1780821917808219	44	16131	9	37	35	16094	16175	0.19781836205878106
M1	string	0	network_modules	43	TRUE	7.767264458330092e-12	45	46	9	0.1956521739130435	0.2	GO:2000816	GO:BP	negative regulation of mitotic sister chromatid separation	16175	26071		0.18055555555555555	0.2465753424657534	45	16130	9	37	36	16093	16175	0.195551411761321
M1	string	0	network_modules	43	TRUE	7.767264458330092e-12	45	46	9	0.1956521739130435	0.2	GO:0033048	GO:BP	negative regulation of mitotic sister chromatid segregation	16175	8003		0.18055555555555555	0.2465753424657534	45	16130	9	37	36	16093	16175	0.195551411761321
M1	string	0	network_modules	43	TRUE	7.767264458330092e-12	45	46	9	0.1956521739130435	0.2	GO:0033046	GO:BP	negative regulation of sister chromatid segregation	16175	8001		0.18055555555555555	0.2465753424657534	45	16130	9	37	36	16093	16175	0.195551411761321
M1	string	0	network_modules	43	TRUE	7.767264458330092e-12	45	46	9	0.1956521739130435	0.2	GO:0031577	GO:BP	spindle checkpoint signaling	16175	7223		0.18055555555555555	0.2465753424657534	45	16130	9	37	36	16093	16175	0.195551411761321
M1	string	0	network_modules	43	TRUE	7.767264458330092e-12	45	46	9	0.1956521739130435	0.2	GO:0045841	GO:BP	negative regulation of mitotic metaphase/anaphase transition	16175	11657		0.18055555555555555	0.2465753424657534	45	16130	9	37	36	16093	16175	0.195551411761321
M1	string	0	network_modules	43	TRUE	9.505990048824539e-12	252	46	14	0.30434782608695654	0.05555555555555555	GO:0140014	GO:BP	mitotic nuclear division	16175	19633		0.25	0.2602739726027397	252	15923	14	32	238	15891	16175	0.12452489208992938
M1	string	0	network_modules	43	TRUE	1.189447069006379e-11	47	46	9	0.1956521739130435	0.19148936170212766	GO:0051985	GO:BP	negative regulation of chromosome segregation	16175	14047		0.2638888888888889	0.3013698630136986	47	16128	9	37	38	16091	16175	0.19123469943197696
M1	string	0	network_modules	43	TRUE	1.189447069006379e-11	47	46	9	0.1956521739130435	0.19148936170212766	GO:1902100	GO:BP	negative regulation of metaphase/anaphase transition of cell cycle	16175	22014		0.2638888888888889	0.3013698630136986	47	16128	9	37	38	16091	16175	0.19123469943197696
M1	string	0	network_modules	43	TRUE	1.189447069006379e-11	47	46	9	0.1956521739130435	0.19148936170212766	GO:1905819	GO:BP	negative regulation of chromosome separation	16175	24929		0.2638888888888889	0.3013698630136986	47	16128	9	37	38	16091	16175	0.19123469943197696
M1	string	0	network_modules	43	TRUE	2.6337698009477437e-11	51	46	9	0.1956521739130435	0.17647058823529413	GO:0033047	GO:BP	regulation of mitotic sister chromatid segregation	16175	8002		0.3055555555555556	0.3150684931506849	51	16124	9	37	42	16087	16175	0.18336938996738786
M1	string	0	network_modules	43	TRUE	3.17845347135855e-11	52	46	9	0.1956521739130435	0.17307692307692307	GO:0045839	GO:BP	negative regulation of mitotic nuclear division	16175	11655		0.3194444444444444	0.3287671232876712	52	16123	9	37	43	16086	16175	0.1815449705943287
M1	string	0	network_modules	43	TRUE	6.491239540890396e-11	56	46	9	0.1956521739130435	0.16071428571428573	GO:0010965	GO:BP	regulation of mitotic sister chromatid separation	16175	4541		0.3333333333333333	0.3424657534246575	56	16119	9	37	47	16082	16175	0.1747379766192526
M1	string	0	network_modules	43	TRUE	7.692442407277576e-11	57	46	9	0.1956521739130435	0.15789473684210525	GO:0051784	GO:BP	negative regulation of nuclear division	16175	13934		0.3472222222222222	0.3561643835616438	57	16118	9	37	48	16081	16175	0.1731480614165571
M1	string	0	network_modules	43	TRUE	9.086552386713964e-11	58	46	9	0.1956521739130435	0.15517241379310345	GO:0051306	GO:BP	mitotic sister chromatid separation	16175	13637		0.3611111111111111	0.3698630136986301	58	16117	9	37	49	16080	16175	0.17159900518846777
M1	string	0	network_modules	43	TRUE	1.8797805283236667e-10	21	46	7	0.15217391304347827	0.3333333333333333	GO:0034508	GO:BP	centromere complex assembly	16175	8672		0.375	0.3835616438356164	21	16154	7	39	14	16115	16175	0.22376329356705307
M1	string	0	network_modules	43	TRUE	3.9653962814321694e-10	410	46	15	0.32608695652173914	0.036585365853658534	GO:0051656	GO:BP	establishment of organelle localization	16175	13869		0.3888888888888889	0.3972602739726027	410	15765	15	31	395	15734	16175	0.10218110738520594
M1	string	0	network_modules	43	TRUE	5.413347805207403e-10	70	46	9	0.1956521739130435	0.12857142857142856	GO:1905818	GO:BP	regulation of chromosome separation	16175	24928		0.4027777777777778	0.410958904109589	70	16105	9	37	61	16068	16175	0.15565415003703315
M1	string	0	network_modules	43	TRUE	1.1712693871121437e-9	76	46	9	0.1956521739130435	0.11842105263157894	GO:0051304	GO:BP	chromosome separation	16175	13635		0.4166666666666667	0.4246575342465753	76	16099	9	37	67	16062	16175	0.14912175582233708
M1	string	0	network_modules	43	TRUE	1.9872553682841324e-9	14	46	6	0.13043478260869565	0.42857142857142855	GO:0051382	GO:BP	kinetochore assembly	16175	13686		0.4305555555555556	0.4383561643835616	14	16161	6	40	8	16121	16175	0.23530074058189082
M1	string	0	network_modules	43	TRUE	2.570060052849757e-9	379	46	14	0.30434782608695654	0.036939313984168866	GO:0000280	GO:BP	nuclear division	16175	78		0.4444444444444444	0.4520547945205479	379	15796	14	32	365	15764	16175	0.09917534683291791
M1	string	0	network_modules	43	TRUE	2.9865282556426033e-9	792	46	18	0.391304347826087	0.022727272727272728	GO:0000278	GO:BP	mitotic cell cycle	16175	76		0.4583333333333333	0.4657534246575342	792	15383	18	28	774	15355	16175	0.08472154917437207
M1	string	0	network_modules	43	TRUE	3.7032930946167132e-9	86	46	9	0.1956521739130435	0.10465116279069768	GO:0030071	GO:BP	regulation of mitotic metaphase/anaphase transition	16175	6671		0.4722222222222222	0.4794520547945205	86	16089	9	37	77	16052	16175	0.13977359491122887
M1	string	0	network_modules	43	TRUE	4.582182715223538e-9	88	46	9	0.1956521739130435	0.10227272727272728	GO:1902099	GO:BP	regulation of metaphase/anaphase transition of cell cycle	16175	22013		0.4861111111111111	0.4931506849315068	88	16087	9	37	79	16050	16175	0.13809494998432859
M1	string	0	network_modules	43	TRUE	5.640711328087703e-9	90	46	9	0.1956521739130435	0.1	GO:2001251	GO:BP	negative regulation of chromosome organization	16175	26440		0.5	0.5205479452054794	90	16085	9	37	81	16048	16175	0.13647165888415483
M1	string	0	network_modules	43	TRUE	5.640711328087703e-9	90	46	9	0.1956521739130435	0.1	GO:0007091	GO:BP	metaphase/anaphase transition of mitotic cell cycle	16175	2675		0.5	0.5205479452054794	90	16085	9	37	81	16048	16175	0.13647165888415483
M1	string	0	network_modules	43	TRUE	6.909951295147687e-9	92	46	9	0.1956521739130435	0.09782608695652174	GO:0044784	GO:BP	metaphase/anaphase transition of cell cycle	16175	11156		0.5277777777777778	0.5342465753424658	92	16083	9	37	83	16046	16175	0.13490070630134432
M1	string	0	network_modules	43	TRUE	1.1656965322971036e-8	424	46	14	0.30434782608695654	0.0330188679245283	GO:0048285	GO:BP	organelle fission	16175	12627		0.5416666666666666	0.547945205479452	424	15751	14	32	410	15719	16175	0.09296883859759246
M1	string	0	network_modules	43	TRUE	1.176810445959301e-8	519	46	15	0.32608695652173914	0.028901734104046242	GO:0051640	GO:BP	organelle localization	16175	13853		0.5555555555555556	0.5616438356164384	519	15656	15	31	504	15625	16175	0.08909294706251256
M1	string	0	network_modules	43	TRUE	1.3570472615174452e-8	99	46	9	0.1956521739130435	0.09090909090909091	GO:0033045	GO:BP	regulation of sister chromatid segregation	16175	8000		0.5694444444444444	0.5753424657534246	99	16076	9	37	90	16039	16175	0.12977605172091092
M1	string	0	network_modules	43	TRUE	2.5373861824322315e-8	106	46	9	0.1956521739130435	0.08490566037735849	GO:0007088	GO:BP	regulation of mitotic nuclear division	16175	2673		0.5833333333333334	0.589041095890411	106	16069	9	37	97	16032	16175	0.12515869204204086
M1	string	0	network_modules	43	TRUE	2.545903555340159e-8	656	46	16	0.34782608695652173	0.024390243902439025	GO:1903047	GO:BP	mitotic cell cycle process	16175	22727		0.5972222222222222	0.6027397260273972	656	15519	16	30	640	15489	16175	0.08318698723587362
M1	string	0	network_modules	43	TRUE	7.275271652772189e-8	119	46	9	0.1956521739130435	0.07563025210084033	GO:0051783	GO:BP	regulation of nuclear division	16175	13933		0.6111111111111112	0.6164383561643836	119	16056	9	37	110	16019	16175	0.11767018545602977
M1	string	0	network_modules	43	TRUE	1.056294859497929e-7	124	46	9	0.1956521739130435	0.07258064516129033	GO:0051983	GO:BP	regulation of chromosome segregation	16175	14045		0.625	0.6301369863013698	124	16051	9	37	115	16014	16175	0.11510207504562348
M1	string	0	network_modules	43	TRUE	2.1270878780551875e-7	134	46	9	0.1956521739130435	0.06716417910447761	GO:0007093	GO:BP	mitotic cell cycle checkpoint signaling	16175	2676		0.6388888888888888	0.6438356164383562	134	16041	9	37	125	16004	16175	0.1103942077355508
M1	string	0	network_modules	43	TRUE	7.804934423649805e-7	15	46	5	0.10869565217391304	0.3333333333333333	GO:0034501	GO:BP	protein localization to kinetochore	16175	8667		0.6527777777777778	0.6712328767123288	15	16160	5	41	10	16119	16175	0.1890793884610999
M1	string	0	network_modules	43	TRUE	7.804934423649805e-7	15	46	5	0.10869565217391304	0.3333333333333333	GO:1903083	GO:BP	protein localization to condensed chromosome	16175	22757		0.6527777777777778	0.6712328767123288	15	16160	5	41	10	16119	16175	0.1890793884610999
M1	string	0	network_modules	43	TRUE	9.840432879192495e-7	159	46	9	0.1956521739130435	0.05660377358490566	GO:1901991	GO:BP	negative regulation of mitotic cell cycle phase transition	16175	21924		0.6805555555555556	0.684931506849315	159	16016	9	37	150	15979	16175	0.10058690946681663
M1	string	0	network_modules	43	TRUE	1.4651220694949648e-6	37	46	6	0.13043478260869565	0.16216216216216217	GO:0071459	GO:BP	protein localization to chromosome, centromeric region	16175	16692		0.6944444444444444	0.6986301369863014	37	16138	6	40	31	16098	16175	0.1432528376118353
M1	string	0	network_modules	43	TRUE	2.424260126419581e-6	176	46	9	0.1956521739130435	0.05113636363636364	GO:0000075	GO:BP	cell cycle checkpoint signaling	16175	26		0.7083333333333334	0.7123287671232876	176	15999	9	37	167	15962	16175	0.09511542977405608
M1	string	0	network_modules	43	TRUE	8.156224135303558e-6	202	46	9	0.1956521739130435	0.04455445544554455	GO:0045930	GO:BP	negative regulation of mitotic cell cycle	16175	11724		0.7222222222222222	0.726027397260274	202	15973	9	37	193	15936	16175	0.0880825984250343
M1	string	0	network_modules	43	TRUE	1.898265917759143e-5	304	46	10	0.21739130434782608	0.03289473684210526	GO:0010639	GO:BP	negative regulation of organelle organization	16175	4285		0.7361111111111112	0.7397260273972602	304	15871	10	36	294	15835	16175	0.07810034328258088
M1	string	0	network_modules	43	TRUE	2.0115424681279732e-5	224	46	9	0.1956521739130435	0.04017857142857143	GO:1901988	GO:BP	negative regulation of cell cycle phase transition	16175	21921		0.75	0.7534246575342466	224	15951	9	37	215	15914	16175	0.08308145565206687
M1	string	0	network_modules	43	TRUE	2.437071753875321e-5	229	46	9	0.1956521739130435	0.039301310043668124	GO:0033044	GO:BP	regulation of chromosome organization	16175	7999		0.7638888888888888	0.7671232876712328	229	15946	9	37	220	15909	16175	0.08204259478427806
M1	string	0	network_modules	43	TRUE	3.843993815509808e-5	3	46	3	0.06521739130434782	1	GO:0043060	GO:BP	meiotic metaphase I homologous chromosome alignment	16175	10507		0.7777777777777778	0.7945205479452054	3	16172	3	43	0	16129	16175	0.25503722021892494
M1	string	0	network_modules	43	TRUE	3.843993815509808e-5	3	46	3	0.06521739130434782	1	GO:0051311	GO:BP	meiotic metaphase chromosome alignment	16175	13642		0.7777777777777778	0.7945205479452054	3	16172	3	43	0	16129	16175	0.25503722021892494
M1	string	0	network_modules	43	TRUE	7.799582998733505e-5	262	46	9	0.1956521739130435	0.03435114503816794	GO:0010948	GO:BP	negative regulation of cell cycle process	16175	4526		0.8055555555555556	0.8082191780821918	262	15913	9	37	253	15876	16175	0.07591835123434
M1	string	0	network_modules	43	TRUE	1.4120771722670825e-4	376	46	10	0.21739130434782608	0.026595744680851064	GO:1901987	GO:BP	regulation of cell cycle phase transition	16175	21920		0.8194444444444444	0.821917808219178	376	15799	10	36	366	15763	16175	0.06880788572047111
M1	string	0	network_modules	43	TRUE	1.6522642812636396e-4	286	46	9	0.1956521739130435	0.03146853146853147	GO:1901990	GO:BP	regulation of mitotic cell cycle phase transition	16175	21923		0.8333333333333334	0.8356164383561644	286	15889	9	37	277	15852	16175	0.07211678675133518
M1	string	0	network_modules	43	TRUE	6.800680841610534e-4	338	46	9	0.1956521739130435	0.026627218934911243	GO:0045786	GO:BP	negative regulation of cell cycle	16175	11618		0.8472222222222222	0.8493150684931506	338	15837	9	37	329	15800	16175	0.06524633134157695
M1	string	0	network_modules	43	TRUE	0.0010069952750669134	465	46	10	0.21739130434782608	0.021505376344086023	GO:0044770	GO:BP	cell cycle phase transition	16175	11146		0.8611111111111112	0.863013698630137	465	15710	10	36	455	15674	16175	0.060290120764386716
M1	string	0	network_modules	43	TRUE	0.0010418304994975047	24	46	4	0.08695652173913043	0.16666666666666666	GO:0051315	GO:BP	attachment of mitotic spindle microtubules to kinetochore	16175	13643		0.875	0.8767123287671232	24	16151	4	42	20	16109	16175	0.11858829756710812
M1	string	0	network_modules	43	TRUE	0.001185575914769042	59	46	5	0.10869565217391304	0.0847457627118644	GO:0007080	GO:BP	mitotic metaphase chromosome alignment	16175	2669		0.8888888888888888	0.8904109589041096	59	16116	5	41	54	16075	16175	0.09305781159485248
M1	string	0	network_modules	43	TRUE	0.001334699334252442	7	46	3	0.06521739130434782	0.42857142857142855	GO:0031055	GO:BP	chromatin remodeling at centromere	16175	7017		0.9027777777777778	0.9178082191780822	7	16168	3	43	4	16125	16175	0.16634672734727224
M1	string	0	network_modules	43	TRUE	0.001334699334252442	7	46	3	0.06521739130434782	0.42857142857142855	GO:0034080	GO:BP	CENP-A containing chromatin assembly	16175	8395		0.9027777777777778	0.9178082191780822	7	16168	3	43	4	16125	16175	0.16634672734727224
M1	string	0	network_modules	43	TRUE	0.001392999610833035	183	46	7	0.15217391304347827	0.03825136612021858	GO:0065004	GO:BP	protein-DNA complex assembly	16175	15888		0.9305555555555556	0.9315068493150684	183	15992	7	39	176	15953	16175	0.07112638196173948
M1	string	0	network_modules	43	TRUE	0.0014494049437288978	370	46	9	0.1956521739130435	0.024324324324324326	GO:0044772	GO:BP	mitotic cell cycle phase transition	16175	11148		0.9444444444444444	0.9452054794520548	370	15805	9	37	361	15768	16175	0.06171748551356176
M1	string	0	network_modules	43	TRUE	0.0017484218121142623	118	46	6	0.13043478260869565	0.05084745762711865	GO:0034502	GO:BP	protein localization to chromosome	16175	8668		0.9583333333333334	0.958904109589041	118	16057	6	40	112	16017	16175	0.07727587361817333
M1	string	0	network_modules	43	TRUE	0.0030787359767903665	206	46	7	0.15217391304347827	0.03398058252427184	GO:0071824	GO:BP	protein-DNA complex organization	16175	16927		0.9722222222222222	0.9726027397260274	206	15969	7	39	199	15930	16175	0.06640928615633329
M1	string	0	network_modules	43	TRUE	0.004734005038310308	427	46	9	0.1956521739130435	0.02107728337236534	GO:0007346	GO:BP	regulation of mitotic cell cycle	16175	2855		0.9861111111111112	0.9863013698630136	427	15748	9	37	418	15711	16175	0.05638067512193842
M1	string	0	network_modules	43	TRUE	0.007724587798273318	583	46	10	0.21739130434782608	0.017152658662092625	GO:0051129	GO:BP	negative regulation of cellular component organization	16175	13513		1	1	583	15592	10	36	573	15556	16175	0.05195736650132436
M1	string	0	network_modules	44	TRUE	1.8500931061372623e-4	20	38	4	0.10526315789473684	0.2	GO:0071786	GO:BP	endoplasmic reticulum tubular network organization	16175	16907		0	0.5	20	16155	4	34	16	16121	16175	0.1436484536060909
M1	string	0	network_modules	44	TRUE	0.0025024146751928874	86	38	5	0.13157894736842105	0.05813953488372093	GO:0007029	GO:BP	endoplasmic reticulum organization	16175	2634		1	1	86	16089	5	33	81	16056	16175	0.08425272306736742
M1	string	0	network_modules	45	TRUE	5.445243542259867e-7	29	22	5	0.22727272727272727	0.1724137931034483	KEGG:04392	KEGG	Hippo signaling pathway - multiple species	8484	312		NA	1	29	8455	5	17	24	8438	8484	0.19556249478499144
M1	string	0	network_modules	45	TRUE	1.56700009259414e-5	19	22	4	0.18181818181818182	0.21052631578947367	REAC:R-HSA-2028269	REAC	Signaling by Hippo	10916	2259		NA	1	19	10897	4	18	15	10879	10916	0.19413804065373627
M1	string	0	network_modules	45	TRUE	3.1642283578753577e-4	50	43	5	0.11627906976744186	0.1	GO:0031098	GO:BP	stress-activated protein kinase signaling cascade	16175	7024		0	0.25	50	16125	5	38	45	16087	16175	0.10526875122083677
M1	string	0	network_modules	45	TRUE	6.752388922117156e-4	180	43	7	0.16279069767441862	0.03888888888888889	GO:0046777	GO:BP	protein autophosphorylation	16175	12365		0.3333333333333333	0.5	180	15995	7	36	173	15959	16175	0.07464212552799063
M1	string	0	network_modules	45	TRUE	0.008499216659131259	44	43	4	0.09302325581395349	0.09090909090909091	GO:0035329	GO:BP	hippo signaling	16175	8973		0.6666666666666666	0.75	44	16131	4	39	40	16092	16175	0.08951166717829744
M1	string	0	network_modules	45	TRUE	0.00931043208544662	45	43	4	0.09302325581395349	0.08888888888888889	GO:0051403	GO:BP	stress-activated MAPK cascade	16175	13696		1	1	45	16130	4	39	41	16091	16175	0.08845364990621811
M1	string	0	network_modules	46	TRUE	9.559626115320225e-69	32	40	29	0.725	0.90625	KEGG:04130	KEGG	SNARE interactions in vesicular transport	8484	272		0	0.5	32	8452	29	11	3	8441	8484	0.8097939086898753
M1	string	0	network_modules	46	TRUE	1.9896033886248947e-52	101	49	30	0.6122448979591837	0.297029702970297	GO:0090174	GO:BP	organelle membrane fusion	16175	18081		0	0.013157894736842105	101	16074	30	19	71	16055	16175	0.4240620946604779
M1	string	0	network_modules	46	TRUE	1.4112909731645697e-50	157	49	32	0.6530612244897959	0.20382165605095542	GO:0061025	GO:BP	membrane fusion	16175	15142		0.013333333333333334	0.02631578947368421	157	16018	32	17	125	16001	16175	0.36172259297998094
M1	string	0	network_modules	46	TRUE	3.3773160507890787e-50	99	49	29	0.5918367346938775	0.29292929292929293	GO:0006906	GO:BP	vesicle fusion	16175	2557		0.02666666666666667	0.039473684210526314	99	16076	29	20	70	16056	16175	0.41396118889116607
M1	string	0	network_modules	46	TRUE	5.50516328500805e-48	136	49	30	0.6122448979591837	0.22058823529411764	GO:0048284	GO:BP	organelle fusion	16175	12626		0.04	0.05263157894736842	136	16039	30	19	106	16020	16175	0.3645360845021535
M1	string	0	network_modules	46	TRUE	3.303840799759915e-38	315	49	31	0.6326530612244898	0.09841269841269841	GO:0016050	GO:BP	vesicle organization	16175	5082		0.05333333333333334	0.06578947368421052	315	15860	31	18	284	15842	16175	0.24460148927200506
M1	string	0	network_modules	46	TRUE	6.104974920961088e-35	657	49	35	0.7142857142857143	0.0532724505327245	GO:0061024	GO:BP	membrane organization	16175	15141		0.06666666666666667	0.07894736842105263	657	15518	35	14	622	15504	16175	0.18811525854558334
M1	string	0	network_modules	46	TRUE	1.274645177001649e-32	70	49	20	0.40816326530612246	0.2857142857142857	GO:0140056	GO:BP	organelle localization by membrane tethering	16175	19654		0.08	0.09210526315789473	70	16105	20	29	50	16076	16175	0.33912063558141775
M1	string	0	network_modules	46	TRUE	2.7362666213273577e-31	80	49	20	0.40816326530612246	0.25	GO:0022406	GO:BP	membrane docking	16175	6597		0.09333333333333334	0.10526315789473684	80	16095	20	29	60	16066	16175	0.3168310529443798
M1	string	0	network_modules	46	TRUE	7.726876087827173e-28	55	49	17	0.3469387755102041	0.3090909090909091	GO:0048278	GO:BP	vesicle docking	16175	12620		0.10666666666666667	0.11842105263157894	55	16120	17	32	38	16088	16175	0.3253048293551922
M1	string	0	network_modules	46	TRUE	2.295556926300752e-25	56	49	16	0.32653061224489793	0.2857142857142857	GO:0140029	GO:BP	exocytic process	16175	19642		0.12	0.13157894736842105	56	16119	16	33	40	16086	16175	0.30318696662461225
M1	string	0	network_modules	46	TRUE	1.1316371020395055e-23	263	49	22	0.4489795918367347	0.08365019011406843	GO:0006887	GO:BP	exocytosis	16175	2543		0.13333333333333333	0.14473684210526316	263	15912	22	27	241	15885	16175	0.18860171708984552
M1	string	0	network_modules	46	TRUE	7.732446459472056e-23	58	49	15	0.30612244897959184	0.25862068965517243	GO:0016079	GO:BP	synaptic vesicle exocytosis	16175	5106		0.14666666666666667	0.15789473684210525	58	16117	15	34	43	16083	16175	0.2789978920515387
M1	string	0	network_modules	46	TRUE	5.703839992973293e-21	161	49	18	0.3673469387755102	0.11180124223602485	GO:0045055	GO:BP	regulated exocytosis	16175	11253		0.16	0.17105263157894737	161	16014	18	31	143	15983	16175	0.19845523802875686
M1	string	0	network_modules	46	TRUE	6.718574497607594e-20	202	36	18	0.5	0.0891089108910891	REAC:R-HSA-6811442	REAC	Intra-Golgi and retrograde Golgi-to-ER traffic	10916	1262		0	0.034482758620689655	202	10714	18	18	184	10696	10916	0.20551364099040437
M1	string	0	network_modules	46	TRUE	7.101085984713938e-19	101	49	15	0.30612244897959184	0.1485148514851485	GO:0007269	GO:BP	neurotransmitter secretion	16175	2797		0.17333333333333334	0.19736842105263158	101	16074	15	34	86	16040	16175	0.20984628891158616
M1	string	0	network_modules	46	TRUE	7.101085984713938e-19	101	49	15	0.30612244897959184	0.1485148514851485	GO:0099643	GO:BP	signal release from synapse	16175	19183		0.17333333333333334	0.19736842105263158	101	16074	15	34	86	16040	16175	0.20984628891158616
M1	string	0	network_modules	46	TRUE	7.300875278738518e-18	117	49	15	0.30612244897959184	0.1282051282051282	GO:0099504	GO:BP	synaptic vesicle cycle	16175	19100		0.2	0.21052631578947367	117	16058	15	34	102	16024	16175	0.19442422171941204
M1	string	0	network_modules	46	TRUE	8.170532038619024e-18	646	49	24	0.4897959183673469	0.03715170278637771	GO:0140352	GO:BP	export from cell	16175	19748		0.21333333333333335	0.2236842105263158	646	15529	24	25	622	15504	16175	0.12663862803099366
M1	string	0	network_modules	46	TRUE	1.2386736395757748e-17	121	49	15	0.30612244897959184	0.12396694214876033	GO:0099003	GO:BP	vesicle-mediated transport in synapse	16175	18999		0.22666666666666666	0.23684210526315788	121	16054	15	34	106	16020	16175	0.19104920573005219
M1	string	0	network_modules	46	TRUE	1.883082860405432e-17	583	49	23	0.46938775510204084	0.03945111492281304	GO:0032940	GO:BP	secretion by cell	16175	7926		0.24	0.25	583	15592	23	26	560	15566	16175	0.12815249871251605
M1	string	0	network_modules	46	TRUE	3.6556615287687467e-17	519	49	22	0.4489795918367347	0.04238921001926782	GO:0051640	GO:BP	organelle localization	16175	13853		0.25333333333333335	0.2631578947368421	519	15656	22	27	497	15629	16175	0.13040059093758868
M1	string	0	network_modules	46	TRUE	1.9247722675906055e-16	284	49	18	0.3673469387755102	0.06338028169014084	GO:0048193	GO:BP	Golgi vesicle transport	16175	12570		0.26666666666666666	0.27631578947368424	284	15891	18	31	266	15860	16175	0.14680820867422298
M1	string	0	network_modules	46	TRUE	2.0814090542313853e-16	145	49	15	0.30612244897959184	0.10344827586206896	GO:0006836	GO:BP	neurotransmitter transport	16175	2506		0.28	0.2894736842105263	145	16030	15	34	130	15996	16175	0.17378635028118306
M1	string	0	network_modules	46	TRUE	2.0892057197253934e-16	649	49	23	0.46938775510204084	0.03543913713405239	GO:0046903	GO:BP	secretion	16175	12430		0.29333333333333333	0.3026315789473684	649	15526	23	26	626	15500	16175	0.12057338101504653
M1	string	0	network_modules	46	TRUE	2.163119905128005e-16	44	36	11	0.3055555555555556	0.25	REAC:R-HSA-6811438	REAC	Intra-Golgi traffic	10916	1263		0.03571428571428571	0.06896551724137931	44	10872	11	25	33	10847	10916	0.2737425268019187
M1	string	0	network_modules	46	TRUE	4.3598604091180787e-16	17	49	9	0.1836734693877551	0.5294117647058824	GO:0048499	GO:BP	synaptic vesicle membrane organization	16175	12788		0.30666666666666664	0.3157894736842105	17	16158	9	40	8	16118	16175	0.3106811749660045
M1	string	0	network_modules	46	TRUE	9.858856115997722e-16	311	49	18	0.3673469387755102	0.05787781350482315	GO:0023061	GO:BP	signal release	16175	6645		0.32	0.32894736842105265	311	15864	18	31	293	15833	16175	0.1397401169511314
M1	string	0	network_modules	46	TRUE	3.531541896935647e-15	12	49	8	0.16326530612244897	0.6666666666666666	GO:0099500	GO:BP	vesicle fusion to plasma membrane	16175	19098		0.3333333333333333	0.35526315789473684	12	16163	8	41	4	16122	16175	0.3290359463501185
M1	string	0	network_modules	46	TRUE	3.531541896935647e-15	12	49	8	0.16326530612244897	0.6666666666666666	GO:0031629	GO:BP	synaptic vesicle fusion to presynaptic active zone membrane	16175	7242		0.3333333333333333	0.35526315789473684	12	16163	8	41	4	16122	16175	0.3290359463501185
M1	string	0	network_modules	46	TRUE	1.3322987805007983e-13	487	49	19	0.3877551020408163	0.039014373716632446	GO:0098916	GO:BP	anterograde trans-synaptic signaling	16175	18949		0.36	0.3815789473684211	487	15688	19	30	468	15658	16175	0.11536795869023612
M1	string	0	network_modules	46	TRUE	1.3322987805007983e-13	487	49	19	0.3877551020408163	0.039014373716632446	GO:0007268	GO:BP	chemical synaptic transmission	16175	2796		0.36	0.3815789473684211	487	15688	19	30	468	15658	16175	0.11536795869023612
M1	string	0	network_modules	46	TRUE	1.608955027873596e-13	492	49	19	0.3877551020408163	0.03861788617886179	GO:0099537	GO:BP	trans-synaptic signaling	16175	19116		0.38666666666666666	0.39473684210526316	492	15683	19	30	473	15653	16175	0.11469931594320473
M1	string	0	network_modules	46	TRUE	3.8712277343612767e-13	516	49	19	0.3877551020408163	0.03682170542635659	GO:0099536	GO:BP	synaptic signaling	16175	19115		0.4	0.40789473684210525	516	15659	19	30	497	15629	16175	0.11162051326941008
M1	string	0	network_modules	46	TRUE	4.788612625994176e-13	522	49	19	0.3877551020408163	0.03639846743295019	GO:0010256	GO:BP	endomembrane system organization	16175	4029		0.41333333333333333	0.42105263157894735	522	15653	19	30	503	15623	16175	0.11088272453085045
M1	string	0	network_modules	46	TRUE	4.691093841940711e-12	13	49	7	0.14285714285714285	0.5384615384615384	GO:0016082	GO:BP	synaptic vesicle priming	16175	5109		0.4266666666666667	0.4342105263157895	13	16162	7	42	6	16120	16175	0.2763194840698658
M1	string	0	network_modules	46	TRUE	9.625964668249747e-12	49	36	9	0.25	0.1836734693877551	REAC:R-HSA-6811440	REAC	Retrograde transport at the Trans-Golgi-Network	10916	2096		0.07142857142857142	0.10344827586206896	49	10867	9	27	40	10840	10916	0.21126070424237778
M1	string	0	network_modules	46	TRUE	1.2397570109397487e-10	78	40	10	0.25	0.1282051282051282	KEGG:04721	KEGG	Synaptic vesicle cycle	8484	351		1	1	78	8406	10	30	68	8376	8484	0.1736529861206622
M1	string	0	network_modules	46	TRUE	1.700872951020355e-10	524	49	17	0.3469387755102041	0.03244274809160305	GO:0006886	GO:BP	intracellular protein transport	16175	2542		0.44	0.4473684210526316	524	15651	17	32	507	15619	16175	0.09793151644192827
M1	string	0	network_modules	46	TRUE	1.5662832180543718e-8	137	49	10	0.20408163265306123	0.072992700729927	GO:0098876	GO:BP	vesicle-mediated transport to the plasma membrane	16175	18924		0.4533333333333333	0.4605263157894737	137	16038	10	39	127	15999	16175	0.11766264318659943
M1	string	0	network_modules	46	TRUE	1.6063150119758648e-8	94	49	9	0.1836734693877551	0.09574468085106383	GO:0042147	GO:BP	retrograde transport, endosome to Golgi	16175	9990		0.4666666666666667	0.47368421052631576	94	16081	9	40	85	16041	16175	0.12898576936470724
M1	string	0	network_modules	46	TRUE	2.3931677128764703e-8	10	36	5	0.1388888888888889	0.5	REAC:R-HSA-168799	REAC	Neurotoxicity of clostridium toxins	10916	1592		0.10714285714285714	0.13793103448275862	10	10906	5	31	5	10875	10916	0.2623379185960718
M1	string	0	network_modules	46	TRUE	3.618761398248993e-8	270	49	12	0.24489795918367346	0.044444444444444446	GO:0016197	GO:BP	endosomal transport	16175	5169		0.48	0.4868421052631579	270	15905	12	37	258	15868	16175	0.0981875564430271
M1	string	0	network_modules	46	TRUE	2.2950884415068415e-7	594	49	15	0.30612244897959184	0.025252525252525252	GO:0051668	GO:BP	localization within membrane	16175	13880		0.49333333333333335	0.5	594	15581	15	34	579	15547	16175	0.07895584263287542
M1	string	0	network_modules	46	TRUE	3.0432136867059964e-7	409	49	13	0.2653061224489796	0.03178484107579462	GO:0060627	GO:BP	regulation of vesicle-mediated transport	16175	14803		0.5066666666666667	0.5131578947368421	409	15766	13	36	396	15730	16175	0.08427608586269744
M1	string	0	network_modules	46	TRUE	3.0675902982854217e-7	130	49	9	0.1836734693877551	0.06923076923076923	GO:0016482	GO:BP	cytosolic transport	16175	5232		0.52	0.5263157894736842	130	16045	9	40	121	16005	16175	0.10843061725016612
M1	string	0	network_modules	46	TRUE	3.529138557588358e-7	102	36	8	0.2222222222222222	0.0784313725490196	REAC:R-HSA-6807878	REAC	COPI-mediated anterograde transport	10916	279		0.14285714285714285	0.1724137931034483	102	10814	8	28	94	10786	10916	0.12727354136380634
M1	string	0	network_modules	46	TRUE	4.1490818310470256e-7	155	36	9	0.25	0.05806451612903226	REAC:R-HSA-199977	REAC	ER to Golgi Anterograde Transport	10916	823		0.17857142857142858	0.20689655172413793	155	10761	9	27	146	10734	10916	0.11464448836785185
M1	string	0	network_modules	46	TRUE	6.31336607129599e-7	68	36	7	0.19444444444444445	0.10294117647058823	REAC:R-HSA-204005	REAC	COPII-mediated vesicle transport	10916	280		0.21428571428571427	0.2413793103448276	68	10848	7	29	61	10819	10916	0.1376022062546155
M1	string	0	network_modules	46	TRUE	7.983908160312025e-7	18	36	5	0.1388888888888889	0.2777777777777778	REAC:R-HSA-888590	REAC	GABA synthesis, release, reuptake and degradation	10916	1013		0.25	0.27586206896551724	18	10898	5	31	13	10867	10916	0.19456789190387858
M1	string	0	network_modules	46	TRUE	9.804258345176518e-7	148	49	9	0.1836734693877551	0.060810810810810814	GO:0017157	GO:BP	regulation of exocytosis	16175	5287		0.5333333333333333	0.5394736842105263	148	16027	9	40	139	15987	16175	0.10103597937938456
M1	string	0	network_modules	46	TRUE	1.3147391049225403e-6	34	49	6	0.12244897959183673	0.17647058823529413	GO:0006891	GO:BP	intra-Golgi vesicle-mediated transport	16175	2546		0.5466666666666666	0.5526315789473685	34	16141	6	43	28	16098	16175	0.1448469937245232
M1	string	0	network_modules	46	TRUE	2.078065884905642e-6	186	36	9	0.25	0.04838709677419355	REAC:R-HSA-948021	REAC	Transport to the Golgi and subsequent modification	10916	2604		0.2857142857142857	0.3103448275862069	186	10730	9	27	177	10703	10916	0.10354445099911673
M1	string	0	network_modules	46	TRUE	3.7149394822138907e-6	404	49	12	0.24489795918367346	0.0297029702970297	GO:1903530	GO:BP	regulation of secretion by cell	16175	23080		0.56	0.5657894736842105	404	15771	12	37	392	15734	16175	0.07768294605279893
M1	string	0	network_modules	46	TRUE	3.9047033718577705e-6	24	36	5	0.1388888888888889	0.20833333333333334	REAC:R-HSA-449836	REAC	Other interleukin signaling	10916	1651		0.32142857142857145	0.3448275862068966	24	10892	5	31	19	10861	10916	0.16787210255890742
M1	string	0	network_modules	46	TRUE	4.7846221082424454e-6	7	49	4	0.08163265306122448	0.5714285714285714	GO:0048280	GO:BP	vesicle fusion with Golgi apparatus	16175	12622		0.5733333333333334	0.5789473684210527	7	16168	4	45	3	16123	16175	0.21520742606987248
M1	string	0	network_modules	46	TRUE	4.869320784748656e-6	25	36	5	0.1388888888888889	0.2	REAC:R-HSA-5339562	REAC	Uptake and actions of bacterial toxins	10916	2626		0.35714285714285715	0.3793103448275862	25	10891	5	31	20	10860	10916	0.1643777099563733
M1	string	0	network_modules	46	TRUE	5.738721627318158e-6	20	49	5	0.10204081632653061	0.25	GO:0035493	GO:BP	SNARE complex assembly	16175	9063		0.5866666666666667	0.5921052631578947	20	16155	5	44	15	16111	16175	0.15812107356619148
M1	string	0	network_modules	46	TRUE	6.924753852381833e-6	126	49	8	0.16326530612244897	0.06349206349206349	GO:0006888	GO:BP	endoplasmic reticulum to Golgi vesicle-mediated transport	16175	2544		0.6	0.6052631578947368	126	16049	8	41	118	16008	16175	0.0974836366750434
M1	string	0	network_modules	46	TRUE	9.017568731425117e-6	99	36	7	0.19444444444444445	0.0707070707070707	REAC:R-HSA-6811434	REAC	COPI-dependent Golgi-to-ER retrograde traffic	10916	277		0.39285714285714285	0.41379310344827586	99	10817	7	29	92	10788	10916	0.11248145428344221
M1	string	0	network_modules	46	TRUE	1.0211885577615967e-5	442	49	12	0.24489795918367346	0.027149321266968326	GO:0051046	GO:BP	regulation of secretion	16175	13456		0.6133333333333333	0.618421052631579	442	15733	12	37	430	15696	16175	0.07356390543643901
M1	string	0	network_modules	46	TRUE	1.0836889924714006e-5	3	36	3	0.08333333333333333	1	REAC:R-HSA-5250971	REAC	Toxicity of botulinum toxin type C (botC)	10916	2525		0.42857142857142855	0.4482758620689655	3	10913	3	33	0	10880	10916	0.28823833939555044
M1	string	0	network_modules	46	TRUE	1.9100764976109364e-5	52	49	6	0.12244897959183673	0.11538461538461539	GO:0006890	GO:BP	retrograde vesicle-mediated transport, Golgi to endoplasmic reticulum	16175	2545		0.6266666666666667	0.631578947368421	52	16123	6	43	46	16080	16175	0.11610609890560405
M1	string	0	network_modules	46	TRUE	2.0447107800035543e-5	285	49	10	0.20408163265306123	0.03508771929824561	GO:1990778	GO:BP	protein localization to cell periphery	16175	25286		0.64	0.6447368421052632	285	15890	10	39	275	15851	16175	0.07812402486515062
M1	string	0	network_modules	46	TRUE	3.650074707738273e-5	72	36	6	0.16666666666666666	0.08333333333333333	REAC:R-HSA-199992	REAC	trans-Golgi Network Vesicle Budding	10916	2749		0.4642857142857143	0.4827586206896552	72	10844	6	30	66	10814	10916	0.11375004101508397
M1	string	0	network_modules	46	TRUE	4.838258863013408e-5	3	49	3	0.061224489795918366	1	GO:0035494	GO:BP	SNARE complex disassembly	16175	9064		0.6533333333333333	0.6578947368421053	3	16172	3	46	0	16126	16175	0.24708367303836232
M1	string	0	network_modules	46	TRUE	5.798377341585226e-5	16	36	4	0.1111111111111111	0.25	REAC:R-HSA-264642	REAC	Acetylcholine Neurotransmitter Release Cycle	10916	53		0.5	0.5172413793103449	16	10900	4	32	12	10868	10916	0.16486079800460265
M1	string	0	network_modules	46	TRUE	6.958978071668977e-5	133	36	7	0.19444444444444445	0.05263157894736842	REAC:R-HSA-8856688	REAC	Golgi-to-ER retrograde transport	10916	1084		0.5357142857142857	0.5517241379310345	133	10783	7	29	126	10754	10916	0.09556464488825207
M1	string	0	network_modules	46	TRUE	7.564709316831486e-5	17	36	4	0.1111111111111111	0.23529411764705882	REAC:R-HSA-181429	REAC	Serotonin Neurotransmitter Release Cycle	10916	2206		0.5714285714285714	0.6206896551724138	17	10899	4	32	13	10867	10916	0.15981216925385214
M1	string	0	network_modules	46	TRUE	7.564709316831486e-5	17	36	4	0.1111111111111111	0.23529411764705882	REAC:R-HSA-181430	REAC	Norepinephrine Neurotransmitter Release Cycle	10916	1609		0.5714285714285714	0.6206896551724138	17	10899	4	32	13	10867	10916	0.15981216925385214
M1	string	0	network_modules	46	TRUE	7.949703052153897e-5	776	49	14	0.2857142857142857	0.01804123711340206	GO:0060341	GO:BP	regulation of cellular localization	16175	14553		0.6666666666666666	0.6710526315789473	776	15399	14	35	762	15364	16175	0.0613200274985852
M1	string	0	network_modules	46	TRUE	1.0716788271551245e-4	253	49	9	0.1836734693877551	0.03557312252964427	GO:0072659	GO:BP	protein localization to plasma membrane	16175	17480		0.68	0.6842105263157895	253	15922	9	40	244	15882	16175	0.07464694705756819
M1	string	0	network_modules	46	TRUE	1.3456537893193814e-4	36	49	5	0.10204081632653061	0.1388888888888889	GO:0006904	GO:BP	vesicle docking involved in exocytosis	16175	2556		0.6933333333333334	0.6973684210526315	36	16139	5	44	31	16095	16175	0.11675781131169478
M1	string	0	network_modules	46	TRUE	1.4689461722636692e-4	684	49	13	0.2653061224489796	0.019005847953216373	GO:0032880	GO:BP	regulation of protein localization	16175	7877		0.7066666666666667	0.7105263157894737	684	15491	13	36	671	15455	16175	0.06108750538692407
M1	string	0	network_modules	46	TRUE	1.470465553076896e-4	305	36	9	0.25	0.029508196721311476	REAC:R-HSA-446203	REAC	Asparagine N-linked glycosylation	10916	169		0.6428571428571429	0.6551724137931034	305	10611	9	27	296	10584	10916	0.07750707387140053
M1	string	0	network_modules	46	TRUE	1.830059985765331e-4	50	36	5	0.1388888888888889	0.1	REAC:R-HSA-112310	REAC	Neurotransmitter release cycle	10916	1595		0.6785714285714286	0.6896551724137931	50	10866	5	31	45	10835	10916	0.1144152292999189
M1	string	0	network_modules	46	TRUE	2.297899172724689e-4	22	36	4	0.1111111111111111	0.18181818181818182	REAC:R-HSA-212676	REAC	Dopamine Neurotransmitter Release Cycle	10916	781		0.7142857142857143	0.7241379310344828	22	10894	4	32	18	10862	10916	0.1399274823328539
M1	string	0	network_modules	46	TRUE	2.775144132991446e-4	23	36	4	0.1111111111111111	0.17391304347826086	REAC:R-HSA-210500	REAC	Glutamate Neurotransmitter Release Cycle	10916	1055		0.75	0.7586206896551724	23	10893	4	32	19	10861	10916	0.1367431380246217
M1	string	0	network_modules	46	TRUE	4.817638762644785e-4	5	49	3	0.061224489795918366	0.6	GO:0010807	GO:BP	regulation of synaptic vesicle priming	16175	4419		0.72	0.7763157894736842	5	16170	3	46	2	16124	16175	0.19101430012590817
M1	string	0	network_modules	46	TRUE	4.817638762644785e-4	5	49	3	0.061224489795918366	0.6	GO:0002553	GO:BP	histamine secretion by mast cell	16175	1074		0.72	0.7763157894736842	5	16170	3	46	2	16124	16175	0.19101430012590817
M1	string	0	network_modules	46	TRUE	4.817638762644785e-4	5	49	3	0.061224489795918366	0.6	GO:0002441	GO:BP	histamine secretion involved in inflammatory response	16175	964		0.72	0.7763157894736842	5	16170	3	46	2	16124	16175	0.19101430012590817
M1	string	0	network_modules	46	TRUE	4.817638762644785e-4	5	49	3	0.061224489795918366	0.6	GO:0002349	GO:BP	histamine production involved in inflammatory response	16175	881		0.72	0.7763157894736842	5	16170	3	46	2	16124	16175	0.19101430012590817
M1	string	0	network_modules	46	TRUE	4.817638762644785e-4	5	49	3	0.061224489795918366	0.6	GO:0001821	GO:BP	histamine secretion	16175	478		0.72	0.7763157894736842	5	16170	3	46	2	16124	16175	0.19101430012590817
M1	string	0	network_modules	46	TRUE	6.512524222871573e-4	93	49	6	0.12244897959183673	0.06451612903225806	GO:1903076	GO:BP	regulation of protein localization to plasma membrane	16175	22751		0.7866666666666666	0.7894736842105263	93	16082	6	43	87	16039	16175	0.08508166790790114
M1	string	0	network_modules	46	TRUE	7.431766582300546e-4	66	36	5	0.1388888888888889	0.07575757575757576	REAC:R-HSA-9824439	REAC	Bacterial Infection Pathways	10916	204		0.7857142857142857	0.8275862068965517	66	10850	5	31	61	10819	10916	0.09857147290916542
M1	string	0	network_modules	46	TRUE	7.431766582300546e-4	66	36	5	0.1388888888888889	0.07575757575757576	REAC:R-HSA-9662360	REAC	Sensory processing of sound by inner hair cells of the cochlea	10916	2202		0.7857142857142857	0.8275862068965517	66	10850	5	31	61	10819	10916	0.09857147290916542
M1	string	0	network_modules	46	TRUE	0.001002325679889099	100	49	6	0.12244897959183673	0.06	GO:0006892	GO:BP	post-Golgi vesicle-mediated transport	16175	2547		0.8	0.8026315789473685	100	16075	6	43	94	16032	16175	0.08176331309678588
M1	string	0	network_modules	46	TRUE	0.0013029736154702804	56	49	5	0.10204081632653061	0.08928571428571429	GO:0043299	GO:BP	leukocyte degranulation	16175	10607		0.8133333333333334	0.8157894736842105	56	16119	5	44	51	16075	16175	0.09251218830782164
M1	string	0	network_modules	46	TRUE	0.0013143933649274377	74	36	5	0.1388888888888889	0.06756756756756757	REAC:R-HSA-9659379	REAC	Sensory processing of sound	10916	2201		0.8571428571428571	0.8620689655172413	74	10842	5	31	69	10811	10916	0.09261150980186808
M1	string	0	network_modules	46	TRUE	0.0019572643362400777	112	49	6	0.12244897959183673	0.05357142857142857	GO:1904375	GO:BP	regulation of protein localization to cell periphery	16175	23762		0.8266666666666667	0.8289473684210527	112	16063	6	43	106	16020	16175	0.07679475544195664
M1	string	0	network_modules	46	TRUE	0.002359830198247183	63	49	5	0.10204081632653061	0.07936507936507936	GO:0002275	GO:BP	myeloid cell activation involved in immune response	16175	807		0.84	0.8421052631578947	63	16112	5	44	58	16068	16175	0.08685728229278895
M1	string	0	network_modules	46	TRUE	0.0026806530384460053	8	49	3	0.061224489795918366	0.375	GO:0043308	GO:BP	eosinophil degranulation	16175	10616		0.8533333333333334	0.881578947368421	8	16167	3	46	5	16121	16175	0.1505642449285411
M1	string	0	network_modules	46	TRUE	0.0026806530384460053	8	49	3	0.061224489795918366	0.375	GO:0002278	GO:BP	eosinophil activation involved in immune response	16175	810		0.8533333333333334	0.881578947368421	8	16167	3	46	5	16121	16175	0.1505642449285411
M1	string	0	network_modules	46	TRUE	0.0026806530384460053	8	49	3	0.061224489795918366	0.375	GO:0002447	GO:BP	eosinophil mediated immunity	16175	970		0.8533333333333334	0.881578947368421	8	16167	3	46	5	16121	16175	0.1505642449285411
M1	string	0	network_modules	46	TRUE	0.0034524867943872897	90	36	5	0.1388888888888889	0.05555555555555555	REAC:R-HSA-1236974	REAC	ER-Phagosome pathway	10916	824		0.8928571428571429	0.896551724137931	90	10826	5	31	85	10795	10916	0.08310648232449264
M1	string	0	network_modules	46	TRUE	0.003460276026263554	68	49	5	0.10204081632653061	0.07352941176470588	GO:0045921	GO:BP	positive regulation of exocytosis	16175	11715		0.8933333333333333	0.8947368421052632	68	16107	5	44	63	16063	16175	0.08335265650344988
M1	string	0	network_modules	46	TRUE	0.00401240553524907	9	49	3	0.061224489795918366	0.3333333333333333	GO:0043307	GO:BP	eosinophil activation	16175	10615		0.9066666666666666	0.9210526315789473	9	16166	3	46	6	16120	16175	0.14181320713184362
M1	string	0	network_modules	46	TRUE	0.00401240553524907	9	49	3	0.061224489795918366	0.3333333333333333	GO:0051608	GO:BP	histamine transport	16175	13824		0.9066666666666666	0.9210526315789473	9	16166	3	46	6	16120	16175	0.14181320713184362
M1	string	0	network_modules	46	TRUE	0.0040270705512332325	504	49	10	0.20408163265306123	0.01984126984126984	GO:0072657	GO:BP	protein localization to membrane	16175	17478		0.9333333333333333	0.9342105263157895	504	15671	10	39	494	15632	16175	0.0548613795121425
M1	string	0	network_modules	46	TRUE	0.004602527426025497	72	49	5	0.10204081632653061	0.06944444444444445	GO:0002444	GO:BP	myeloid leukocyte mediated immunity	16175	967		0.9466666666666667	0.9473684210526315	72	16103	5	44	67	16059	16175	0.08080950775113024
M1	string	0	network_modules	46	TRUE	0.006725067810336678	35	49	4	0.08163265306122448	0.11428571428571428	GO:1903307	GO:BP	positive regulation of regulated secretory pathway	16175	22894		0.96	0.9605263157894737	35	16140	4	45	31	16095	16175	0.09427357544854438
M1	string	0	network_modules	46	TRUE	0.00698823339367401	104	36	5	0.1388888888888889	0.04807692307692308	REAC:R-HSA-8856825	REAC	Cargo recognition for clathrin-mediated endocytosis	10916	309		0.9285714285714286	0.9310344827586207	104	10812	5	31	99	10781	10916	0.07660127260740396
M1	string	0	network_modules	46	TRUE	0.007296958383044968	79	49	5	0.10204081632653061	0.06329113924050633	GO:0032456	GO:BP	endocytic recycling	16175	7571		0.9733333333333334	0.9736842105263158	79	16096	5	44	74	16052	16175	0.07682089989332995
M1	string	0	network_modules	46	TRUE	0.007320257848252259	105	36	5	0.1388888888888889	0.047619047619047616	REAC:R-HSA-1236975	REAC	Antigen processing-Cross presentation	10916	153		0.9642857142857143	0.9655172413793104	105	10811	5	31	100	10780	10916	0.07618516825241356
M1	string	0	network_modules	46	TRUE	0.008474166460597876	144	49	6	0.12244897959183673	0.041666666666666664	GO:0007030	GO:BP	Golgi organization	16175	2635		0.9866666666666667	1	144	16031	6	43	138	15988	16175	0.06663319452003089
M1	string	0	network_modules	46	TRUE	0.008474166460597876	144	49	6	0.12244897959183673	0.041666666666666664	GO:1905475	GO:BP	regulation of protein localization to membrane	16175	24661		0.9866666666666667	1	144	16031	6	43	138	15988	16175	0.06663319452003089
M1	string	0	network_modules	46	TRUE	0.00921576704302917	54	36	4	0.1111111111111111	0.07407407407407407	REAC:R-HSA-432722	REAC	Golgi Associated Vesicle Biogenesis	10916	1082		1	1	54	10862	4	32	50	10830	10916	0.08704159136483579
M1	string	0	network_modules	47	TRUE	1.6333196291009167e-32	79	22	18	0.8181818181818182	0.22784810126582278	KEGG:03018	KEGG	RNA degradation	8484	211		0	0.5	79	8405	18	4	61	8401	8484	0.42940975505013806
M1	string	0	network_modules	47	TRUE	1.725709701052978e-21	56	36	14	0.3888888888888889	0.25	REAC:R-HSA-429914	REAC	Deadenylation-dependent mRNA decay	10916	454		0	0.07692307692307693	56	10860	14	22	42	10838	10916	0.3089937935150849
M1	string	0	network_modules	47	TRUE	5.770106963011302e-17	16	36	9	0.25	0.5625	REAC:R-HSA-429958	REAC	mRNA decay by 3' to 5' exoribonuclease	10916	2709		0.08333333333333333	0.15384615384615385	16	10900	9	27	7	10873	10916	0.3736916176084648
M1	string	0	network_modules	47	TRUE	1.2234147999124146e-16	17	36	9	0.25	0.5294117647058824	REAC:R-HSA-450604	REAC	KSRP (KHSRP) binds and destabilizes mRNA	10916	1283		0.16666666666666666	0.38461538461538464	17	10899	9	27	8	10872	10916	0.3624171167098414
M1	string	0	network_modules	47	TRUE	1.2234147999124146e-16	17	36	9	0.25	0.5294117647058824	REAC:R-HSA-450385	REAC	Butyrate Response Factor 1 (BRF1) binds and destabilizes mRNA	10916	259		0.16666666666666666	0.38461538461538464	17	10899	9	27	8	10872	10916	0.3624171167098414
M1	string	0	network_modules	47	TRUE	1.2234147999124146e-16	17	36	9	0.25	0.5294117647058824	REAC:R-HSA-450513	REAC	Tristetraprolin (TTP, ZFP36) binds and destabilizes mRNA	10916	2608		0.16666666666666666	0.38461538461538464	17	10899	9	27	8	10872	10916	0.3624171167098414
M1	string	0	network_modules	47	TRUE	2.0507330713057288e-16	205	45	16	0.35555555555555557	0.07804878048780488	GO:0016072	GO:BP	rRNA metabolic process	16175	5099		0	0.022222222222222223	205	15970	16	29	189	15941	16175	0.1619005225953688
M1	string	0	network_modules	47	TRUE	1.1270759585374723e-14	8	45	7	0.15555555555555556	0.875	GO:0034475	GO:BP	U4 snRNA 3'-end processing	16175	8652		0.022727272727272728	0.044444444444444446	8	16167	7	38	1	16129	16175	0.3683631114620746
M1	string	0	network_modules	47	TRUE	2.306606892270328e-14	27	36	9	0.25	0.3333333333333333	REAC:R-HSA-380994	REAC	ATF4 activates genes in response to endoplasmic reticulum  stress	10916	35		0.4166666666666667	0.46153846153846156	27	10889	9	27	18	10862	10916	0.28664625121460446
M1	string	0	network_modules	47	TRUE	2.4088097304761754e-14	169	45	14	0.3111111111111111	0.08284023668639054	GO:0006364	GO:BP	rRNA processing	16175	2140		0.045454545454545456	0.06666666666666667	169	16006	14	31	155	15975	16175	0.15618108280550158
M1	string	0	network_modules	47	TRUE	1.365085845084822e-13	32	36	9	0.25	0.28125	REAC:R-HSA-381042	REAC	PERK regulates gene expression	10916	1664		0.5	0.5384615384615384	32	10884	9	27	23	10857	10916	0.26287452045614956
M1	string	0	network_modules	47	TRUE	1.0311891060670704e-12	22	45	8	0.17777777777777778	0.36363636363636365	GO:0034472	GO:BP	snRNA 3'-end processing	16175	8649		0.06818181818181818	0.08888888888888889	22	16153	8	37	14	16116	16175	0.2528351602140231
M1	string	0	network_modules	47	TRUE	2.72096961182969e-12	182	36	13	0.3611111111111111	0.07142857142857142	REAC:R-HSA-6791226	REAC	Major pathway of rRNA processing in the nucleolus and cytosol	10916	1389		0.5833333333333334	0.6153846153846154	182	10734	13	23	169	10711	10916	0.15473741030804253
M1	string	0	network_modules	47	TRUE	4.77579526967288e-12	14	45	7	0.15555555555555556	0.5	GO:0071027	GO:BP	nuclear RNA surveillance	16175	16427		0.09090909090909091	0.1111111111111111	14	16161	7	38	7	16123	16175	0.27784176660903037
M1	string	0	network_modules	47	TRUE	5.473092428002311e-12	192	36	13	0.3611111111111111	0.06770833333333333	REAC:R-HSA-8868773	REAC	rRNA processing in the nucleus and cytosol	10916	2734		0.6666666666666666	0.6923076923076923	192	10724	13	23	179	10701	10916	0.1503232598905094
M1	string	0	network_modules	47	TRUE	5.86777642733624e-12	390	45	16	0.35555555555555557	0.041025641025641026	GO:0022613	GO:BP	ribonucleoprotein complex biogenesis	16175	6620		0.11363636363636363	0.13333333333333333	390	15785	16	29	374	15756	16175	0.11412723216594843
M1	string	0	network_modules	47	TRUE	6.343998994692204e-12	251	45	14	0.3111111111111111	0.055776892430278883	GO:0042254	GO:BP	ribosome biogenesis	16175	10060		0.13636363636363635	0.15555555555555556	251	15924	14	31	237	15893	16175	0.12631794662962934
M1	string	0	network_modules	47	TRUE	1.0601625270407352e-11	202	36	13	0.3611111111111111	0.06435643564356436	REAC:R-HSA-72312	REAC	rRNA processing	10916	2732		0.75	0.7692307692307693	202	10714	13	23	189	10691	10916	0.14623253090850713
M1	string	0	network_modules	47	TRUE	1.2387495958914667e-11	590	45	18	0.4	0.030508474576271188	GO:0016071	GO:BP	mRNA metabolic process	16175	5098		0.1590909090909091	0.17777777777777778	590	15585	18	27	572	15558	16175	0.10242052322571928
M1	string	0	network_modules	47	TRUE	1.5853896857857852e-11	16	45	7	0.15555555555555556	0.4375	GO:0071025	GO:BP	RNA surveillance	16175	16425		0.18181818181818182	0.2	16	16159	7	38	9	16121	16175	0.25970550267176884
M1	string	0	network_modules	47	TRUE	2.4251334336902842e-11	80	45	10	0.2222222222222222	0.125	GO:0031123	GO:BP	RNA 3'-end processing	16175	7048		0.20454545454545456	0.2222222222222222	80	16095	10	35	70	16060	16175	0.16358944223457544
M1	string	0	network_modules	47	TRUE	2.7522393999197013e-11	279	45	14	0.3111111111111111	0.05017921146953405	GO:0006401	GO:BP	RNA catabolic process	16175	2162		0.22727272727272727	0.24444444444444444	279	15896	14	31	265	15865	16175	0.11921507144064596
M1	string	0	network_modules	47	TRUE	5.7135585606791606e-11	34	45	8	0.17777777777777778	0.23529411764705882	GO:0016180	GO:BP	snRNA processing	16175	5161		0.25	0.26666666666666666	34	16141	8	37	26	16104	16175	0.20260051609037585
M1	string	0	network_modules	47	TRUE	7.155261417040498e-11	299	45	14	0.3111111111111111	0.046822742474916385	GO:0141188	GO:BP	nucleic acid catabolic process	16175	20075		0.2727272727272727	0.28888888888888886	299	15876	14	31	285	15845	16175	0.11474660071786684
M1	string	0	network_modules	47	TRUE	1.9833678094035688e-9	86	36	9	0.25	0.10465116279069768	REAC:R-HSA-450531	REAC	Regulation of mRNA stability by proteins that bind AU-rich elements	10916	2043		0.8333333333333334	0.8461538461538461	86	10830	9	27	77	10803	10916	0.1575326257582882
M1	string	0	network_modules	47	TRUE	3.6969050765512675e-9	92	36	9	0.25	0.09782608695652174	REAC:R-HSA-381119	REAC	Unfolded Protein Response (UPR)	10916	2624		0.9166666666666666	0.9230769230769231	92	10824	9	27	83	10797	10916	0.15200543866678265
M1	string	0	network_modules	47	TRUE	4.948262810630183e-9	7	45	5	0.1111111111111111	0.7142857142857143	GO:0071035	GO:BP	nuclear polyadenylation-dependent rRNA catabolic process	16175	16433		0.29545454545454547	0.3333333333333333	7	16168	5	40	2	16128	16175	0.28107281724315075
M1	string	0	network_modules	47	TRUE	4.948262810630183e-9	7	45	5	0.1111111111111111	0.7142857142857143	GO:0071038	GO:BP	TRAMP-dependent tRNA surveillance pathway	16175	16436		0.29545454545454547	0.3333333333333333	7	16168	5	40	2	16128	16175	0.28107281724315075
M1	string	0	network_modules	47	TRUE	4.9617645650632495e-9	57	45	8	0.17777777777777778	0.14035087719298245	GO:0016073	GO:BP	snRNA metabolic process	16175	5100		0.3409090909090909	0.35555555555555557	57	16118	8	37	49	16081	16175	0.15531831454613157
M1	string	0	network_modules	47	TRUE	5.716647157826556e-9	33	45	7	0.15555555555555556	0.21212121212121213	GO:0000460	GO:BP	maturation of 5.8S rRNA	16175	150		0.36363636363636365	0.37777777777777777	33	16142	7	38	26	16104	16175	0.17970062393486144
M1	string	0	network_modules	47	TRUE	1.316816648925508e-8	8	45	5	0.1111111111111111	0.625	GO:0106354	GO:BP	tRNA surveillance	16175	19317		0.38636363636363635	0.4	8	16167	5	40	3	16127	16175	0.2627808082166211
M1	string	0	network_modules	47	TRUE	1.738443565930149e-8	448	45	14	0.3111111111111111	0.03125	GO:0034655	GO:BP	nucleobase-containing compound catabolic process	16175	8711		0.4090909090909091	0.4222222222222222	448	15727	14	31	434	15696	16175	0.09122057068213192
M1	string	0	network_modules	47	TRUE	2.9567298873145757e-8	9	45	5	0.1111111111111111	0.5555555555555556	GO:0000467	GO:BP	exonucleolytic trimming to generate mature 3'-end of 5.8S rRNA from tricistronic rRNA transcript (SSU-rRNA, 5.8S rRNA, LSU-rRNA)	16175	157		0.4318181818181818	0.4444444444444444	9	16166	5	40	4	16126	16175	0.24762131111917512
M1	string	0	network_modules	47	TRUE	5.9012698841024436e-8	10	45	5	0.1111111111111111	0.5	GO:0031125	GO:BP	rRNA 3'-end processing	16175	7050		0.45454545454545453	0.4888888888888889	10	16165	5	40	5	16125	16175	0.23479009660638958
M1	string	0	network_modules	47	TRUE	5.9012698841024436e-8	10	45	5	0.1111111111111111	0.5	GO:0071028	GO:BP	nuclear mRNA surveillance	16175	16428		0.45454545454545453	0.4888888888888889	10	16165	5	40	5	16125	16175	0.23479009660638958
M1	string	0	network_modules	47	TRUE	2.521668423082836e-7	352	45	12	0.26666666666666666	0.03409090909090909	GO:0006397	GO:BP	mRNA processing	16175	2158		0.5	0.5111111111111111	352	15823	12	33	340	15790	16175	0.0886573438523828
M1	string	0	network_modules	47	TRUE	2.818254320957374e-7	15	36	5	0.1388888888888889	0.3333333333333333	REAC:R-HSA-430039	REAC	mRNA decay by 5' to 3' exoribonuclease	10916	2710		1	1	15	10901	5	31	10	10870	10916	0.21353587204644206
M1	string	0	network_modules	47	TRUE	1.0103007190997816e-6	16	45	5	0.1111111111111111	0.3125	GO:0016078	GO:BP	tRNA decay	16175	5105		0.5227272727272727	0.5333333333333333	16	16159	5	40	11	16119	16175	0.18502906152309348
M1	string	0	network_modules	47	TRUE	6.016004690162094e-6	22	45	5	0.1111111111111111	0.22727272727272727	GO:0000466	GO:BP	maturation of 5.8S rRNA from tricistronic rRNA transcript (SSU-rRNA, 5.8S rRNA, LSU-rRNA)	16175	156		0.5454545454545454	0.5555555555555556	22	16153	5	40	17	16113	16175	0.15729099582351247
M1	string	0	network_modules	47	TRUE	6.479626050644541e-6	8	45	4	0.08888888888888889	0.5	GO:0071051	GO:BP	poly(A)-dependent snoRNA 3'-end processing	16175	16446		0.5681818181818182	0.5777777777777777	8	16167	4	41	4	16126	16175	0.20998965659389432
M1	string	0	network_modules	47	TRUE	1.769338890707531e-5	226	45	9	0.2	0.03982300884955752	GO:0006402	GO:BP	mRNA catabolic process	16175	2163		0.5909090909090909	0.6	226	15949	9	36	217	15913	16175	0.08371250007567829
M1	string	0	network_modules	47	TRUE	3.593298566672222e-5	3	45	3	0.06666666666666667	1	GO:0034473	GO:BP	U1 snRNA 3'-end processing	16175	8650		0.6136363636363636	0.6444444444444445	3	16172	3	42	0	16130	16175	0.25786339001168607
M1	string	0	network_modules	47	TRUE	3.593298566672222e-5	3	45	3	0.06666666666666667	1	GO:0034476	GO:BP	U5 snRNA 3'-end processing	16175	8653		0.6136363636363636	0.6444444444444445	3	16172	3	42	0	16130	16175	0.25786339001168607
M1	string	0	network_modules	47	TRUE	4.544965735002362e-5	12	45	4	0.08888888888888889	0.3333333333333333	GO:0031126	GO:BP	sno(s)RNA 3'-end processing	16175	7051		0.6590909090909091	0.6666666666666666	12	16163	4	41	8	16122	16175	0.17099732053242012
M1	string	0	network_modules	47	TRUE	6.551638224765509e-5	13	45	4	0.08888888888888889	0.3076923076923077	GO:0045006	GO:BP	DNA deamination	16175	11224		0.6818181818181818	0.6888888888888889	13	16162	4	41	9	16121	16175	0.16417876280705937
M1	string	0	network_modules	47	TRUE	9.153694738174338e-5	14	45	4	0.08888888888888889	0.2857142857142857	GO:0016075	GO:BP	rRNA catabolic process	16175	5102		0.7045454545454546	0.7333333333333333	14	16161	4	41	10	16120	16175	0.15810046615427484
M1	string	0	network_modules	47	TRUE	9.153694738174338e-5	14	45	4	0.08888888888888889	0.2857142857142857	GO:0043144	GO:BP	sno(s)RNA processing	16175	10551		0.7045454545454546	0.7333333333333333	14	16161	4	41	10	16120	16175	0.15810046615427484
M1	string	0	network_modules	47	TRUE	1.434519800033954e-4	4	45	3	0.06666666666666667	0.75	GO:0071042	GO:BP	nuclear polyadenylation-dependent mRNA catabolic process	16175	16440		0.75	0.7777777777777778	4	16171	3	42	1	16129	16175	0.22311547311668495
M1	string	0	network_modules	47	TRUE	1.434519800033954e-4	4	45	3	0.06666666666666667	0.75	GO:0071047	GO:BP	polyadenylation-dependent mRNA catabolic process	16175	16445		0.75	0.7777777777777778	4	16171	3	42	1	16129	16175	0.22311547311668495
M1	string	0	network_modules	47	TRUE	1.5651206902535117e-4	291	45	9	0.2	0.030927835051546393	GO:0000375	GO:BP	RNA splicing, via transesterification reactions	16175	107		0.7954545454545454	0.8	291	15884	9	36	282	15848	16175	0.0723269989158072
M1	string	0	network_modules	47	TRUE	1.6575658399609384e-4	16	45	4	0.08888888888888889	0.25	GO:0016074	GO:BP	sno(s)RNA metabolic process	16175	5101		0.8181818181818182	0.8222222222222222	16	16159	4	41	12	16118	16175	0.1476908409487558
M1	string	0	network_modules	47	TRUE	3.579314629860438e-4	5	45	3	0.06666666666666667	0.6	GO:0071034	GO:BP	CUT catabolic process	16175	16432		0.8409090909090909	0.8666666666666667	5	16170	3	42	2	16128	16175	0.19938095783993656
M1	string	0	network_modules	47	TRUE	3.579314629860438e-4	5	45	3	0.06666666666666667	0.6	GO:0071043	GO:BP	CUT metabolic process	16175	16441		0.8409090909090909	0.8666666666666667	5	16170	3	42	2	16128	16175	0.19938095783993656
M1	string	0	network_modules	47	TRUE	0.0011848989822258972	113	45	6	0.13333333333333333	0.05309734513274336	GO:0000956	GO:BP	nuclear-transcribed mRNA catabolic process	16175	264		0.8863636363636364	0.8888888888888888	113	16062	6	39	107	16023	16175	0.08012353504242942
M1	string	0	network_modules	47	TRUE	0.001563084474495196	27	45	4	0.08888888888888889	0.14814814814814814	GO:0006304	GO:BP	DNA modification	16175	2111		0.9090909090909091	0.9111111111111111	27	16148	4	41	23	16107	16175	0.11285126480608967
M1	string	0	network_modules	47	TRUE	0.0019405540900220698	287	45	8	0.17777777777777778	0.027874564459930314	GO:0000398	GO:BP	mRNA splicing, via spliceosome	16175	121		0.9318181818181818	0.9555555555555556	287	15888	8	37	279	15851	16175	0.06402815675123733
M1	string	0	network_modules	47	TRUE	0.0019405540900220698	287	45	8	0.17777777777777778	0.027874564459930314	GO:0000377	GO:BP	RNA splicing, via transesterification reactions with bulged adenosine as nucleophile	16175	109		0.9318181818181818	0.9555555555555556	287	15888	8	37	279	15851	16175	0.06402815675123733
M1	string	0	network_modules	47	TRUE	0.0021369005682090403	397	45	9	0.2	0.022670025188916875	GO:0008380	GO:BP	RNA splicing	16175	3186		0.9772727272727273	0.9777777777777777	397	15778	9	36	388	15742	16175	0.059893574795861014
M1	string	0	network_modules	47	TRUE	0.004507380319303342	174	22	5	0.22727272727272727	0.028735632183908046	KEGG:03040	KEGG	Spliceosome	8484	215		1	1	174	8310	5	17	169	8293	8484	0.0743831042933181
M1	string	0	network_modules	47	TRUE	0.00972397699349667	92	45	5	0.1111111111111111	0.05434782608695652	GO:0061157	GO:BP	mRNA destabilization	16175	15262		1	1	92	16083	5	40	87	16043	16175	0.07404446716556236
M1	string	0	network_modules	48	TRUE	6.780549587065513e-74	57	41	34	0.8292682926829268	0.5964912280701754	REAC:R-HSA-380108	REAC	Chemokine receptors bind chemokines	10916	346		0	0.16666666666666666	57	10859	34	7	23	10852	10916	0.7020374011425904
M1	string	0	network_modules	48	TRUE	3.715739475079847e-72	98	44	39	0.8863636363636364	0.3979591836734694	KEGG:04061	KEGG	Viral protein interaction with cytokine and cytokine receptor	8484	254		0	0.125	98	8386	39	5	59	8381	8484	0.5911262951146661
M1	string	0	network_modules	48	TRUE	4.308197725400272e-57	91	48	31	0.6458333333333334	0.34065934065934067	GO:0030593	GO:BP	neutrophil chemotaxis	16175	6860		0	0.007751937984496124	91	16084	31	17	60	16067	16175	0.46697222961221435
M1	string	0	network_modules	48	TRUE	1.2069305786998912e-56	110	48	32	0.6666666666666666	0.2909090909090909	GO:0071621	GO:BP	granulocyte chemotaxis	16175	16801		0.0078125	0.015503875968992248	110	16065	32	16	78	16049	16175	0.43803336407265236
M1	string	0	network_modules	48	TRUE	2.061464999486955e-56	190	44	38	0.8636363636363636	0.2	KEGG:04062	KEGG	Chemokine signaling pathway	8484	255		0.14285714285714285	0.25	190	8294	38	6	152	8288	8484	0.4105041269324039
M1	string	0	network_modules	48	TRUE	3.3200152227933766e-56	273	48	38	0.7916666666666666	0.1391941391941392	GO:0060326	GO:BP	cell chemotaxis	16175	14538		0.015625	0.023255813953488372	273	15902	38	10	235	15892	16175	0.32814382304317974
M1	string	0	network_modules	48	TRUE	3.02854960755216e-55	375	48	40	0.8333333333333334	0.10666666666666667	GO:0042330	GO:BP	taxis	16175	10096		0.0234375	0.03875968992248062	375	15800	40	8	335	15792	16175	0.29370345570134443
M1	string	0	network_modules	48	TRUE	3.02854960755216e-55	375	48	40	0.8333333333333334	0.10666666666666667	GO:0006935	GO:BP	chemotaxis	16175	2574		0.0234375	0.03875968992248062	375	15800	40	8	335	15792	16175	0.29370345570134443
M1	string	0	network_modules	48	TRUE	1.2064163614274227e-54	106	48	31	0.6458333333333334	0.29245283018867924	GO:1990266	GO:BP	neutrophil migration	16175	25128		0.0390625	0.046511627906976744	106	16069	31	17	75	16052	16175	0.43224689445776376
M1	string	0	network_modules	48	TRUE	2.4688252934392556e-54	127	48	32	0.6666666666666666	0.25196850393700787	GO:0097530	GO:BP	granulocyte migration	16175	18690		0.046875	0.05426356589147287	127	16048	32	16	95	16032	16175	0.4072295686601814
M1	string	0	network_modules	48	TRUE	4.0664953384648645e-54	195	41	35	0.8536585365853658	0.1794871794871795	REAC:R-HSA-375276	REAC	Peptide ligand-binding receptors	10916	1726		0.2	0.3333333333333333	195	10721	35	6	160	10715	10916	0.38744098465435256
M1	string	0	network_modules	48	TRUE	1.3556777159926827e-53	68	48	28	0.5833333333333334	0.4117647058823529	GO:0070098	GO:BP	chemokine-mediated signaling pathway	16175	15910		0.0546875	0.06201550387596899	68	16107	28	20	40	16087	16175	0.48831703872856724
M1	string	0	network_modules	48	TRUE	1.6098716899633674e-53	291	44	40	0.9090909090909091	0.13745704467353953	KEGG:04060	KEGG	Cytokine-cytokine receptor interaction	8484	253		0.2857142857142857	0.375	291	8193	40	4	251	8189	8484	0.34705006831916363
M1	string	0	network_modules	48	TRUE	6.709529200419626e-52	76	48	28	0.5833333333333334	0.3684210526315789	GO:1990868	GO:BP	response to chemokine	16175	25323		0.0625	0.07751937984496124	76	16099	28	20	48	16079	16175	0.4616218543137832
M1	string	0	network_modules	48	TRUE	6.709529200419626e-52	76	48	28	0.5833333333333334	0.3684210526315789	GO:1990869	GO:BP	cellular response to chemokine	16175	25324		0.0625	0.07751937984496124	76	16099	28	20	48	16079	16175	0.4616218543137832
M1	string	0	network_modules	48	TRUE	1.984117862482522e-48	186	48	32	0.6666666666666666	0.17204301075268819	GO:0097529	GO:BP	myeloid leukocyte migration	16175	18689		0.078125	0.08527131782945736	186	15989	32	16	154	15973	16175	0.33525348214525025
M1	string	0	network_modules	48	TRUE	2.46239809629558e-47	200	48	32	0.6666666666666666	0.16	GO:0030595	GO:BP	leukocyte chemotaxis	16175	6861		0.0859375	0.09302325581395349	200	15975	32	16	168	15959	16175	0.3230210833757843
M1	string	0	network_modules	48	TRUE	1.1913487792527653e-45	328	41	35	0.8536585365853658	0.10670731707317073	REAC:R-HSA-373076	REAC	Class A/1 (Rhodopsin-like receptors)	10916	365		0.4	0.5	328	10588	35	6	293	10582	10916	0.2962231664875487
M1	string	0	network_modules	48	TRUE	3.0909825276653185e-43	304	48	33	0.6875	0.10855263157894737	GO:0050900	GO:BP	leukocyte migration	16175	13342		0.09375	0.10077519379844961	304	15871	33	15	271	15856	16175	0.2686483108848575
M1	string	0	network_modules	48	TRUE	2.666067977498606e-40	460	41	35	0.8536585365853658	0.07608695652173914	REAC:R-HSA-500792	REAC	GPCR ligand binding	10916	1019		0.6	0.6666666666666666	460	10456	35	6	425	10450	10916	0.24801478739179744
M1	string	0	network_modules	48	TRUE	1.6407626715699047e-36	774	48	37	0.7708333333333334	0.04780361757105943	GO:0007186	GO:BP	G protein-coupled receptor signaling pathway	16175	2744		0.1015625	0.10852713178294573	774	15401	37	11	737	15390	16175	0.18478660447249956
M1	string	0	network_modules	48	TRUE	3.6630395356422795e-35	594	48	34	0.7083333333333334	0.05723905723905724	GO:0006954	GO:BP	inflammatory response	16175	2585		0.109375	0.11627906976744186	594	15581	34	14	560	15567	16175	0.194811405400738
M1	string	0	network_modules	48	TRUE	8.210031803640107e-33	419	48	30	0.625	0.07159904534606205	GO:0019221	GO:BP	cytokine-mediated signaling pathway	16175	5598		0.1171875	0.12403100775193798	419	15756	30	18	389	15738	16175	0.20575690183667283
M1	string	0	network_modules	48	TRUE	8.252103364134595e-31	555	48	31	0.6458333333333334	0.055855855855855854	GO:0071345	GO:BP	cellular response to cytokine stimulus	16175	16597		0.125	0.13178294573643412	555	15620	31	17	524	15603	16175	0.18327894308078216
M1	string	0	network_modules	48	TRUE	9.528575957065228e-30	59	48	18	0.375	0.3050847457627119	GO:0048247	GO:BP	lymphocyte chemotaxis	16175	12605		0.1328125	0.13953488372093023	59	16116	18	30	41	16086	16175	0.3360622338388239
M1	string	0	network_modules	48	TRUE	3.356576367535632e-29	625	48	31	0.6458333333333334	0.0496	GO:1901652	GO:BP	response to peptide	16175	21619		0.140625	0.15503875968992248	625	15550	31	17	594	15533	16175	0.17187392415873642
M1	string	0	network_modules	48	TRUE	3.356576367535632e-29	625	48	31	0.6458333333333334	0.0496	GO:0034097	GO:BP	response to cytokine	16175	8408		0.140625	0.15503875968992248	625	15550	31	17	594	15533	16175	0.17187392415873642
M1	string	0	network_modules	48	TRUE	4.015068079210814e-28	312	41	26	0.6341463414634146	0.08333333333333333	REAC:R-HSA-418594	REAC	G alpha (i) signalling events	10916	987		0.8	0.8333333333333334	312	10604	26	15	286	10589	10916	0.22314596231428777
M1	string	0	network_modules	48	TRUE	3.1463175411515808e-27	188	48	22	0.4583333333333333	0.11702127659574468	GO:0071674	GO:BP	mononuclear cell migration	16175	16847		0.15625	0.16279069767441862	188	15987	22	26	166	15961	16175	0.22737977027419468
M1	string	0	network_modules	48	TRUE	5.104875037140311e-27	102	48	19	0.3958333333333333	0.18627450980392157	GO:0072676	GO:BP	lymphocyte migration	16175	17494		0.1640625	0.17054263565891473	102	16073	19	29	83	16044	16175	0.26845868809612367
M1	string	0	network_modules	48	TRUE	2.5383753322770416e-26	67	48	17	0.3541666666666667	0.2537313432835821	GO:0002548	GO:BP	monocyte chemotaxis	16175	1069		0.171875	0.17829457364341086	67	16108	17	31	50	16077	16175	0.2973228672519455
M1	string	0	network_modules	48	TRUE	6.411313265739537e-22	89	48	16	0.3333333333333333	0.1797752808988764	GO:0071347	GO:BP	cellular response to interleukin-1	16175	16599		0.1796875	0.18604651162790697	89	16086	16	32	73	16054	16175	0.2417793010714552
M1	string	0	network_modules	48	TRUE	7.891079106843401e-21	78	48	15	0.3125	0.19230769230769232	GO:0061844	GO:BP	antimicrobial humoral immune response mediated by antimicrobial peptide	16175	15685		0.1875	0.1937984496124031	78	16097	15	33	63	16064	16175	0.24230614231841924
M1	string	0	network_modules	48	TRUE	1.1036884874295135e-20	105	48	16	0.3333333333333333	0.1523809523809524	GO:0070555	GO:BP	response to interleukin-1	16175	16175		0.1953125	0.20155038759689922	105	16070	16	32	89	16038	16175	0.2220358830169079
M1	string	0	network_modules	48	TRUE	3.205644539930663e-20	85	48	15	0.3125	0.17647058823529413	GO:0071346	GO:BP	cellular response to type II interferon	16175	16598		0.203125	0.20930232558139536	85	16090	15	33	70	16057	16175	0.23183842696753187
M1	string	0	network_modules	48	TRUE	1.054746601170115e-18	175	48	17	0.3541666666666667	0.09714285714285714	GO:0070374	GO:BP	positive regulation of ERK1 and ERK2 cascade	16175	16085		0.2109375	0.21705426356589147	175	16000	17	31	158	15969	16175	0.18106853614895102
M1	string	0	network_modules	48	TRUE	1.1065361009677355e-18	27	48	11	0.22916666666666666	0.4074074074074074	GO:0048245	GO:BP	eosinophil chemotaxis	16175	12603		0.21875	0.2248062015503876	27	16148	11	37	16	16111	16175	0.3040348349918531
M1	string	0	network_modules	48	TRUE	1.2883774551344366e-18	107	48	15	0.3125	0.14018691588785046	GO:0034341	GO:BP	response to type II interferon	16175	8579		0.2265625	0.23255813953488372	107	16068	15	33	92	16035	16175	0.20586062490209808
M1	string	0	network_modules	48	TRUE	4.6071163294529496e-18	30	48	11	0.22916666666666666	0.36666666666666664	GO:0072677	GO:BP	eosinophil migration	16175	17495		0.234375	0.24031007751937986	30	16145	11	37	19	16108	16175	0.28822439455518495
M1	string	0	network_modules	48	TRUE	1.1617053006101587e-17	123	48	15	0.3125	0.12195121951219512	GO:0019730	GO:BP	antimicrobial humoral response	16175	6021		0.2421875	0.24806201550387597	123	16052	15	33	108	16019	16175	0.1914794819705779
M1	string	0	network_modules	48	TRUE	1.9394147263336633e-17	164	48	16	0.3333333333333333	0.0975609756097561	GO:0071356	GO:BP	cellular response to tumor necrosis factor	16175	16608		0.25	0.2558139534883721	164	16011	16	32	148	15979	16175	0.17600319864617756
M1	string	0	network_modules	48	TRUE	7.673466234286618e-17	224	48	17	0.3541666666666667	0.07589285714285714	GO:0006959	GO:BP	humoral immune response	16175	2590		0.2578125	0.26356589147286824	224	15951	17	31	207	15920	16175	0.15887488196497632
M1	string	0	network_modules	48	TRUE	8.944007185227091e-17	180	48	16	0.3333333333333333	0.08888888888888889	GO:0034612	GO:BP	response to tumor necrosis factor	16175	8690		0.265625	0.2713178294573643	180	15995	16	32	164	15963	16175	0.1675683841504075
M1	string	0	network_modules	48	TRUE	2.33867800299196e-16	239	48	17	0.3541666666666667	0.07112970711297072	GO:0070372	GO:BP	regulation of ERK1 and ERK2 cascade	16175	16083		0.2734375	0.27906976744186046	239	15936	17	31	222	15905	16175	0.15346153622031644
M1	string	0	network_modules	48	TRUE	7.093592202624004e-16	255	48	17	0.3541666666666667	0.06666666666666667	GO:0070371	GO:BP	ERK1 and ERK2 cascade	16175	16082		0.28125	0.2868217054263566	255	15920	17	31	238	15889	16175	0.14821047433399093
M1	string	0	network_modules	48	TRUE	6.036838399926076e-15	142	48	14	0.2916666666666667	0.09859154929577464	GO:0071222	GO:BP	cellular response to lipopolysaccharide	16175	16484		0.2890625	0.29457364341085274	142	16033	14	34	128	15999	16175	0.16544383592207873
M1	string	0	network_modules	48	TRUE	1.6051182804373723e-14	152	48	14	0.2916666666666667	0.09210526315789473	GO:0071219	GO:BP	cellular response to molecule of bacterial origin	16175	16481		0.296875	0.3023255813953488	152	16023	14	34	138	15989	16175	0.15960933194342478
M1	string	0	network_modules	48	TRUE	1.9510720602763585e-14	376	48	18	0.375	0.047872340425531915	GO:0043410	GO:BP	positive regulation of MAPK cascade	16175	10678		0.3046875	0.31007751937984496	376	15799	18	30	358	15769	16175	0.12735580547642178
M1	string	0	network_modules	48	TRUE	9.374132316423147e-14	172	48	14	0.2916666666666667	0.08139534883720931	GO:0002685	GO:BP	regulation of leukocyte migration	16175	1203		0.3125	0.32558139534883723	172	16003	14	34	158	15969	16175	0.14947909721609023
M1	string	0	network_modules	48	TRUE	9.374132316423147e-14	172	48	14	0.2916666666666667	0.08139534883720931	GO:0071216	GO:BP	cellular response to biotic stimulus	16175	16478		0.3125	0.32558139534883723	172	16003	14	34	158	15969	16175	0.14947909721609023
M1	string	0	network_modules	48	TRUE	3.067743466139763e-13	187	48	14	0.2916666666666667	0.0748663101604278	GO:0032496	GO:BP	response to lipopolysaccharide	16175	7607		0.328125	0.3333333333333333	187	15988	14	34	173	15954	16175	0.14295259972123084
M1	string	0	network_modules	48	TRUE	9.76498035680977e-13	203	48	14	0.2916666666666667	0.06896551724137931	GO:0002237	GO:BP	response to molecule of bacterial origin	16175	770		0.3359375	0.34108527131782945	203	15972	14	34	189	15938	16175	0.13678732434718846
M1	string	0	network_modules	48	TRUE	1.1150716039438206e-12	116	48	12	0.25	0.10344827586206896	GO:0050921	GO:BP	positive regulation of chemotaxis	16175	13363		0.34375	0.3488372093023256	116	16059	12	36	104	16023	16175	0.156999915744606
M1	string	0	network_modules	48	TRUE	7.366605457870227e-12	181	48	13	0.2708333333333333	0.0718232044198895	GO:0050920	GO:BP	regulation of chemotaxis	16175	13362		0.3515625	0.35658914728682173	181	15994	13	35	168	15959	16175	0.13466268727688066
M1	string	0	network_modules	48	TRUE	8.054687490273449e-12	530	48	18	0.375	0.033962264150943396	GO:0043408	GO:BP	regulation of MAPK cascade	16175	10676		0.359375	0.3643410852713178	530	15645	18	30	512	15615	16175	0.10487808991447953
M1	string	0	network_modules	48	TRUE	1.609710292593037e-11	104	48	11	0.22916666666666666	0.10576923076923077	GO:0002688	GO:BP	regulation of leukocyte chemotaxis	16175	1206		0.3671875	0.37209302325581395	104	16071	11	37	93	16034	16175	0.15203456775362076
M1	string	0	network_modules	48	TRUE	5.921491211261914e-11	92	44	11	0.25	0.11956521739130435	KEGG:04657	KEGG	IL-17 signaling pathway	8484	335		0.42857142857142855	0.5	92	8392	11	33	81	8359	8484	0.16672875633841247
M1	string	0	network_modules	48	TRUE	5.931769732201263e-11	595	48	18	0.375	0.030252100840336135	GO:0000165	GO:BP	MAPK cascade	16175	55		0.375	0.3798449612403101	595	15580	18	30	577	15550	16175	0.09802538619661183
M1	string	0	network_modules	48	TRUE	6.023944923956274e-11	81	48	10	0.20833333333333334	0.12345679012345678	GO:0002690	GO:BP	positive regulation of leukocyte chemotaxis	16175	1208		0.3828125	0.3875968992248062	81	16094	10	38	71	16056	16175	0.15714685039058948
M1	string	0	network_modules	48	TRUE	6.09233709008763e-11	117	48	11	0.22916666666666666	0.09401709401709402	GO:0002687	GO:BP	positive regulation of leukocyte migration	16175	1205		0.390625	0.3953488372093023	117	16058	11	37	106	16021	16175	0.14288014841884225
M1	string	0	network_modules	48	TRUE	1.0491553354631557e-10	520	48	17	0.3541666666666667	0.032692307692307694	GO:0033993	GO:BP	response to lipid	16175	8371		0.3984375	0.40310077519379844	520	15655	17	31	503	15624	16175	0.09959566737709294
M1	string	0	network_modules	48	TRUE	1.254333694966504e-10	57	48	9	0.1875	0.15789473684210525	GO:0072678	GO:BP	T cell migration	16175	17496		0.40625	0.4108527131782946	57	16118	9	39	48	16079	16175	0.1693777603079383
M1	string	0	network_modules	48	TRUE	8.221180569607324e-10	24	48	7	0.14583333333333334	0.2916666666666667	GO:0010818	GO:BP	T cell chemotaxis	16175	4430		0.4140625	0.4186046511627907	24	16151	7	41	17	16110	16175	0.20459652651454668
M1	string	0	network_modules	48	TRUE	1.3640970192667545e-9	45	41	8	0.1951219512195122	0.17777777777777778	REAC:R-HSA-6783783	REAC	Interleukin-10 signaling	10916	1234		1	1	45	10871	8	33	37	10838	10916	0.1830341763490614
M1	string	0	network_modules	48	TRUE	2.0333596146127845e-9	114	48	10	0.20833333333333334	0.08771929824561403	GO:0071675	GO:BP	regulation of mononuclear cell migration	16175	16848		0.421875	0.4263565891472868	114	16061	10	38	104	16023	16175	0.13126886078325853
M1	string	0	network_modules	48	TRUE	2.153376303838163e-9	77	48	9	0.1875	0.11688311688311688	GO:0071677	GO:BP	positive regulation of mononuclear cell migration	16175	16850		0.4296875	0.43410852713178294	77	16098	9	39	68	16059	16175	0.14484028910668975
M1	string	0	network_modules	48	TRUE	5.097242056492544e-9	233	48	12	0.25	0.05150214592274678	GO:0006874	GO:BP	intracellular calcium ion homeostasis	16175	2532		0.4375	0.4418604651162791	233	15942	12	36	221	15906	16175	0.10787105372500609
M1	string	0	network_modules	48	TRUE	7.113918744932426e-9	129	48	10	0.20833333333333334	0.07751937984496124	GO:0007204	GO:BP	positive regulation of cytosolic calcium ion concentration	16175	2759		0.4453125	0.4496124031007752	129	16046	10	38	119	16008	16175	0.12289004126834975
M1	string	0	network_modules	48	TRUE	8.147081788814926e-9	479	48	15	0.3125	0.031315240083507306	GO:0040017	GO:BP	positive regulation of locomotion	16175	9905		0.453125	0.4573643410852713	479	15696	15	33	464	15663	16175	0.09104119095697695
M1	string	0	network_modules	48	TRUE	9.66637846563191e-9	246	48	12	0.25	0.04878048780487805	GO:0055074	GO:BP	calcium ion homeostasis	16175	14230		0.4609375	0.46511627906976744	246	15929	12	36	234	15893	16175	0.10466666548183504
M1	string	0	network_modules	48	TRUE	1.4376528476664519e-8	408	48	14	0.2916666666666667	0.03431372549019608	GO:0071396	GO:BP	cellular response to lipid	16175	16648		0.46875	0.4728682170542636	408	15767	14	34	394	15733	16175	0.09270157009921702
M1	string	0	network_modules	48	TRUE	2.0065009032779792e-8	721	48	17	0.3541666666666667	0.023578363384188627	GO:0045087	GO:BP	innate immune response	16175	11270		0.4765625	0.4806201550387597	721	15454	17	31	704	15423	16175	0.0818444708376403
M1	string	0	network_modules	48	TRUE	4.3191395384118804e-8	443	48	14	0.2916666666666667	0.03160270880361174	GO:0009617	GO:BP	response to bacterium	16175	3543		0.484375	0.4883720930232558	443	15732	14	34	429	15698	16175	0.08833981421247578
M1	string	0	network_modules	48	TRUE	5.321489409715818e-8	450	48	14	0.2916666666666667	0.03111111111111111	GO:0030335	GO:BP	positive regulation of cell migration	16175	6781		0.4921875	0.49612403100775193	450	15725	14	34	436	15691	16175	0.08752597809784059
M1	string	0	network_modules	48	TRUE	7.07695761372121e-8	781	48	17	0.3541666666666667	0.02176696542893726	GO:0030334	GO:BP	regulation of cell migration	16175	6780		0.5	0.5038759689922481	781	15394	17	31	764	15363	16175	0.0778468728989607
M1	string	0	network_modules	48	TRUE	9.229969232826555e-8	23	48	6	0.125	0.2608695652173913	GO:1901623	GO:BP	regulation of lymphocyte chemotaxis	16175	21603		0.5078125	0.5116279069767442	23	16152	6	42	17	16110	16175	0.1789173227863711
M1	string	0	network_modules	48	TRUE	9.479603004352504e-8	470	48	14	0.2916666666666667	0.029787234042553193	GO:2000147	GO:BP	positive regulation of cell motility	16175	25495		0.515625	0.5193798449612403	470	15705	14	34	456	15671	16175	0.0852963829227617
M1	string	0	network_modules	48	TRUE	3.4064949970488775e-7	28	48	6	0.125	0.21428571428571427	GO:2000406	GO:BP	positive regulation of T cell migration	16175	25721		0.5234375	0.5271317829457365	28	16147	6	42	22	16105	16175	0.16177701410589976
M1	string	0	network_modules	48	TRUE	4.4992903539514966e-7	55	48	7	0.14583333333333334	0.12727272727272726	GO:2000401	GO:BP	regulation of lymphocyte migration	16175	25716		0.53125	0.5348837209302325	55	16120	7	41	48	16079	16175	0.13348576265768367
M1	string	0	network_modules	48	TRUE	7.008078536136167e-7	14	48	5	0.10416666666666667	0.35714285714285715	GO:0010819	GO:BP	regulation of T cell chemotaxis	16175	4431		0.5390625	0.5426356589147286	14	16161	5	43	9	16118	16175	0.19164393022788773
M1	string	0	network_modules	48	TRUE	9.935234494896258e-7	88	44	8	0.18181818181818182	0.09090909090909091	KEGG:05323	KEGG	Rheumatoid arthritis	8484	485		0.5714285714285714	0.625	88	8396	8	36	80	8360	8484	0.12218133368003099
M1	string	0	network_modules	48	TRUE	1.0298548892802955e-6	101	48	8	0.16666666666666666	0.07920792079207921	GO:0051209	GO:BP	release of sequestered calcium ion into cytosol	16175	13568		0.546875	0.5503875968992248	101	16074	8	40	93	16034	16175	0.11110423798531754
M1	string	0	network_modules	48	TRUE	1.1150381313004494e-6	102	48	8	0.16666666666666666	0.0784313725490196	GO:0051283	GO:BP	negative regulation of sequestering of calcium ion	16175	13619		0.5546875	0.5581395348837209	102	16073	8	40	94	16033	16175	0.11051909870653867
M1	string	0	network_modules	48	TRUE	1.199908430997904e-6	34	48	6	0.125	0.17647058823529413	GO:2000403	GO:BP	positive regulation of lymphocyte migration	16175	25718		0.5625	0.5658914728682171	34	16141	6	42	28	16099	16175	0.14639566621422243
M1	string	0	network_modules	48	TRUE	1.2062704219804918e-6	103	48	8	0.16666666666666666	0.07766990291262135	GO:0051282	GO:BP	regulation of sequestering of calcium ion	16175	13618		0.5703125	0.5736434108527132	103	16072	8	40	95	16032	16175	0.10994230876536046
M1	string	0	network_modules	48	TRUE	1.5199454633424852e-6	106	48	8	0.16666666666666666	0.07547169811320754	GO:0051208	GO:BP	sequestering of calcium ion	16175	13567		0.578125	0.5813953488372093	106	16069	8	40	98	16029	16175	0.10826006512477114
M1	string	0	network_modules	48	TRUE	2.325242570653018e-6	166	48	9	0.1875	0.05421686746987952	GO:0019722	GO:BP	calcium-mediated signaling	16175	6018		0.5859375	0.5891472868217055	166	16009	9	39	157	15970	16175	0.09594160264572138
M1	string	0	network_modules	48	TRUE	2.441181727320837e-6	38	48	6	0.125	0.15789473684210525	GO:2000404	GO:BP	regulation of T cell migration	16175	25719		0.59375	0.5968992248062015	38	16137	6	42	32	16095	16175	0.13821492185958476
M1	string	0	network_modules	48	TRUE	3.2397434097381506e-6	407	48	12	0.25	0.029484029484029485	GO:0098771	GO:BP	inorganic ion homeostasis	16175	18886		0.6015625	0.6046511627906976	407	15768	12	36	395	15732	16175	0.0783198348420569
M1	string	0	network_modules	48	TRUE	4.025530034726699e-6	19	48	5	0.10416666666666667	0.2631578947368421	GO:0090023	GO:BP	positive regulation of neutrophil chemotaxis	16175	17957		0.609375	0.6124031007751938	19	16156	5	43	14	16113	16175	0.1640393141926977
M1	string	0	network_modules	48	TRUE	4.597496566521615e-6	42	48	6	0.125	0.14285714285714285	GO:0071622	GO:BP	regulation of granulocyte chemotaxis	16175	16802		0.6171875	0.6201550387596899	42	16133	6	42	36	16091	16175	0.1312198042116289
M1	string	0	network_modules	48	TRUE	4.8755943342130436e-6	422	48	12	0.25	0.02843601895734597	GO:0030003	GO:BP	intracellular monoatomic cation homeostasis	16175	6648		0.625	0.627906976744186	422	15753	12	36	410	15717	16175	0.0766345184076868
M1	string	0	network_modules	48	TRUE	5.422522019703372e-6	426	48	12	0.25	0.028169014084507043	GO:0006873	GO:BP	intracellular monoatomic ion homeostasis	16175	2531		0.6328125	0.6356589147286822	426	15749	12	36	414	15713	16175	0.07619931844352856
M1	string	0	network_modules	48	TRUE	5.754882580160751e-6	531	48	13	0.2708333333333333	0.02448210922787194	GO:0032103	GO:BP	positive regulation of response to external stimulus	16175	7367		0.640625	0.6434108527131783	531	15644	13	35	518	15609	16175	0.07287068280909205
M1	string	0	network_modules	48	TRUE	7.192338398257485e-6	113	44	8	0.18181818181818182	0.07079646017699115	KEGG:04668	KEGG	TNF signaling pathway	8484	342		0.7142857142857143	0.75	113	8371	8	36	105	8335	8484	0.10612682978044966
M1	string	0	network_modules	48	TRUE	9.056177020721264e-6	22	48	5	0.10416666666666667	0.22727272727272727	GO:0002407	GO:BP	dendritic cell chemotaxis	16175	931		0.6484375	0.6589147286821705	22	16153	5	43	17	16110	16175	0.152184679453142
M1	string	0	network_modules	48	TRUE	9.056177020721264e-6	22	48	5	0.10416666666666667	0.22727272727272727	GO:0071624	GO:BP	positive regulation of granulocyte chemotaxis	16175	16804		0.6484375	0.6589147286821705	22	16153	5	43	17	16110	16175	0.152184679453142
M1	string	0	network_modules	48	TRUE	1.5196259258141e-5	467	48	12	0.25	0.02569593147751606	GO:0055080	GO:BP	monoatomic cation homeostasis	16175	14233		0.6640625	0.6666666666666666	467	15708	12	36	455	15672	16175	0.07204660570814896
M1	string	0	network_modules	48	TRUE	1.8150057609946176e-5	25	48	5	0.10416666666666667	0.2	GO:0036336	GO:BP	dendritic cell migration	16175	9571		0.671875	0.6821705426356589	25	16150	5	43	20	16107	16175	0.14251756475681487
M1	string	0	network_modules	48	TRUE	1.8150057609946176e-5	25	48	5	0.10416666666666667	0.2	GO:1902624	GO:BP	positive regulation of neutrophil migration	16175	22395		0.671875	0.6821705426356589	25	16150	5	43	20	16107	16175	0.14251756475681487
M1	string	0	network_modules	48	TRUE	1.8365812933731227e-5	475	48	12	0.25	0.02526315789473684	GO:0050801	GO:BP	monoatomic ion homeostasis	16175	13267		0.6875	0.689922480620155	475	15700	12	36	463	15664	16175	0.0712956971922619
M1	string	0	network_modules	48	TRUE	2.2421713008809334e-5	26	48	5	0.10416666666666667	0.19230769230769232	GO:0090022	GO:BP	regulation of neutrophil chemotaxis	16175	17956		0.6953125	0.6976744186046512	26	16149	5	43	21	16106	16175	0.13967010215375383
M1	string	0	network_modules	48	TRUE	3.8826563918646124e-5	623	48	13	0.2708333333333333	0.02086677367576244	GO:0019725	GO:BP	cellular homeostasis	16175	6020		0.703125	0.7054263565891473	623	15552	13	35	610	15517	16175	0.0658615813935868
M1	string	0	network_modules	48	TRUE	3.9887617373130374e-5	160	48	8	0.16666666666666666	0.05	GO:0097553	GO:BP	calcium ion transmembrane import into cytosol	16175	18700		0.7109375	0.7131782945736435	160	16015	8	40	152	15975	16175	0.08642533451747798
M1	string	0	network_modules	48	TRUE	4.7167327377258024e-5	3	48	3	0.0625	1	GO:2000547	GO:BP	regulation of dendritic cell dendrite assembly	16175	25848		0.71875	0.7364341085271318	3	16172	3	45	0	16127	16175	0.24965193430207336
M1	string	0	network_modules	48	TRUE	4.7167327377258024e-5	3	48	3	0.0625	1	GO:0097026	GO:BP	dendritic cell dendrite assembly	16175	18450		0.71875	0.7364341085271318	3	16172	3	45	0	16127	16175	0.24965193430207336
M1	string	0	network_modules	48	TRUE	4.7167327377258024e-5	3	48	3	0.0625	1	GO:0002408	GO:BP	myeloid dendritic cell chemotaxis	16175	932		0.71875	0.7364341085271318	3	16172	3	45	0	16127	16175	0.24965193430207336
M1	string	0	network_modules	48	TRUE	5.800022823491235e-5	324	48	10	0.20833333333333334	0.030864197530864196	GO:0006816	GO:BP	calcium ion transport	16175	2495		0.7421875	0.7441860465116279	324	15851	10	38	314	15813	16175	0.07332349906676308
M1	string	0	network_modules	48	TRUE	6.153057701850495e-5	102	44	7	0.1590909090909091	0.06862745098039216	KEGG:04064	KEGG	NF-kappa B signaling pathway	8484	256		0.8571428571428571	0.875	102	8382	7	37	95	8345	8484	0.0974318320328499
M1	string	0	network_modules	48	TRUE	6.715058376703728e-5	534	48	12	0.25	0.02247191011235955	GO:0055082	GO:BP	intracellular chemical homeostasis	16175	14235		0.75	0.751937984496124	534	15641	12	36	522	15605	16175	0.06625476560772041
M1	string	0	network_modules	48	TRUE	7.836708589155521e-5	791	48	14	0.2916666666666667	0.017699115044247787	GO:1901701	GO:BP	cellular response to oxygen-containing compound	16175	21654		0.7578125	0.7596899224806202	791	15384	14	34	777	15350	16175	0.061411484038050364
M1	string	0	network_modules	48	TRUE	9.201954171794088e-5	13	48	4	0.08333333333333333	0.3076923076923077	GO:0010820	GO:BP	positive regulation of T cell chemotaxis	16175	4432		0.765625	0.7674418604651163	13	16162	4	44	9	16118	16175	0.15888348371018224
M1	string	0	network_modules	48	TRUE	9.317806331565702e-5	34	48	5	0.10416666666666667	0.14705882352941177	GO:1902622	GO:BP	regulation of neutrophil migration	16175	22393		0.7734375	0.7751937984496124	34	16141	5	43	29	16098	16175	0.12157907080229756
M1	string	0	network_modules	48	TRUE	1.0883949866769831e-4	182	48	8	0.16666666666666666	0.04395604395604396	GO:0051651	GO:BP	maintenance of location in cell	16175	13864		0.78125	0.7829457364341085	182	15993	8	40	174	15953	16175	0.08038585655394587
M1	string	0	network_modules	48	TRUE	1.0964443108341751e-4	70	44	6	0.13636363636363635	0.08571428571428572	KEGG:05120	KEGG	Epithelial cell signaling in Helicobacter pylori infection	8484	426		1	1	70	8414	6	38	64	8376	8484	0.10225818081077748
M1	string	0	network_modules	48	TRUE	1.2058725319957504e-4	686	48	13	0.2708333333333333	0.018950437317784258	GO:0008284	GO:BP	positive regulation of cell population proliferation	16175	3151		0.7890625	0.7906976744186046	686	15489	13	35	673	15454	16175	0.06183760872294696
M1	string	0	network_modules	48	TRUE	1.2568253811541297e-4	36	48	5	0.10416666666666667	0.1388888888888889	GO:0051281	GO:BP	positive regulation of release of sequestered calcium ion into cytosol	16175	13617		0.796875	0.7984496124031008	36	16139	5	43	31	16096	16175	0.11801779198889065
M1	string	0	network_modules	48	TRUE	1.8827556790651238e-4	4	48	3	0.0625	0.75	GO:1903237	GO:BP	negative regulation of leukocyte tethering or rolling	16175	22849		0.8046875	0.8062015503875969	4	16171	3	45	1	16126	16175	0.2159970931269729
M1	string	0	network_modules	48	TRUE	2.798492681415509e-4	42	48	5	0.10416666666666667	0.11904761904761904	GO:0030838	GO:BP	positive regulation of actin filament polymerization	16175	6923		0.8125	0.813953488372093	42	16133	5	43	37	16090	16175	0.10888589915530066
M1	string	0	network_modules	48	TRUE	3.895521853024054e-4	18	48	4	0.08333333333333333	0.2222222222222222	GO:0140131	GO:BP	positive regulation of lymphocyte chemotaxis	16175	19677		0.8203125	0.8217054263565892	18	16157	4	44	14	16113	16175	0.13454006691658724
M1	string	0	network_modules	48	TRUE	4.697067084389192e-4	5	48	3	0.0625	0.6	GO:1904995	GO:BP	negative regulation of leukocyte adhesion to vascular endothelial cell	16175	24280		0.828125	0.8294573643410853	5	16170	3	45	2	16125	16175	0.1930077784488105
M1	string	0	network_modules	48	TRUE	5.962329467647808e-4	93	48	6	0.125	0.06451612903225806	GO:0051928	GO:BP	positive regulation of calcium ion transport	16175	13999		0.8359375	0.8372093023255814	93	16082	6	42	87	16040	16175	0.08604713342528687
M1	string	0	network_modules	48	TRUE	8.003314885834063e-4	236	48	8	0.16666666666666666	0.03389830508474576	GO:0050678	GO:BP	regulation of epithelial cell proliferation	16175	13212		0.84375	0.8449612403100775	236	15939	8	40	228	15899	16175	0.06919312914121435
M1	string	0	network_modules	48	TRUE	9.374532700844624e-4	6	48	3	0.0625	0.5	GO:0002606	GO:BP	positive regulation of dendritic cell antigen processing and presentation	16175	1127		0.8515625	0.8682170542635659	6	16169	3	45	3	16124	16175	0.1760214817462675
M1	string	0	network_modules	48	TRUE	9.374532700844624e-4	6	48	3	0.0625	0.5	GO:0002692	GO:BP	negative regulation of cellular extravasation	16175	1210		0.8515625	0.8682170542635659	6	16169	3	45	3	16124	16175	0.1760214817462675
M1	string	0	network_modules	48	TRUE	9.374532700844624e-4	6	48	3	0.0625	0.5	GO:2000669	GO:BP	negative regulation of dendritic cell apoptotic process	16175	25944		0.8515625	0.8682170542635659	6	16169	3	45	3	16124	16175	0.1760214817462675
M1	string	0	network_modules	48	TRUE	0.0012017322121730745	249	48	8	0.16666666666666666	0.0321285140562249	GO:0070588	GO:BP	calcium ion transmembrane transport	16175	16193		0.875	0.875968992248062	249	15926	8	40	241	15886	16175	0.06703400767232953
M1	string	0	network_modules	48	TRUE	0.0017264074651211674	60	48	5	0.10416666666666667	0.08333333333333333	GO:0051279	GO:BP	regulation of release of sequestered calcium ion into cytosol	16175	13615		0.8828125	0.8837209302325582	60	16115	5	43	55	16072	16175	0.09015266525254684
M1	string	0	network_modules	48	TRUE	0.002337952119285193	272	48	8	0.16666666666666666	0.029411764705882353	GO:0050673	GO:BP	epithelial cell proliferation	16175	13207		0.890625	0.8914728682170543	272	15903	8	40	264	15863	16175	0.06358030368658125
M1	string	0	network_modules	48	TRUE	0.002469992119341276	274	48	8	0.16666666666666666	0.029197080291970802	GO:0051235	GO:BP	maintenance of location	16175	13585		0.8984375	0.8992248062015504	274	15901	8	40	266	15861	16175	0.063299543484458
M1	string	0	network_modules	48	TRUE	0.0026139281453638327	8	48	3	0.0625	0.375	GO:0002579	GO:BP	positive regulation of antigen processing and presentation	16175	1100		0.90625	0.9069767441860465	8	16167	3	45	5	16122	16175	0.1521451045645191
M1	string	0	network_modules	48	TRUE	0.0029565590543745046	622	48	11	0.22916666666666666	0.017684887459807074	GO:0030155	GO:BP	regulation of cell adhesion	16175	6688		0.9140625	0.9147286821705426	622	15553	11	37	611	15516	16175	0.05410837027511135
M1	string	0	network_modules	48	TRUE	0.0031090927483636704	763	48	12	0.25	0.015727391874180863	GO:0048878	GO:BP	chemical homeostasis	16175	13119		0.921875	0.9224806201550387	763	15412	12	36	751	15376	16175	0.05219455437908862
M1	string	0	network_modules	48	TRUE	0.003400553607337743	631	48	11	0.22916666666666666	0.017432646592709985	GO:0022603	GO:BP	regulation of anatomical structure morphogenesis	16175	6611		0.9296875	0.9302325581395349	631	15544	11	37	620	15507	16175	0.05357987876805496
M1	string	0	network_modules	48	TRUE	0.0034823619031015933	69	48	5	0.10416666666666667	0.07246376811594203	GO:1904427	GO:BP	positive regulation of calcium ion transmembrane transport	16175	23809		0.9375	0.937984496124031	69	16106	5	43	64	16063	16175	0.08362551282799918
M1	string	0	network_modules	48	TRUE	0.003912713238941439	9	48	3	0.0625	0.3333333333333333	GO:2000668	GO:BP	regulation of dendritic cell apoptotic process	16175	25943		0.9453125	0.9689922480620154	9	16166	3	45	6	16121	16175	0.14330518866402014
M1	string	0	network_modules	48	TRUE	0.003912713238941439	9	48	3	0.0625	0.3333333333333333	GO:0097048	GO:BP	dendritic cell apoptotic process	16175	18461		0.9453125	0.9689922480620154	9	16166	3	45	6	16121	16175	0.14330518866402014
M1	string	0	network_modules	48	TRUE	0.003912713238941439	9	48	3	0.0625	0.3333333333333333	GO:0002604	GO:BP	regulation of dendritic cell antigen processing and presentation	16175	1125		0.9453125	0.9689922480620154	9	16166	3	45	6	16121	16175	0.14330518866402014
M1	string	0	network_modules	48	TRUE	0.003912713238941439	9	48	3	0.0625	0.3333333333333333	GO:0001771	GO:BP	immunological synapse formation	16175	437		0.9453125	0.9689922480620154	9	16166	3	45	6	16121	16175	0.14330518866402014
M1	string	0	network_modules	48	TRUE	0.00392380022251374	128	48	6	0.125	0.046875	GO:0034767	GO:BP	positive regulation of monoatomic ion transmembrane transport	16175	8736		0.9765625	0.9767441860465116	128	16047	6	42	122	16005	16175	0.07209302118578254
M1	string	0	network_modules	48	TRUE	0.006830367898799565	79	48	5	0.10416666666666667	0.06329113924050633	GO:0032273	GO:BP	positive regulation of protein polymerization	16175	7454		0.984375	0.9844961240310077	79	16096	5	43	74	16053	16175	0.0776942126031485
M1	string	0	network_modules	48	TRUE	0.0076536598308820855	11	48	3	0.0625	0.2727272727272727	GO:0001768	GO:BP	establishment of T cell polarity	16175	434		0.9921875	0.9922480620155039	11	16164	3	45	8	16119	16175	0.12937367591274335
M1	string	0	network_modules	48	TRUE	0.008996616553414301	38	48	4	0.08333333333333333	0.10526315789473684	GO:0002686	GO:BP	negative regulation of leukocyte migration	16175	1204		1	1	38	16137	4	44	34	16093	16175	0.09126080510410235
M1	string	0	network_modules	49	TRUE	5.870699897149201e-14	630	44	20	0.45454545454545453	0.031746031746031744	GO:0098660	GO:BP	inorganic ion transmembrane transport	16175	18816		0	0.015384615384615385	630	15545	20	24	610	15521	16175	0.11218794239915914
M1	string	0	network_modules	49	TRUE	3.7936806563460045e-12	671	44	19	0.4318181818181818	0.028315946348733235	GO:0034220	GO:BP	monoatomic ion transmembrane transport	16175	8508		0.015625	0.03076923076923077	671	15504	19	25	652	15479	16175	0.1022336063262255
M1	string	0	network_modules	49	TRUE	4.4621100389285816e-12	677	44	19	0.4318181818181818	0.028064992614475627	GO:0030001	GO:BP	metal ion transport	16175	6646		0.03125	0.046153846153846156	677	15498	19	25	658	15473	16175	0.10170252679080974
M1	string	0	network_modules	49	TRUE	4.591034319212183e-12	575	44	18	0.4090909090909091	0.03130434782608696	GO:0098662	GO:BP	inorganic cation transmembrane transport	16175	18818		0.046875	0.06153846153846154	575	15600	18	26	557	15574	16175	0.10536186739233225
M1	string	0	network_modules	49	TRUE	4.8763658802392305e-12	577	44	18	0.4090909090909091	0.03119584055459272	GO:0098655	GO:BP	monoatomic cation transmembrane transport	16175	18811		0.0625	0.07692307692307693	577	15598	18	26	559	15572	16175	0.10515103093160803
M1	string	0	network_modules	49	TRUE	7.424627277377117e-12	108	44	11	0.25	0.10185185185185185	GO:0001508	GO:BP	action potential	16175	323		0.078125	0.09230769230769231	108	16067	11	33	97	16034	16175	0.15604286739786152
M1	string	0	network_modules	49	TRUE	7.51252784970599e-12	262	44	14	0.3181818181818182	0.05343511450381679	GO:0034765	GO:BP	regulation of monoatomic ion transmembrane transport	16175	8734		0.09375	0.1076923076923077	262	15913	14	30	248	15883	16175	0.12493876607625247
M1	string	0	network_modules	49	TRUE	1.4334617204343068e-11	159	44	12	0.2727272727272727	0.07547169811320754	GO:0006814	GO:BP	sodium ion transport	16175	2494		0.109375	0.12307692307692308	159	16016	12	32	147	15984	16175	0.13917156023528388
M1	string	0	network_modules	49	TRUE	1.835934100221493e-11	117	44	11	0.25	0.09401709401709402	GO:0098659	GO:BP	inorganic cation import across plasma membrane	16175	18815		0.125	0.15384615384615385	117	16058	11	33	106	16025	16175	0.14962021944932072
M1	string	0	network_modules	49	TRUE	1.835934100221493e-11	117	44	11	0.25	0.09401709401709402	GO:0099587	GO:BP	inorganic ion import across plasma membrane	16175	19152		0.125	0.15384615384615385	117	16058	11	33	106	16025	16175	0.14962021944932072
M1	string	0	network_modules	49	TRUE	2.7284999527632956e-11	748	44	19	0.4318181818181818	0.02540106951871658	GO:0006812	GO:BP	monoatomic cation transport	16175	2492		0.15625	0.16923076923076924	748	15427	19	25	729	15402	16175	0.0958862113583702
M1	string	0	network_modules	49	TRUE	6.803310663489283e-11	203	32	12	0.375	0.059113300492610835	REAC:R-HSA-397014	REAC	Muscle contraction	10916	1496		0	0.041666666666666664	203	10713	12	20	191	10693	10916	0.14304825713792904
M1	string	0	network_modules	49	TRUE	2.843246023922181e-10	341	44	14	0.3181818181818182	0.04105571847507331	GO:0043269	GO:BP	regulation of monoatomic ion transport	16175	10593		0.171875	0.18461538461538463	341	15834	14	30	327	15804	16175	0.10801149574000111
M1	string	0	network_modules	49	TRUE	3.741203368869373e-10	71	44	9	0.20454545454545456	0.1267605633802817	GO:0086001	GO:BP	cardiac muscle cell action potential	16175	17878		0.1875	0.2	71	16104	9	35	62	16069	16175	0.15812934178158425
M1	string	0	network_modules	49	TRUE	4.739284763450977e-10	354	44	14	0.3181818181818182	0.03954802259887006	GO:0034762	GO:BP	regulation of transmembrane transport	16175	8731		0.203125	0.2153846153846154	354	15821	14	30	340	15791	16175	0.1057663351164879
M1	string	0	network_modules	49	TRUE	7.790716232647825e-10	31	32	7	0.21875	0.22580645161290322	REAC:R-HSA-445095	REAC	Interaction between L1 and Ankyrins	10916	1219		0.043478260869565216	0.08333333333333333	31	10885	7	25	24	10860	10916	0.2199997608631648
M1	string	0	network_modules	49	TRUE	9.492459977188929e-10	27	44	7	0.1590909090909091	0.25925925925925924	GO:0086010	GO:BP	membrane depolarization during action potential	16175	17884		0.21875	0.23076923076923078	27	16148	7	37	20	16111	16175	0.2014017477316593
M1	string	0	network_modules	49	TRUE	1.2361405558594263e-9	259	32	12	0.375	0.04633204633204633	REAC:R-HSA-112315	REAC	Transmission across Chemical Synapses	10916	2580		0.08695652173913043	0.125	259	10657	12	20	247	10637	10916	0.1251474773515089
M1	string	0	network_modules	49	TRUE	1.3917121354182689e-9	303	44	13	0.29545454545454547	0.0429042904290429	GO:0003012	GO:BP	muscle system process	16175	1463		0.234375	0.24615384615384617	303	15872	13	31	290	15841	16175	0.1065973537717435
M1	string	0	network_modules	49	TRUE	2.5009680015645092e-9	182	44	11	0.25	0.06043956043956044	GO:0098739	GO:BP	import across plasma membrane	16175	18866		0.25	0.26153846153846155	182	15993	11	33	171	15960	16175	0.11821679617698705
M1	string	0	network_modules	49	TRUE	4.695560109259532e-9	258	44	12	0.2727272727272727	0.046511627906976744	GO:0006936	GO:BP	muscle contraction	16175	2575		0.265625	0.27692307692307694	258	15917	12	32	246	15885	16175	0.10704223976779952
M1	string	0	network_modules	49	TRUE	7.284908448166373e-9	144	44	10	0.22727272727272727	0.06944444444444445	GO:0006941	GO:BP	striated muscle contraction	16175	2579		0.28125	0.2923076923076923	144	16031	10	34	134	15997	16175	0.12141479233465154
M1	string	0	network_modules	49	TRUE	1.3356059549514738e-8	282	44	12	0.2727272727272727	0.0425531914893617	GO:0042391	GO:BP	regulation of membrane potential	16175	10141		0.296875	0.3076923076923077	282	15893	12	32	270	15861	16175	0.10187117743666999
M1	string	0	network_modules	49	TRUE	2.4925235447714672e-08	21	44	6	0.13636363636363635	0.2857142857142857	GO:0086012	GO:BP	membrane depolarization during cardiac muscle cell action potential	16175	17886		0.3125	0.3230769230769231	21	16154	6	38	15	16116	16175	0.19589989369402297
M1	string	0	network_modules	49	TRUE	2.7402249187065532e-8	130	32	9	0.28125	0.06923076923076923	REAC:R-HSA-5576891	REAC	Cardiac conduction	10916	306		0.13043478260869565	0.16666666666666666	130	10786	9	23	121	10763	10916	0.13463086415216838
M1	string	0	network_modules	49	TRUE	3.335763095250428e-8	43	44	7	0.1590909090909091	0.16279069767441862	GO:1902305	GO:BP	regulation of sodium ion transmembrane transport	16175	22192		0.328125	0.35384615384615387	43	16132	7	37	36	16095	16175	0.1586677245249234
M1	string	0	network_modules	49	TRUE	3.335763095250428e-8	43	44	7	0.1590909090909091	0.16279069767441862	GO:1990573	GO:BP	potassium ion import across plasma membrane	16175	25222		0.328125	0.35384615384615387	43	16132	7	37	36	16095	16175	0.1586677245249234
M1	string	0	network_modules	49	TRUE	3.7917967800595274e-8	117	44	9	0.20454545454545456	0.07692307692307693	GO:0035725	GO:BP	sodium ion transmembrane transport	16175	9195		0.359375	0.36923076923076925	117	16058	9	35	108	16023	16175	0.1216059924446527
M1	string	0	network_modules	49	TRUE	4.2804230667312995e-8	196	32	10	0.3125	0.05102040816326531	REAC:R-HSA-112314	REAC	Neurotransmitter receptors and postsynaptic signal transmission	10916	1594		0.17391304347826086	0.20833333333333334	196	10720	10	22	186	10698	10916	0.1202735254451711
M1	string	0	network_modules	49	TRUE	5.91228562821235e-8	29	32	6	0.1875	0.20689655172413793	REAC:R-HSA-997272	REAC	Inhibition  of voltage gated Ca2+ channels via Gbeta/gamma subunits	10916	1188		0.21739130434782608	0.3333333333333333	29	10887	6	26	23	10861	10916	0.194713008988557
M1	string	0	network_modules	49	TRUE	5.91228562821235e-8	29	32	6	0.1875	0.20689655172413793	REAC:R-HSA-1296059	REAC	G protein gated Potassium channels	10916	995		0.21739130434782608	0.3333333333333333	29	10887	6	26	23	10861	10916	0.194713008988557
M1	string	0	network_modules	49	TRUE	5.91228562821235e-8	29	32	6	0.1875	0.20689655172413793	REAC:R-HSA-1296041	REAC	Activation of G protein gated Potassium channels	10916	82		0.21739130434782608	0.3333333333333333	29	10887	6	26	23	10861	10916	0.194713008988557
M1	string	0	network_modules	49	TRUE	6.561492830913518e-8	740	44	16	0.36363636363636365	0.021621621621621623	GO:0098657	GO:BP	import into cell	16175	18813		0.375	0.38461538461538464	740	15435	16	28	724	15407	16175	0.07945902495397256
M1	string	0	network_modules	49	TRUE	7.545833460643902e-8	48	44	7	0.1590909090909091	0.14583333333333334	GO:0086002	GO:BP	cardiac muscle cell action potential involved in contraction	16175	17879		0.390625	0.4	48	16127	7	37	41	16090	16175	0.14990305300165527
M1	string	0	network_modules	49	TRUE	8.862018753397714e-8	185	44	10	0.22727272727272727	0.05405405405405406	GO:0060047	GO:BP	heart contraction	16175	14310		0.40625	0.4153846153846154	185	15990	10	34	175	15956	16175	0.10601136078374492
M1	string	0	network_modules	49	TRUE	1.1209783991628087e-7	32	32	6	0.1875	0.1875	REAC:R-HSA-5576892	REAC	Phase 0 - rapid depolarisation	10916	1732		0.34782608695652173	0.375	32	10884	6	26	26	10858	10916	0.18511117236310176
M1	string	0	network_modules	49	TRUE	1.21495635500461e-7	191	44	10	0.22727272727272727	0.05235602094240838	GO:0003015	GO:BP	heart process	16175	1466		0.421875	0.4307692307692308	191	15984	10	34	181	15950	16175	0.10417321055858049
M1	string	0	network_modules	49	TRUE	1.9539054701546344e-7	400	32	12	0.375	0.03	REAC:R-HSA-112316	REAC	Neuronal System	10916	1590		0.391304347826087	0.4166666666666667	400	10516	12	20	388	10496	10916	0.09764804248843205
M1	string	0	network_modules	49	TRUE	1.9955911268652566e-7	35	32	6	0.1875	0.17142857142857143	REAC:R-HSA-1296065	REAC	Inwardly rectifying K+ channels	10916	1271		0.43478260869565216	0.4583333333333333	35	10881	6	26	29	10855	10916	0.17676094115651603
M1	string	0	network_modules	49	TRUE	3.0202282807674324e-7	58	44	7	0.1590909090909091	0.1206896551724138	GO:0051899	GO:BP	membrane depolarization	16175	13983		0.4375	0.4461538461538462	58	16117	7	37	51	16080	16175	0.13587157162036567
M1	string	0	network_modules	49	TRUE	3.3144511561716963e-7	31	44	6	0.13636363636363635	0.1935483870967742	GO:0060306	GO:BP	regulation of membrane repolarization	16175	14519		0.453125	0.46153846153846156	31	16144	6	38	25	16106	16175	0.1605480351140657
M1	string	0	network_modules	49	TRUE	4.355973974974917e-7	61	44	7	0.1590909090909091	0.11475409836065574	GO:0002028	GO:BP	regulation of sodium ion transport	16175	630		0.46875	0.47692307692307695	61	16114	7	37	54	16077	16175	0.13234264435037862
M1	string	0	network_modules	49	TRUE	4.4932323798387794e-7	119	32	8	0.25	0.06722689075630252	REAC:R-HSA-373760	REAC	L1CAM interactions	10916	1294		0.4782608695652174	0.5	119	10797	8	24	111	10773	10916	0.12485219976302177
M1	string	0	network_modules	49	TRUE	4.900526006166473e-7	62	44	7	0.1590909090909091	0.11290322580645161	GO:0086003	GO:BP	cardiac muscle cell contraction	16175	17880		0.484375	0.49230769230769234	62	16113	7	37	55	16076	16175	0.13122284669238693
M1	string	0	network_modules	49	TRUE	4.96576794317379e-7	33	44	6	0.13636363636363635	0.18181818181818182	GO:0099622	GO:BP	cardiac muscle cell membrane repolarization	16175	19167		0.5	0.5076923076923077	33	16142	6	38	27	16104	16175	0.15547343047805276
M1	string	0	network_modules	49	TRUE	7.373516510272052e-7	43	32	6	0.1875	0.13953488372093023	REAC:R-HSA-991365	REAC	Activation of GABAB receptors	10916	83		0.5217391304347826	0.5833333333333334	43	10873	6	26	37	10847	10916	0.15889686770919925
M1	string	0	network_modules	49	TRUE	7.373516510272052e-7	43	32	6	0.1875	0.13953488372093023	REAC:R-HSA-977444	REAC	GABA B receptor activation	10916	1010		0.5217391304347826	0.5833333333333334	43	10873	6	26	37	10847	10916	0.15889686770919925
M1	string	0	network_modules	49	TRUE	9.164350903739801e-7	111	44	8	0.18181818181818182	0.07207207207207207	GO:0060048	GO:BP	cardiac muscle contraction	16175	14311		0.515625	0.5230769230769231	111	16064	8	36	103	16028	16175	0.11068272421690045
M1	string	0	network_modules	49	TRUE	1.894588521047409e-6	50	32	6	0.1875	0.12	REAC:R-HSA-112310	REAC	Neurotransmitter release cycle	10916	1595		0.6086956521739131	0.625	50	10866	6	26	44	10840	10916	0.1468874066233615
M1	string	0	network_modules	49	TRUE	2.0952722844176206e-6	183	44	9	0.20454545454545456	0.04918032786885246	GO:0071805	GO:BP	potassium ion transmembrane transport	16175	16918		0.53125	0.5384615384615384	183	15992	9	35	174	15957	16175	0.09542044079493296
M1	string	0	network_modules	49	TRUE	2.2191302158324115e-6	19	44	5	0.11363636363636363	0.2631578947368421	GO:0060307	GO:BP	regulation of ventricular cardiac muscle cell membrane repolarization	16175	14520		0.546875	0.5538461538461539	19	16156	5	39	14	16117	16175	0.17147505364430812
M1	string	0	network_modules	49	TRUE	2.7456147616730936e-6	63	28	6	0.21428571428571427	0.09523809523809523	KEGG:05416	KEGG	Viral myocarditis	8484	493		0	0.2	63	8421	6	22	57	8399	8484	0.1386505321982482
M1	string	0	network_modules	49	TRUE	3.6392029358356077e-6	82	44	7	0.1590909090909091	0.08536585365853659	GO:0002027	GO:BP	regulation of heart rate	16175	629		0.5625	0.5692307692307692	82	16093	7	37	75	16056	16175	0.11326493926461742
M1	string	0	network_modules	49	TRUE	4.090902394915703e-6	46	44	6	0.13636363636363635	0.13043478260869565	GO:0086009	GO:BP	membrane repolarization	16175	17883		0.578125	0.5846153846153846	46	16129	6	38	40	16091	16175	0.1309491934782602
M1	string	0	network_modules	49	TRUE	4.198077478696814e-6	198	44	9	0.20454545454545456	0.045454545454545456	GO:0006813	GO:BP	potassium ion transport	16175	2493		0.59375	0.6	198	15977	9	35	189	15942	16175	0.09133744499496665
M1	string	0	network_modules	49	TRUE	5.10231147818502e-6	86	44	7	0.1590909090909091	0.08139534883720931	GO:0070252	GO:BP	actin-mediated cell contraction	16175	16020		0.609375	0.6153846153846154	86	16089	7	37	79	16052	16175	0.11043565653669483
M1	string	0	network_modules	49	TRUE	5.847899409609887e-6	60	32	6	0.1875	0.1	REAC:R-HSA-977443	REAC	GABA receptor activation	10916	1011		0.6521739130434783	0.6666666666666666	60	10856	6	26	54	10830	10916	0.13347914059167243
M1	string	0	network_modules	49	TRUE	6.370230211433244e-6	23	44	5	0.11363636363636363	0.21739130434782608	GO:0099625	GO:BP	ventricular cardiac muscle cell membrane repolarization	16175	19170		0.625	0.6461538461538462	23	16152	5	39	18	16113	16175	0.15552906649905257
M1	string	0	network_modules	49	TRUE	6.370230211433244e-6	23	44	5	0.11363636363636363	0.21739130434782608	GO:0099623	GO:BP	regulation of cardiac muscle cell membrane repolarization	16175	19168		0.625	0.6461538461538462	23	16152	5	39	18	16113	16175	0.15552906649905257
M1	string	0	network_modules	49	TRUE	1.2378151177361363e-5	26	44	5	0.11363636363636363	0.19230769230769232	GO:0010765	GO:BP	positive regulation of sodium ion transport	16175	4386		0.65625	0.6615384615384615	26	16149	5	39	21	16110	16175	0.14605308542257683
M1	string	0	network_modules	49	TRUE	1.5672391868604184e-5	84	28	6	0.21428571428571427	0.07142857142857142	KEGG:05412	KEGG	Arrhythmogenic right ventricular cardiomyopathy	8484	490		0.25	0.4	84	8400	6	22	78	8378	8484	0.11878629470028428
M1	string	0	network_modules	49	TRUE	1.94281725287021e-5	163	44	8	0.18181818181818182	0.049079754601226995	GO:0008016	GO:BP	regulation of heart contraction	16175	3097		0.671875	0.676923076923077	163	16012	8	36	155	15976	16175	0.0898042993280848
M1	string	0	network_modules	49	TRUE	2.879544977049041e-5	110	44	7	0.1590909090909091	0.06363636363636363	GO:0030048	GO:BP	actin filament-based movement	16175	6667		0.6875	0.6923076923076923	110	16065	7	37	103	16028	16175	0.09677774324027892
M1	string	0	network_modules	49	TRUE	3.086480677661375e-5	4	32	3	0.09375	0.75	REAC:R-HSA-1296053	REAC	Classical Kir channels	10916	370		0.6956521739130435	0.7083333333333334	4	10912	3	29	1	10883	10916	0.2645650834450549
M1	string	0	network_modules	49	TRUE	3.7008078898508815e-5	97	28	6	0.21428571428571427	0.061855670103092786	KEGG:05410	KEGG	Hypertrophic cardiomyopathy	8484	489		0.5	0.6	97	8387	6	22	91	8365	8484	0.10979642768073677
M1	string	0	network_modules	49	TRUE	4.986841698852034e-5	102	28	6	0.21428571428571427	0.058823529411764705	KEGG:05414	KEGG	Dilated cardiomyopathy	8484	491		0.75	0.8	102	8382	6	22	96	8360	8484	0.10679228963146022
M1	string	0	network_modules	49	TRUE	5.152490297522815e-5	34	44	5	0.11363636363636363	0.14705882352941177	GO:2000649	GO:BP	regulation of sodium ion transmembrane transporter activity	16175	25931		0.703125	0.7076923076923077	34	16141	5	39	29	16102	16175	0.12718736277475062
M1	string	0	network_modules	49	TRUE	5.269241057602471e-5	358	44	10	0.22727272727272727	0.027932960893854747	GO:0008015	GO:BP	blood circulation	16175	3096		0.71875	0.7230769230769231	358	15817	10	34	348	15783	16175	0.0728259824321187
M1	string	0	network_modules	49	TRUE	6.43462642003506e-5	190	44	8	0.18181818181818182	0.042105263157894736	GO:1903522	GO:BP	regulation of blood circulation	16175	23072		0.734375	0.7384615384615385	190	15985	8	36	182	15949	16175	0.08244015703984818
M1	string	0	network_modules	49	TRUE	1.0598839182880152e-4	15	44	4	0.09090909090909091	0.26666666666666666	GO:0014819	GO:BP	regulation of skeletal muscle contraction	16175	4698		0.75	0.7538461538461538	15	16160	4	40	11	16120	16175	0.15439315130996134
M1	string	0	network_modules	49	TRUE	1.4483574542729916e-4	22	32	4	0.125	0.18181818181818182	REAC:R-HSA-212676	REAC	Dopamine Neurotransmitter Release Cycle	10916	781		0.7391304347826086	0.75	22	10894	4	28	18	10866	10916	0.14869281762091496
M1	string	0	network_modules	49	TRUE	1.5292284878554128e-4	103	32	6	0.1875	0.05825242718446602	REAC:R-HSA-1296071	REAC	Potassium Channels	10916	1780		0.782608695652174	0.7916666666666666	103	10813	6	26	97	10787	10916	0.09986870424662353
M1	string	0	network_modules	49	TRUE	3.5434328232170477e-4	439	44	10	0.22727272727272727	0.022779043280182234	GO:0003013	GO:BP	circulatory system process	16175	1464		0.765625	0.7692307692307693	439	15736	10	34	429	15702	16175	0.06432462357439385
M1	string	0	network_modules	49	TRUE	0.0010872489891489679	7	44	3	0.06818181818181818	0.42857142857142855	GO:1903361	GO:BP	protein localization to basolateral plasma membrane	16175	22944		0.78125	0.7846153846153846	7	16168	3	41	4	16127	16175	0.17012417475866906
M1	string	0	network_modules	49	TRUE	0.0011577134119368285	381	44	9	0.20454545454545456	0.023622047244094488	GO:0044057	GO:BP	regulation of system process	16175	10893		0.796875	0.8	381	15794	9	35	372	15759	16175	0.062328605918105705
M1	string	0	network_modules	49	TRUE	0.0023403247286479067	43	32	4	0.125	0.09302325581395349	REAC:R-HSA-9609736	REAC	Assembly and cell surface presentation of NMDA receptors	10916	173		0.8260869565217391	0.8333333333333334	43	10873	4	28	39	10845	10916	0.10479461543491295
M1	string	0	network_modules	49	TRUE	0.002366995053132927	31	44	4	0.09090909090909091	0.12903225806451613	GO:0019226	GO:BP	transmission of nerve impulse	16175	5600		0.8125	0.8153846153846154	31	16144	4	40	27	16104	16175	0.10626915486052782
M1	string	0	network_modules	49	TRUE	0.002599487273892833	9	44	3	0.06818181818181818	0.3333333333333333	GO:0035090	GO:BP	maintenance of apical/basal cell polarity	16175	8804		0.828125	0.8461538461538461	9	16166	3	41	6	16125	16175	0.1497708561602542
M1	string	0	network_modules	49	TRUE	0.002599487273892833	9	44	3	0.06818181818181818	0.3333333333333333	GO:0045199	GO:BP	maintenance of epithelial cell apical/basal polarity	16175	11323		0.828125	0.8461538461538461	9	16166	3	41	6	16125	16175	0.1497708561602542
M1	string	0	network_modules	49	TRUE	0.002752285260348953	74	44	5	0.11363636363636363	0.06756756756756757	GO:0070509	GO:BP	calcium ion import	16175	16164		0.859375	0.8615384615384616	74	16101	5	39	69	16062	16175	0.08440511667046248
M1	string	0	network_modules	49	TRUE	0.003354804493240374	47	32	4	0.125	0.0851063829787234	REAC:R-HSA-9717189	REAC	Sensory perception of taste	10916	2200		0.8695652173913043	0.875	47	10869	4	28	43	10841	10916	0.09995111037699632
M1	string	0	network_modules	49	TRUE	0.0034680426961126564	34	44	4	0.09090909090909091	0.11764705882352941	GO:0003254	GO:BP	regulation of membrane depolarization	16175	1684		0.875	0.8769230769230769	34	16141	4	40	30	16101	16175	0.10127048812425626
M1	string	0	network_modules	49	TRUE	0.0035780650999336187	78	44	5	0.11363636363636363	0.0641025641025641	GO:0006942	GO:BP	regulation of striated muscle contraction	16175	2580		0.890625	0.8923076923076924	78	16097	5	39	73	16058	16175	0.08203617657400343
M1	string	0	network_modules	49	TRUE	0.004254524433322254	229	44	7	0.1590909090909091	0.03056768558951965	GO:1904062	GO:BP	regulation of monoatomic cation transmembrane transport	16175	23501		0.90625	0.9076923076923077	229	15946	7	37	222	15909	16175	0.06407143000439593
M1	string	0	network_modules	49	TRUE	0.004387574174499657	36	44	4	0.09090909090909091	0.1111111111111111	GO:0003009	GO:BP	skeletal muscle contraction	16175	1460		0.921875	0.9230769230769231	36	16139	4	40	32	16099	16175	0.09828628555497232
M1	string	0	network_modules	49	TRUE	0.0065136451141048655	76	28	4	0.14285714285714285	0.05263157894736842	KEGG:04971	KEGG	Gastric acid secretion	8484	402		1	1	76	8408	4	24	72	8384	8484	0.08177521831744516
M1	string	0	network_modules	49	TRUE	0.0067535738464736955	40	44	4	0.09090909090909091	0.1	GO:0086091	GO:BP	regulation of heart rate by cardiac conduction	16175	17929		0.9375	0.9384615384615385	40	16135	4	40	36	16095	16175	0.09299407399159294
M1	string	0	network_modules	49	TRUE	0.006781704764443223	56	32	4	0.125	0.07142857142857142	REAC:R-HSA-6794361	REAC	Neurexins and neuroligins	10916	1587		0.9130434782608695	0.9166666666666666	56	10860	4	28	52	10832	10916	0.09097991431027593
M1	string	0	network_modules	49	TRUE	0.00725666715850641	19	32	3	0.09375	0.15789473684210525	REAC:R-HSA-5576886	REAC	Phase 4 - resting membrane potential	10916	1736		0.9565217391304348	0.9583333333333334	19	10897	3	29	16	10868	10916	0.11968682346539561
M1	string	0	network_modules	49	TRUE	0.007468897897600184	41	44	4	0.09090909090909091	0.0975609756097561	GO:0050881	GO:BP	musculoskeletal movement	16175	13325		0.953125	0.9692307692307692	41	16134	4	40	37	16094	16175	0.09179163127095712
M1	string	0	network_modules	49	TRUE	0.007468897897600184	41	44	4	0.09090909090909091	0.0975609756097561	GO:0050879	GO:BP	multicellular organismal movement	16175	13324		0.953125	0.9692307692307692	41	16134	4	40	37	16094	16175	0.09179163127095712
M1	string	0	network_modules	49	TRUE	0.008422817101874452	3	32	2	0.0625	0.6666666666666666	REAC:R-HSA-1296067	REAC	Potassium transport channels	10916	1781		1	1	3	10913	2	30	1	10883	10916	0.20355307370907774
M1	string	0	network_modules	49	TRUE	0.008783550448260544	13	44	3	0.06818181818181818	0.23076923076923078	GO:2000651	GO:BP	positive regulation of sodium ion transmembrane transporter activity	16175	25933		0.984375	0.9846153846153847	13	16162	3	41	10	16121	16175	0.12417654470808295
M1	string	0	network_modules	49	TRUE	0.009952704989704656	44	44	4	0.09090909090909091	0.09090909090909091	GO:0098703	GO:BP	calcium ion import across plasma membrane	16175	18835		1	1	44	16131	4	40	40	16091	16175	0.0884293934321831
M1	string	0	network_modules	50	TRUE	7.082897040406246e-23	65	44	15	0.3409090909090909	0.23076923076923078	GO:0042273	GO:BP	ribosomal large subunit biogenesis	16175	10070		0	0.0625	65	16110	15	29	50	16081	16175	0.2781149624526636
M1	string	0	network_modules	50	TRUE	6.437811133820232e-22	251	44	20	0.45454545454545453	0.0796812749003984	GO:0042254	GO:BP	ribosome biogenesis	16175	10060		0.06666666666666667	0.125	251	15924	20	24	231	15900	16175	0.1855106895332655
M1	string	0	network_modules	50	TRUE	6.877863122174072e-22	205	44	19	0.4318181818181818	0.09268292682926829	GO:0016072	GO:BP	rRNA metabolic process	16175	5099		0.13333333333333333	0.1875	205	15970	19	25	186	15945	16175	0.19569249049319892
M1	string	0	network_modules	50	TRUE	1.184131454555723e-21	169	44	18	0.4090909090909091	0.10650887573964497	GO:0006364	GO:BP	rRNA processing	16175	2140		0.2	0.25	169	16006	18	26	151	15980	16175	0.20475712565085058
M1	string	0	network_modules	50	TRUE	3.2669249992536123e-19	27	44	11	0.25	0.4074074074074074	GO:0000470	GO:BP	maturation of LSU-rRNA	16175	159		0.26666666666666666	0.3125	27	16148	11	33	16	16115	16175	0.31770879877942354
M1	string	0	network_modules	50	TRUE	4.699390194644347e-18	390	44	20	0.45454545454545453	0.05128205128205128	GO:0022613	GO:BP	ribonucleoprotein complex biogenesis	16175	6620		0.3333333333333333	0.375	390	15785	20	24	370	15761	16175	0.1465521275239794
M1	string	0	network_modules	50	TRUE	7.046103837473014e-12	15	44	7	0.1590909090909091	0.4666666666666667	GO:0000463	GO:BP	maturation of LSU-rRNA from tricistronic rRNA transcript (SSU-rRNA, 5.8S rRNA, LSU-rRNA)	16175	153		0.4	0.4375	15	16160	7	37	8	16123	16175	0.2713814034541817
M1	string	0	network_modules	50	TRUE	6.835440802124334e-7	192	22	8	0.36363636363636365	0.041666666666666664	REAC:R-HSA-8868773	REAC	rRNA processing in the nucleus and cytosol	10916	2734		0	0.3333333333333333	192	10724	8	14	184	10710	10916	0.11830085544429166
M1	string	0	network_modules	50	TRUE	1.0217938880687985e-6	202	22	8	0.36363636363636365	0.039603960396039604	REAC:R-HSA-72312	REAC	rRNA processing	10916	2732		0.5	0.6666666666666666	202	10714	8	14	194	10700	10916	0.11508379385929339
M1	string	0	network_modules	50	TRUE	4.4036207103022154e-5	33	44	5	0.11363636363636363	0.15151515151515152	GO:0000460	GO:BP	maturation of 5.8S rRNA	16175	150		0.4666666666666667	0.5	33	16142	5	39	28	16103	16175	0.12916762138181118
M1	string	0	network_modules	50	TRUE	0.00024777007127161743	46	44	5	0.11363636363636363	0.10869565217391304	GO:0006356	GO:BP	regulation of transcription by RNA polymerase I	16175	2133		0.5333333333333333	0.5625	46	16129	5	39	41	16090	16175	0.10865947061808658
M1	string	0	network_modules	50	TRUE	3.940782562593052e-4	182	22	6	0.2727272727272727	0.03296703296703297	REAC:R-HSA-6791226	REAC	Major pathway of rRNA processing in the nucleolus and cytosol	10916	1389		1	1	182	10734	6	16	176	10718	10916	0.08986635007476099
M1	string	0	network_modules	50	TRUE	8.236200880333635e-4	139	10	4	0.4	0.02877697841726619	KEGG:03008	KEGG	Ribosome biogenesis in eukaryotes	8484	207		NA	1	139	8345	4	6	135	8339	8484	0.10380847704517679
M1	string	0	network_modules	50	TRUE	0.00104337619831861	61	44	5	0.11363636363636363	0.08196721311475409	GO:0006360	GO:BP	transcription by RNA polymerase I	16175	2136		0.6	0.625	61	16114	5	39	56	16075	16175	0.09361235835029948
M1	string	0	network_modules	50	TRUE	0.0019533835047983146	529	44	10	0.22727272727272727	0.01890359168241966	GO:0006325	GO:BP	chromatin organization	16175	2122		0.6666666666666666	0.6875	529	15646	10	34	519	15612	16175	0.0571323061476223
M1	string	0	network_modules	50	TRUE	0.0020656605965778934	30	44	4	0.09090909090909091	0.13333333333333333	GO:0009303	GO:BP	rRNA transcription	16175	3450		0.7333333333333333	0.75	30	16145	4	40	26	16105	16175	0.10809748729406153
M1	string	0	network_modules	50	TRUE	0.002315409178040722	209	44	7	0.1590909090909091	0.03349282296650718	GO:0040029	GO:BP	epigenetic regulation of gene expression	16175	9916		0.8	0.8125	209	15966	7	37	202	15929	16175	0.06759681513867415
M1	string	0	network_modules	50	TRUE	0.0046825115208164285	148	44	6	0.13636363636363635	0.04054054054054054	GO:0072331	GO:BP	signal transduction by p53 class mediator	16175	17354		0.8666666666666667	0.875	148	16027	6	38	142	15989	16175	0.06977774601739252
M1	string	0	network_modules	50	TRUE	0.004928830335473916	454	44	9	0.20454545454545456	0.019823788546255508	GO:0006338	GO:BP	chromatin remodeling	16175	2126		0.9333333333333333	0.9375	454	15721	9	35	445	15686	16175	0.05580346771401545
M1	string	0	network_modules	50	TRUE	0.005086746010750936	11	44	3	0.06818181818181818	0.2727272727272727	GO:0016479	GO:BP	negative regulation of transcription by RNA polymerase I	16175	5230		1	1	11	16164	3	41	8	16123	16175	0.1352335010505478
M1	string	0	network_modules	51	TRUE	2.7484788840403935e-28	96	43	20	0.46511627906976744	0.20833333333333334	REAC:R-HSA-975956	REAC	Nonsense Mediated Decay (NMD) independent of the Exon Junction Complex (EJC)	10916	1607		0	0.02702702702702703	96	10820	20	23	76	10797	10916	0.3073583933436561
M1	string	0	network_modules	51	TRUE	7.980798275831383e-28	182	43	23	0.5348837209302325	0.12637362637362637	REAC:R-HSA-6791226	REAC	Major pathway of rRNA processing in the nucleolus and cytosol	10916	1389		0.027777777777777776	0.05405405405405406	182	10734	23	20	159	10714	10916	0.25451486610269397
M1	string	0	network_modules	51	TRUE	2.902661390944833e-27	192	43	23	0.5348837209302325	0.11979166666666667	REAC:R-HSA-8868773	REAC	rRNA processing in the nucleus and cytosol	10916	2734		0.05555555555555555	0.08108108108108109	192	10724	23	20	169	10704	10916	0.24747549828614754
M1	string	0	network_modules	51	TRUE	5.308547716472455e-27	158	48	21	0.4375	0.13291139240506328	GO:0002181	GO:BP	cytoplasmic translation	16175	729		0	0.07692307692307693	158	16017	21	27	137	15990	16175	0.23726876132748295
M1	string	0	network_modules	51	TRUE	8.03081595360171e-27	112	43	20	0.46511627906976744	0.17857142857142858	REAC:R-HSA-156827	REAC	L13a-mediated translational silencing of Ceruloplasmin expression	10916	1293		0.08333333333333333	0.10810810810810811	112	10804	20	23	92	10781	10916	0.2838545075040341
M1	string	0	network_modules	51	TRUE	8.325369989333437e-27	90	43	19	0.4418604651162791	0.2111111111111111	REAC:R-HSA-156902	REAC	Peptide chain elongation	10916	1723		0.1111111111111111	0.16216216216216217	90	10826	19	24	71	10802	10916	0.3015593370287828
M1	string	0	network_modules	51	TRUE	8.325369989333437e-27	90	43	19	0.4418604651162791	0.2111111111111111	REAC:R-HSA-192823	REAC	Viral mRNA Translation	10916	2650		0.1111111111111111	0.16216216216216217	90	10826	19	24	71	10802	10916	0.3015593370287828
M1	string	0	network_modules	51	TRUE	9.837376492820159e-27	202	43	23	0.5348837209302325	0.11386138613861387	REAC:R-HSA-72312	REAC	rRNA processing	10916	2732		0.16666666666666666	0.1891891891891892	202	10714	23	20	179	10694	10916	0.2409572162288703
M1	string	0	network_modules	51	TRUE	1.7169986558569177e-26	116	43	20	0.46511627906976744	0.1724137931034483	REAC:R-HSA-975957	REAC	Nonsense Mediated Decay (NMD) enhanced by the Exon Junction Complex (EJC)	10916	1606		0.19444444444444445	0.24324324324324326	116	10800	20	23	96	10777	10916	0.27874443826852235
M1	string	0	network_modules	51	TRUE	1.7169986558569177e-26	116	43	20	0.46511627906976744	0.1724137931034483	REAC:R-HSA-927802	REAC	Nonsense-Mediated Decay (NMD)	10916	1608		0.19444444444444445	0.24324324324324326	116	10800	20	23	96	10777	10916	0.27874443826852235
M1	string	0	network_modules	51	TRUE	2.0712612707838692e-26	94	43	19	0.4418604651162791	0.20212765957446807	REAC:R-HSA-72764	REAC	Eukaryotic Translation Termination	10916	872		0.25	0.32432432432432434	94	10822	19	24	75	10798	10916	0.294878555866868
M1	string	0	network_modules	51	TRUE	2.0712612707838692e-26	94	43	19	0.4418604651162791	0.20212765957446807	REAC:R-HSA-156842	REAC	Eukaryotic Translation Elongation	10916	870		0.25	0.32432432432432434	94	10822	19	24	75	10798	10916	0.294878555866868
M1	string	0	network_modules	51	TRUE	2.0712612707838692e-26	94	43	19	0.4418604651162791	0.20212765957446807	REAC:R-HSA-2408557	REAC	Selenocysteine synthesis	10916	2188		0.25	0.32432432432432434	94	10822	19	24	75	10798	10916	0.294878555866868
M1	string	0	network_modules	51	TRUE	3.567866916971171e-26	120	43	20	0.46511627906976744	0.16666666666666666	REAC:R-HSA-72613	REAC	Eukaryotic Translation Initiation	10916	871		0.3333333333333333	0.3783783783783784	120	10796	20	23	100	10773	10916	0.27388908730685096
M1	string	0	network_modules	51	TRUE	3.567866916971171e-26	120	43	20	0.46511627906976744	0.16666666666666666	REAC:R-HSA-72737	REAC	Cap-dependent Translation Initiation	10916	304		0.3333333333333333	0.3783783783783784	120	10796	20	23	100	10773	10916	0.27388908730685096
M1	string	0	network_modules	51	TRUE	1.1323143221564872e-25	102	43	19	0.4418604651162791	0.18627450980392157	REAC:R-HSA-72689	REAC	Formation of a pool of free 40S subunits	10916	953		0.3888888888888889	0.43243243243243246	102	10814	19	24	83	10790	10916	0.28270426127311976
M1	string	0	network_modules	51	TRUE	1.1323143221564872e-25	102	43	19	0.4418604651162791	0.18627450980392157	REAC:R-HSA-9633012	REAC	Response of EIF2AK4 (GCN2) to amino acid deficiency	10916	2087		0.3888888888888889	0.43243243243243246	102	10814	19	24	83	10790	10916	0.28270426127311976
M1	string	0	network_modules	51	TRUE	9.315988160939441e-25	113	43	19	0.4418604651162791	0.168141592920354	REAC:R-HSA-72706	REAC	GTP hydrolysis and joining of the 60S ribosomal subunit	10916	1027		0.4444444444444444	0.4864864864864865	113	10803	19	24	94	10779	10916	0.2681027045912023
M1	string	0	network_modules	51	TRUE	9.315988160939441e-25	113	43	19	0.4418604651162791	0.168141592920354	REAC:R-HSA-1799339	REAC	SRP-dependent cotranslational protein targeting to membrane	10916	2157		0.4444444444444444	0.4864864864864865	113	10803	19	24	94	10779	10916	0.2681027045912023
M1	string	0	network_modules	51	TRUE	1.895900397835956e-24	117	43	19	0.4418604651162791	0.1623931623931624	REAC:R-HSA-2408522	REAC	Selenoamino acid metabolism	10916	2187		0.5	0.5135135135135135	117	10799	19	24	98	10775	10916	0.2633049031936229
M1	string	0	network_modules	51	TRUE	2.5448785908537862e-23	133	43	19	0.4418604651162791	0.14285714285714285	REAC:R-HSA-168273	REAC	Influenza Viral RNA Transcription and Replication	10916	1186		0.5277777777777778	0.5405405405405406	133	10783	19	24	114	10759	10916	0.2463026330255731
M1	string	0	network_modules	51	TRUE	6.4548585417171106e-23	171	43	20	0.46511627906976744	0.11695906432748537	REAC:R-HSA-9010553	REAC	Regulation of expression of SLITs and ROBOs	10916	2031		0.5555555555555556	0.5675675675675675	171	10745	20	23	151	10722	10916	0.22761681405146536
M1	string	0	network_modules	51	TRUE	4.200011402891639e-22	153	43	19	0.4418604651162791	0.12418300653594772	REAC:R-HSA-168255	REAC	Influenza Infection	10916	1185		0.5833333333333334	0.5945945945945946	153	10763	19	24	134	10739	10916	0.22887400447726933
M1	string	0	network_modules	51	TRUE	4.949508038093573e-22	153	38	19	0.5	0.12418300653594772	KEGG:03010	KEGG	Ribosome	8484	208		0	0.5	153	8331	19	19	134	8312	8484	0.24293444001907108
M1	string	0	network_modules	51	TRUE	7.014154671020526e-22	157	43	19	0.4418604651162791	0.12101910828025478	REAC:R-HSA-9711097	REAC	Cellular response to starvation	10916	337		0.6111111111111112	0.6216216216216216	157	10759	19	24	138	10735	10916	0.22578805141843447
M1	string	0	network_modules	51	TRUE	8.875551726652301e-21	217	43	20	0.46511627906976744	0.09216589861751152	REAC:R-HSA-376176	REAC	Signaling by ROBO receptors	10916	2301		0.6388888888888888	0.6486486486486487	217	10699	20	23	197	10676	10916	0.20059173991382295
M1	string	0	network_modules	51	TRUE	1.9912823730022604e-19	566	48	24	0.5	0.04240282685512368	GO:0006412	GO:BP	translation	16175	2170		0.08333333333333333	0.15384615384615385	566	15609	24	24	542	15585	16175	0.13805512376930448
M1	string	0	network_modules	51	TRUE	1.5709957765977729e-18	231	38	19	0.5	0.08225108225108226	KEGG:05171	KEGG	Coronavirus disease - COVID-19	8484	452		1	1	231	8253	19	19	212	8234	8484	0.1948529607734043
M1	string	0	network_modules	51	TRUE	3.6551398891809915e-18	292	43	20	0.46511627906976744	0.0684931506849315	REAC:R-HSA-72766	REAC	Translation	10916	2565		0.6666666666666666	0.6756756756756757	292	10624	20	23	272	10601	10916	0.1708539466890897
M1	string	0	network_modules	51	TRUE	5.4133575234920215e-16	251	48	17	0.3541666666666667	0.06772908366533864	GO:0042254	GO:BP	ribosome biogenesis	16175	10060		0.16666666666666666	0.23076923076923078	251	15924	17	31	234	15893	16175	0.1494771570498612
M1	string	0	network_modules	51	TRUE	1.0247905699575956e-14	370	43	19	0.4418604651162791	0.051351351351351354	REAC:R-HSA-71291	REAC	Metabolism of amino acids and derivatives	10916	1421		0.6944444444444444	0.7027027027027027	370	10546	19	24	351	10522	10916	0.14177560316761678
M1	string	0	network_modules	51	TRUE	3.036805667513977e-14	205	48	15	0.3125	0.07317073170731707	GO:0016072	GO:BP	rRNA metabolic process	16175	5099		0.25	0.3076923076923077	205	15970	15	33	190	15937	16175	0.14622720937539163
M1	string	0	network_modules	51	TRUE	7.298262922689823e-14	169	48	14	0.2916666666666667	0.08284023668639054	GO:0006364	GO:BP	rRNA processing	16175	2140		0.3333333333333333	0.38461538461538464	169	16006	14	34	155	15972	16175	0.15088537881615116
M1	string	0	network_modules	51	TRUE	8.102074069379777e-14	94	48	12	0.25	0.1276595744680851	GO:0042274	GO:BP	ribosomal small subunit biogenesis	16175	10071		0.4166666666666667	0.46153846153846156	94	16081	12	36	82	16045	16175	0.17526410551517427
M1	string	0	network_modules	51	TRUE	9.180538301866039e-13	390	48	17	0.3541666666666667	0.04358974358974359	GO:0022613	GO:BP	ribonucleoprotein complex biogenesis	16175	6620		0.5	0.5384615384615384	390	15785	17	31	373	15754	16175	0.11738709082179273
M1	string	0	network_modules	51	TRUE	3.858707778241094e-12	37	43	9	0.20930232558139536	0.24324324324324326	REAC:R-HSA-9735869	REAC	SARS-CoV-1 modulates host translation machinery	10916	2116		0.7222222222222222	0.7297297297297297	37	10879	9	34	28	10845	10916	0.22279788631531688
M1	string	0	network_modules	51	TRUE	5.7414707008514106e-12	59	43	10	0.23255813953488372	0.1694915254237288	REAC:R-HSA-72649	REAC	Translation initiation complex formation	10916	2566		0.75	0.7567567567567568	59	10857	10	33	49	10824	10916	0.19483234214361098
M1	string	0	network_modules	51	TRUE	6.870756045729652e-12	60	43	10	0.23255813953488372	0.16666666666666666	REAC:R-HSA-72662	REAC	Activation of the mRNA upon binding of the cap-binding complex and eIFs, and subsequent binding to 43S	10916	105		0.7777777777777778	0.7837837837837838	60	10856	10	33	50	10823	10916	0.1931328954912368
M1	string	0	network_modules	51	TRUE	4.828758229265977e-11	140	43	12	0.27906976744186046	0.08571428571428572	REAC:R-HSA-9678108	REAC	SARS-CoV-1 Infection	10916	2114		0.8055555555555556	0.8108108108108109	140	10776	12	31	128	10745	10916	0.14880276087278044
M1	string	0	network_modules	51	TRUE	9.071902835115608e-11	51	43	9	0.20930232558139536	0.17647058823529413	REAC:R-HSA-9754678	REAC	SARS-CoV-2 modulates host translation machinery	10916	2125		0.8333333333333334	0.8378378378378378	51	10865	9	34	42	10831	10916	0.18870917480594163
M1	string	0	network_modules	51	TRUE	1.0939823868119752e-10	52	43	9	0.20930232558139536	0.17307692307692307	REAC:R-HSA-72695	REAC	Formation of the ternary complex, and subsequently, the 43S complex	10916	973		0.8611111111111112	0.8648648648648649	52	10864	9	34	43	10830	10916	0.18681078725735759
M1	string	0	network_modules	51	TRUE	3.6634885274036963e-10	59	43	9	0.20930232558139536	0.15254237288135594	REAC:R-HSA-72702	REAC	Ribosomal scanning and start codon recognition	10916	2106		0.8888888888888888	0.8918918918918919	59	10857	9	34	50	10823	10916	0.17488552159982906
M1	string	0	network_modules	51	TRUE	8.359105261125683e-10	95	43	10	0.23255813953488372	0.10526315789473684	REAC:R-HSA-9692914	REAC	SARS-CoV-1-host interactions	10916	2119		0.9166666666666666	0.918918918918919	95	10821	10	33	85	10788	10916	0.15156362214136412
M1	string	0	network_modules	51	TRUE	4.081350754449739e-7	459	43	14	0.32558139534883723	0.030501089324618737	REAC:R-HSA-9679506	REAC	SARS-CoV Infections	10916	2112		0.9444444444444444	0.9459459459459459	459	10457	14	29	445	10428	10916	0.08884169112722007
M1	string	0	network_modules	51	TRUE	4.0173844509840354e-6	292	43	11	0.2558139534883721	0.03767123287671233	REAC:R-HSA-9694516	REAC	SARS-CoV-2 Infection	10916	2122		0.9722222222222222	0.972972972972973	292	10624	11	32	281	10592	10916	0.08927808726507516
M1	string	0	network_modules	51	TRUE	7.163137091581504e-6	343	48	11	0.22916666666666666	0.03206997084548105	GO:0140694	GO:BP	membraneless organelle assembly	16175	19860		0.5833333333333334	0.6153846153846154	343	15832	11	37	332	15795	16175	0.07875085464076875
M1	string	0	network_modules	51	TRUE	8.136353860283845e-6	46	48	6	0.125	0.13043478260869565	GO:0030490	GO:BP	maturation of SSU-rRNA	16175	6815		0.6666666666666666	0.6923076923076923	46	16129	6	42	40	16087	16175	0.12514706108230023
M1	string	0	network_modules	51	TRUE	9.306267412422772e-6	47	48	6	0.125	0.1276595744680851	GO:0042255	GO:BP	ribosome assembly	16175	10061		0.75	0.7692307692307693	47	16128	6	42	41	16086	16175	0.12374972755223324
M1	string	0	network_modules	51	TRUE	2.0190666570861202e-5	197	43	9	0.20930232558139536	0.04568527918781726	REAC:R-HSA-9705683	REAC	SARS-CoV-2-host interactions	10916	2128		1	1	197	10719	9	34	188	10685	10916	0.09034966948337313
M1	string	0	network_modules	51	TRUE	6.877222373245242e-5	65	48	6	0.125	0.09230769230769231	GO:0042273	GO:BP	ribosomal large subunit biogenesis	16175	10070		0.8333333333333334	0.8461538461538461	65	16110	6	42	59	16068	16175	0.10432837961257489
M1	string	0	network_modules	51	TRUE	0.0032371852617989762	68	48	5	0.10416666666666667	0.07352941176470588	GO:0090307	GO:BP	mitotic spindle assembly	16175	18189		0.9166666666666666	0.9230769230769231	68	16107	5	43	63	16064	16175	0.08428767645998726
M1	string	0	network_modules	51	TRUE	0.008721685693332492	83	48	5	0.10416666666666667	0.060240963855421686	GO:0000281	GO:BP	mitotic cytokinesis	16175	79		1	1	83	16092	5	43	78	16049	16175	0.07561954141721475
M1	string	0	network_modules	52	TRUE	1.6188660090912755e-11	168	24	11	0.4583333333333333	0.06547619047619048	KEGG:04141	KEGG	Protein processing in endoplasmic reticulum	8484	278		0	0.25	168	8316	11	13	157	8303	8484	0.16765243556823414
M1	string	0	network_modules	52	TRUE	3.3873257969613406e-8	68	47	8	0.1702127659574468	0.11764705882352941	GO:0006487	GO:BP	protein N-linked glycosylation	16175	2221		0	0.043478260869565216	68	16107	8	39	60	16068	16175	0.13850713559838293
M1	string	0	network_modules	52	TRUE	8.161692341681699e-8	808	47	17	0.3617021276595745	0.02103960396039604	GO:0033365	GO:BP	protein localization to organelle	16175	8175		0.045454545454545456	0.08695652173913043	808	15367	17	30	791	15337	16175	0.07725153206226557
M1	string	0	network_modules	52	TRUE	1.8608980172381415e-7	183	47	10	0.2127659574468085	0.0546448087431694	GO:0006486	GO:BP	protein glycosylation	16175	2220		0.09090909090909091	0.17391304347826086	183	15992	10	37	173	15955	16175	0.10282484028797952
M1	string	0	network_modules	52	TRUE	1.8608980172381415e-7	183	47	10	0.2127659574468085	0.0546448087431694	GO:0043413	GO:BP	macromolecule glycosylation	16175	10680		0.09090909090909091	0.17391304347826086	183	15992	10	37	173	15955	16175	0.10282484028797952
M1	string	0	network_modules	52	TRUE	3.688604259757739e-7	265	47	11	0.23404255319148937	0.04150943396226415	GO:0009101	GO:BP	glycoprotein biosynthetic process	16175	3273		0.18181818181818182	0.21739130434782608	265	15910	11	36	254	15874	16175	0.09255972460044033
M1	string	0	network_modules	52	TRUE	5.41687608636883e-7	204	47	10	0.2127659574468085	0.049019607843137254	GO:0070085	GO:BP	glycosylation	16175	15903		0.22727272727272727	0.2608695652173913	204	15971	10	37	194	15934	16175	0.09682463824235574
M1	string	0	network_modules	52	TRUE	5.794149083933005e-7	31	47	6	0.1276595744680851	0.1935483870967742	GO:0045048	GO:BP	protein insertion into ER membrane	16175	11247		0.2727272727272727	0.30434782608695654	31	16144	6	41	25	16103	16175	0.1552031328995187
M1	string	0	network_modules	52	TRUE	1.152134768985634e-6	31	24	5	0.20833333333333334	0.16129032258064516	KEGG:03060	KEGG	Protein export	8484	217		0.3333333333333333	0.5	31	8453	5	19	26	8434	8484	0.18067952725982964
M1	string	0	network_modules	52	TRUE	2.139666409635581e-6	38	47	6	0.1276595744680851	0.15789473684210525	GO:0018279	GO:BP	protein N-linked glycosylation via asparagine	16175	5395		0.3181818181818182	0.34782608695652173	38	16137	6	41	32	16096	16175	0.13972896070342056
M1	string	0	network_modules	52	TRUE	2.3032201362480646e-6	315	47	11	0.23404255319148937	0.03492063492063492	GO:0009100	GO:BP	glycoprotein metabolic process	16175	3272		0.36363636363636365	0.391304347826087	315	15860	11	36	304	15824	16175	0.0838226058731894
M1	string	0	network_modules	52	TRUE	2.534841983449467e-6	239	47	10	0.2127659574468085	0.04184100418410042	GO:0090150	GO:BP	establishment of protein localization to membrane	16175	18059		0.4090909090909091	0.43478260869565216	239	15936	10	37	229	15899	16175	0.08858450369186015
M1	string	0	network_modules	52	TRUE	5.40013823503198e-6	44	47	6	0.1276595744680851	0.13636363636363635	GO:0051205	GO:BP	protein insertion into membrane	16175	13565		0.45454545454545453	0.4782608695652174	44	16131	6	41	38	16090	16175	0.12949265636682833
M1	string	0	network_modules	52	TRUE	5.650666165918623e-6	42	24	5	0.20833333333333334	0.11904761904761904	KEGG:00513	KEGG	Various types of N-glycan biosynthesis	8484	66		0.6666666666666666	0.75	42	8442	5	19	37	8423	8484	0.15434340740976746
M1	string	0	network_modules	52	TRUE	7.541576780326816e-6	113	31	7	0.22580645161290322	0.061946902654867256	REAC:R-HSA-1799339	REAC	SRP-dependent cotranslational protein targeting to membrane	10916	2157		0	0.14285714285714285	113	10803	7	24	106	10779	10916	0.11359904181873992
M1	string	0	network_modules	52	TRUE	1.2458445608259903e-5	13	31	4	0.12903225806451613	0.3076923076923077	REAC:R-HSA-400511	REAC	Synthesis, secretion, and inactivation of Glucose-dependent Insulinotropic Polypeptide (GIP)	10916	2416		0.16666666666666666	0.2857142857142857	13	10903	4	27	9	10876	10916	0.1978139013611731
M1	string	0	network_modules	52	TRUE	1.867355341914269e-5	53	24	5	0.20833333333333334	0.09433962264150944	KEGG:00510	KEGG	N-Glycan biosynthesis	8484	63		1	1	53	8431	5	19	48	8412	8484	0.13660935767797777
M1	string	0	network_modules	52	TRUE	3.9114902515104004e-5	11	47	4	0.0851063829787234	0.36363636363636365	GO:0045050	GO:BP	protein insertion into ER membrane by stop-transfer membrane-anchor sequence	16175	11249		0.5	0.5217391304347826	11	16164	4	43	7	16121	16175	0.17482762706404742
M1	string	0	network_modules	52	TRUE	4.5220778127747075e-5	62	47	6	0.1276595744680851	0.0967741935483871	GO:0070972	GO:BP	protein localization to endoplasmic reticulum	16175	16407		0.5454545454545454	0.5652173913043478	62	16113	6	41	56	16072	16175	0.10817639534913435
M1	string	0	network_modules	52	TRUE	5.2793071288122684e-5	18	31	4	0.12903225806451613	0.2222222222222222	REAC:R-HSA-422085	REAC	Synthesis, secretion, and deacylation of Ghrelin	10916	2414		0.3333333333333333	0.42857142857142855	18	10898	4	27	14	10871	10916	0.16754559210936695
M1	string	0	network_modules	52	TRUE	8.438887322766464e-5	13	47	4	0.0851063829787234	0.3076923076923077	GO:0006465	GO:BP	signal peptide processing	16175	2206		0.5909090909090909	0.6086956521739131	13	16162	4	43	9	16119	16175	0.16059243437159476
M1	string	0	network_modules	52	TRUE	1.0264512752936087e-4	21	31	4	0.12903225806451613	0.19047619047619047	REAC:R-HSA-381771	REAC	Synthesis, secretion, and inactivation of Glucagon-like Peptide-1 (GLP-1)	10916	2415		0.5	0.5714285714285714	21	10895	4	27	17	10868	10916	0.15480372465114825
M1	string	0	network_modules	52	TRUE	1.8116017577909146e-4	24	31	4	0.12903225806451613	0.16666666666666666	REAC:R-HSA-400508	REAC	Incretin synthesis, secretion, and inactivation	10916	1180		0.6666666666666666	0.7142857142857143	24	10892	4	27	20	10865	10916	0.14451243288517882
M1	string	0	network_modules	52	TRUE	1.903928625350933e-4	483	47	11	0.23404255319148937	0.022774327122153208	GO:0051604	GO:BP	protein maturation	16175	13821		0.6363636363636364	0.6521739130434783	483	15692	11	36	472	15656	16175	0.06476001925588544
M1	string	0	network_modules	52	TRUE	2.785211577241296e-4	17	47	4	0.0851063829787234	0.23529411764705882	GO:0071816	GO:BP	tail-anchored membrane protein insertion into ER membrane	16175	16925		0.6818181818181818	0.6956521739130435	17	16158	4	43	13	16115	16175	0.14003938848202985
M1	string	0	network_modules	52	TRUE	2.924424036674946e-4	504	47	11	0.23404255319148937	0.021825396825396824	GO:0072657	GO:BP	protein localization to membrane	16175	17478		0.7272727272727273	0.7391304347826086	504	15671	11	36	493	15635	16175	0.06303558091172802
M1	string	0	network_modules	52	TRUE	3.2824120573291335e-4	86	47	6	0.1276595744680851	0.06976744186046512	GO:0007029	GO:BP	endoplasmic reticulum organization	16175	2634		0.7727272727272727	0.782608695652174	86	16089	6	41	80	16048	16175	0.09081704522033124
M1	string	0	network_modules	52	TRUE	3.56263848300739e-4	514	47	11	0.23404255319148937	0.021400778210116732	GO:1901137	GO:BP	carbohydrate derivative biosynthetic process	16175	21245		0.8181818181818182	0.8260869565217391	514	15661	11	36	503	15625	16175	0.06224903893266231
M1	string	0	network_modules	52	TRUE	0.0015015520739277424	594	47	11	0.23404255319148937	0.018518518518518517	GO:0051668	GO:BP	localization within membrane	16175	13880		0.8636363636363636	0.8695652173913043	594	15581	11	36	583	15545	16175	0.05663454986143353
M1	string	0	network_modules	52	TRUE	0.0021466447715611744	275	47	8	0.1702127659574468	0.02909090909090909	GO:0006605	GO:BP	protein targeting	16175	2322		0.9090909090909091	0.9130434782608695	275	15900	8	39	267	15861	16175	0.06397770008303597
M1	string	0	network_modules	52	TRUE	0.0027093979181138025	29	47	4	0.0851063829787234	0.13793103448275862	GO:0045047	GO:BP	protein targeting to ER	16175	11246		0.9545454545454546	0.9565217391304348	29	16146	4	43	25	16103	16175	0.10631311162823315
M1	string	0	network_modules	52	TRUE	0.004604505107010729	292	31	7	0.22580645161290322	0.023972602739726026	REAC:R-HSA-72766	REAC	Translation	10916	2565		0.8333333333333334	0.8571428571428571	292	10624	7	24	285	10600	10916	0.06583723118733277
M1	string	0	network_modules	52	TRUE	0.0046283999527571475	33	47	4	0.0851063829787234	0.12121212121212122	GO:0072599	GO:BP	establishment of protein localization to endoplasmic reticulum	16175	17463		1	1	33	16142	4	43	29	16099	16175	0.09937831981467984
M1	string	0	network_modules	52	TRUE	0.00610826977173196	305	31	7	0.22580645161290322	0.022950819672131147	REAC:R-HSA-446203	REAC	Asparagine N-linked glycosylation	10916	169		1	1	305	10611	7	24	298	10587	10916	0.06407267358835385
M1	string	0	network_modules	53	TRUE	2.686229935401279e-69	71	44	33	0.75	0.4647887323943662	GO:0045109	GO:BP	intermediate filament organization	16175	11280		0	0.07142857142857142	71	16104	33	11	38	16093	16175	0.5890551371751652
M1	string	0	network_modules	53	TRUE	5.716382653391879e-66	85	44	33	0.75	0.38823529411764707	GO:0045104	GO:BP	intermediate filament cytoskeleton organization	16175	11275		0.07692307692307693	0.14285714285714285	85	16090	33	11	52	16079	16175	0.5379725045812545
M1	string	0	network_modules	53	TRUE	9.269485707822498e-66	86	44	33	0.75	0.38372093023255816	GO:0045103	GO:BP	intermediate filament-based process	16175	11274		0.15384615384615385	0.21428571428571427	86	16089	33	11	53	16078	16175	0.5348078329286047
M1	string	0	network_modules	53	TRUE	6.10242923007644e-52	128	39	31	0.7948717948717948	0.2421875	REAC:R-HSA-6809371	REAC	Formation of the cornified envelope	10916	969		0	0.5	128	10788	31	8	97	10780	10916	0.43562067583055236
M1	string	0	network_modules	53	TRUE	2.9763157852356767e-44	215	39	31	0.7948717948717948	0.14418604651162792	REAC:R-HSA-6805567	REAC	Keratinization	10916	1288		1	1	215	10701	31	8	184	10693	10916	0.3340489695047824
M1	string	0	network_modules	53	TRUE	8.039472550122787e-38	748	44	36	0.8181818181818182	0.0481283422459893	GO:0097435	GO:BP	supramolecular fiber organization	16175	18657		0.23076923076923078	0.2857142857142857	748	15427	36	8	712	15419	16175	0.19196879843794676
M1	string	0	network_modules	53	TRUE	1.9572383147270865e-36	33	44	18	0.4090909090909091	0.5454545454545454	GO:0031424	GO:BP	keratinization	16175	7162		0.3076923076923077	0.35714285714285715	33	16142	18	26	15	16116	16175	0.4711431396329518
M1	string	0	network_modules	53	TRUE	1.753407563154494e-35	454	44	31	0.7045454545454546	0.06828193832599119	GO:0030855	GO:BP	epithelial cell differentiation	16175	6938		0.38461538461538464	0.42857142857142855	454	15721	31	13	423	15708	16175	0.21390714677222772
M1	string	0	network_modules	53	TRUE	2.590860393750056e-31	701	44	32	0.7272727272727273	0.0456490727532097	GO:0060429	GO:BP	epithelium development	16175	14627		0.46153846153846156	0.5	701	15474	32	12	669	15462	16175	0.17542602569343704
M1	string	0	network_modules	53	TRUE	2.446505820032617e-26	231	44	22	0.5	0.09523809523809523	GO:0008544	GO:BP	epidermis development	16175	3192		0.5384615384615384	0.5714285714285714	231	15944	22	22	209	15922	16175	0.21380614085914398
M1	string	0	network_modules	53	TRUE	7.694090631384671e-26	102	44	18	0.4090909090909091	0.17647058823529413	GO:0030216	GO:BP	keratinocyte differentiation	16175	6724		0.6153846153846154	0.6428571428571429	102	16073	18	26	84	16047	16175	0.26574468332438933
M1	string	0	network_modules	53	TRUE	1.5822845572094674e-25	168	44	20	0.45454545454545453	0.11904761904761904	GO:0043588	GO:BP	skin development	16175	10792		0.6923076923076923	0.7142857142857143	168	16007	20	24	148	15983	16175	0.22880678027583878
M1	string	0	network_modules	53	TRUE	4.4638898020089357e-23	142	44	18	0.4090909090909091	0.1267605633802817	GO:0009913	GO:BP	epidermal cell differentiation	16175	3769		0.7692307692307693	0.7857142857142857	142	16033	18	26	124	16007	16175	0.22412326761730006
M1	string	0	network_modules	53	TRUE	7.948972652152261e-22	86	22	14	0.6363636363636364	0.16279069767441862	KEGG:05150	KEGG	Staphylococcus aureus infection	8484	439		0	0.5	86	8398	14	8	72	8390	8484	0.31876457690318966
M1	string	0	network_modules	53	TRUE	7.120061281192688e-19	136	22	14	0.6363636363636364	0.10294117647058823	KEGG:04915	KEGG	Estrogen signaling pathway	8484	372		1	1	136	8348	14	8	122	8340	8484	0.251848879980757
M1	string	0	network_modules	53	TRUE	3.79906576517443e-4	50	44	5	0.11363636363636363	0.1	GO:0042303	GO:BP	molting cycle	16175	10076		0.8461538461538461	0.9285714285714286	50	16125	5	39	45	16086	16175	0.10400276940391837
M1	string	0	network_modules	53	TRUE	3.79906576517443e-4	50	44	5	0.11363636363636363	0.1	GO:0042633	GO:BP	hair cycle	16175	10266		0.8461538461538461	0.9285714285714286	50	16125	5	39	45	16086	16175	0.10400276940391837
M1	string	0	network_modules	53	TRUE	0.006769439892468681	12	44	3	0.06818181818181818	0.25	GO:0031069	GO:BP	hair follicle morphogenesis	16175	7018		1	1	12	16163	3	41	9	16122	16175	0.12936163613663396
M1	string	0	network_modules	54	TRUE	3.563922459764646e-7	105	35	8	0.22857142857142856	0.0761904761904762	REAC:R-HSA-425393	REAC	Transport of inorganic cations/anions and amino acids/oligopeptides	10916	2596		0	0.16666666666666666	105	10811	8	27	97	10784	10916	0.12722882311164788
M1	string	0	network_modules	54	TRUE	1.0163322092146049e-6	245	35	10	0.2857142857142857	0.04081632653061224	REAC:R-HSA-425407	REAC	SLC-mediated transmembrane transport	10916	2146		0.2	0.3333333333333333	245	10671	10	25	235	10646	10916	0.10080433078426508
M1	string	0	network_modules	54	TRUE	2.392571127519864e-6	326	46	11	0.2391304347826087	0.03374233128834356	GO:0015711	GO:BP	organic anion transport	16175	4831		0	0.0625	326	15849	11	35	315	15814	16175	0.08321584403020932
M1	string	0	network_modules	54	TRUE	2.68583185658148e-6	248	46	10	0.21739130434782608	0.04032258064516129	GO:0046942	GO:BP	carboxylic acid transport	16175	12438		0.06666666666666667	0.125	248	15927	10	36	238	15891	16175	0.0878223099826273
M1	string	0	network_modules	54	TRUE	2.7924915545769485e-6	249	46	10	0.21739130434782608	0.040160642570281124	GO:0015849	GO:BP	organic acid transport	16175	4958		0.13333333333333333	0.1875	249	15926	10	36	239	15890	16175	0.08762171642245709
M1	string	0	network_modules	54	TRUE	3.2600750114281434e-6	182	46	9	0.1956521739130435	0.04945054945054945	GO:0098739	GO:BP	import across plasma membrane	16175	18866		0.2	0.25	182	15993	9	37	173	15956	16175	0.09336418448346001
M1	string	0	network_modules	54	TRUE	9.705467319238797e-6	41	27	5	0.18518518518518517	0.12195121951219512	KEGG:04216	KEGG	Ferroptosis	8484	293		0	0.5	41	8443	5	22	36	8421	8484	0.1469455242551082
M1	string	0	network_modules	54	TRUE	1.5978713288643372e-5	32	35	5	0.14285714285714285	0.15625	REAC:R-HSA-352230	REAC	Amino acid transport across the plasma membrane	10916	141		0.4	0.5	32	10884	5	30	27	10854	10916	0.14678824273374155
M1	string	0	network_modules	54	TRUE	3.324136298538134e-5	11	46	4	0.08695652173913043	0.36363636363636365	GO:0015824	GO:BP	proline transport	16175	4936		0.26666666666666666	0.3125	11	16164	4	42	7	16122	16175	0.17674251786612571
M1	string	0	network_modules	54	TRUE	2.980205868969513e-4	45	46	5	0.10869565217391304	0.1111111111111111	GO:0015804	GO:BP	neutral amino acid transport	16175	4918		0.3333333333333333	0.375	45	16130	5	41	40	16089	16175	0.1073860074830208
M1	string	0	network_modules	54	TRUE	5.827689077667523e-4	98	46	6	0.13043478260869565	0.061224489795918366	GO:0006865	GO:BP	amino acid transport	16175	2527		0.4	0.4375	98	16077	6	40	92	16037	16175	0.08559348328191112
M1	string	0	network_modules	54	TRUE	9.816095352535282e-4	107	46	6	0.13043478260869565	0.056074766355140186	GO:1905039	GO:BP	carboxylic acid transmembrane transport	16175	24314		0.4666666666666667	0.5	107	16068	6	40	101	16028	16175	0.08157107880365393
M1	string	0	network_modules	54	TRUE	0.001095232328456364	109	46	6	0.13043478260869565	0.05504587155963303	GO:1903825	GO:BP	organic acid transmembrane transport	16175	23308		0.5333333333333333	0.5625	109	16066	6	40	103	16026	16175	0.08074357389084647
M1	string	0	network_modules	54	TRUE	0.001272374276216252	740	46	12	0.2608695652173913	0.016216216216216217	GO:0098657	GO:BP	import into cell	16175	18813		0.6	0.625	740	15435	12	34	728	15401	16175	0.05498332495532098
M1	string	0	network_modules	54	TRUE	0.001650503252655597	63	46	5	0.10869565217391304	0.07936507936507936	GO:0015807	GO:BP	L-amino acid transport	16175	4921		0.6666666666666666	0.6875	63	16112	5	41	58	16071	16175	0.0898543039870963
M1	string	0	network_modules	54	TRUE	0.003050628578577426	42	35	4	0.11428571428571428	0.09523809523809523	REAC:R-HSA-9035034	REAC	RHOF GTPase cycle	10916	1867		0.6	0.6666666666666666	42	10874	4	31	38	10843	10916	0.10117261182530903
M1	string	0	network_modules	54	TRUE	0.00410092687202239	70	27	4	0.14814814814814814	0.05714285714285714	KEGG:05230	KEGG	Central carbon metabolism in cancer	8484	478		1	1	70	8414	4	23	66	8391	8484	0.0873843192156923
M1	string	0	network_modules	54	TRUE	0.004548801131702547	10	46	3	0.06521739130434782	0.3	GO:0015820	GO:BP	L-leucine transport	16175	4932		0.7333333333333333	0.75	10	16165	3	43	7	16122	16175	0.1387900893578019
M1	string	0	network_modules	54	TRUE	0.007029712581676295	38	46	4	0.08695652173913043	0.10526315789473684	GO:0089718	GO:BP	amino acid import across plasma membrane	16175	17945		0.8	0.8125	38	16137	4	42	34	16095	16175	0.09333052261047864
M1	string	0	network_modules	54	TRUE	0.007212703464336296	52	35	4	0.11428571428571428	0.07692307692307693	REAC:R-HSA-9013405	REAC	RHOD GTPase cycle	10916	1866		0.8	0.8333333333333334	52	10864	4	31	48	10833	10916	0.09021281106561631
M1	string	0	network_modules	54	TRUE	0.008247297543832651	87	46	5	0.10869565217391304	0.05747126436781609	GO:0010232	GO:BP	vascular transport	16175	4011		0.8666666666666667	0.9375	87	16088	5	41	82	16047	16175	0.07543632762571462
M1	string	0	network_modules	54	TRUE	0.008247297543832651	87	46	5	0.10869565217391304	0.05747126436781609	GO:0150104	GO:BP	transport across blood-brain barrier	16175	20143		0.8666666666666667	0.9375	87	16088	5	41	82	16047	16175	0.07543632762571462
M1	string	0	network_modules	54	TRUE	0.008306261904253369	12	46	3	0.06521739130434782	0.25	GO:0015803	GO:BP	branched-chain amino acid transport	16175	4917		1	1	12	16163	3	43	9	16120	16175	0.12646275296011072
M1	string	0	network_modules	54	TRUE	0.009024696850942688	55	35	4	0.11428571428571428	0.07272727272727272	REAC:R-HSA-9013409	REAC	RHOJ GTPase cycle	10916	1870		1	1	55	10861	4	31	51	10830	10916	0.08750993493353164
M1	string	0	network_modules	55	TRUE	3.2667363864323507e-21	309	46	21	0.45652173913043476	0.06796116504854369	GO:0016236	GO:BP	macroautophagy	16175	5179		0	0.008695652173913044	309	15866	21	25	288	15841	16175	0.1706488449304629
M1	string	0	network_modules	55	TRUE	9.421443147572797e-20	10	46	9	0.1956521739130435	0.9	GO:1904896	GO:BP	ESCRT complex disassembly	16175	24203		0.008771929824561403	0.02608695652173913	10	16165	9	37	1	16128	16175	0.419026814046758
M1	string	0	network_modules	55	TRUE	9.421443147572797e-20	10	46	9	0.1956521739130435	0.9	GO:1904903	GO:BP	ESCRT III complex disassembly	16175	24210		0.008771929824561403	0.02608695652173913	10	16165	9	37	1	16128	16175	0.419026814046758
M1	string	0	network_modules	55	TRUE	8.172254462397261e-19	30	34	11	0.3235294117647059	0.36666666666666664	REAC:R-HSA-77387	REAC	Insulin receptor recycling	10916	1210		0	0.05263157894736842	30	10886	11	23	19	10863	10916	0.3425016559085266
M1	string	0	network_modules	55	TRUE	1.26424714072509e-18	31	34	11	0.3235294117647059	0.3548387096774194	REAC:R-HSA-917977	REAC	Transferrin endocytosis and recycling	10916	2564		0.05555555555555555	0.10526315789473684	31	10885	11	23	20	10862	10916	0.3368514031932722
M1	string	0	network_modules	55	TRUE	2.5097030087338307e-18	88	46	14	0.30434782608695654	0.1590909090909091	GO:0007032	GO:BP	endosome organization	16175	2637		0.02631578947368421	0.034782608695652174	88	16087	14	32	74	16055	16175	0.21700871965359717
M1	string	0	network_modules	55	TRUE	8.884140230394646e-18	36	34	11	0.3235294117647059	0.3055555555555556	REAC:R-HSA-1222556	REAC	ROS and RNS production in phagocytes	10916	1910		0.1111111111111111	0.15789473684210525	36	10880	11	23	25	10857	10916	0.3122101205072588
M1	string	0	network_modules	55	TRUE	1.870678355736773e-17	14	46	9	0.1956521739130435	0.6428571428571429	GO:0046753	GO:BP	non-lytic viral release	16175	12352		0.03508771929824561	0.043478260869565216	14	16161	9	37	5	16124	16175	0.3537370250116592
M1	string	0	network_modules	55	TRUE	5.3929809986960985e-17	491	46	21	0.45652173913043476	0.04276985743380855	GO:0061919	GO:BP	process utilizing autophagic mechanism	16175	15723		0.043859649122807015	0.06086956521739131	491	15684	21	25	470	15659	16175	0.1326567571832511
M1	string	0	network_modules	55	TRUE	5.3929809986960985e-17	491	46	21	0.45652173913043476	0.04276985743380855	GO:0006914	GO:BP	autophagy	16175	2563		0.043859649122807015	0.06086956521739131	491	15684	21	25	470	15659	16175	0.1326567571832511
M1	string	0	network_modules	55	TRUE	6.851555034674623e-17	25	46	10	0.21739130434782608	0.4	GO:0031468	GO:BP	nuclear membrane reassembly	16175	7184		0.06140350877192982	0.06956521739130435	25	16150	10	36	15	16114	16175	0.29343143430219293
M1	string	0	network_modules	55	TRUE	1.0908947960007574e-16	27	33	10	0.30303030303030304	0.37037037037037035	KEGG:04966	KEGG	Collecting duct acid secretion	8484	400		0	0.09090909090909091	27	8457	10	23	17	8434	8484	0.33267062875773695
M1	string	0	network_modules	55	TRUE	2.257526654183189e-16	17	46	9	0.1956521739130435	0.5294117647058824	GO:0061952	GO:BP	midbody abscission	16175	15745		0.07017543859649122	0.0782608695652174	17	16158	9	37	8	16121	16175	0.32073523075167265
M1	string	0	network_modules	55	TRUE	4.1645142789722877e-16	29	46	10	0.21739130434782608	0.3448275862068966	GO:0035891	GO:BP	exit from host cell	16175	9315		0.07894736842105263	0.09565217391304348	29	16146	10	36	19	16110	16175	0.2721658135967238
M1	string	0	network_modules	55	TRUE	4.1645142789722877e-16	29	46	10	0.21739130434782608	0.3448275862068966	GO:0019076	GO:BP	viral release from host cell	16175	5568		0.07894736842105263	0.09565217391304348	29	16146	10	36	19	16110	16175	0.2721658135967238
M1	string	0	network_modules	55	TRUE	1.2457344955668417e-15	50	33	11	0.3333333333333333	0.22	KEGG:05110	KEGG	Vibrio cholerae infection	8484	424		0.1	0.18181818181818182	50	8434	11	22	39	8412	8484	0.2673211741381081
M1	string	0	network_modules	55	TRUE	1.333161455780207e-15	32	46	10	0.21739130434782608	0.3125	GO:0036258	GO:BP	multivesicular body assembly	16175	9519		0.09649122807017543	0.10434782608695652	32	16143	10	36	22	16107	16175	0.2588952993382586
M1	string	0	network_modules	55	TRUE	1.9089208814696637e-15	33	46	10	0.21739130434782608	0.30303030303030304	GO:0036257	GO:BP	multivesicular body organization	16175	9518		0.10526315789473684	0.11304347826086956	33	16142	10	36	23	16106	16175	0.25487719287493454
M1	string	0	network_modules	55	TRUE	2.61942594162536e-15	57	34	11	0.3235294117647059	0.19298245614035087	REAC:R-HSA-917937	REAC	Iron uptake and transport	10916	1277		0.16666666666666666	0.21052631578947367	57	10859	11	23	46	10836	10916	0.24686723371134
M1	string	0	network_modules	55	TRUE	2.707126635127026e-15	21	46	9	0.1956521739130435	0.42857142857142855	GO:1902774	GO:BP	late endosome to lysosome transport	16175	22495		0.11403508771929824	0.12173913043478261	21	16154	9	37	12	16117	16175	0.2882458076362517
M1	string	0	network_modules	55	TRUE	3.767542608218376e-15	108	46	13	0.2826086956521739	0.12037037037037036	GO:0061640	GO:BP	cytoskeleton-dependent cytokinesis	16175	15599		0.12280701754385964	0.13043478260869565	108	16067	13	33	95	16034	16175	0.18094302461245854
M1	string	0	network_modules	55	TRUE	5.115586786640882e-15	13	46	8	0.17391304347826086	0.6153846153846154	GO:0046761	GO:BP	viral budding from plasma membrane	16175	12356		0.13157894736842105	0.1391304347826087	13	16162	8	38	5	16124	16175	0.326227631108329
M1	string	0	network_modules	55	TRUE	8.788889956045018e-15	83	46	12	0.2608695652173913	0.14457831325301204	GO:0000281	GO:BP	mitotic cytokinesis	16175	79		0.14035087719298245	0.14782608695652175	83	16092	12	34	71	16058	16175	0.1911485520481658
M1	string	0	network_modules	55	TRUE	9.650974597776253e-15	38	46	10	0.21739130434782608	0.2631578947368421	GO:0032506	GO:BP	cytokinetic process	16175	7613		0.14912280701754385	0.1565217391304348	38	16137	10	36	28	16101	16175	0.23721359573519193
M1	string	0	network_modules	55	TRUE	1.866138756066746e-14	25	46	9	0.1956521739130435	0.36	GO:1902410	GO:BP	mitotic cytokinetic process	16175	22262		0.15789473684210525	0.16521739130434782	25	16150	9	37	16	16113	16175	0.2638781749632267
M1	string	0	network_modules	55	TRUE	3.874775003978325e-14	43	46	10	0.21739130434782608	0.23255813953488372	GO:0071763	GO:BP	nuclear membrane organization	16175	16893		0.16666666666666666	0.17391304347826086	43	16132	10	36	33	16096	16175	0.22270999101603797
M1	string	0	network_modules	55	TRUE	4.263512492177022e-14	27	46	9	0.1956521739130435	0.3333333333333333	GO:0001778	GO:BP	plasma membrane repair	16175	443		0.17543859649122806	0.1826086956521739	27	16148	9	37	18	16111	16175	0.25377085879755734
M1	string	0	network_modules	55	TRUE	4.897291043416791e-14	73	34	11	0.3235294117647059	0.1506849315068493	REAC:R-HSA-74752	REAC	Signaling by Insulin receptor	10916	2260		0.2222222222222222	0.2631578947368421	73	10843	11	23	62	10820	10916	0.21729772777430892
M1	string	0	network_modules	55	TRUE	5.526715722118814e-14	96	46	12	0.2608695652173913	0.125	GO:0080171	GO:BP	lytic vacuole organization	16175	17845		0.18421052631578946	0.2	96	16079	12	34	84	16045	16175	0.17724864686555436
M1	string	0	network_modules	55	TRUE	5.526715722118814e-14	96	46	12	0.2608695652173913	0.125	GO:0007040	GO:BP	lysosome organization	16175	2644		0.18421052631578946	0.2	96	16079	12	34	84	16045	16175	0.17724864686555436
M1	string	0	network_modules	55	TRUE	6.879014150771259e-14	70	33	11	0.3333333333333333	0.15714285714285714	KEGG:05120	KEGG	Epithelial cell signaling in Helicobacter pylori infection	8484	426		0.2	0.2727272727272727	70	8414	11	22	59	8392	8484	0.2245675014718882
M1	string	0	network_modules	55	TRUE	9.582258504717427e-14	17	46	8	0.17391304347826086	0.47058823529411764	GO:0032510	GO:BP	endosome to lysosome transport via multivesicular body sorting pathway	16175	7617		0.20175438596491227	0.20869565217391303	17	16158	8	38	9	16120	16175	0.28490551275834214
M1	string	0	network_modules	55	TRUE	1.8848483910669081e-13	55	34	10	0.29411764705882354	0.18181818181818182	REAC:R-HSA-9639288	REAC	Amino acids regulate mTORC1	10916	142		0.2777777777777778	0.3157894736842105	55	10861	10	24	45	10837	10916	0.2282176212797016
M1	string	0	network_modules	55	TRUE	2.4259357173856056e-13	78	33	11	0.3333333333333333	0.14102564102564102	KEGG:04721	KEGG	Synaptic vesicle cycle	8484	351		0.3	0.36363636363636365	78	8406	11	22	67	8384	8484	0.21222357138089545
M1	string	0	network_modules	55	TRUE	3.059661409424872e-13	315	46	16	0.34782608695652173	0.050793650793650794	GO:0016050	GO:BP	vesicle organization	16175	5082		0.21052631578947367	0.21739130434782608	315	15860	16	30	299	15830	16175	0.1268971120728972
M1	string	0	network_modules	55	TRUE	3.8614323999226147e-13	53	46	10	0.21739130434782608	0.18867924528301888	GO:0006998	GO:BP	nuclear envelope organization	16175	2613		0.21929824561403508	0.22608695652173913	53	16122	10	36	43	16086	16175	0.20008680976658774
M1	string	0	network_modules	55	TRUE	4.2998410391363507e-13	202	46	14	0.30434782608695654	0.06930693069306931	GO:0007033	GO:BP	vacuole organization	16175	2638		0.22807017543859648	0.23478260869565218	202	15973	14	32	188	15941	16175	0.14035382922876366
M1	string	0	network_modules	55	TRUE	4.729419758807111e-13	54	46	10	0.21739130434782608	0.18518518518518517	GO:0071709	GO:BP	membrane assembly	16175	16873		0.23684210526315788	0.24347826086956523	54	16121	10	36	44	16085	16175	0.19817440689894203
M1	string	0	network_modules	55	TRUE	7.954109803457548e-13	21	46	8	0.17391304347826086	0.38095238095238093	GO:0039702	GO:BP	viral budding via host ESCRT complex	16175	9879		0.24561403508771928	0.25217391304347825	21	16154	8	38	13	16116	16175	0.2560045506016524
M1	string	0	network_modules	55	TRUE	9.745122503436866e-13	88	33	11	0.3333333333333333	0.125	KEGG:05323	KEGG	Rheumatoid arthritis	8484	485		0.4	0.45454545454545453	88	8396	11	22	77	8374	8484	0.19919385237757006
M1	string	0	network_modules	55	TRUE	1.0228807479042642e-12	58	46	10	0.21739130434782608	0.1724137931034483	GO:0044091	GO:BP	membrane biogenesis	16175	10913		0.2543859649122807	0.2608695652173913	58	16117	10	36	48	16081	16175	0.19102152409183476
M1	string	0	network_modules	55	TRUE	1.1085608396102003e-12	37	46	9	0.1956521739130435	0.24324324324324326	GO:0045324	GO:BP	late endosome to vacuole transport	16175	11357		0.2631578947368421	0.26956521739130435	37	16138	9	37	28	16101	16175	0.21615781668967968
M1	string	0	network_modules	55	TRUE	2.3523599506639048e-12	522	46	18	0.391304347826087	0.034482758620689655	GO:0010256	GO:BP	endomembrane system organization	16175	4029		0.2719298245614035	0.2782608695652174	522	15653	18	28	504	15625	16175	0.10849731462622846
M1	string	0	network_modules	55	TRUE	2.3639625597795506e-12	175	46	13	0.2826086956521739	0.07428571428571429	GO:0000910	GO:BP	cytokinesis	16175	243		0.2807017543859649	0.28695652173913044	175	16000	13	33	162	15967	16175	0.14030501405860243
M1	string	0	network_modules	55	TRUE	2.8568535142140377e-12	24	46	8	0.17391304347826086	0.3333333333333333	GO:0046755	GO:BP	viral budding	16175	12354		0.2894736842105263	0.2956521739130435	24	16151	8	38	16	16113	16175	0.23923523845319994
M1	string	0	network_modules	55	TRUE	3.0962417408929817e-12	41	46	9	0.1956521739130435	0.21951219512195122	GO:0032509	GO:BP	endosome transport via multivesicular body sorting pathway	16175	7616		0.2982456140350877	0.30434782608695654	41	16134	9	37	32	16097	16175	0.20510579495112283
M1	string	0	network_modules	55	TRUE	6.2266535488011e-12	44	46	9	0.1956521739130435	0.20454545454545456	GO:0090148	GO:BP	membrane fission	16175	18057		0.30701754385964913	0.3130434782608696	44	16131	9	37	35	16094	16175	0.19781836205878106
M1	string	0	network_modules	55	TRUE	1.189447069006379e-11	47	46	9	0.1956521739130435	0.19148936170212766	GO:0071985	GO:BP	multivesicular body sorting pathway	16175	17028		0.3157894736842105	0.3217391304347826	47	16128	9	37	38	16091	16175	0.19123469943197696
M1	string	0	network_modules	55	TRUE	2.0451428737226e-11	155	46	12	0.2608695652173913	0.07741935483870968	GO:0007034	GO:BP	vacuolar transport	16175	2639		0.32456140350877194	0.33043478260869563	155	16020	12	34	143	15986	16175	0.13775018357052413
M1	string	0	network_modules	55	TRUE	5.292516162249914e-11	33	46	8	0.17391304347826086	0.24242424242424243	GO:0019068	GO:BP	virion assembly	16175	5561		0.3333333333333333	0.3391304347826087	33	16142	8	38	25	16104	16175	0.2034188250738453
M1	string	0	network_modules	55	TRUE	8.93416637836719e-11	35	46	8	0.17391304347826086	0.22857142857142856	GO:0043162	GO:BP	ubiquitin-dependent protein catabolic process via the multivesicular body sorting pathway	16175	10562		0.34210526315789475	0.34782608695652173	35	16140	8	38	27	16102	16175	0.19739149939398648
M1	string	0	network_modules	55	TRUE	1.1204844779874742e-10	134	33	11	0.3333333333333333	0.08208955223880597	KEGG:00190	KEGG	Oxidative phosphorylation	8484	18		0.5	0.5454545454545454	134	8350	11	22	123	8328	8484	0.1591493515903915
M1	string	0	network_modules	55	TRUE	2.7511906192863687e-10	22	46	7	0.15217391304347827	0.3181818181818182	GO:1901673	GO:BP	regulation of mitotic spindle assembly	16175	21638		0.3508771929824561	0.3565217391304348	22	16153	7	39	15	16114	16175	0.2185358037197715
M1	string	0	network_modules	55	TRUE	3.076848620346561e-10	11	46	6	0.13043478260869565	0.5454545454545454	GO:0051469	GO:BP	vesicle fusion with vacuole	16175	13730		0.35964912280701755	0.3739130434782609	11	16164	6	40	5	16124	16175	0.26581035057586755
M1	string	0	network_modules	55	TRUE	3.076848620346561e-10	11	46	6	0.13043478260869565	0.5454545454545454	GO:0061763	GO:BP	multivesicular body-lysosome fusion	16175	15654		0.35964912280701755	0.3739130434782609	11	16164	6	40	5	16124	16175	0.26581035057586755
M1	string	0	network_modules	55	TRUE	3.1241144052840366e-10	147	33	11	0.3333333333333333	0.07482993197278912	KEGG:04145	KEGG	Phagosome	8484	281		0.6	0.6363636363636364	147	8337	11	22	136	8315	8484	0.1513338793012771
M1	string	0	network_modules	55	TRUE	3.581253942284802e-10	67	46	9	0.1956521739130435	0.13432835820895522	GO:0008333	GO:BP	endosome to lysosome transport	16175	3164		0.37719298245614036	0.3826086956521739	67	16108	9	37	58	16071	16175	0.15924018792608008
M1	string	0	network_modules	55	TRUE	5.127312563202004e-10	265	46	13	0.2826086956521739	0.04905660377358491	GO:0051301	GO:BP	cell division	16175	13632		0.38596491228070173	0.391304347826087	265	15910	13	33	252	15877	16175	0.11199816991378349
M1	string	0	network_modules	55	TRUE	5.900764398704545e-10	28	34	7	0.20588235294117646	0.25	REAC:R-HSA-162588	REAC	Budding and maturation of HIV virion	10916	258		0.3333333333333333	0.3684210526315789	28	10888	7	27	21	10861	10916	0.22468284261360733
M1	string	0	network_modules	55	TRUE	6.140647934985461e-10	12	46	6	0.13043478260869565	0.5	GO:0097576	GO:BP	vacuole fusion	16175	18701		0.39473684210526316	0.4	12	16163	6	40	6	16123	16175	0.2543806460956114
M1	string	0	network_modules	55	TRUE	1.301966792442433e-9	31	34	7	0.20588235294117646	0.22580645161290322	REAC:R-HSA-917729	REAC	Endosomal Sorting Complex Required For Transport (ESCRT)	10916	841		0.3888888888888889	0.42105263157894735	31	10885	7	27	24	10858	10916	0.2132752603874797
M1	string	0	network_modules	55	TRUE	1.4863028427008687e-9	182	34	11	0.3235294117647059	0.06043956043956044	REAC:R-HSA-983712	REAC	Ion channel transport	10916	1272		0.4444444444444444	0.47368421052631576	182	10734	11	23	171	10711	10916	0.13395769237511665
M1	string	0	network_modules	55	TRUE	1.9872553682841324e-9	14	46	6	0.13043478260869565	0.42857142857142855	GO:0097212	GO:BP	lysosomal membrane organization	16175	18546		0.40350877192982454	0.40869565217391307	14	16161	6	40	8	16121	16175	0.23530074058189082
M1	string	0	network_modules	55	TRUE	2.1821133635378284e-9	121	46	10	0.21739130434782608	0.08264462809917356	GO:0006997	GO:BP	nucleus organization	16175	2612		0.41228070175438597	0.41739130434782606	121	16054	10	36	111	16018	16175	0.13009769139325697
M1	string	0	network_modules	55	TRUE	3.0341600372830616e-9	125	46	10	0.21739130434782608	0.08	GO:0007041	GO:BP	lysosomal transport	16175	2645		0.42105263157894735	0.4260869565217391	125	16050	10	36	115	16014	16175	0.12786433865005387
M1	string	0	network_modules	55	TRUE	3.289022741303561e-9	126	46	10	0.21739130434782608	0.07936507936507936	GO:0051701	GO:BP	biological process involved in interaction with host	16175	13901		0.4298245614035088	0.43478260869565216	126	16049	10	36	116	16013	16175	0.1273223425417873
M1	string	0	network_modules	55	TRUE	4.162056278902192e-9	31	46	7	0.15217391304347827	0.22580645161290322	GO:0090169	GO:BP	regulation of spindle assembly	16175	18077		0.43859649122807015	0.4434782608695652	31	16144	7	39	24	16105	16175	0.18347160527199122
M1	string	0	network_modules	55	TRUE	4.432323448783844e-9	55	46	8	0.17391304347826086	0.14545454545454545	GO:0097352	GO:BP	autophagosome maturation	16175	18619		0.4473684210526316	0.45217391304347826	55	16120	8	38	47	16082	16175	0.1564272604956547
M1	string	0	network_modules	55	TRUE	4.743811974666525e-9	248	33	12	0.36363636363636365	0.04838709677419355	KEGG:04144	KEGG	Endocytosis	8484	280		0.7	0.7272727272727273	248	8236	12	21	236	8215	8484	0.12404868415120826
M1	string	0	network_modules	55	TRUE	8.004945670998815e-9	59	46	8	0.17391304347826086	0.13559322033898305	GO:0007080	GO:BP	mitotic metaphase chromosome alignment	16175	2669		0.45614035087719296	0.4608695652173913	59	16116	8	38	51	16078	16175	0.1508312575287609
M1	string	0	network_modules	55	TRUE	9.818694746655505e-9	157	34	10	0.29411764705882354	0.06369426751592357	REAC:R-HSA-9711097	REAC	Cellular response to starvation	10916	337		0.5	0.5263157894736842	157	10759	10	24	147	10735	10916	0.1313287442140418
M1	string	0	network_modules	55	TRUE	2.8139915918359552e-8	156	46	10	0.21739130434782608	0.0641025641025641	GO:0016241	GO:BP	regulation of macroautophagy	16175	5183		0.4649122807017544	0.46956521739130436	156	16019	10	36	146	15983	16175	0.1135203728577444
M1	string	0	network_modules	55	TRUE	3.4839707688799724e-8	41	46	7	0.15217391304347827	0.17073170731707318	GO:0060236	GO:BP	regulation of mitotic spindle organization	16175	14457		0.47368421052631576	0.4782608695652174	41	16134	7	39	34	16095	16175	0.15892847819988354
M1	string	0	network_modules	55	TRUE	4.9726184773978636e-8	43	46	7	0.15217391304347827	0.16279069767441862	GO:0010824	GO:BP	regulation of centrosome duplication	16175	4434		0.4824561403508772	0.48695652173913045	43	16132	7	39	36	16093	16175	0.15506983933706267
M1	string	0	network_modules	55	TRUE	5.900893562601476e-8	44	46	7	0.15217391304347827	0.1590909090909091	GO:0090224	GO:BP	regulation of spindle organization	16175	18121		0.49122807017543857	0.4956521739130435	44	16131	7	39	37	16092	16175	0.1532389163384338
M1	string	0	network_modules	55	TRUE	1.1242469976134102e-7	48	46	7	0.15217391304347827	0.14583333333333334	GO:0046605	GO:BP	regulation of centrosome cycle	16175	12255		0.5	0.5043478260869565	48	16127	7	39	41	16088	16175	0.1464904923997145
M1	string	0	network_modules	55	TRUE	1.2900789636884818e-7	330	33	12	0.36363636363636365	0.03636363636363636	KEGG:05165	KEGG	Human papillomavirus infection	8484	446		0.8	0.8181818181818182	330	8154	12	21	318	8133	8484	0.10495340412465735
M1	string	0	network_modules	55	TRUE	1.7391341480633505e-7	32	34	6	0.17647058823529413	0.1875	REAC:R-HSA-9668328	REAC	Sealing of the nuclear envelope (NE) by ESCRT-III	10916	2185		0.5555555555555556	0.5789473684210527	32	10884	6	28	26	10856	10916	0.17942243181207018
M1	string	0	network_modules	55	TRUE	2.595948346318076e-7	137	46	9	0.1956521739130435	0.06569343065693431	GO:0007009	GO:BP	plasma membrane organization	16175	2621		0.5087719298245614	0.5130434782608696	137	16038	9	37	128	16001	16175	0.10908094849955458
M1	string	0	network_modules	55	TRUE	3.6770984573072444e-7	155	33	9	0.2727272727272727	0.05806451612903226	KEGG:04150	KEGG	mTOR signaling pathway	8484	284		0.9	0.9090909090909091	155	8329	9	24	146	8305	8484	0.11872897159304481
M1	string	0	network_modules	55	TRUE	4.4296732822749404e-7	96	46	8	0.17391304347826086	0.08333333333333333	GO:0051310	GO:BP	metaphase chromosome alignment	16175	13641		0.5175438596491229	0.5217391304347826	96	16079	8	38	88	16041	16175	0.11679026633687842
M1	string	0	network_modules	55	TRUE	5.683276422920067e-7	99	46	8	0.17391304347826086	0.08080808080808081	GO:0006906	GO:BP	vesicle fusion	16175	2557		0.5263157894736842	0.5304347826086957	99	16076	8	38	91	16038	16175	0.11489083862083552
M1	string	0	network_modules	55	TRUE	5.771943379001377e-7	32	46	6	0.13043478260869565	0.1875	GO:0007035	GO:BP	vacuolar acidification	16175	2640		0.5350877192982456	0.5391304347826087	32	16143	6	40	26	16103	16175	0.15438609740670636
M1	string	0	network_modules	55	TRUE	6.680791326696863e-7	101	46	8	0.17391304347826086	0.07920792079207921	GO:0090174	GO:BP	organelle membrane fusion	16175	18081		0.543859649122807	0.5478260869565217	101	16074	8	38	93	16036	16175	0.11367086730556744
M1	string	0	network_modules	55	TRUE	6.695853255084599e-7	215	46	10	0.21739130434782608	0.046511627906976744	GO:0032984	GO:BP	protein-containing complex disassembly	16175	7964		0.5526315789473685	0.5565217391304348	215	15960	10	36	205	15924	16175	0.09517548208276644
M1	string	0	network_modules	55	TRUE	7.826944783744926e-7	103	46	8	0.17391304347826086	0.07766990291262135	GO:0051303	GO:BP	establishment of chromosome localization	16175	13634		0.5614035087719298	0.5652173913043478	103	16072	8	38	95	16034	16175	0.11248584604428075
M1	string	0	network_modules	55	TRUE	1.0435961980466806e-6	225	46	10	0.21739130434782608	0.044444444444444446	GO:0044403	GO:BP	biological process involved in symbiotic interaction	16175	10991		0.5701754385964912	0.5739130434782609	225	15950	10	36	215	15914	16175	0.09278368898128772
M1	string	0	network_modules	55	TRUE	1.1467524601081175e-6	108	46	8	0.17391304347826086	0.07407407407407407	GO:0050000	GO:BP	chromosome localization	16175	13183		0.5789473684210527	0.5826086956521739	108	16067	8	38	100	16029	16175	0.10966553716423424
M1	string	0	network_modules	55	TRUE	1.41893784481685e-6	68	46	7	0.15217391304347827	0.10294117647058823	GO:0090307	GO:BP	mitotic spindle assembly	16175	18189		0.5877192982456141	0.591304347826087	68	16107	7	39	61	16068	16175	0.12213244816261278
M1	string	0	network_modules	55	TRUE	1.934194885638868e-6	71	46	7	0.15217391304347827	0.09859154929577464	GO:0051298	GO:BP	centrosome duplication	16175	13629		0.5964912280701754	0.6	71	16104	7	39	64	16065	16175	0.11938563933158998
M1	string	0	network_modules	55	TRUE	2.118553885989135e-6	242	46	10	0.21739130434782608	0.04132231404958678	GO:0019058	GO:BP	viral life cycle	16175	5555		0.6052631578947368	0.6086956521739131	242	15933	10	36	232	15897	16175	0.0890507904146772
M1	string	0	network_modules	55	TRUE	3.1354298492413204e-6	252	46	10	0.21739130434782608	0.03968253968253968	GO:0140014	GO:BP	mitotic nuclear division	16175	19633		0.6140350877192983	0.6173913043478261	252	15923	10	36	242	15887	16175	0.08702682118627009
M1	string	0	network_modules	55	TRUE	3.4678840653498318e-6	124	46	8	0.17391304347826086	0.06451612903225806	GO:0007052	GO:BP	mitotic spindle organization	16175	2651		0.6228070175438597	0.6260869565217392	124	16051	8	38	116	16013	16175	0.10179140976216258
M1	string	0	network_modules	55	TRUE	5.046706372135943e-6	45	46	6	0.13043478260869565	0.13333333333333333	GO:0051452	GO:BP	intracellular pH reduction	16175	13713		0.631578947368421	0.6347826086956522	45	16130	6	40	39	16090	16175	0.12942735855259585
M1	string	0	network_modules	55	TRUE	6.754859249124143e-6	507	34	12	0.35294117647058826	0.023668639053254437	REAC:R-HSA-9006934	REAC	Signaling by Receptor Tyrosine Kinases	10916	2302		0.6111111111111112	0.631578947368421	507	10409	12	22	495	10387	10916	0.08140749171855088
M1	string	0	network_modules	55	TRUE	7.228793266571908e-6	136	46	8	0.17391304347826086	0.058823529411764705	GO:0048284	GO:BP	organelle fusion	16175	12626		0.6403508771929824	0.6434782608695652	136	16039	8	38	128	16001	16175	0.09679936797063064
M1	string	0	network_modules	55	TRUE	8.742634641355255e-6	158	33	8	0.24242424242424243	0.05063291139240506	KEGG:04217	KEGG	Necroptosis	8484	294		1	1	158	8326	8	25	150	8301	8484	0.10344720493273742
M1	string	0	network_modules	55	TRUE	1.0060889780928736e-5	374	46	11	0.2391304347826087	0.029411764705882353	GO:0022411	GO:BP	cellular component disassembly	16175	6602		0.6491228070175439	0.6521739130434783	374	15801	11	35	363	15766	16175	0.07675592352488383
M1	string	0	network_modules	55	TRUE	1.8326429908860112e-5	153	46	8	0.17391304347826086	0.05228758169934641	GO:1902850	GO:BP	microtubule cytoskeleton organization involved in mitosis	16175	22560		0.6578947368421053	0.6608695652173913	153	16022	8	38	145	15984	16175	0.09073186772855772
M1	string	0	network_modules	55	TRUE	2.2448523738000376e-5	157	46	8	0.17391304347826086	0.050955414012738856	GO:0061025	GO:BP	membrane fusion	16175	15142		0.6666666666666666	0.6695652173913044	157	16018	8	38	149	15980	16175	0.08944506911403702
M1	string	0	network_modules	55	TRUE	2.3140355679991267e-5	70	34	6	0.17647058823529413	0.08571428571428572	REAC:R-HSA-2995410	REAC	Nuclear Envelope (NE) Reassembly	10916	1612		0.6666666666666666	0.6842105263157895	70	10846	6	28	64	10818	10916	0.11908630717181792
M1	string	0	network_modules	55	TRUE	2.6974638978214625e-5	519	46	12	0.2608695652173913	0.023121387283236993	GO:0051640	GO:BP	organelle localization	16175	13853		0.6754385964912281	0.6782608695652174	519	15656	12	34	507	15622	16175	0.06932967623765497
M1	string	0	network_modules	55	TRUE	3.477835833793653e-5	324	46	10	0.21739130434782608	0.030864197530864196	GO:0010506	GO:BP	regulation of autophagy	16175	4181		0.6842105263157895	0.6869565217391305	324	15851	10	36	314	15815	16175	0.07522784935464534
M1	string	0	network_modules	55	TRUE	3.768284074924655e-5	656	46	13	0.2826086956521739	0.019817073170731708	GO:1903047	GO:BP	mitotic cell cycle process	16175	22727		0.6929824561403509	0.6956521739130435	656	15519	13	33	643	15486	16175	0.06553071074862482
M1	string	0	network_modules	55	TRUE	3.836836681453755e-5	657	46	13	0.2826086956521739	0.0197869101978691	GO:0061024	GO:BP	membrane organization	16175	15141		0.7017543859649122	0.7043478260869566	657	15518	13	33	644	15485	16175	0.0654662050650548
M1	string	0	network_modules	55	TRUE	4.6840703982567545e-5	132	34	7	0.20588235294117646	0.05303030303030303	REAC:R-HSA-162599	REAC	Late Phase of HIV Life Cycle	10916	1304		0.7222222222222222	0.7368421052631579	132	10784	7	27	125	10757	10916	0.0991067210806456
M1	string	0	network_modules	55	TRUE	5.139166818908118e-5	113	46	7	0.15217391304347827	0.061946902654867256	GO:0051225	GO:BP	spindle assembly	16175	13578		0.7105263157894737	0.7130434782608696	113	16062	7	39	106	16023	16175	0.09309163246678548
M1	string	0	network_modules	55	TRUE	5.384089993698614e-5	66	46	6	0.13043478260869565	0.09090909090909091	GO:1902600	GO:BP	proton transmembrane transport	16175	22372		0.7192982456140351	0.7217391304347827	66	16109	6	40	60	16069	16175	0.10585311325500436
M1	string	0	network_modules	55	TRUE	5.48754217163031e-5	176	46	8	0.17391304347826086	0.045454545454545456	GO:0007051	GO:BP	spindle organization	16175	2650		0.7280701754385965	0.7304347826086957	176	15999	8	38	168	15961	16175	0.08392468735815724
M1	string	0	network_modules	55	TRUE	5.9925285835859186e-5	178	46	8	0.17391304347826086	0.0449438202247191	GO:0000070	GO:BP	mitotic sister chromatid segregation	16175	24		0.7368421052631579	0.7391304347826086	178	15997	8	38	170	15959	16175	0.08339378906337196
M1	string	0	network_modules	55	TRUE	7.209909943921812e-5	350	46	10	0.21739130434782608	0.02857142857142857	GO:0016032	GO:BP	viral process	16175	5071		0.7456140350877193	0.7478260869565218	350	15825	10	36	340	15789	16175	0.07184920558722385
M1	string	0	network_modules	55	TRUE	8.917923530270932e-5	145	34	7	0.20588235294117646	0.04827586206896552	REAC:R-HSA-162587	REAC	HIV Life Cycle	10916	1103		0.7777777777777778	0.7894736842105263	145	10771	7	27	138	10744	10916	0.09403528860399932
M1	string	0	network_modules	55	TRUE	1.0097475578634299e-4	270	46	9	0.1956521739130435	0.03333333333333333	GO:0016197	GO:BP	endosomal transport	16175	5169		0.7543859649122807	0.7565217391304347	270	15905	9	37	261	15868	16175	0.07459781780653292
M1	string	0	network_modules	55	TRUE	1.1670888358119115e-4	225	34	8	0.23529411764705882	0.035555555555555556	REAC:R-HSA-162906	REAC	HIV Infection	10916	1102		0.8333333333333334	0.8421052631578947	225	10691	8	26	217	10665	10916	0.08445865891914332
M1	string	0	network_modules	55	TRUE	1.285705128363215e-4	129	46	7	0.15217391304347827	0.05426356589147287	GO:0007098	GO:BP	centrosome cycle	16175	2681		0.7631578947368421	0.7652173913043478	129	16046	7	39	122	16007	16175	0.08657697495180518
M1	string	0	network_modules	55	TRUE	1.3635949124679548e-4	15	46	4	0.08695652173913043	0.26666666666666666	GO:1903543	GO:BP	positive regulation of exosomal secretion	16175	23093		0.7719298245614035	0.7739130434782608	15	16160	4	42	11	16118	16175	0.15093810133310476
M1	string	0	network_modules	55	TRUE	1.520940528797978e-4	379	46	10	0.21739130434782608	0.026385224274406333	GO:0000280	GO:BP	nuclear division	16175	78		0.7807017543859649	0.782608695652174	379	15796	10	36	369	15760	16175	0.06847604658753101
M1	string	0	network_modules	55	TRUE	1.728526884074805e-4	80	46	6	0.13043478260869565	0.075	GO:0051453	GO:BP	regulation of intracellular pH	16175	13714		0.7894736842105263	0.7913043478260869	80	16095	6	40	74	16055	16175	0.09552878145304322
M1	string	0	network_modules	55	TRUE	2.005650074044643e-4	82	46	6	0.13043478260869565	0.07317073170731707	GO:0030641	GO:BP	regulation of cellular pH	16175	6868		0.7982456140350878	0.8	82	16093	6	40	76	16053	16175	0.09426948989327825
M1	string	0	network_modules	55	TRUE	2.3676842815178802e-4	17	46	4	0.08695652173913043	0.23529411764705882	GO:1903541	GO:BP	regulation of exosomal secretion	16175	23091		0.8070175438596491	0.808695652173913	17	16158	4	42	13	16116	16175	0.1415866407850201
M1	string	0	network_modules	55	TRUE	2.48915252067135e-4	85	46	6	0.13043478260869565	0.07058823529411765	GO:0006885	GO:BP	regulation of pH	16175	2541		0.8157894736842105	0.8173913043478261	85	16090	6	40	79	16050	16175	0.09246260223242238
M1	string	0	network_modules	55	TRUE	2.7727704811291365e-4	217	46	8	0.17391304347826086	0.03686635944700461	GO:0000819	GO:BP	sister chromatid segregation	16175	237		0.8245614035087719	0.8260869565217391	217	15958	8	38	209	15920	16175	0.07450202192289998
M1	string	0	network_modules	55	TRUE	3.0084641203859043e-4	146	46	7	0.15217391304347827	0.04794520547945205	GO:0031023	GO:BP	microtubule organizing center organization	16175	6997		0.8333333333333334	0.8347826086956521	146	16029	7	39	139	15990	16175	0.08083026972769376
M1	string	0	network_modules	55	TRUE	3.1522012582635715e-4	147	46	7	0.15217391304347827	0.047619047619047616	GO:0070507	GO:BP	regulation of microtubule cytoskeleton organization	16175	16162		0.8421052631578947	0.8434782608695652	147	16028	7	39	140	15989	16175	0.08052258877311805
M1	string	0	network_modules	55	TRUE	3.161024338632022e-4	410	46	10	0.21739130434782608	0.024390243902439025	GO:0051656	GO:BP	establishment of organelle localization	16175	13869		0.8508771929824561	0.8521739130434782	410	15765	10	36	400	15729	16175	0.06524996507171398
M1	string	0	network_modules	55	TRUE	3.410748419559478e-4	792	46	13	0.2826086956521739	0.016414141414141416	GO:0000278	GO:BP	mitotic cell cycle	16175	76		0.8596491228070176	0.8608695652173913	792	15383	13	33	779	15350	16175	0.057821780451795174
M1	string	0	network_modules	55	TRUE	4.312496541412063e-4	424	46	10	0.21739130434782608	0.02358490566037736	GO:0048285	GO:BP	organelle fission	16175	12627		0.868421052631579	0.8695652173913043	424	15751	10	36	414	15715	16175	0.0639028800515745
M1	string	0	network_modules	55	TRUE	4.7899615658345847e-4	20	46	4	0.08695652173913043	0.2	GO:1990182	GO:BP	exosomal secretion	16175	25111		0.8771929824561403	0.8782608695652174	20	16155	4	42	16	16113	16175	0.13026669629403015
M1	string	0	network_modules	55	TRUE	5.904724034261949e-4	21	46	4	0.08695652173913043	0.19047619047619047	GO:0007042	GO:BP	lysosomal lumen acidification	16175	2646		0.8859649122807017	0.8956521739130435	21	16154	4	42	17	16112	16175	0.12703952246325517
M1	string	0	network_modules	55	TRUE	5.904724034261949e-4	21	46	4	0.08695652173913043	0.19047619047619047	GO:0097734	GO:BP	extracellular exosome biogenesis	16175	18749		0.8859649122807017	0.8956521739130435	21	16154	4	42	17	16112	16175	0.12703952246325517
M1	string	0	network_modules	55	TRUE	6.971601464760406e-4	339	46	9	0.1956521739130435	0.02654867256637168	GO:0042060	GO:BP	wound healing	16175	9947		0.9035087719298246	0.9043478260869565	339	15836	9	37	330	15799	16175	0.06512903470418875
M1	string	0	network_modules	55	TRUE	8.699985322815225e-4	23	46	4	0.08695652173913043	0.17391304347826086	GO:0140112	GO:BP	extracellular vesicle biogenesis	16175	19667		0.9122807017543859	0.9130434782608695	23	16152	4	42	19	16110	16175	0.12122274427348453
M1	string	0	network_modules	55	TRUE	0.0011803925930799345	361	46	9	0.1956521739130435	0.024930747922437674	GO:0007059	GO:BP	chromosome segregation	16175	2658		0.9210526315789473	0.9217391304347826	361	15814	9	37	352	15777	16175	0.06266545934370549
M1	string	0	network_modules	55	TRUE	0.0015539771941343809	186	46	7	0.15217391304347827	0.03763440860215054	GO:1902115	GO:BP	regulation of organelle assembly	16175	22028		0.9298245614035088	0.9304347826086956	186	15989	7	39	179	15950	16175	0.07046416579472213
M1	string	0	network_modules	55	TRUE	0.0017725646248094723	277	46	8	0.17391304347826086	0.02888086642599278	GO:0098813	GO:BP	nuclear chromosome segregation	16175	18900		0.9385964912280702	0.9391304347826087	277	15898	8	38	269	15860	16175	0.06453878109737979
M1	string	0	network_modules	55	TRUE	0.001990859903619409	28	46	4	0.08695652173913043	0.14285714285714285	GO:0035751	GO:BP	regulation of lysosomal lumen pH	16175	9214		0.9473684210526315	0.9478260869565217	28	16147	4	42	24	16105	16175	0.10948733272780738
M1	string	0	network_modules	55	TRUE	0.0027411258919578744	13	34	3	0.08823529411764706	0.23076923076923078	REAC:R-HSA-9679504	REAC	Translation of Replicase and Assembly of the Replication Transcription Complex	10916	2568		0.8888888888888888	0.8947368421052632	13	10903	3	31	10	10872	10916	0.1410732550803085
M1	string	0	network_modules	55	TRUE	0.0031919872204680096	407	46	9	0.1956521739130435	0.022113022113022112	GO:0009611	GO:BP	response to wounding	16175	3539		0.956140350877193	0.9565217391304348	407	15768	9	37	398	15731	16175	0.05813431980988235
M1	string	0	network_modules	55	TRUE	0.0034812782104250424	14	34	3	0.08823529411764706	0.21428571428571427	REAC:R-HSA-9694676	REAC	Translation of Replicase and Assembly of the Replication Transcription Complex	10916	2569		0.9444444444444444	0.9473684210526315	14	10902	3	31	11	10871	10916	0.13580474827579567
M1	string	0	network_modules	55	TRUE	0.004548801131702547	10	46	3	0.06521739130434782	0.3	GO:0101024	GO:BP	mitotic nuclear membrane organization	16175	19197		0.9649122807017544	0.9739130434782609	10	16165	3	43	7	16122	16175	0.1387900893578019
M1	string	0	network_modules	55	TRUE	0.004548801131702547	10	46	3	0.06521739130434782	0.3	GO:0007084	GO:BP	mitotic nuclear membrane reassembly	16175	2670		0.9649122807017544	0.9739130434782609	10	16165	3	43	7	16122	16175	0.1387900893578019
M1	string	0	network_modules	55	TRUE	0.006049777536405578	440	46	9	0.1956521739130435	0.020454545454545454	GO:0051493	GO:BP	regulation of cytoskeleton organization	16175	13748		0.9824561403508771	0.9826086956521739	440	15735	9	37	431	15698	16175	0.055300622075031974
M1	string	0	network_modules	55	TRUE	0.006773657282850455	232	46	7	0.15217391304347827	0.03017241379310345	GO:0032886	GO:BP	regulation of microtubule-based process	16175	7882		0.9912280701754386	0.991304347826087	232	15943	7	39	225	15904	16175	0.06190656643079219
M1	string	0	network_modules	55	TRUE	0.008306261904253369	12	46	3	0.06521739130434782	0.25	GO:0048388	GO:BP	endosomal lumen acidification	16175	12723		1	1	12	16163	3	43	9	16120	16175	0.12646275296011072
M1	string	0	network_modules	55	TRUE	0.008445718523981759	113	34	5	0.14705882352941177	0.04424778761061947	REAC:R-HSA-9610379	REAC	HCMV Late Events	10916	1090		1	1	113	10803	5	29	108	10774	10916	0.0754967254188823
M1	string	0	network_modules	56	TRUE	4.178279833635203e-30	590	44	30	0.6818181818181818	0.05084745762711865	GO:0016071	GO:BP	mRNA metabolic process	16175	5098		0	0.02564102564102564	590	15585	30	14	560	15571	16175	0.17978381702214902
M1	string	0	network_modules	56	TRUE	1.0928607772426419e-29	397	44	27	0.6136363636363636	0.06801007556675064	GO:0008380	GO:BP	RNA splicing	16175	3186		0.02631578947368421	0.05128205128205128	397	15778	27	17	370	15761	16175	0.19883924677848824
M1	string	0	network_modules	56	TRUE	1.149125901210188e-25	352	44	24	0.5454545454545454	0.06818181818181818	GO:0006397	GO:BP	mRNA processing	16175	2158		0.05263157894736842	0.07692307692307693	352	15823	24	20	328	15803	16175	0.18745656130918734
M1	string	0	network_modules	56	TRUE	3.3124954062388516e-24	287	44	22	0.5	0.07665505226480836	GO:0000398	GO:BP	mRNA splicing, via spliceosome	16175	121		0.07894736842105263	0.1282051282051282	287	15888	22	22	265	15866	16175	0.19078427230844577
M1	string	0	network_modules	56	TRUE	3.3124954062388516e-24	287	44	22	0.5	0.07665505226480836	GO:0000377	GO:BP	RNA splicing, via transesterification reactions with bulged adenosine as nucleophile	16175	109		0.07894736842105263	0.1282051282051282	287	15888	22	22	265	15866	16175	0.19078427230844577
M1	string	0	network_modules	56	TRUE	4.5201953920265676e-24	291	44	22	0.5	0.07560137457044673	GO:0000375	GO:BP	RNA splicing, via transesterification reactions	16175	107		0.13157894736842105	0.15384615384615385	291	15884	22	22	269	15862	16175	0.18939518868821684
M1	string	0	network_modules	56	TRUE	6.490346744296636e-23	273	44	21	0.4772727272727273	0.07692307692307693	GO:1903311	GO:BP	regulation of mRNA metabolic process	16175	22895		0.15789473684210525	0.1794871794871795	273	15902	21	23	252	15879	16175	0.18666514040493487
M1	string	0	network_modules	56	TRUE	2.77835449430707e-17	276	31	17	0.5483870967741935	0.06159420289855073	REAC:R-HSA-72203	REAC	Processing of Capped Intron-Containing Pre-mRNA	10916	1796		0	0.25	276	10640	17	14	259	10626	10916	0.1778247079991483
M1	string	0	network_modules	56	TRUE	4.680040460410254e-16	202	31	15	0.4838709677419355	0.07425742574257425	REAC:R-HSA-72163	REAC	mRNA Splicing - Major Pathway	10916	2707		0.3333333333333333	0.5	202	10714	15	16	187	10698	10916	0.1842779283115779
M1	string	0	network_modules	56	TRUE	7.867896003176849e-16	209	31	15	0.4838709677419355	0.07177033492822966	REAC:R-HSA-72172	REAC	mRNA Splicing	10916	2706		0.6666666666666666	0.75	209	10707	15	16	194	10691	10916	0.18097514153804733
M1	string	0	network_modules	56	TRUE	5.2200661397813825e-15	84	44	12	0.2727272727272727	0.14285714285714285	GO:1903312	GO:BP	negative regulation of mRNA metabolic process	16175	22896		0.18421052631578946	0.20512820512820512	84	16091	12	32	72	16059	16175	0.19439626816402594
M1	string	0	network_modules	56	TRUE	2.5699437173216643e-14	175	44	14	0.3181818181818182	0.08	GO:0043484	GO:BP	regulation of RNA splicing	16175	10730		0.21052631578947367	0.23076923076923078	175	16000	14	30	161	15970	16175	0.15517153709616424
M1	string	0	network_modules	56	TRUE	9.540132666473024e-13	226	44	14	0.3181818181818182	0.061946902654867256	GO:0006402	GO:BP	mRNA catabolic process	16175	2163		0.23684210526315788	0.2564102564102564	226	15949	14	30	212	15919	16175	0.13536051684542658
M1	string	0	network_modules	56	TRUE	2.72934534188522e-12	67	44	10	0.22727272727272727	0.14925373134328357	GO:0000380	GO:BP	alternative mRNA splicing, via spliceosome	16175	112		0.2631578947368421	0.28205128205128205	67	16108	10	34	57	16074	16175	0.1814432315183363
M1	string	0	network_modules	56	TRUE	1.797080036058558e-11	279	44	14	0.3181818181818182	0.05017921146953405	GO:0006401	GO:BP	RNA catabolic process	16175	2162		0.2894736842105263	0.3076923076923077	279	15896	14	30	265	15866	16175	0.12071569393890873
M1	string	0	network_modules	56	TRUE	2.2225107245758326e-11	119	44	11	0.25	0.09243697478991597	GO:0050684	GO:BP	regulation of mRNA processing	16175	13215		0.3157894736842105	0.3333333333333333	119	16056	11	33	108	16023	16175	0.14829125147530173
M1	string	0	network_modules	56	TRUE	3.714097007794635e-11	172	44	12	0.2727272727272727	0.06976744186046512	GO:0061013	GO:BP	regulation of mRNA catabolic process	16175	15136		0.34210526315789475	0.358974358974359	172	16003	12	32	160	15971	16175	0.13345395128891052
M1	string	0	network_modules	56	TRUE	4.677513010473867e-11	299	44	14	0.3181818181818182	0.046822742474916385	GO:0141188	GO:BP	nucleic acid catabolic process	16175	20075		0.3684210526315789	0.38461538461538464	299	15876	14	30	285	15846	16175	0.11620251179334046
M1	string	0	network_modules	56	TRUE	1.452363539426844e-10	98	44	10	0.22727272727272727	0.10204081632653061	GO:0048024	GO:BP	regulation of mRNA splicing, via spliceosome	16175	12475		0.39473684210526316	0.41025641025641024	98	16077	10	34	88	16043	16175	0.1488802318788023
M1	string	0	network_modules	56	TRUE	2.164797598036817e-10	67	44	9	0.20454545454545456	0.13432835820895522	GO:1902373	GO:BP	negative regulation of mRNA catabolic process	16175	22245		0.42105263157894735	0.4358974358974359	67	16108	9	35	58	16073	16175	0.1629620771889885
M1	string	0	network_modules	56	TRUE	4.572578643252879e-10	156	44	11	0.25	0.07051282051282051	GO:0043488	GO:BP	regulation of mRNA stability	16175	10733		0.4473684210526316	0.46153846153846156	156	16019	11	33	145	15986	16175	0.12844405942409168
M1	string	0	network_modules	56	TRUE	8.009550494828457e-10	77	44	9	0.20454545454545456	0.11688311688311688	GO:1902369	GO:BP	negative regulation of RNA catabolic process	16175	22241		0.47368421052631576	0.48717948717948717	77	16098	9	35	68	16063	16175	0.15159035960165024
M1	string	0	network_modules	56	TRUE	9.709787997914162e-10	167	44	11	0.25	0.0658682634730539	GO:0043487	GO:BP	regulation of RNA stability	16175	10732		0.5	0.5128205128205128	167	16008	11	33	156	15975	16175	0.12383309137769587
M1	string	0	network_modules	56	TRUE	2.4184070230666705e-9	54	44	8	0.18181818181818182	0.14814814814814814	GO:0000381	GO:BP	regulation of alternative mRNA splicing, via spliceosome	16175	113		0.5263157894736842	0.5384615384615384	54	16121	8	36	46	16085	16175	0.161597981538413
M1	string	0	network_modules	56	TRUE	4.4200877440245315e-9	58	44	8	0.18181818181818182	0.13793103448275862	GO:0048255	GO:BP	mRNA stabilization	16175	12610		0.5526315789473685	0.5641025641025641	58	16117	8	36	50	16081	16175	0.1557293749776381
M1	string	0	network_modules	56	TRUE	7.48480939040328e-9	434	44	14	0.3181818181818182	0.03225806451612903	GO:0010608	GO:BP	post-transcriptional regulation of gene expression	16175	4255		0.5789473684210527	0.5897435897435898	434	15741	14	30	420	15711	16175	0.09416606218267265
M1	string	0	network_modules	56	TRUE	1.146436021836712e-8	448	44	14	0.3181818181818182	0.03125	GO:0034655	GO:BP	nucleobase-containing compound catabolic process	16175	8711		0.6052631578947368	0.6153846153846154	448	15727	14	30	434	15697	16175	0.0924488208620522
M1	string	0	network_modules	56	TRUE	1.4774150995585275e-8	67	44	8	0.18181818181818182	0.11940298507462686	GO:0043489	GO:BP	RNA stabilization	16175	10734		0.631578947368421	0.6410256410256411	67	16108	8	36	59	16072	16175	0.1444809228596407
M1	string	0	network_modules	56	TRUE	1.497368917726775e-6	118	44	8	0.18181818181818182	0.06779661016949153	GO:0045727	GO:BP	positive regulation of translation	16175	11569		0.6578947368421053	0.6666666666666666	118	16057	8	36	110	16021	16175	0.10710737547783956
M1	string	0	network_modules	56	TRUE	2.3742644677473556e-6	125	44	8	0.18181818181818182	0.064	GO:1903313	GO:BP	positive regulation of mRNA metabolic process	16175	22897		0.6842105263157895	0.6923076923076923	125	16050	8	36	117	16014	16175	0.10382974745000391
M1	string	0	network_modules	56	TRUE	5.293925255175227e-6	174	20	7	0.35	0.040229885057471264	KEGG:03040	KEGG	Spliceosome	8484	215		NA	1	174	8310	7	13	167	8297	8484	0.11300456693265432
M1	string	0	network_modules	56	TRUE	7.096991075469601e-6	290	44	10	0.22727272727272727	0.034482758620689655	GO:0009895	GO:BP	negative regulation of catabolic process	16175	3755		0.7105263157894737	0.717948717948718	290	15885	10	34	280	15851	16175	0.0823962653959335
M1	string	0	network_modules	56	TRUE	8.219261822561636e-6	92	44	7	0.1590909090909091	0.07608695652173914	GO:0061157	GO:BP	mRNA destabilization	16175	15262		0.7368421052631579	0.7435897435897436	92	16083	7	37	85	16046	16175	0.10653608370645111
M1	string	0	network_modules	56	TRUE	1.030505380714985e-5	95	44	7	0.1590909090909091	0.07368421052631578	GO:0050779	GO:BP	RNA destabilization	16175	13253		0.7631578947368421	0.7692307692307693	95	16080	7	37	88	16043	16175	0.1047234516874655
M1	string	0	network_modules	56	TRUE	1.193208205842114e-5	97	44	7	0.1590909090909091	0.07216494845360824	GO:0061014	GO:BP	positive regulation of mRNA catabolic process	16175	15137		0.7894736842105263	0.7948717948717948	97	16078	7	37	90	16041	16175	0.1035610091629196
M1	string	0	network_modules	56	TRUE	6.886768374871026e-5	5	31	3	0.0967741935483871	0.6	REAC:R-HSA-8849468	REAC	PTK6 Regulates Proteins Involved in RNA Processing	10916	1708		1	1	5	10911	3	28	2	10883	10916	0.24022156554436042
M1	string	0	network_modules	56	TRUE	9.145687168865908e-4	112	44	6	0.13636363636363635	0.05357142857142857	GO:0031047	GO:BP	regulatory ncRNA-mediated gene silencing	16175	7011		0.8157894736842105	0.8205128205128205	112	16063	6	38	106	16025	16175	0.08152372835795826
M1	string	0	network_modules	56	TRUE	9.639050528896855e-4	113	44	6	0.13636363636363635	0.05309734513274336	GO:0000956	GO:BP	nuclear-transcribed mRNA catabolic process	16175	264		0.8421052631578947	0.8461538461538461	113	16062	6	38	107	16024	16175	0.08112596226552131
M1	string	0	network_modules	56	TRUE	0.001135818161104036	26	44	4	0.09090909090909091	0.15384615384615385	GO:0070935	GO:BP	3'-UTR-mediated mRNA stabilization	16175	16379		0.868421052631579	0.8717948717948718	26	16149	4	40	22	16109	16175	0.11642334721899003
M1	string	0	network_modules	56	TRUE	0.001635314428147096	290	44	8	0.18181818181818182	0.027586206896551724	GO:0006417	GO:BP	regulation of translation	16175	2174		0.8947368421052632	0.8974358974358975	290	15885	8	36	282	15849	16175	0.06450567417800983
M1	string	0	network_modules	56	TRUE	0.003066099426331782	33	44	4	0.09090909090909091	0.12121212121212122	GO:2000765	GO:BP	regulation of cytoplasmic translation	16175	26025		0.9210526315789473	0.9230769230769231	33	16142	4	40	29	16102	16175	0.10286181228556958
M1	string	0	network_modules	56	TRUE	0.005086746010750936	11	44	3	0.06818181818181818	0.2727272727272727	GO:0070934	GO:BP	CRD-mediated mRNA stabilization	16175	16378		0.9473684210526315	0.9487179487179487	11	16164	3	41	8	16123	16175	0.1352335010505478
M1	string	0	network_modules	56	TRUE	0.006769439892468681	12	44	3	0.06818181818181818	0.25	GO:1900152	GO:BP	negative regulation of nuclear-transcribed mRNA catabolic process, deadenylation-dependent decay	16175	20436		0.9736842105263158	0.9743589743589743	12	16163	3	41	9	16122	16175	0.12936163613663396
M1	string	0	network_modules	56	TRUE	0.007091913316088083	159	44	6	0.13636363636363635	0.03773584905660377	GO:0001649	GO:BP	osteoblast differentiation	16175	367		1	1	159	16016	6	38	153	15978	16175	0.06698390031975936
M1	string	0	network_modules	57	TRUE	2.3212232644588338e-33	510	45	31	0.6888888888888889	0.060784313725490195	GO:0007169	GO:BP	cell surface receptor protein tyrosine kinase signaling pathway	16175	2733		0	0.0136986301369863	510	15665	31	14	479	15651	16175	0.1986943522977352
M1	string	0	network_modules	57	TRUE	4.2662690951578507e-29	790	45	32	0.7111111111111111	0.04050632911392405	GO:0007167	GO:BP	enzyme-linked receptor protein signaling pathway	16175	2731		0.013888888888888888	0.0273972602739726	790	15385	32	13	758	15372	16175	0.16229545233668205
M1	string	0	network_modules	57	TRUE	2.7522669282079966e-26	47	41	16	0.3902439024390244	0.3404255319148936	REAC:R-HSA-512988	REAC	Interleukin-3, Interleukin-5 and GM-CSF signaling	10916	1246		0	0.010101010101010102	47	10869	16	25	31	10844	10916	0.3619219925109716
M1	string	0	network_modules	57	TRUE	2.971064358722473e-23	84	38	17	0.4473684210526316	0.20238095238095238	KEGG:04012	KEGG	ErbB signaling pathway	8484	245		0	0.010309278350515464	84	8400	17	21	67	8379	8484	0.2963693988825268
M1	string	0	network_modules	57	TRUE	1.3952038248505535e-22	21	41	12	0.2926829268292683	0.5714285714285714	REAC:R-HSA-912631	REAC	Regulation of signaling by CBL	10916	2049		0.01020408163265306	0.020202020202020204	21	10895	12	29	9	10866	10916	0.40742806498944406
M1	string	0	network_modules	57	TRUE	1.417999081345319e-22	507	41	26	0.6341463414634146	0.05128205128205128	REAC:R-HSA-9006934	REAC	Signaling by Receptor Tyrosine Kinases	10916	2302		0.02040816326530612	0.030303030303030304	507	10409	26	15	481	10394	10916	0.17147017406754786
M1	string	0	network_modules	57	TRUE	4.8980356268702555e-22	76	38	16	0.42105263157894735	0.21052631578947367	KEGG:05220	KEGG	Chronic myeloid leukemia	8484	471		0.010416666666666666	0.020618556701030927	76	8408	16	22	60	8386	8484	0.2933666138974517
M1	string	0	network_modules	57	TRUE	4.528202159193477e-21	26	41	12	0.2926829268292683	0.46153846153846156	REAC:R-HSA-186763	REAC	Downstream signal transduction	10916	790		0.030612244897959183	0.04040404040404041	26	10890	12	29	14	10861	10916	0.36566963065029884
M1	string	0	network_modules	57	TRUE	6.583633509504257e-21	38	41	13	0.3170731707317073	0.34210526315789475	REAC:R-HSA-8853659	REAC	RET signaling	10916	1845		0.04081632653061224	0.050505050505050504	38	10878	13	28	25	10850	10916	0.32691852459342535
M1	string	0	network_modules	57	TRUE	9.851857411165809e-21	39	41	13	0.3170731707317073	0.3333333333333333	REAC:R-HSA-1433557	REAC	Signaling by SCF-KIT	10916	2306		0.05102040816326531	0.06060606060606061	39	10877	13	28	26	10849	10916	0.32262060435720263
M1	string	0	network_modules	57	TRUE	5.437771803504712e-20	235	38	20	0.5263157894736842	0.0851063829787234	KEGG:04014	KEGG	Ras signaling pathway	8484	247		0.020833333333333332	0.030927835051546393	235	8249	20	18	215	8231	8484	0.203797598369897
M1	string	0	network_modules	57	TRUE	7.129572830639784e-18	79	38	14	0.3684210526315789	0.17721518987341772	KEGG:01521	KEGG	EGFR tyrosine kinase inhibitor resistance	8484	195		0.03125	0.041237113402061855	79	8405	14	24	65	8381	8484	0.2507906246007758
M1	string	0	network_modules	57	TRUE	1.871537953030368e-17	65	41	13	0.3170731707317073	0.2	REAC:R-HSA-2219530	REAC	Constitutive Signaling by Aberrant PI3K in Cancer	10916	401		0.061224489795918366	0.0707070707070707	65	10851	13	28	52	10823	10916	0.24829916002875707
M1	string	0	network_modules	57	TRUE	9.363032326364182e-17	70	38	13	0.34210526315789475	0.18571428571428572	KEGG:05230	KEGG	Central carbon metabolism in cancer	8484	478		0.041666666666666664	0.05154639175257732	70	8414	13	25	57	8389	8484	0.24755619544454743
M1	string	0	network_modules	57	TRUE	1.5010904887596182e-16	54	41	12	0.2926829268292683	0.2222222222222222	REAC:R-HSA-186797	REAC	Signaling by PDGF	10916	2291		0.07142857142857142	0.08080808080808081	54	10862	12	29	42	10833	10916	0.25181600846005503
M1	string	0	network_modules	57	TRUE	3.162721703216291e-16	26	41	10	0.24390243902439024	0.38461538461538464	REAC:R-HSA-912526	REAC	Interleukin receptor SHC signaling	10916	1230		0.08163265306122448	0.09090909090909091	26	10890	10	31	16	10859	10916	0.3042246590791174
M1	string	0	network_modules	57	TRUE	1.244630464615928e-15	44	41	11	0.2682926829268293	0.25	REAC:R-HSA-451927	REAC	Interleukin-2 family signaling	10916	1240		0.09183673469387756	0.10101010101010101	44	10872	11	30	33	10842	10916	0.25609100211856584
M1	string	0	network_modules	57	TRUE	1.375768250406762e-15	418	41	20	0.4878048780487805	0.04784688995215311	REAC:R-HSA-5663202	REAC	Diseases of signal transduction by growth factor receptors and second messengers	10916	773		0.10204081632653061	0.1111111111111111	418	10498	20	21	398	10477	10916	0.14382723616801923
M1	string	0	network_modules	57	TRUE	1.770505565639586e-15	30	41	10	0.24390243902439024	0.3333333333333333	REAC:R-HSA-9680350	REAC	Signaling by CSF1 (M-CSF) in myeloid cells	10916	2226		0.11224489795918367	0.12121212121212122	30	10886	10	31	20	10855	10916	0.282839996720963
M1	string	0	network_modules	57	TRUE	1.8738786233312167e-15	235	45	16	0.35555555555555557	0.06808510638297872	GO:0043491	GO:BP	phosphatidylinositol 3-kinase/protein kinase B signal transduction	16175	10736		0.027777777777777776	0.0410958904109589	235	15940	16	29	219	15911	16175	0.15053725381243294
M1	string	0	network_modules	57	TRUE	2.385142134162761e-15	92	41	13	0.3170731707317073	0.14130434782608695	REAC:R-HSA-6811558	REAC	PI5P, PP2A and IER3 Regulate PI3K/AKT Signaling	10916	1677		0.12244897959183673	0.1414141414141414	92	10824	13	28	79	10796	10916	0.2073063042655281
M1	string	0	network_modules	57	TRUE	2.385142134162761e-15	92	41	13	0.3170731707317073	0.14130434782608695	REAC:R-HSA-2219528	REAC	PI3K/AKT Signaling in Cancer	10916	1674		0.12244897959183673	0.1414141414141414	92	10824	13	28	79	10796	10916	0.2073063042655281
M1	string	0	network_modules	57	TRUE	6.498113331643121e-15	99	41	13	0.3170731707317073	0.13131313131313133	REAC:R-HSA-199418	REAC	Negative regulation of the PI3K/AKT network	10916	1580		0.14285714285714285	0.15151515151515152	99	10817	13	28	86	10789	10916	0.19949225827400063
M1	string	0	network_modules	57	TRUE	6.604703608849385e-15	202	38	16	0.42105263157894735	0.07920792079207921	KEGG:04510	KEGG	Focal adhesion	8484	313		0.052083333333333336	0.061855670103092786	202	8282	16	22	186	8260	8484	0.17477527440728113
M1	string	0	network_modules	57	TRUE	1.47477678927025e-14	36	41	10	0.24390243902439024	0.2777777777777778	REAC:R-HSA-9607240	REAC	FLT3 Signaling	10916	917		0.15306122448979592	0.16161616161616163	36	10880	10	31	26	10849	10916	0.25767893693993077
M1	string	0	network_modules	57	TRUE	2.2966319426378356e-14	77	38	12	0.3157894736842105	0.15584415584415584	KEGG:05100	KEGG	Bacterial invasion of epithelial cells	8484	423		0.0625	0.07216494845360824	77	8407	12	26	65	8381	8484	0.21693719417901475
M1	string	0	network_modules	57	TRUE	2.3231357832474183e-14	137	38	14	0.3684210526315789	0.10218978102189781	KEGG:04910	KEGG	Insulin signaling pathway	8484	367		0.07291666666666667	0.08247422680412371	137	8347	14	24	123	8323	8484	0.18746526003266675
M1	string	0	network_modules	57	TRUE	8.806837238941434e-14	16	41	8	0.1951219512195122	0.5	REAC:R-HSA-210993	REAC	Tie2 Signaling	10916	2509		0.16326530612244897	0.1717171717171717	16	10900	8	33	8	10867	10916	0.3108128866030493
M1	string	0	network_modules	57	TRUE	1.2016679206585484e-13	118	38	13	0.34210526315789475	0.11016949152542373	KEGG:04722	KEGG	Neurotrophin signaling pathway	8484	352		0.08333333333333333	0.09278350515463918	118	8366	13	25	105	8341	8484	0.1879754939591826
M1	string	0	network_modules	57	TRUE	2.748120179306132e-13	310	38	17	0.4473684210526316	0.054838709677419356	KEGG:05206	KEGG	MicroRNAs in cancer	8484	458		0.09375	0.10309278350515463	310	8174	17	21	293	8153	8484	0.14686892100191573
M1	string	0	network_modules	57	TRUE	3.060555571423409e-13	68	38	11	0.2894736842105263	0.16176470588235295	KEGG:05211	KEGG	Renal cell carcinoma	8484	462		0.10416666666666667	0.1134020618556701	68	8416	11	27	57	8389	8484	0.21172596371203875
M1	string	0	network_modules	57	TRUE	9.579444500985013e-13	75	38	11	0.2894736842105263	0.14666666666666667	KEGG:05214	KEGG	Glioma	8484	465		0.11458333333333333	0.12371134020618557	75	8409	11	27	64	8382	8484	0.20109609940220993
M1	string	0	network_modules	57	TRUE	2.2182110479839103e-12	147	38	13	0.34210526315789475	0.08843537414965986	KEGG:04072	KEGG	Phospholipase D signaling pathway	8484	261		0.125	0.13402061855670103	147	8337	13	25	134	8312	8484	0.16695163014024486
M1	string	0	network_modules	57	TRUE	3.292494886280902e-12	23	41	8	0.1951219512195122	0.34782608695652173	REAC:R-HSA-9006335	REAC	Signaling by Erythropoietin	10916	2238		0.17346938775510204	0.18181818181818182	23	10893	8	33	15	10860	10916	0.2584604562230308
M1	string	0	network_modules	57	TRUE	9.634924187009236e-12	210	38	14	0.3684210526315789	0.06666666666666667	KEGG:04015	KEGG	Rap1 signaling pathway	8484	248		0.13541666666666666	0.14432989690721648	210	8274	14	24	196	8250	8484	0.14836769139567396
M1	string	0	network_modules	57	TRUE	1.621282553825799e-11	96	38	11	0.2894736842105263	0.11458333333333333	KEGG:04666	KEGG	Fc gamma R-mediated phagocytosis	8484	341		0.14583333333333334	0.15463917525773196	96	8388	11	27	85	8361	8484	0.17639816540945774
M1	string	0	network_modules	57	TRUE	1.7041287675491563e-11	45	41	9	0.21951219512195122	0.2	REAC:R-HSA-74751	REAC	Insulin receptor signalling cascade	10916	1211		0.1836734693877551	0.1919191919191919	45	10871	9	32	36	10839	10916	0.2064072571841556
M1	string	0	network_modules	57	TRUE	1.8232741032787653e-11	97	38	11	0.2894736842105263	0.1134020618556701	KEGG:05215	KEGG	Prostate cancer	8484	466		0.15625	0.16494845360824742	97	8387	11	27	86	8360	8484	0.17542263593382923
M1	string	0	network_modules	57	TRUE	2.364021783470911e-11	70	38	10	0.2631578947368421	0.14285714285714285	KEGG:04917	KEGG	Prolactin signaling pathway	8484	374		0.16666666666666666	0.17525773195876287	70	8414	10	28	60	8386	8484	0.1890159816934825
M1	string	0	network_modules	57	TRUE	3.1761033645074814e-11	72	38	10	0.2631578947368421	0.1388888888888889	KEGG:05218	KEGG	Melanoma	8484	469		0.17708333333333334	0.18556701030927836	72	8412	10	28	62	8384	8484	0.1862220481180117
M1	string	0	network_modules	57	TRUE	4.2453919163087065e-11	17	41	7	0.17073170731707318	0.4117647058823529	REAC:R-HSA-9669938	REAC	Signaling by KIT in disease	10916	2262		0.19387755102040816	0.21212121212121213	17	10899	7	34	10	10865	10916	0.26342535775350523
M1	string	0	network_modules	57	TRUE	4.2453919163087065e-11	17	41	7	0.17073170731707318	0.4117647058823529	REAC:R-HSA-9670439	REAC	Signaling by phosphorylated juxtamembrane, extracellular and kinase domain KIT mutants	10916	2326		0.19387755102040816	0.21212121212121213	17	10899	7	34	10	10865	10916	0.26342535775350523
M1	string	0	network_modules	57	TRUE	5.075225644140823e-11	356	38	16	0.42105263157894735	0.0449438202247191	KEGG:04151	KEGG	PI3K-Akt signaling pathway	8484	285		0.1875	0.1958762886597938	356	8128	16	22	340	8106	8484	0.12682179106747832
M1	string	0	network_modules	57	TRUE	6.854700046389824e-11	147	38	12	0.3157894736842105	0.08163265306122448	KEGG:05224	KEGG	Breast cancer	8484	475		0.19791666666666666	0.20618556701030927	147	8337	12	26	135	8311	8484	0.1534240612319699
M1	string	0	network_modules	57	TRUE	7.43812888117557e-11	148	38	12	0.3157894736842105	0.08108108108108109	KEGG:05226	KEGG	Gastric cancer	8484	477		0.20833333333333334	0.21649484536082475	148	8336	12	26	136	8310	8484	0.15285364044295424
M1	string	0	network_modules	57	TRUE	1.0293714551521196e-10	472	41	17	0.4146341463414634	0.036016949152542374	REAC:R-HSA-449147	REAC	Signaling by Interleukins	10916	2261		0.21428571428571427	0.2222222222222222	472	10444	17	24	455	10420	10916	0.11211721102274405
M1	string	0	network_modules	57	TRUE	1.452436451087511e-10	10	41	6	0.14634146341463414	0.6	REAC:R-HSA-9673770	REAC	Signaling by PDGFRA extracellular domain mutants	10916	2293		0.22448979591836735	0.24242424242424243	10	10906	6	35	4	10871	10916	0.2951537286625512
M1	string	0	network_modules	57	TRUE	1.452436451087511e-10	10	41	6	0.14634146341463414	0.6	REAC:R-HSA-9673767	REAC	Signaling by PDGFRA transmembrane, juxtamembrane and kinase domain mutants	10916	2294		0.22448979591836735	0.24242424242424243	10	10906	6	35	4	10871	10916	0.2951537286625512
M1	string	0	network_modules	57	TRUE	1.667326018316942e-10	205	38	13	0.34210526315789475	0.06341463414634146	KEGG:05205	KEGG	Proteoglycans in cancer	8484	457		0.21875	0.2268041237113402	205	8279	13	25	192	8254	8484	0.13888301329631633
M1	string	0	network_modules	57	TRUE	1.9879616222788492e-10	120	38	11	0.2894736842105263	0.09166666666666666	KEGG:04935	KEGG	Growth hormone synthesis, secretion and action	8484	392		0.22916666666666666	0.23711340206185566	120	8364	11	27	109	8337	8484	0.15639465011222495
M1	string	0	network_modules	57	TRUE	5.58289611422916e-10	95	38	10	0.2631578947368421	0.10526315789473684	KEGG:01522	KEGG	Endocrine resistance	8484	196		0.23958333333333334	0.24742268041237114	95	8389	10	28	85	8361	8484	0.16061356303083776
M1	string	0	network_modules	57	TRUE	7.458683053093608e-10	67	38	9	0.23684210526315788	0.13432835820895522	KEGG:05221	KEGG	Acute myeloid leukemia	8484	472		0.25	0.25773195876288657	67	8417	9	29	58	8388	8484	0.17349293877140823
M1	string	0	network_modules	57	TRUE	1.3322021316134377e-9	301	38	14	0.3684210526315789	0.046511627906976744	KEGG:04010	KEGG	MAPK signaling pathway	8484	243		0.2604166666666667	0.26804123711340205	301	8183	14	24	287	8159	8484	0.12072484005739877
M1	string	0	network_modules	57	TRUE	1.4618928271233303e-9	72	38	9	0.23684210526315788	0.125	KEGG:05223	KEGG	Non-small cell lung cancer	8484	474		0.2708333333333333	0.27835051546391754	72	8412	9	29	63	8383	8484	0.16697928459573252
M1	string	0	network_modules	57	TRUE	1.4647285378994934e-9	190	38	12	0.3157894736842105	0.06315789473684211	KEGG:04062	KEGG	Chemokine signaling pathway	8484	255		0.28125	0.28865979381443296	190	8294	12	26	178	8268	8484	0.13300252619492067
M1	string	0	network_modules	57	TRUE	1.4787691263153102e-9	253	41	13	0.3170731707317073	0.05138339920948617	REAC:R-HSA-1257604	REAC	PIP3 activates AKT signaling	10916	1679		0.24489795918367346	0.25252525252525254	253	10663	13	28	240	10635	10916	0.11993192452215234
M1	string	0	network_modules	57	TRUE	1.6352840596381635e-9	50	45	8	0.17777777777777778	0.16	GO:0046854	GO:BP	phosphatidylinositol phosphate biosynthetic process	16175	12405		0.041666666666666664	0.0547945205479452	50	16125	8	37	42	16088	16175	0.16621034850260183
M1	string	0	network_modules	57	TRUE	1.7333491250382016e-9	73	41	9	0.21951219512195122	0.1232876712328767	REAC:R-HSA-74752	REAC	Signaling by Insulin receptor	10916	2260		0.25510204081632654	0.26262626262626265	73	10843	9	32	64	10811	10916	0.16033444164535549
M1	string	0	network_modules	57	TRUE	2.5234986781834912e-9	76	41	9	0.21951219512195122	0.11842105263157894	REAC:R-HSA-6806834	REAC	Signaling by MET	10916	2270		0.2653061224489796	0.2727272727272727	76	10840	9	32	67	10808	10916	0.15695688379605288
M1	string	0	network_modules	57	TRUE	2.5371000098221976e-9	264	41	13	0.3170731707317073	0.04924242424242424	REAC:R-HSA-5673001	REAC	RAF/MAP kinase cascade	10916	1841		0.2755102040816326	0.2828282828282828	264	10652	13	28	251	10624	10916	0.11706459900445224
M1	string	0	network_modules	57	TRUE	3.216969421766252e-9	269	41	13	0.3170731707317073	0.048327137546468404	REAC:R-HSA-5684996	REAC	MAPK1/MAPK3 signaling	10916	1351		0.2857142857142857	0.29292929292929293	269	10647	13	28	256	10619	10916	0.11581735430951383
M1	string	0	network_modules	57	TRUE	4.357690286852304e-9	81	38	9	0.23684210526315788	0.1111111111111111	KEGG:04662	KEGG	B cell receptor signaling pathway	8484	339		0.2916666666666667	0.29896907216494845	81	8403	9	29	72	8374	8484	0.1567821368805337
M1	string	0	network_modules	57	TRUE	4.673230564638948e-9	52	41	8	0.1951219512195122	0.15384615384615385	REAC:R-HSA-1660499	REAC	Synthesis of PIPs at the plasma membrane	10916	2395		0.29591836734693877	0.30303030303030304	52	10864	8	33	44	10831	10916	0.16975246655014115
M1	string	0	network_modules	57	TRUE	5.6043907005148245e-9	136	45	10	0.2222222222222222	0.07352941176470588	GO:0046488	GO:BP	phosphatidylinositol metabolic process	16175	12192		0.05555555555555555	0.0684931506849315	136	16039	10	35	126	16004	16175	0.1236835035775797
M1	string	0	network_modules	57	TRUE	7.04010343376494e-9	166	38	11	0.2894736842105263	0.06626506024096386	KEGG:05225	KEGG	Hepatocellular carcinoma	8484	476		0.3020833333333333	0.30927835051546393	166	8318	11	27	155	8291	8484	0.130712847812214
M1	string	0	network_modules	57	TRUE	9.444955775191896e-9	293	41	13	0.3170731707317073	0.04436860068259386	REAC:R-HSA-9006925	REAC	Intracellular signaling by second messengers	10916	1266		0.30612244897959184	0.31313131313131315	293	10623	13	28	280	10595	10916	0.11026266174847643
M1	string	0	network_modules	57	TRUE	9.652023433567666e-9	58	38	8	0.21052631578947367	0.13793103448275862	KEGG:05213	KEGG	Endometrial cancer	8484	464		0.3125	0.31958762886597936	58	8426	8	30	50	8396	8484	0.16581038529819137
M1	string	0	network_modules	57	TRUE	1.1807111642482901e-8	227	38	12	0.3157894736842105	0.05286343612334802	KEGG:04810	KEGG	Regulation of actin cytoskeleton	8484	365		0.3229166666666667	0.32989690721649484	227	8257	12	26	215	8231	8484	0.12014082776438234
M1	string	0	network_modules	57	TRUE	1.22547462935937e-8	129	38	10	0.2631578947368421	0.07751937984496124	KEGG:04926	KEGG	Relaxin signaling pathway	8484	383		0.3333333333333333	0.3402061855670103	129	8355	10	28	119	8327	8484	0.13591514699521687
M1	string	0	network_modules	57	TRUE	1.255974842610032e-8	18	41	6	0.14634146341463414	0.3333333333333333	REAC:R-HSA-9671555	REAC	Signaling by PDGFR in disease	10916	2292		0.3163265306122449	0.32323232323232326	18	10898	6	35	12	10863	10916	0.218966265729218
M1	string	0	network_modules	57	TRUE	1.7659880563096428e-8	308	41	13	0.3170731707317073	0.04220779220779221	REAC:R-HSA-5683057	REAC	MAPK family signaling cascades	10916	1348		0.32653061224489793	0.3333333333333333	308	10608	13	28	295	10580	10916	0.10711065336552884
M1	string	0	network_modules	57	TRUE	2.054252051710868e-8	214	45	11	0.24444444444444444	0.0514018691588785	GO:0018108	GO:BP	peptidyl-tyrosine phosphorylation	16175	5327		0.06944444444444445	0.0821917808219178	214	15961	11	34	203	15927	16175	0.1068835419850586
M1	string	0	network_modules	57	TRUE	2.1608092304797994e-8	215	45	11	0.24444444444444444	0.05116279069767442	GO:0018212	GO:BP	peptidyl-tyrosine modification	16175	5371		0.08333333333333333	0.0958904109589041	215	15960	11	34	204	15926	16175	0.10660951284844608
M1	string	0	network_modules	57	TRUE	2.4934723127219967e-8	98	38	9	0.23684210526315788	0.09183673469387756	KEGG:05231	KEGG	Choline metabolism in cancer	8484	479		0.34375	0.35051546391752575	98	8386	9	29	89	8357	8484	0.14142305004465677
M1	string	0	network_modules	57	TRUE	3.1616495984253e-8	39	41	7	0.17073170731707318	0.1794871794871795	REAC:R-HSA-112399	REAC	IRS-mediated signalling	10916	1164		0.336734693877551	0.3434343434343434	39	10877	7	34	32	10843	10916	0.17202186084838036
M1	string	0	network_modules	57	TRUE	3.192173137650731e-8	67	38	8	0.21052631578947367	0.11940298507462686	KEGG:04664	KEGG	Fc epsilon RI signaling pathway	8484	340		0.3541666666666667	0.36082474226804123	67	8417	8	30	59	8387	8484	0.1535510055301587
M1	string	0	network_modules	57	TRUE	4.668874762053629e-8	116	45	9	0.2	0.07758620689655173	GO:0006661	GO:BP	phosphatidylinositol biosynthetic process	16175	2370		0.09722222222222222	0.1095890410958904	116	16059	9	36	107	16023	16175	0.1207024830331168
M1	string	0	network_modules	57	TRUE	6.551820651877578e-8	43	41	7	0.17073170731707318	0.16279069767441862	REAC:R-HSA-2428924	REAC	IGF1R signaling cascade	10916	1142		0.3469387755102041	0.36363636363636365	43	10873	7	34	36	10839	10916	0.16349651928537084
M1	string	0	network_modules	57	TRUE	6.551820651877578e-8	43	41	7	0.17073170731707318	0.16279069767441862	REAC:R-HSA-2428928	REAC	IRS-related events triggered by IGF1R	10916	1165		0.3469387755102041	0.36363636363636365	43	10873	7	34	36	10839	10916	0.16349651928537084
M1	string	0	network_modules	57	TRUE	7.770077685710227e-8	44	41	7	0.17073170731707318	0.1590909090909091	REAC:R-HSA-2404192	REAC	Signaling by Type 1 Insulin-like Growth Factor 1 Receptor (IGF1R)	10916	2312		0.3673469387755102	0.37373737373737376	44	10872	7	34	37	10838	10916	0.16154658318166565
M1	string	0	network_modules	57	TRUE	8.844810867755177e-8	112	41	9	0.21951219512195122	0.08035714285714286	REAC:R-HSA-187037	REAC	Signaling by NTRK1 (TRKA)	10916	2284		0.37755102040816324	0.3838383838383838	112	10804	9	32	103	10772	10916	0.1274997097729273
M1	string	0	network_modules	57	TRUE	8.96934190931703e-8	76	38	8	0.21052631578947367	0.10526315789473684	KEGG:05212	KEGG	Pancreatic cancer	8484	463		0.3645833333333333	0.3711340206185567	76	8408	8	30	68	8378	8484	0.143494731419823
M1	string	0	network_modules	57	TRUE	1.0793745810843756e-7	46	41	7	0.17073170731707318	0.15217391304347827	REAC:R-HSA-1227986	REAC	Signaling by ERBB2	10916	2232		0.3877551020408163	0.3939393939393939	46	10870	7	34	39	10836	10916	0.15783654403747635
M1	string	0	network_modules	57	TRUE	1.164802589958216e-7	162	38	10	0.2631578947368421	0.06172839506172839	KEGG:04630	KEGG	JAK-STAT signaling pathway	8484	332		0.375	0.38144329896907214	162	8322	10	28	152	8294	8484	0.11961832861160616
M1	string	0	network_modules	57	TRUE	1.6243919120985466e-7	530	45	14	0.3111111111111111	0.026415094339622643	GO:0043408	GO:BP	regulation of MAPK cascade	16175	10676		0.1111111111111111	0.1232876712328767	530	15645	14	31	516	15614	16175	0.08258292896234833
M1	string	0	network_modules	57	TRUE	1.9536609782987085e-7	27	41	6	0.14634146341463414	0.2222222222222222	REAC:R-HSA-9682385	REAC	FLT3 signaling in disease	10916	920		0.3979591836734694	0.40404040404040403	27	10889	6	35	21	10854	10916	0.17783991336885374
M1	string	0	network_modules	57	TRUE	2.073767773297717e-7	124	38	9	0.23684210526315788	0.07258064516129033	KEGG:04650	KEGG	Natural killer cell mediated cytotoxicity	8484	334		0.3854166666666667	0.3917525773195876	124	8360	9	29	115	8331	8484	0.12420769633813489
M1	string	0	network_modules	57	TRUE	2.2527055808973212e-7	83	41	8	0.1951219512195122	0.0963855421686747	REAC:R-HSA-1483255	REAC	PI Metabolism	10916	1665		0.40816326530612246	0.41414141414141414	83	10833	8	33	75	10800	10916	0.13254744815786879
M1	string	0	network_modules	57	TRUE	2.4453064182402354e-7	86	38	8	0.21052631578947367	0.09302325581395349	KEGG:05210	KEGG	Colorectal cancer	8484	461		0.3958333333333333	0.4020618556701031	86	8398	8	30	78	8368	8484	0.13418529053278525
M1	string	0	network_modules	57	TRUE	2.668308746332937e-7	13	41	5	0.12195121951219512	0.38461538461538464	REAC:R-HSA-5637810	REAC	Constitutive Signaling by EGFRvIII	10916	402		0.41836734693877553	0.4444444444444444	13	10903	5	36	8	10867	10916	0.21499103432231356
M1	string	0	network_modules	57	TRUE	2.668308746332937e-7	13	41	5	0.12195121951219512	0.38461538461538464	REAC:R-HSA-5637812	REAC	Signaling by EGFRvIII in Cancer	10916	2231		0.41836734693877553	0.4444444444444444	13	10903	5	36	8	10867	10916	0.21499103432231356
M1	string	0	network_modules	57	TRUE	2.668308746332937e-7	13	41	5	0.12195121951219512	0.38461538461538464	REAC:R-HSA-1433559	REAC	Regulation of KIT signaling	10916	1982		0.41836734693877553	0.4444444444444444	13	10903	5	36	8	10867	10916	0.21499103432231356
M1	string	0	network_modules	57	TRUE	2.9358678620853116e-7	274	45	11	0.24444444444444444	0.040145985401459854	GO:0032956	GO:BP	regulation of actin cytoskeleton organization	16175	7940		0.125	0.136986301369863	274	15901	11	34	263	15867	16175	0.09311856586477828
M1	string	0	network_modules	57	TRUE	3.6179564890853237e-7	131	41	9	0.21951219512195122	0.06870229007633588	REAC:R-HSA-166520	REAC	Signaling by NTRKs	10916	2287		0.4489795918367347	0.45454545454545453	131	10785	9	32	122	10753	10916	0.11701382896640766
M1	string	0	network_modules	57	TRUE	4.139290102972437e-7	14	41	5	0.12195121951219512	0.35714285714285715	REAC:R-HSA-9665348	REAC	Signaling by ERBB2 ECD mutants	10916	2233		0.45918367346938777	0.46464646464646464	14	10902	5	36	9	10866	10916	0.20702287916336845
M1	string	0	network_modules	57	TRUE	4.7122758542333123e-7	136	38	9	0.23684210526315788	0.0661764705882353	KEGG:04915	KEGG	Estrogen signaling pathway	8484	372		0.40625	0.41237113402061853	136	8348	9	29	127	8319	8484	0.11793121706433222
M1	string	0	network_modules	57	TRUE	5.899031289368146e-7	32	41	6	0.14634146341463414	0.1875	REAC:R-HSA-5655302	REAC	Signaling by FGFR1 in disease	10916	2243		0.46938775510204084	0.47474747474747475	32	10884	6	35	26	10849	10916	0.16287369998394255
M1	string	0	network_modules	57	TRUE	6.191863648169833e-7	15	41	5	0.12195121951219512	0.3333333333333333	REAC:R-HSA-9703648	REAC	Signaling by FLT3 ITD and TKD mutants	10916	2254		0.47959183673469385	0.48484848484848486	15	10901	5	36	10	10865	10916	0.1998604315705672
M1	string	0	network_modules	57	TRUE	6.432143804940056e-7	97	38	8	0.21052631578947367	0.08247422680412371	KEGG:04070	KEGG	Phosphatidylinositol signaling system	8484	259		0.4166666666666667	0.422680412371134	97	8387	8	30	89	8357	8484	0.1256127681345943
M1	string	0	network_modules	57	TRUE	7.419179403713e-7	595	45	14	0.3111111111111111	0.023529411764705882	GO:0000165	GO:BP	MAPK cascade	16175	55		0.1388888888888889	0.1506849315068493	595	15580	14	31	581	15549	16175	0.07697647916790486
M1	string	0	network_modules	57	TRUE	7.937178372446721e-7	389	45	12	0.26666666666666666	0.030848329048843187	GO:0007264	GO:BP	small GTPase-mediated signal transduction	16175	2792		0.1527777777777778	0.1643835616438356	389	15786	12	33	377	15753	16175	0.08364579488146875
M1	string	0	network_modules	57	TRUE	8.981213923581913e-7	37	38	6	0.15789473684210525	0.16216216216216217	KEGG:04960	KEGG	Aldosterone-regulated sodium reabsorption	8484	396		0.4270833333333333	0.4329896907216495	37	8447	6	32	31	8415	8484	0.15628532684760085
M1	string	0	network_modules	57	TRUE	1.0175499210212444e-6	308	45	11	0.24444444444444444	0.03571428571428571	GO:0032970	GO:BP	regulation of actin filament-based process	16175	7953		0.16666666666666666	0.1780821917808219	308	15867	11	34	297	15833	16175	0.08711034487787818
M1	string	0	network_modules	57	TRUE	1.2540553668262189e-6	36	41	6	0.14634146341463414	0.16666666666666666	REAC:R-HSA-109704	REAC	PI3K Cascade	10916	1671		0.4897959183673469	0.494949494949495	36	10880	6	35	30	10845	10916	0.15319458362332722
M1	string	0	network_modules	57	TRUE	1.268892644763624e-6	17	41	5	0.12195121951219512	0.29411764705882354	REAC:R-HSA-1236382	REAC	Constitutive Signaling by Ligand-Responsive EGFR Cancer Variants	10916	403		0.5	0.5151515151515151	17	10899	5	36	12	10863	10916	0.18746811796648116
M1	string	0	network_modules	57	TRUE	1.268892644763624e-6	17	41	5	0.12195121951219512	0.29411764705882354	REAC:R-HSA-5637815	REAC	Signaling by Ligand-Responsive EGFR Variants in Cancer	10916	2267		0.5	0.5151515151515151	17	10899	5	36	12	10863	10916	0.18746811796648116
M1	string	0	network_modules	57	TRUE	1.9278221146140366e-6	72	38	7	0.18421052631578946	0.09722222222222222	KEGG:01524	KEGG	Platinum drug resistance	8484	198		0.4375	0.44329896907216493	72	8412	7	31	65	8381	8484	0.12849375755117412
M1	string	0	network_modules	57	TRUE	2.344904071725569e-6	221	38	10	0.2631578947368421	0.04524886877828054	KEGG:05208	KEGG	Chemical carcinogenesis - reactive oxygen species	8484	460		0.4479166666666667	0.4536082474226804	221	8263	10	28	211	8235	8484	0.09985037291293919
M1	string	0	network_modules	57	TRUE	2.4012949168850414e-6	180	45	9	0.2	0.05	GO:0046777	GO:BP	protein autophosphorylation	16175	12365		0.18055555555555555	0.1917808219178082	180	15995	9	36	171	15959	16175	0.09509811596642023
M1	string	0	network_modules	57	TRUE	2.5551044218539394e-6	223	38	10	0.2631578947368421	0.04484304932735426	KEGG:05163	KEGG	Human cytomegalovirus infection	8484	444		0.4583333333333333	0.4639175257731959	223	8261	10	28	213	8233	8484	0.09931479801721496
M1	string	0	network_modules	57	TRUE	3.514497146439259e-6	46	38	6	0.15789473684210525	0.13043478260869565	KEGG:04930	KEGG	Type II diabetes mellitus	8484	387		0.46875	0.4742268041237113	46	8438	6	32	40	8406	8484	0.1392709449675364
M1	string	0	network_modules	57	TRUE	3.6942541762142936e-6	189	45	9	0.2	0.047619047619047616	GO:0046474	GO:BP	glycerophospholipid biosynthetic process	16175	12181		0.19444444444444445	0.2054794520547945	189	15986	9	36	180	15950	16175	0.09255889597446564
M1	string	0	network_modules	57	TRUE	4.015761574755945e-6	47	38	6	0.15789473684210525	0.1276595744680851	KEGG:04973	KEGG	Carbohydrate digestion and absorption	8484	404		0.4791666666666667	0.4845360824742268	47	8437	6	32	41	8405	8484	0.13768302030697602
M1	string	0	network_modules	57	TRUE	4.127002263423045e-6	21	41	5	0.12195121951219512	0.23809523809523808	REAC:R-HSA-9664565	REAC	Signaling by ERBB2 KD Mutants	10916	2234		0.5204081632653061	0.5252525252525253	21	10895	5	36	16	10859	10916	0.1681891956810287
M1	string	0	network_modules	57	TRUE	4.150312128378168e-6	450	45	12	0.26666666666666666	0.02666666666666667	GO:0030335	GO:BP	positive regulation of cell migration	16175	6781		0.20833333333333334	0.2191780821917808	450	15725	12	33	438	15692	16175	0.07670959158443988
M1	string	0	network_modules	57	TRUE	4.673361713135229e-6	269	45	10	0.2222222222222222	0.03717472118959108	GO:0006650	GO:BP	glycerophospholipid metabolic process	16175	2360		0.2222222222222222	0.2328767123287671	269	15906	10	35	259	15871	16175	0.08491455557735099
M1	string	0	network_modules	57	TRUE	4.6937998395440796e-6	686	45	14	0.3111111111111111	0.02040816326530612	GO:0008284	GO:BP	positive regulation of cell population proliferation	16175	3151		0.2361111111111111	0.2465753424657534	686	15489	14	31	672	15458	16175	0.07042506450963644
M1	string	0	network_modules	57	TRUE	5.326141927153535e-6	22	41	5	0.12195121951219512	0.22727272727272727	REAC:R-HSA-1227990	REAC	Signaling by ERBB2 in Cancer	10916	2236		0.5306122448979592	0.5353535353535354	22	10894	5	36	17	10858	10916	0.16420438060402512
M1	string	0	network_modules	57	TRUE	5.743821224784556e-6	181	38	9	0.23684210526315788	0.049723756906077346	KEGG:04360	KEGG	Axon guidance	8484	305		0.4895833333333333	0.4948453608247423	181	8303	9	29	172	8274	8484	0.10003988068010675
M1	string	0	network_modules	57	TRUE	6.7723122430346614e-06	470	45	12	0.26666666666666666	0.02553191489361702	GO:2000147	GO:BP	positive regulation of cell motility	16175	25495		0.25	0.2602739726027397	470	15705	12	33	458	15672	16175	0.07471868610844568
M1	string	0	network_modules	57	TRUE	6.786913841934774e-6	23	41	5	0.12195121951219512	0.21739130434782608	REAC:R-HSA-1643713	REAC	Signaling by EGFR in Cancer	10916	2230		0.5408163265306123	0.5454545454545454	23	10893	5	36	18	10857	10916	0.16047975331868616
M1	string	0	network_modules	57	TRUE	6.911548549819871e-6	131	38	8	0.21052631578947367	0.061068702290076333	KEGG:04068	KEGG	FoxO signaling pathway	8484	258		0.5	0.5051546391752577	131	8353	8	30	123	8323	8484	0.10612922453758811
M1	string	0	network_modules	57	TRUE	7.2302004582861375e-6	204	45	9	0.2	0.04411764705882353	GO:0051896	GO:BP	regulation of phosphatidylinositol 3-kinase/protein kinase B signal transduction	16175	13980		0.2638888888888889	0.273972602739726	204	15971	9	36	195	15935	16175	0.08869392432902296
M1	string	0	network_modules	57	TRUE	7.334121167132482e-6	132	38	8	0.21052631578947367	0.06060606060606061	KEGG:04380	KEGG	Osteoclast differentiation	8484	309		0.5104166666666666	0.5154639175257731	132	8352	8	30	124	8322	8484	0.10566890203314973
M1	string	0	network_modules	57	TRUE	7.7696014063569e-6	9	41	4	0.0975609756097561	0.4444444444444444	REAC:R-HSA-198203	REAC	PI3K/AKT activation	10916	1675		0.5510204081632653	0.5555555555555556	9	10907	4	37	5	10870	10916	0.20694611200607474
M1	string	0	network_modules	57	TRUE	8.261749503638098e-6	376	45	11	0.24444444444444444	0.02925531914893617	GO:0043410	GO:BP	positive regulation of MAPK cascade	16175	10678		0.2777777777777778	0.2876712328767123	376	15799	11	34	365	15765	16175	0.07753667988955912
M1	string	0	network_modules	57	TRUE	8.379587244299857e-6	479	45	12	0.26666666666666666	0.025052192066805846	GO:0040017	GO:BP	positive regulation of locomotion	16175	9905		0.2916666666666667	0.3013698630136986	479	15696	12	33	467	15663	16175	0.07386125566783415
M1	string	0	network_modules	57	TRUE	8.710085682687755e-6	287	45	10	0.2222222222222222	0.03484320557491289	GO:0002768	GO:BP	immune response-regulating cell surface receptor signaling pathway	16175	1279		0.3055555555555556	0.3150684931506849	287	15888	10	35	277	15853	16175	0.08180993870515865
M1	string	0	network_modules	57	TRUE	9.254734372617907e-6	136	38	8	0.21052631578947367	0.058823529411764705	KEGG:05135	KEGG	Yersinia infection	8484	432		0.5208333333333334	0.5257731958762887	136	8348	8	30	128	8318	8484	0.10387648248021981
M1	string	0	network_modules	57	TRUE	1.004059622299587e-5	191	41	9	0.21951219512195122	0.04712041884816754	REAC:R-HSA-202733	REAC	Cell surface interactions at the vascular wall	10916	327		0.5612244897959183	0.5656565656565656	191	10725	9	32	182	10693	10916	0.0946038878582928
M1	string	0	network_modules	57	TRUE	1.065733296830417e-5	25	41	5	0.12195121951219512	0.2	REAC:R-HSA-2424491	REAC	DAP12 signaling	10916	433		0.5714285714285714	0.5757575757575758	25	10891	5	36	20	10855	10916	0.15370556055678397
M1	string	0	network_modules	57	TRUE	1.2914215714877659e-5	10	41	4	0.0975609756097561	0.4	REAC:R-HSA-8875555	REAC	MET activates RAP1 and RAC1	10916	1364		0.5816326530612245	0.5858585858585859	10	10906	4	37	6	10869	10916	0.19614939279676105
M1	string	0	network_modules	57	TRUE	1.2922920455848403e-5	218	45	9	0.2	0.04128440366972477	GO:0008654	GO:BP	phospholipid biosynthetic process	16175	3225		0.3194444444444444	0.3287671232876712	218	15957	9	36	209	15921	16175	0.08543985724312998
M1	string	0	network_modules	57	TRUE	1.3055473875418699e-5	150	45	8	0.17777777777777778	0.05333333333333334	GO:0051897	GO:BP	positive regulation of phosphatidylinositol 3-kinase/protein kinase B signal transduction	16175	13981		0.3333333333333333	0.3424657534246575	150	16025	8	37	142	15988	16175	0.09285375330337776
M1	string	0	network_modules	57	TRUE	1.3158514489143949e-5	26	41	5	0.12195121951219512	0.19230769230769232	REAC:R-HSA-1839124	REAC	FGFR1 mutant receptor activation	10916	901		0.5918367346938775	0.5959595959595959	26	10890	5	36	21	10854	10916	0.15061223015116368
M1	string	0	network_modules	57	TRUE	1.4163374217044542e-5	502	45	12	0.26666666666666666	0.02390438247011952	GO:0071363	GO:BP	cellular response to growth factor stimulus	16175	16615		0.3472222222222222	0.3561643835616438	502	15673	12	33	490	15640	16175	0.07176919599021236
M1	string	0	network_modules	57	TRUE	1.4606540766359641e-5	58	38	6	0.15789473684210525	0.10344827586206896	KEGG:04923	KEGG	Regulation of lipolysis in adipocytes	8484	380		0.53125	0.5360824742268041	58	8426	6	32	52	8394	8484	0.12296652500490222
M1	string	0	network_modules	57	TRUE	1.4614854786921517e-05	140	41	8	0.1951219512195122	0.05714285714285714	REAC:R-HSA-2029480	REAC	Fcgamma receptor (FCGR) dependent phagocytosis	10916	939		0.6020408163265306	0.6060606060606061	140	10776	8	33	132	10743	10916	0.09947797059697064
M1	string	0	network_modules	57	TRUE	1.6207412445976243e-5	59	38	6	0.15789473684210525	0.1016949152542373	KEGG:04370	KEGG	VEGF signaling pathway	8484	307		0.5416666666666666	0.5463917525773195	59	8425	6	32	53	8393	8484	0.12183207946776158
M1	string	0	network_modules	57	TRUE	1.769338890707531e-5	226	45	9	0.2	0.03982300884955752	GO:0045017	GO:BP	glycerolipid biosynthetic process	16175	11231		0.3611111111111111	0.3698630136986301	226	15949	9	36	217	15913	16175	0.08371250007567829
M1	string	0	network_modules	57	TRUE	1.810018457563473e-5	94	41	7	0.17073170731707318	0.07446808510638298	REAC:R-HSA-4420097	REAC	VEGFA-VEGFR2 Pathway	10916	2634		0.6122448979591837	0.6161616161616161	94	10822	7	34	87	10788	10916	0.10773605045071083
M1	string	0	network_modules	57	TRUE	1.8323681952811933e-5	406	45	11	0.24444444444444444	0.027093596059113302	GO:0042110	GO:BP	T cell activation	16175	9970		0.375	0.3835616438356164	406	15769	11	34	395	15735	16175	0.07406175348086866
M1	string	0	network_modules	57	TRUE	1.9143578711329583e-5	100	38	7	0.18421052631578946	0.07	KEGG:04933	KEGG	AGE-RAGE signaling pathway in diabetic complications	8484	390		0.5520833333333334	0.5567010309278351	100	8384	7	31	93	8353	8484	0.10716132558035706
M1	string	0	network_modules	57	TRUE	1.9783251352295013e-5	56	41	6	0.14634146341463414	0.10714285714285714	REAC:R-HSA-1226099	REAC	Signaling by FGFR in disease	10916	2240		0.6224489795918368	0.6262626262626263	56	10860	6	35	50	10825	10916	0.12136727218609895
M1	string	0	network_modules	57	TRUE	1.9843511026755823e-5	61	38	6	0.15789473684210525	0.09836065573770492	KEGG:04213	KEGG	Longevity regulating pathway - multiple species	8484	290		0.5625	0.5670103092783505	61	8423	6	32	55	8391	8484	0.11964525816336938
M1	string	0	network_modules	57	TRUE	2.0503026939474577e-5	101	38	7	0.18421052631578946	0.06930693069306931	KEGG:05142	KEGG	Chagas disease	8484	434		0.5729166666666666	0.5773195876288659	101	8383	7	31	94	8352	8484	0.10656296762097352
M1	string	0	network_modules	57	TRUE	2.052962497985597e-5	519	45	12	0.26666666666666666	0.023121387283236993	GO:0070848	GO:BP	response to growth factor	16175	16340		0.3888888888888889	0.3972602739726027	519	15656	12	33	507	15623	16175	0.07030730792613184
M1	string	0	network_modules	57	TRUE	2.5458094464986166e-5	155	38	8	0.21052631578947367	0.05161290322580645	KEGG:04150	KEGG	mTOR signaling pathway	8484	284		0.5833333333333334	0.5876288659793815	155	8329	8	30	147	8299	8484	0.09629106025380799
M1	string	0	network_modules	57	TRUE	2.6534432652754142e-5	64	38	6	0.15789473684210525	0.09375	KEGG:04929	KEGG	GnRH secretion	8484	386		0.59375	0.5979381443298969	64	8420	6	32	58	8388	8484	0.11655410393959752
M1	string	0	network_modules	57	TRUE	3.02757680020683e-5	12	41	4	0.0975609756097561	0.3333333333333333	REAC:R-HSA-9027284	REAC	Erythropoietin activates RAS	10916	859		0.6326530612244898	0.6464646464646465	12	10904	4	37	8	10867	10916	0.17873601165110325
M1	string	0	network_modules	57	TRUE	3.02757680020683e-5	12	41	4	0.0975609756097561	0.3333333333333333	REAC:R-HSA-9027276	REAC	Erythropoietin activates Phosphoinositide-3-kinase (PI3K)	10916	857		0.6326530612244898	0.6464646464646465	12	10904	4	37	8	10867	10916	0.17873601165110325
M1	string	0	network_modules	57	TRUE	3.1126970633603785e-5	328	45	10	0.2222222222222222	0.03048780487804878	GO:0006644	GO:BP	phospholipid metabolic process	16175	2355		0.4027777777777778	0.410958904109589	328	15847	10	35	318	15812	16175	0.07567525594857864
M1	string	0	network_modules	57	TRUE	3.352400480480903e-5	31	41	5	0.12195121951219512	0.16129032258064516	REAC:R-HSA-187687	REAC	Signalling to ERKs	10916	2331		0.6530612244897959	0.6666666666666666	31	10885	5	36	26	10849	10916	0.13743549503429361
M1	string	0	network_modules	57	TRUE	3.352400480480903e-5	31	41	5	0.12195121951219512	0.16129032258064516	REAC:R-HSA-389356	REAC	Co-stimulation by CD28	10916	378		0.6530612244897959	0.6666666666666666	31	10885	5	36	26	10849	10916	0.13743549503429361
M1	string	0	network_modules	57	TRUE	3.461598316989557e-5	109	38	7	0.18421052631578946	0.06422018348623854	KEGG:04066	KEGG	HIF-1 signaling pathway	8484	257		0.6041666666666666	0.6082474226804123	109	8375	7	31	102	8344	8484	0.10206523630670626
M1	string	0	network_modules	57	TRUE	3.5737166793802816e-5	162	38	8	0.21052631578947367	0.04938271604938271	KEGG:05161	KEGG	Hepatitis B	8484	442		0.6145833333333334	0.6185567010309279	162	8322	8	30	154	8292	8484	0.09382294708700481
M1	string	0	network_modules	57	TRUE	3.6549488394962275e-5	104	41	7	0.17073170731707318	0.0673076923076923	REAC:R-HSA-194138	REAC	Signaling by VEGF	10916	2313		0.673469387755102	0.6767676767676768	104	10812	7	34	97	10778	10916	0.10189386763303446
M1	string	0	network_modules	57	TRUE	4.022722263742258e-5	337	45	10	0.2222222222222222	0.02967359050445104	GO:0046486	GO:BP	glycerolipid metabolic process	16175	12190		0.4166666666666667	0.4246575342465753	337	15838	10	35	327	15803	16175	0.07447336390204376
M1	string	0	network_modules	57	TRUE	4.1192472726605834e-5	112	45	7	0.15555555555555556	0.0625	GO:0038127	GO:BP	ERBB signaling pathway	16175	9716		0.4305555555555556	0.4383561643835616	112	16063	7	38	105	16025	16175	0.09467193806541907
M1	string	0	network_modules	57	TRUE	4.195873439255899e-5	440	45	11	0.24444444444444444	0.025	GO:0051493	GO:BP	regulation of cytoskeleton organization	16175	13748		0.4444444444444444	0.4520547945205479	440	15735	11	34	429	15701	16175	0.07053706517296426
M1	string	0	network_modules	57	TRUE	4.544965735002362e-5	12	45	4	0.08888888888888889	0.3333333333333333	GO:0036092	GO:BP	phosphatidylinositol-3-phosphate biosynthetic process	16175	9435		0.4583333333333333	0.4657534246575342	12	16163	4	41	8	16122	16175	0.17099732053242012
M1	string	0	network_modules	57	TRUE	4.703779626315282e-5	114	38	7	0.18421052631578946	0.06140350877192982	KEGG:04670	KEGG	Leukocyte transendothelial migration	8484	343		0.625	0.6288659793814433	114	8370	7	31	107	8339	8484	0.09948833523472368
M1	string	0	network_modules	57	TRUE	5.6842443800207306e-5	569	45	12	0.26666666666666666	0.0210896309314587	GO:0046649	GO:BP	lymphocyte activation	16175	12286		0.4722222222222222	0.4794520547945205	569	15606	12	33	557	15573	16175	0.06636844508338892
M1	string	0	network_modules	57	TRUE	5.947812780656705e-5	699	45	13	0.28888888888888886	0.01859799713876967	GO:0045321	GO:BP	leukocyte activation	16175	11356		0.4861111111111111	0.4931506849315068	699	15476	13	32	686	15444	16175	0.06381528329869982
M1	string	0	network_modules	57	TRUE	6.30136691710877e-5	119	38	7	0.18421052631578946	0.058823529411764705	KEGG:04660	KEGG	T cell receptor signaling pathway	8484	338		0.6354166666666666	0.6391752577319587	119	8365	7	31	112	8334	8484	0.09706876607307971
M1	string	0	network_modules	57	TRUE	6.334945584873482e-5	35	41	5	0.12195121951219512	0.14285714285714285	REAC:R-HSA-114604	REAC	GPVI-mediated activation cascade	10916	1021		0.6836734693877551	0.696969696969697	35	10881	5	36	30	10845	10916	0.1289696207929954
M1	string	0	network_modules	57	TRUE	6.334945584873482e-5	35	41	5	0.12195121951219512	0.14285714285714285	REAC:R-HSA-2172127	REAC	DAP12 interactions	10916	432		0.6836734693877551	0.696969696969697	35	10881	5	36	30	10845	10916	0.1289696207929954
M1	string	0	network_modules	57	TRUE	6.670180393632132e-5	120	38	7	0.18421052631578946	0.058333333333333334	KEGG:04071	KEGG	Sphingolipid signaling pathway	8484	260		0.6458333333333334	0.6494845360824743	120	8364	7	31	113	8333	8484	0.09660229232969526
M1	string	0	network_modules	57	TRUE	7.047075887267586e-5	69	41	6	0.14634146341463414	0.08695652173913043	REAC:R-HSA-2730905	REAC	Role of LAT2/NTAL/LAB on calcium mobilization	10916	2108		0.7040816326530612	0.7070707070707071	69	10847	6	35	63	10812	10916	0.10848082465936
M1	string	0	network_modules	57	TRUE	8.281038379197945e-5	15	41	4	0.0975609756097561	0.26666666666666666	REAC:R-HSA-9706369	REAC	Negative regulation of FLT3	10916	1572		0.7142857142857143	0.7171717171717171	15	10901	4	37	11	10864	10916	0.1594328123539581
M1	string	0	network_modules	57	TRUE	1.1011445891807491e-4	16	41	4	0.0975609756097561	0.25	REAC:R-HSA-1839117	REAC	Signaling by cytosolic FGFR1 fusion mutants	10916	2318		0.7244897959183674	0.7272727272727273	16	10900	4	37	12	10863	10916	0.154230208452833
M1	string	0	network_modules	57	TRUE	1.2369786911922324e-4	744	45	13	0.28888888888888886	0.01747311827956989	GO:0072359	GO:BP	circulatory system development	16175	17370		0.5	0.5068493150684932	744	15431	13	32	731	15399	16175	0.061243927602600584
M1	string	0	network_modules	57	TRUE	1.2664972368354676e-4	40	41	5	0.12195121951219512	0.125	REAC:R-HSA-8875878	REAC	MET promotes cell motility	10916	1368		0.7346938775510204	0.7373737373737373	40	10876	5	36	35	10840	10916	0.12020230081810526
M1	string	0	network_modules	57	TRUE	1.4360540238678662e-4	17	41	4	0.0975609756097561	0.23529411764705882	REAC:R-HSA-9703465	REAC	Signaling by FLT3 fusion proteins	10916	2255		0.7448979591836735	0.7474747474747475	17	10899	4	37	13	10862	10916	0.14948949807296916
M1	string	0	network_modules	57	TRUE	1.448417360916878e-4	40	45	5	0.1111111111111111	0.125	GO:0038084	GO:BP	vascular endothelial growth factor signaling pathway	16175	9685		0.5138888888888888	0.5205479452054794	40	16135	5	40	35	16095	16175	0.11553173075822115
M1	string	0	network_modules	57	TRUE	1.5085775471743187e-4	622	45	12	0.26666666666666666	0.01929260450160772	GO:0030155	GO:BP	regulation of cell adhesion	16175	6688		0.5277777777777778	0.5342465753424658	622	15553	12	33	610	15520	16175	0.06268592796819109
M1	string	0	network_modules	57	TRUE	1.6744188485551845e-4	504	45	11	0.24444444444444444	0.021825396825396824	GO:0001944	GO:BP	vasculature development	16175	555		0.5416666666666666	0.547945205479452	504	15671	11	34	493	15637	16175	0.06483814145485546
M1	string	0	network_modules	57	TRUE	1.7857285740141855e-4	5	41	3	0.07317073170731707	0.6	REAC:R-HSA-8851907	REAC	MET activates PI3K/AKT signaling	10916	1361		0.7551020408163265	0.7575757575757576	5	10911	3	38	2	10873	10916	0.20865737764291237
M1	string	0	network_modules	57	TRUE	1.7947372033181157e-4	632	45	12	0.26666666666666666	0.0189873417721519	GO:0030036	GO:BP	actin cytoskeleton organization	16175	6660		0.5555555555555556	0.5616438356164384	632	15543	12	33	620	15510	16175	0.062039494969554375
M1	string	0	network_modules	57	TRUE	1.8962125933411585e-4	89	38	6	0.15789473684210525	0.06741573033707865	KEGG:04211	KEGG	Longevity regulating pathway	8484	288		0.65625	0.6701030927835051	89	8395	6	32	83	8363	8484	0.0970447441887833
M1	string	0	network_modules	57	TRUE	1.8962125933411585e-4	89	38	6	0.15789473684210525	0.06741573033707865	KEGG:05235	KEGG	PD-L1 expression and PD-1 checkpoint pathway in cancer	8484	480		0.65625	0.6701030927835051	89	8395	6	32	83	8363	8484	0.0970447441887833
M1	string	0	network_modules	57	TRUE	2.0243306206349257e-4	84	45	6	0.13333333333333333	0.07142857142857142	GO:0008286	GO:BP	insulin receptor signaling pathway	16175	3153		0.5694444444444444	0.5753424657534246	84	16091	6	39	78	16052	16175	0.09416453708226108
M1	string	0	network_modules	57	TRUE	2.1759455250116325e-4	143	38	7	0.18421052631578946	0.04895104895104895	KEGG:04550	KEGG	Signaling pathways regulating pluripotency of stem cells	8484	319		0.6770833333333334	0.6804123711340206	143	8341	7	31	136	8310	8484	0.08720255934612581
M1	string	0	network_modules	57	TRUE	2.177247763899927e-4	781	45	13	0.28888888888888886	0.016645326504481434	GO:0030334	GO:BP	regulation of cell migration	16175	6780		0.5833333333333334	0.589041095890411	781	15394	13	32	768	15362	16175	0.05928377482452509
M1	string	0	network_modules	57	TRUE	2.304243241874438e-4	92	38	6	0.15789473684210525	0.06521739130434782	KEGG:05222	KEGG	Small cell lung cancer	8484	473		0.6875	0.6907216494845361	92	8392	6	32	86	8360	8484	0.09523742531703237
M1	string	0	network_modules	57	TRUE	2.3864167125028338e-4	522	45	11	0.24444444444444444	0.0210727969348659	GO:0042327	GO:BP	positive regulation of phosphorylation	16175	10095		0.5972222222222222	0.6027397260273972	522	15653	11	34	511	15619	16175	0.06341445256947356
M1	string	0	network_modules	57	TRUE	2.546546465231669e-4	210	38	8	0.21052631578947367	0.0380952380952381	KEGG:05170	KEGG	Human immunodeficiency virus 1 infection	8484	451		0.6979166666666666	0.7010309278350515	210	8274	8	30	202	8244	8484	0.08020179224042118
M1	string	0	network_modules	57	TRUE	3.223951638858837e-4	48	41	5	0.12195121951219512	0.10416666666666667	REAC:R-HSA-177929	REAC	Signaling by EGFR	10916	2229		0.7653061224489796	0.7676767676767676	48	10868	5	36	43	10832	10916	0.10908946621340657
M1	string	0	network_modules	57	TRUE	3.3178839626616427e-4	210	41	8	0.1951219512195122	0.0380952380952381	REAC:R-HSA-1483257	REAC	Phospholipid metabolism	10916	1748		0.7755102040816326	0.7777777777777778	210	10706	8	33	202	10673	10916	0.07862202462643253
M1	string	0	network_modules	57	TRUE	3.328119325931358e-4	47	45	5	0.1111111111111111	0.10638297872340426	GO:0038093	GO:BP	Fc receptor signaling pathway	16175	9693		0.6111111111111112	0.6164383561643836	47	16128	5	40	42	16088	16175	0.10618008790054517
M1	string	0	network_modules	57	TRUE	3.3357954691533575e-4	98	38	6	0.15789473684210525	0.061224489795918366	KEGG:04750	KEGG	Inflammatory mediator regulation of TRP channels	8484	364		0.7083333333333334	0.711340206185567	98	8386	6	32	92	8354	8484	0.09186501130502955
M1	string	0	network_modules	57	TRUE	3.722886970616379e-4	155	38	7	0.18421052631578946	0.04516129032258064	KEGG:04218	KEGG	Cellular senescence	8484	295		0.71875	0.7216494845360825	155	8329	7	31	148	8298	8484	0.08311088931396567
M1	string	0	network_modules	57	TRUE	3.977284452776691e-4	101	38	6	0.15789473684210525	0.0594059405940594	KEGG:05146	KEGG	Amoebiasis	8484	438		0.7291666666666666	0.7319587628865979	101	8383	6	32	95	8351	8484	0.09028789620249757
M1	string	0	network_modules	57	TRUE	4.212150362097808e-4	102	38	6	0.15789473684210525	0.058823529411764705	KEGG:04914	KEGG	Progesterone-mediated oocyte maturation	8484	371		0.7395833333333334	0.7422680412371134	102	8382	6	32	96	8350	8484	0.08977703507533988
M1	string	0	network_modules	57	TRUE	4.2276514571075154e-4	158	38	7	0.18421052631578946	0.04430379746835443	KEGG:05160	KEGG	Hepatitis C	8484	441		0.75	0.7525773195876289	158	8326	7	31	151	8295	8484	0.08215746457693696
M1	string	0	network_modules	57	TRUE	4.354247700251737e-4	22	41	4	0.0975609756097561	0.18181818181818182	REAC:R-HSA-389357	REAC	CD28 dependent PI3K/Akt signaling	10916	267		0.7857142857142857	0.7878787878787878	22	10894	4	37	18	10857	10916	0.13081164952847205
M1	string	0	network_modules	57	TRUE	4.386466115926818e-4	51	41	5	0.12195121951219512	0.09803921568627451	REAC:R-HSA-8848021	REAC	Signaling by PTK6	10916	2295		0.7959183673469388	0.8080808080808081	51	10865	5	36	46	10829	10916	0.10559948113450923
M1	string	0	network_modules	57	TRUE	4.386466115926818e-4	51	41	5	0.12195121951219512	0.09803921568627451	REAC:R-HSA-9006927	REAC	Signaling by Non-Receptor Tyrosine Kinases	10916	2288		0.7959183673469388	0.8080808080808081	51	10865	5	36	46	10829	10916	0.10559948113450923
M1	string	0	network_modules	57	TRUE	4.567595049420427e-4	437	45	10	0.2222222222222222	0.02288329519450801	GO:0002764	GO:BP	immune response-regulating signaling pathway	16175	1275		0.625	0.6301369863013698	437	15738	10	35	427	15703	16175	0.06359299835260394
M1	string	0	network_modules	57	TRUE	4.7157746451763073e-4	104	38	6	0.15789473684210525	0.057692307692307696	KEGG:04625	KEGG	C-type lectin receptor signaling pathway	8484	330		0.7604166666666666	0.7628865979381443	104	8380	6	32	98	8348	8484	0.08877651260326176
M1	string	0	network_modules	57	TRUE	4.7904795673029907e-4	97	45	6	0.13333333333333333	0.061855670103092786	GO:0007173	GO:BP	epidermal growth factor receptor signaling pathway	16175	2736		0.6388888888888888	0.6438356164383562	97	16078	6	39	91	16039	16175	0.08711323351126764
M1	string	0	network_modules	57	TRUE	5.186583256826203e-4	564	45	11	0.24444444444444444	0.01950354609929078	GO:0045937	GO:BP	positive regulation of phosphate metabolic process	16175	11731		0.6527777777777778	0.6712328767123288	564	15611	11	34	553	15577	16175	0.06034198920411021
M1	string	0	network_modules	57	TRUE	5.186583256826203e-4	564	45	11	0.24444444444444444	0.01950354609929078	GO:0010562	GO:BP	positive regulation of phosphorus metabolic process	16175	4215		0.6527777777777778	0.6712328767123288	564	15611	11	34	553	15577	16175	0.06034198920411021
M1	string	0	network_modules	57	TRUE	5.256643186953297e-4	23	41	4	0.0975609756097561	0.17391304347826086	REAC:R-HSA-373753	REAC	Nephrin family interactions	10916	1582		0.8163265306122449	0.8181818181818182	23	10893	4	37	19	10856	10916	0.12781951901723793
M1	string	0	network_modules	57	TRUE	5.267314724782147e-4	106	38	6	0.15789473684210525	0.05660377358490566	KEGG:04620	KEGG	Toll-like receptor signaling pathway	8484	325		0.7708333333333334	0.7731958762886598	106	8378	6	32	100	8346	8484	0.08780315025904524
M1	string	0	network_modules	57	TRUE	5.87017900619425e-4	108	38	6	0.15789473684210525	0.05555555555555555	KEGG:04931	KEGG	Insulin resistance	8484	388		0.78125	0.7835051546391752	108	8376	6	32	102	8344	8484	0.08685569587519436
M1	string	0	network_modules	57	TRUE	6.117371192495519e-4	708	45	12	0.26666666666666666	0.01694915254237288	GO:0030029	GO:BP	actin filament-based process	16175	6653		0.6805555555555556	0.684931506849315	708	15467	12	33	696	15434	16175	0.05754595814004814
M1	string	0	network_modules	57	TRUE	6.845985820896805e-4	103	45	6	0.13333333333333333	0.05825242718446602	GO:0007265	GO:BP	Ras protein signal transduction	16175	2793		0.6944444444444444	0.6986301369863014	103	16072	6	39	97	16033	16175	0.08430735282199674
M1	string	0	network_modules	57	TRUE	7.468834936025025e-4	25	41	4	0.0975609756097561	0.16	REAC:R-HSA-201556	REAC	Signaling by ALK	10916	2217		0.826530612244898	0.8282828282828283	25	10891	4	37	21	10854	10916	0.12237608806984802
M1	string	0	network_modules	57	TRUE	7.62570435637813e-4	113	38	6	0.15789473684210525	0.05309734513274336	KEGG:04668	KEGG	TNF signaling pathway	8484	342		0.7916666666666666	0.8041237113402062	113	8371	6	32	107	8339	8484	0.08459289215926526
M1	string	0	network_modules	57	TRUE	7.62570435637813e-4	113	38	6	0.15789473684210525	0.05309734513274336	KEGG:04725	KEGG	Cholinergic synapse	8484	355		0.7916666666666666	0.8041237113402062	113	8371	6	32	107	8339	8484	0.08459289215926526
M1	string	0	network_modules	57	TRUE	8.210742643318657e-4	246	38	8	0.21052631578947367	0.032520325203252036	KEGG:05131	KEGG	Shigellosis	8484	428		0.8125	0.8144329896907216	246	8238	8	30	238	8208	8484	0.07256684095992451
M1	string	0	network_modules	57	TRUE	9.575917025593678e-4	109	45	6	0.13333333333333333	0.05504587155963303	GO:0030183	GO:BP	B cell differentiation	16175	6700		0.7083333333333334	0.7123287671232876	109	16066	6	39	103	16027	16175	0.0817299444067824
M1	string	0	network_modules	57	TRUE	9.718560531955111e-4	58	45	5	0.1111111111111111	0.08620689655172414	GO:0035924	GO:BP	cellular response to vascular endothelial growth factor stimulus	16175	9346		0.7222222222222222	0.726027397260274	58	16117	5	40	53	16077	16175	0.09501409787978383
M1	string	0	network_modules	57	TRUE	0.0010638036077134888	265	45	8	0.17777777777777778	0.03018867924528302	GO:0002429	GO:BP	immune response-activating cell surface receptor signaling pathway	16175	952		0.7361111111111112	0.7397260273972602	265	15910	8	37	257	15873	16175	0.06715277844782817
M1	string	0	network_modules	57	TRUE	0.0010776632183669742	120	38	6	0.15789473684210525	0.05	KEGG:04152	KEGG	AMPK signaling pathway	8484	286		0.8229166666666666	0.8247422680412371	120	8364	6	32	114	8332	8484	0.08165420288406283
M1	string	0	network_modules	57	TRUE	0.0011302072300009125	121	38	6	0.15789473684210525	0.049586776859504134	KEGG:04919	KEGG	Thyroid hormone signaling pathway	8484	376		0.8333333333333334	0.8350515463917526	121	8363	6	32	115	8331	8484	0.08125427077345243
M1	string	0	network_modules	57	TRUE	0.0012313855988294435	756	45	12	0.26666666666666666	0.015873015873015872	GO:0050776	GO:BP	regulation of immune response	16175	13250		0.75	0.7534246575342466	756	15419	12	33	744	15386	16175	0.05503318311243564
M1	string	0	network_modules	57	TRUE	0.0013004123385113929	124	38	6	0.15789473684210525	0.04838709677419355	KEGG:04611	KEGG	Platelet activation	8484	321		0.84375	0.845360824742268	124	8360	6	32	118	8328	8484	0.08008209911857415
M1	string	0	network_modules	57	TRUE	0.001321771626907963	73	38	5	0.13157894736842105	0.0684931506849315	KEGG:00562	KEGG	Inositol phosphate metabolism	8484	86		0.8541666666666666	0.8556701030927835	73	8411	5	33	68	8378	8484	0.0893093221728015
M1	string	0	network_modules	57	TRUE	0.001459146000227969	626	45	11	0.24444444444444444	0.01757188498402556	GO:0035295	GO:BP	tube development	16175	8953		0.7638888888888888	0.7671232876712328	626	15549	11	34	615	15515	16175	0.056340343760240344
M1	string	0	network_modules	57	TRUE	0.001484409292538884	9	41	3	0.07317073170731707	0.3333333333333333	REAC:R-HSA-8875656	REAC	MET receptor recycling	10916	1369		0.8367346938775511	0.8686868686868687	9	10907	3	38	6	10869	10916	0.15476863750189845
M1	string	0	network_modules	57	TRUE	0.001484409292538884	9	41	3	0.07317073170731707	0.3333333333333333	REAC:R-HSA-74749	REAC	Signal attenuation	10916	2214		0.8367346938775511	0.8686868686868687	9	10907	3	38	6	10869	10916	0.15476863750189845
M1	string	0	network_modules	57	TRUE	0.001484409292538884	9	41	3	0.07317073170731707	0.3333333333333333	REAC:R-HSA-9634285	REAC	Constitutive Signaling by Overexpressed ERBB2	10916	408		0.8367346938775511	0.8686868686868687	9	10907	3	38	6	10869	10916	0.15476863750189845
M1	string	0	network_modules	57	TRUE	0.001484409292538884	9	41	3	0.07317073170731707	0.3333333333333333	REAC:R-HSA-5655291	REAC	Signaling by FGFR4 in disease	10916	2253		0.8367346938775511	0.8686868686868687	9	10907	3	38	6	10869	10916	0.15476863750189845
M1	string	0	network_modules	57	TRUE	0.0015535683493958505	630	45	11	0.24444444444444444	0.01746031746031746	GO:0043069	GO:BP	negative regulation of programmed cell death	16175	10515		0.7777777777777778	0.7808219178082192	630	15545	11	34	619	15511	16175	0.05610091350212225
M1	string	0	network_modules	57	TRUE	0.0015682135185599469	500	45	10	0.2222222222222222	0.02	GO:0001934	GO:BP	positive regulation of protein phosphorylation	16175	548		0.7916666666666666	0.7945205479452054	500	15675	10	35	490	15640	16175	0.058382540107132
M1	string	0	network_modules	57	TRUE	0.0015951146510536623	259	41	8	0.1951219512195122	0.03088803088803089	REAC:R-HSA-76002	REAC	Platelet activation, signaling and aggregation	10916	1762		0.8775510204081632	0.8787878787878788	259	10657	8	33	251	10624	10916	0.06914684913717076
M1	string	0	network_modules	57	TRUE	0.001621992391801602	182	41	7	0.17073170731707318	0.038461538461538464	REAC:R-HSA-2454202	REAC	Fc epsilon receptor (FCERI) signaling	10916	938		0.8877551020408163	0.8888888888888888	182	10734	7	34	175	10700	10916	0.07387733487399761
M1	string	0	network_modules	57	TRUE	0.0016239038095864078	194	38	7	0.18421052631578946	0.03608247422680412	KEGG:05167	KEGG	Kaposi sarcoma-associated herpesvirus infection	8484	448		0.8645833333333334	0.865979381443299	194	8290	7	31	187	8259	8484	0.0724004865967993
M1	string	0	network_modules	57	TRUE	0.0017256873681374644	67	41	5	0.12195121951219512	0.07462686567164178	REAC:R-HSA-388841	REAC	Regulation of T cell activation by CD28 family	10916	2007		0.8979591836734694	0.898989898989899	67	10849	5	36	62	10813	10916	0.09104739586298963
M1	string	0	network_modules	57	TRUE	0.0017435924301628547	184	41	7	0.17073170731707318	0.03804347826086957	REAC:R-HSA-9013149	REAC	RAC1 GTPase cycle	10916	1836		0.9081632653061225	0.9090909090909091	184	10732	7	34	177	10698	10916	0.07339418734287217
M1	string	0	network_modules	57	TRUE	0.0017587629006700037	638	45	11	0.24444444444444444	0.017241379310344827	GO:0018193	GO:BP	peptidyl-amino acid modification	16175	5353		0.8055555555555556	0.8082191780821918	638	15537	11	34	627	15503	16175	0.055628214479396094
M1	string	0	network_modules	57	TRUE	0.0018912505679000882	196	45	7	0.15555555555555556	0.03571428571428571	GO:0043542	GO:BP	endothelial cell migration	16175	10759		0.8194444444444444	0.821917808219178	196	15979	7	38	189	15941	16175	0.0692460528825143
M1	string	0	network_modules	57	TRUE	0.0019873005641249794	791	45	12	0.26666666666666666	0.015170670037926675	GO:1901701	GO:BP	cellular response to oxygen-containing compound	16175	21654		0.8333333333333334	0.8356164383561644	791	15384	12	33	779	15351	16175	0.05333307797377073
M1	string	0	network_modules	57	TRUE	0.002083204408188868	32	41	4	0.0975609756097561	0.125	REAC:R-HSA-5654741	REAC	Signaling by FGFR3	10916	2249		0.9183673469387755	0.9191919191919192	32	10884	4	37	28	10847	10916	0.1074726869892798
M1	string	0	network_modules	57	TRUE	0.002108965444436113	202	38	7	0.18421052631578946	0.034653465346534656	KEGG:05415	KEGG	Diabetic cardiomyopathy	8484	492		0.875	0.8762886597938144	202	8282	7	31	195	8251	8484	0.07057171963448576
M1	string	0	network_modules	57	TRUE	0.0021106591925019198	135	38	6	0.15789473684210525	0.044444444444444446	KEGG:04210	KEGG	Apoptosis	8484	287		0.8854166666666666	0.8865979381443299	135	8349	6	32	129	8317	8484	0.0761057400975114
M1	string	0	network_modules	57	TRUE	0.002390719737834969	138	38	6	0.15789473684210525	0.043478260869565216	KEGG:05162	KEGG	Measles	8484	443		0.8958333333333334	0.9072164948453608	138	8346	6	32	132	8314	8484	0.07509998269180608
M1	string	0	network_modules	57	TRUE	0.002390719737834969	138	38	6	0.15789473684210525	0.043478260869565216	KEGG:05418	KEGG	Fluid shear stress and atherosclerosis	8484	495		0.8958333333333334	0.9072164948453608	138	8346	6	32	132	8314	8484	0.07509998269180608
M1	string	0	network_modules	57	TRUE	0.002508752231371303	297	45	8	0.17777777777777778	0.026936026936026935	GO:0030098	GO:BP	lymphocyte differentiation	16175	6676		0.8472222222222222	0.8493150684931506	297	15878	8	37	289	15841	16175	0.06271760167496356
M1	string	0	network_modules	57	TRUE	0.00263851389528854	206	45	7	0.15555555555555556	0.03398058252427184	GO:0030217	GO:BP	T cell differentiation	16175	6725		0.8611111111111112	0.863013698630137	206	15969	7	38	199	15931	16175	0.06727434399032
M1	string	0	network_modules	57	TRUE	0.002699980515016966	141	38	6	0.15789473684210525	0.0425531914893617	KEGG:05017	KEGG	Spinocerebellar ataxia	8484	415		0.9166666666666666	0.9175257731958762	141	8343	6	32	135	8311	8484	0.07412457679629254
M1	string	0	network_modules	57	TRUE	0.0027919149865081633	211	38	7	0.18421052631578946	0.03317535545023697	KEGG:05207	KEGG	Chemical carcinogenesis - receptor activation	8484	459		0.9270833333333334	0.9278350515463918	211	8273	7	31	204	8242	8484	0.06863086759709494
M1	string	0	network_modules	57	TRUE	0.003008685343571693	35	41	4	0.0975609756097561	0.11428571428571428	REAC:R-HSA-5654743	REAC	Signaling by FGFR4	10916	2252		0.9285714285714286	0.9292929292929293	35	10881	4	37	31	10844	10916	0.10247921942736668
M1	string	0	network_modules	57	TRUE	0.003441065924723586	218	38	7	0.18421052631578946	0.03211009174311927	KEGG:05166	KEGG	Human T-cell leukemia virus 1 infection	8484	447		0.9375	0.9381443298969072	218	8266	7	31	211	8235	8484	0.06719881432877135
M1	string	0	network_modules	57	TRUE	0.003508893014010798	215	45	7	0.15555555555555556	0.03255813953488372	GO:0110053	GO:BP	regulation of actin filament organization	16175	19377		0.875	0.8767123287671232	215	15960	7	38	208	15922	16175	0.06561316526274348
M1	string	0	network_modules	57	TRUE	0.0038320141636639577	552	45	10	0.2222222222222222	0.018115942028985508	GO:0035239	GO:BP	tube morphogenesis	16175	8921		0.8888888888888888	0.8904109589041096	552	15623	10	35	542	15588	16175	0.05472174961823845
M1	string	0	network_modules	57	TRUE	0.0041604323860865815	140	45	6	0.13333333333333333	0.04285714285714286	GO:0032869	GO:BP	cellular response to insulin stimulus	16175	7866		0.9027777777777778	0.9041095890410958	140	16035	6	39	134	15996	16175	0.0710926483903214
M1	string	0	network_modules	57	TRUE	0.0042856189202696805	93	38	5	0.13157894736842105	0.053763440860215055	KEGG:04520	KEGG	Adherens junction	8484	316		0.9479166666666666	0.9484536082474226	93	8391	5	33	88	8358	8484	0.07770117748579461
M1	string	0	network_modules	57	TRUE	0.004433982725777189	154	38	6	0.15789473684210525	0.03896103896103896	KEGG:04932	KEGG	Non-alcoholic fatty liver disease	8484	389		0.9583333333333334	0.9587628865979382	154	8330	6	32	148	8298	8484	0.07021240955890005
M1	string	0	network_modules	57	TRUE	0.004454418338737029	434	45	9	0.2	0.020737327188940093	GO:0002521	GO:BP	leukocyte differentiation	16175	1043		0.9166666666666666	0.9178082191780822	434	15741	9	36	425	15705	16175	0.05660322262015545
M1	string	0	network_modules	57	TRUE	0.0045775209451053515	79	45	5	0.1111111111111111	0.06329113924050633	GO:0035023	GO:BP	regulation of Rho protein signal transduction	16175	8766		0.9305555555555556	0.9315068493150684	79	16096	5	40	74	16056	16175	0.0804814657814995
M1	string	0	network_modules	57	TRUE	0.004588355241707472	35	45	4	0.08888888888888889	0.11428571428571428	GO:0048008	GO:BP	platelet-derived growth factor receptor signaling pathway	16175	12464		0.9444444444444444	0.9452054794520548	35	16140	4	41	31	16099	16175	0.09858076026974474
M1	string	0	network_modules	57	TRUE	0.005001510664909227	13	41	3	0.07317073170731707	0.23076923076923078	REAC:R-HSA-1963642	REAC	PI3K events in ERBB2 signaling	10916	1672		0.9387755102040817	0.9393939393939394	13	10903	3	38	10	10865	10916	0.1281465422815944
M1	string	0	network_modules	57	TRUE	0.0056717541586859665	447	45	9	0.2	0.020134228187919462	GO:0048514	GO:BP	blood vessel morphogenesis	16175	12799		0.9583333333333334	0.958904109589041	447	15728	9	36	438	15692	16175	0.05553813998594772
M1	string	0	network_modules	57	TRUE	0.006310689297111754	42	41	4	0.0975609756097561	0.09523809523809523	REAC:R-HSA-5654736	REAC	Signaling by FGFR1	10916	2241		0.9489795918367347	0.9494949494949495	42	10874	4	37	38	10837	10916	0.09294440792261335
M1	string	0	network_modules	57	TRUE	0.006348951919572291	14	41	3	0.07317073170731707	0.21428571428571427	REAC:R-HSA-8983432	REAC	Interleukin-15 signaling	10916	1237		0.9591836734693877	0.9797979797979798	14	10902	3	38	11	10864	10916	0.12333359467841012
M1	string	0	network_modules	57	TRUE	0.006348951919572291	14	41	3	0.07317073170731707	0.21428571428571427	REAC:R-HSA-9034015	REAC	Signaling by NTRK3 (TRKC)	10916	2286		0.9591836734693877	0.9797979797979798	14	10902	3	38	11	10864	10916	0.12333359467841012
M1	string	0	network_modules	57	TRUE	0.006348951919572291	14	41	3	0.07317073170731707	0.21428571428571427	REAC:R-HSA-169893	REAC	Prolonged ERK activation events	10916	1807		0.9591836734693877	0.9797979797979798	14	10902	3	38	11	10864	10916	0.12333359467841012
M1	string	0	network_modules	57	TRUE	0.006514872550330423	165	38	6	0.15789473684210525	0.03636363636363636	KEGG:04140	KEGG	Autophagy - animal	8484	277		0.96875	0.9690721649484536	165	8319	6	32	159	8287	8484	0.06724669395137389
M1	string	0	network_modules	57	TRUE	0.0066069662711517796	88	41	5	0.12195121951219512	0.056818181818181816	REAC:R-HSA-9013404	REAC	RAC2 GTPase cycle	10916	1837		0.9897959183673469	0.98989898989899	88	10828	5	36	83	10792	10916	0.07820052228595656
M1	string	0	network_modules	57	TRUE	0.006705029632469679	152	45	6	0.13333333333333333	0.039473684210526314	GO:0032868	GO:BP	response to insulin	16175	7865		0.9722222222222222	0.9726027397260274	152	16023	6	39	146	15984	16175	0.06784807525714899
M1	string	0	network_modules	57	TRUE	0.006773766479451866	330	38	8	0.21052631578947367	0.024242424242424242	KEGG:05165	KEGG	Human papillomavirus infection	8484	446		0.9791666666666666	0.979381443298969	330	8154	8	30	322	8124	8484	0.05954107999747246
M1	string	0	network_modules	57	TRUE	0.006965561445358317	167	38	6	0.15789473684210525	0.03592814371257485	KEGG:05164	KEGG	Influenza A	8484	445		0.9895833333333334	0.9896907216494846	167	8317	6	32	161	8285	8484	0.06673701319799158
M1	string	0	network_modules	57	TRUE	0.008401738167611241	251	38	7	0.18421052631578946	0.027888446215139442	KEGG:04020	KEGG	Calcium signaling pathway	8484	250		1	1	251	8233	7	31	244	8202	8484	0.06121134288157203
M1	string	0	network_modules	57	TRUE	0.009105701431183399	94	41	5	0.12195121951219512	0.05319148936170213	REAC:R-HSA-9013423	REAC	RAC3 GTPase cycle	10916	1838		1	1	94	10822	5	36	89	10786	10916	0.07531931551534989
M1	string	0	network_modules	57	TRUE	0.009332567474676437	610	45	10	0.2222222222222222	0.01639344262295082	GO:0043066	GO:BP	negative regulation of apoptotic process	16175	10512		0.9861111111111112	0.9863013698630136	610	15565	10	35	600	15530	16175	0.05115794516489956
M1	string	0	network_modules	57	TRUE	0.009821908343676043	357	45	8	0.17777777777777778	0.022408963585434174	GO:1903131	GO:BP	mononuclear cell differentiation	16175	22787		1	1	357	15818	8	37	349	15781	16175	0.05597971907733442
M1	string	0	network_modules	58	TRUE	1.341809741169316e-39	298	39	31	0.7948717948717948	0.1040268456375839	REAC:R-HSA-1474244	REAC	Extracellular matrix organization	10916	889		0	0.03125	298	10618	31	8	267	10610	10916	0.28205326666542035
M1	string	0	network_modules	58	TRUE	1.1792693512459215e-31	60	39	19	0.48717948717948717	0.31666666666666665	REAC:R-HSA-2022090	REAC	Assembly of collagen fibrils and other multimeric structures	10916	177		0.03225806451612903	0.0625	60	10856	19	20	41	10836	10916	0.3901144294842665
M1	string	0	network_modules	58	TRUE	4.0190390516689956e-30	89	39	20	0.5128205128205128	0.2247191011235955	REAC:R-HSA-1474290	REAC	Collagen formation	10916	387		0.06451612903225806	0.09375	89	10827	20	19	69	10808	10916	0.33604496843331977
M1	string	0	network_modules	58	TRUE	7.015934074290406e-30	140	39	22	0.5641025641025641	0.15714285714285714	REAC:R-HSA-1474228	REAC	Degradation of the extracellular matrix	10916	726		0.0967741935483871	0.125	140	10776	22	17	118	10759	10916	0.2933719644764025
M1	string	0	network_modules	58	TRUE	2.7093749323507436e-26	84	39	18	0.46153846153846156	0.21428571428571427	REAC:R-HSA-216083	REAC	Integrin cell surface interactions	10916	1216		0.12903225806451613	0.15625	84	10832	18	21	66	10811	10916	0.3109948946119186
M1	string	0	network_modules	58	TRUE	4.880513084969044e-26	67	39	17	0.4358974358974359	0.2537313432835821	REAC:R-HSA-1650814	REAC	Collagen biosynthesis and modifying enzymes	10916	384		0.16129032258064516	0.1875	67	10849	17	22	50	10827	10916	0.32948424610096194
M1	string	0	network_modules	58	TRUE	5.438783433358373e-25	76	39	17	0.4358974358974359	0.2236842105263158	REAC:R-HSA-3000178	REAC	ECM proteoglycans	10916	812		0.1935483870967742	0.21875	76	10840	17	22	59	10818	10916	0.30889543838358996
M1	string	0	network_modules	58	TRUE	1.2488442155744958e-22	59	39	15	0.38461538461538464	0.2542372881355932	REAC:R-HSA-3000171	REAC	Non-integrin membrane-ECM interactions	10916	1603		0.22580645161290322	0.25	59	10857	15	24	44	10833	10916	0.3096996155507254
M1	string	0	network_modules	58	TRUE	1.6116966423227195e-22	44	39	14	0.358974358974359	0.3181818181818182	REAC:R-HSA-8948216	REAC	Collagen chain trimerization	10916	385		0.25806451612903225	0.28125	44	10872	14	25	30	10847	10916	0.33544361490944935
M1	string	0	network_modules	58	TRUE	4.94189168495536e-22	64	39	15	0.38461538461538464	0.234375	REAC:R-HSA-1442490	REAC	Collagen degradation	10916	386		0.2903225806451613	0.3125	64	10852	15	24	49	10828	10916	0.29706522529070767
M1	string	0	network_modules	58	TRUE	5.826806615405813e-21	89	30	15	0.5	0.16853932584269662	KEGG:04512	KEGG	ECM-receptor interaction	8484	314		0	0.14285714285714285	89	8395	15	15	74	8380	8484	0.28621084321762863
M1	string	0	network_modules	58	TRUE	5.374116590721433e-18	103	30	14	0.4666666666666667	0.13592233009708737	KEGG:04974	KEGG	Protein digestion and absorption	8484	405		0.16666666666666666	0.2857142857142857	103	8381	14	16	89	8365	8484	0.24724215665915247
M1	string	0	network_modules	58	TRUE	1.0906022128114118e-17	356	30	19	0.6333333333333333	0.05337078651685393	KEGG:04151	KEGG	PI3K-Akt signaling pathway	8484	285		0.3333333333333333	0.42857142857142855	356	8128	19	11	337	8117	8484	0.1757009350554281
M1	string	0	network_modules	58	TRUE	2.7783020994398463e-17	236	44	17	0.38636363636363635	0.07203389830508475	GO:0030198	GO:BP	extracellular matrix organization	16175	6707		0	0.03333333333333333	236	15939	17	27	219	15912	16175	0.16193157762778984
M1	string	0	network_modules	58	TRUE	2.9882095501829603e-17	237	44	17	0.38636363636363635	0.07172995780590717	GO:0043062	GO:BP	extracellular structure organization	16175	10509		0.034482758620689655	0.06666666666666667	237	15938	17	27	220	15911	16175	0.16156778565075808
M1	string	0	network_modules	58	TRUE	3.212932579114484e-17	238	44	17	0.38636363636363635	0.07142857142857142	GO:0045229	GO:BP	external encapsulating structure organization	16175	11340		0.06896551724137931	0.1	238	15937	17	27	221	15910	16175	0.16120624183597632
M1	string	0	network_modules	58	TRUE	4.5578313699640095e-17	202	30	16	0.5333333333333333	0.07920792079207921	KEGG:04510	KEGG	Focal adhesion	8484	313		0.5	0.5714285714285714	202	8282	16	14	186	8268	8484	0.19909087283911034
M1	string	0	network_modules	58	TRUE	7.88851918368624e-17	54	39	12	0.3076923076923077	0.2222222222222222	REAC:R-HSA-186797	REAC	Signaling by PDGF	10916	2291		0.3225806451612903	0.34375	54	10862	12	27	42	10835	10916	0.2583848813509231
M1	string	0	network_modules	58	TRUE	3.9237765589038425e-16	42	39	11	0.28205128205128205	0.2619047619047619	REAC:R-HSA-419037	REAC	NCAM1 interactions	10916	1512		0.3548387096774194	0.375	42	10874	11	28	31	10846	10916	0.26908214917858686
M1	string	0	network_modules	58	TRUE	7.440872244643087e-16	507	39	21	0.5384615384615384	0.04142011834319527	REAC:R-HSA-9006934	REAC	Signaling by Receptor Tyrosine Kinases	10916	2302		0.3870967741935484	0.40625	507	10409	21	18	486	10391	10916	0.13999482037246033
M1	string	0	network_modules	58	TRUE	1.0616121544351937e-15	30	39	10	0.2564102564102564	0.3333333333333333	REAC:R-HSA-8874081	REAC	MET activates PTK2 signaling	10916	1362		0.41935483870967744	0.4375	30	10886	10	29	20	10857	10916	0.29013617486538057
M1	string	0	network_modules	58	TRUE	2.4644428692311614e-14	59	39	11	0.28205128205128205	0.1864406779661017	REAC:R-HSA-375165	REAC	NCAM signaling for neurite out-growth	10916	1511		0.45161290322580644	0.46875	59	10857	11	28	48	10829	10916	0.2259359400237036
M1	string	0	network_modules	58	TRUE	2.9233972073579893e-14	40	39	10	0.2564102564102564	0.25	REAC:R-HSA-8875878	REAC	MET promotes cell motility	10916	1368		0.4838709677419355	0.5	40	10876	10	29	30	10847	10916	0.25047293709682944
M1	string	0	network_modules	58	TRUE	2.9995348092938994e-14	15	39	8	0.20512820512820512	0.5333333333333333	REAC:R-HSA-2214320	REAC	Anchoring fibril formation	10916	146		0.5161290322580645	0.53125	15	10901	8	31	7	10870	10916	0.3293584202957917
M1	string	0	network_modules	58	TRUE	1.3113288055149573e-11	50	44	9	0.20454545454545456	0.18	GO:0030199	GO:BP	collagen fibril organization	16175	6708		0.10344827586206896	0.13333333333333333	50	16125	9	35	41	16090	16175	0.18953158008626367
M1	string	0	network_modules	58	TRUE	3.0164704542239184e-11	76	39	10	0.2564102564102564	0.13157894736842105	REAC:R-HSA-6806834	REAC	Signaling by MET	10916	2270		0.5483870967741935	0.5625	76	10840	10	29	66	10811	10916	0.17963867943673728
M1	string	0	network_modules	58	TRUE	8.172432489268231e-11	330	30	14	0.4666666666666667	0.04242424242424243	KEGG:05165	KEGG	Human papillomavirus infection	8484	446		0.6666666666666666	0.7142857142857143	330	8154	14	16	316	8138	8484	0.13179474201730226
M1	string	0	network_modules	58	TRUE	1.3643549159758155e-9	27	39	7	0.1794871794871795	0.25925925925925924	REAC:R-HSA-3000170	REAC	Syndecan interactions	10916	2367		0.5806451612903226	0.59375	27	10889	7	32	20	10857	10916	0.21338917190005735
M1	string	0	network_modules	58	TRUE	3.335763095250428e-8	43	44	7	0.1590909090909091	0.16279069767441862	GO:0035987	GO:BP	endodermal cell differentiation	16175	9378		0.13793103448275862	0.16666666666666666	43	16132	7	37	36	16095	16175	0.1586677245249234
M1	string	0	network_modules	58	TRUE	1.0195602302131092e-7	50	44	7	0.1590909090909091	0.14	GO:0001706	GO:BP	endoderm formation	16175	398		0.1724137931034483	0.2	50	16125	7	37	43	16088	16175	0.14676717474509102
M1	string	0	network_modules	58	TRUE	2.661052559676231e-7	57	44	7	0.1590909090909091	0.12280701754385964	GO:0007492	GO:BP	endoderm development	16175	2978		0.20689655172413793	0.23333333333333334	57	16118	7	37	50	16081	16175	0.13710848188051616
M1	string	0	network_modules	58	TRUE	2.983302393407738e-7	30	39	6	0.15384615384615385	0.2	REAC:R-HSA-3000157	REAC	Laminin interactions	10916	1303		0.6129032258064516	0.625	30	10886	6	33	24	10853	10916	0.17282433173803566
M1	string	0	network_modules	58	TRUE	1.3436594111708832e-6	770	44	15	0.3409090909090909	0.01948051948051948	GO:0048646	GO:BP	anatomical structure formation involved in morphogenesis	16175	12904		0.2413793103448276	0.26666666666666666	770	15405	15	29	755	15376	16175	0.07194206243482203
M1	string	0	network_modules	58	TRUE	1.42143345795823e-6	18	39	5	0.1282051282051282	0.2777777777777778	REAC:R-HSA-2243919	REAC	Crosslinking of collagen fibrils	10916	417		0.6451612903225806	0.65625	18	10898	5	34	13	10864	10916	0.1867733652215004
M1	string	0	network_modules	58	TRUE	3.0531229681536322e-6	80	44	7	0.1590909090909091	0.0875	GO:0001704	GO:BP	formation of primary germ layer	16175	396		0.27586206896551724	0.3	80	16095	7	37	73	16058	16175	0.11475693859331867
M1	string	0	network_modules	58	TRUE	5.612252184549614e-6	283	44	10	0.22727272727272727	0.0353356890459364	GO:0001501	GO:BP	skeletal system development	16175	318		0.3103448275862069	0.3333333333333333	283	15892	10	34	273	15858	16175	0.08356309369055448
M1	string	0	network_modules	58	TRUE	1.2433160706579621e-5	512	44	12	0.2727272727272727	0.0234375	GO:0009790	GO:BP	embryo development	16175	3677		0.3448275862068966	0.36666666666666664	512	15663	12	32	500	15631	16175	0.07191458449274889
M1	string	0	network_modules	58	TRUE	3.925068118967612e-5	115	44	7	0.1590909090909091	0.06086956521739131	GO:0007369	GO:BP	gastrulation	16175	2871		0.3793103448275862	0.4	115	16060	7	37	108	16023	16175	0.09447308124503892
M1	string	0	network_modules	58	TRUE	8.249132770975525e-5	101	30	6	0.2	0.0594059405940594	KEGG:05146	KEGG	Amoebiasis	8484	438		0.8333333333333334	0.8571428571428571	101	8383	6	24	95	8359	8484	0.10331123337618535
M1	string	0	network_modules	58	TRUE	1.1710763397884146e-4	41	39	5	0.1282051282051282	0.12195121951219512	REAC:R-HSA-3560782	REAC	Diseases associated with glycosaminoglycan metabolism	10916	750		0.6774193548387096	0.6875	41	10875	5	34	36	10841	10916	0.12182227967877295
M1	string	0	network_modules	58	TRUE	2.487760093364998e-4	20	39	4	0.10256410256410256	0.2	REAC:R-HSA-4420332	REAC	Defective B3GALT6 causes EDSP2 and SEMDJL1	10916	490		0.7096774193548387	0.78125	20	10896	4	35	16	10861	10916	0.14104570776244424
M1	string	0	network_modules	58	TRUE	2.487760093364998e-4	20	39	4	0.10256410256410256	0.2	REAC:R-HSA-3560783	REAC	Defective B4GALT7 causes EDS, progeroid type	10916	495		0.7096774193548387	0.78125	20	10896	4	35	16	10861	10916	0.14104570776244424
M1	string	0	network_modules	58	TRUE	2.487760093364998e-4	20	39	4	0.10256410256410256	0.2	REAC:R-HSA-3560801	REAC	Defective B3GAT3 causes JDSSDHD	10916	492		0.7096774193548387	0.78125	20	10896	4	35	16	10861	10916	0.14104570776244424
M1	string	0	network_modules	58	TRUE	2.5792474782860344e-4	543	44	11	0.25	0.020257826887661142	GO:0009887	GO:BP	animal organ morphogenesis	16175	3747		0.41379310344827586	0.43333333333333335	543	15632	11	33	532	15599	16175	0.06275518325852313
M1	string	0	network_modules	58	TRUE	4.4535462888807927e-4	450	44	10	0.22727272727272727	0.022222222222222223	GO:0030335	GO:BP	positive regulation of cell migration	16175	6781		0.4482758620689655	0.4666666666666667	450	15725	10	34	440	15691	16175	0.06333982061556148
M1	string	0	network_modules	58	TRUE	5.317362957309458e-4	168	44	7	0.1590909090909091	0.041666666666666664	GO:0043588	GO:BP	skin development	16175	10792		0.4827586206896552	0.5	168	16007	7	37	161	15970	16175	0.07660454014745861
M1	string	0	network_modules	58	TRUE	6.645234070717825e-4	470	44	10	0.22727272727272727	0.02127659574468085	GO:2000147	GO:BP	positive regulation of cell motility	16175	25495		0.5172413793103449	0.5333333333333333	470	15705	10	34	460	15671	16175	0.06163249982759779
M1	string	0	network_modules	58	TRUE	7.55900945916348e-4	26	39	4	0.10256410256410256	0.15384615384615385	REAC:R-HSA-1971475	REAC	A tetrasaccharide linker sequence is required for GAG synthesis	10916	6		0.8064516129032258	0.8125	26	10890	4	35	22	10855	10916	0.12306414928441647
M1	string	0	network_modules	58	TRUE	7.907862352842949e-4	479	44	10	0.22727272727272727	0.020876826722338204	GO:0040017	GO:BP	positive regulation of locomotion	16175	9905		0.5517241379310345	0.5666666666666667	479	15696	10	34	469	15662	16175	0.060896818097884255
M1	string	0	network_modules	58	TRUE	8.060383330263122e-4	480	44	10	0.22727272727272727	0.020833333333333332	GO:0001568	GO:BP	blood vessel development	16175	353		0.5862068965517241	0.6	480	15695	10	34	470	15661	16175	0.06081626073775701
M1	string	0	network_modules	58	TRUE	0.001222110138339572	279	44	8	0.18181818181818182	0.02867383512544803	GO:0031589	GO:BP	cell-substrate adhesion	16175	7233		0.6206896551724138	0.6333333333333333	279	15896	8	36	271	15860	16175	0.06601503887913913
M1	string	0	network_modules	58	TRUE	0.0012585785110053962	504	44	10	0.22727272727272727	0.01984126984126984	GO:0001944	GO:BP	vasculature development	16175	555		0.6551724137931034	0.6666666666666666	504	15671	10	34	494	15637	16175	0.05895001468146947
M1	string	0	network_modules	58	TRUE	0.0013079366276362385	119	44	6	0.13636363636363635	0.05042016806722689	GO:0001936	GO:BP	regulation of endothelial cell proliferation	16175	550		0.6896551724137931	0.7	119	16056	6	38	113	16018	16175	0.07884238696705265
M1	string	0	network_modules	58	TRUE	0.002623526720632489	11	39	3	0.07692307692307693	0.2727272727272727	REAC:R-HSA-446107	REAC	Type I hemidesmosome assembly	10916	2612		0.8387096774193549	0.875	11	10905	3	36	8	10869	10916	0.14327218005737144
M1	string	0	network_modules	58	TRUE	0.002623526720632489	11	39	3	0.07692307692307693	0.2727272727272727	REAC:R-HSA-430116	REAC	GP1b-IX-V activation signalling	10916	1017		0.8387096774193549	0.875	11	10905	3	36	8	10869	10916	0.14327218005737144
M1	string	0	network_modules	58	TRUE	0.0026315906301549387	309	44	8	0.18181818181818182	0.025889967637540454	GO:0048598	GO:BP	embryonic morphogenesis	16175	12865		0.7241379310344828	0.7333333333333333	309	15866	8	36	301	15830	16175	0.062080272151128026
M1	string	0	network_modules	58	TRUE	0.002741321917425575	135	44	6	0.13636363636363635	0.044444444444444446	GO:0001935	GO:BP	endothelial cell proliferation	16175	549		0.7586206896551724	0.7666666666666667	135	16040	6	38	129	16002	16175	0.07349198819020848
M1	string	0	network_modules	58	TRUE	0.003355443244709463	77	44	5	0.11363636363636363	0.06493506493506493	GO:0043406	GO:BP	positive regulation of MAP kinase activity	16175	10674		0.7931034482758621	0.8	77	16098	5	39	72	16059	16175	0.082611505935515
M1	string	0	network_modules	58	TRUE	0.00354081631803811	140	39	6	0.15384615384615385	0.04285714285714286	REAC:R-HSA-3781865	REAC	Diseases of glycosylation	10916	765		0.9032258064516129	0.90625	140	10776	6	33	134	10743	10916	0.07504678156607511
M1	string	0	network_modules	58	TRUE	0.004831764047702836	205	30	6	0.2	0.02926829268292683	KEGG:05205	KEGG	Proteoglycans in cancer	8484	457		1	1	205	8279	6	24	199	8255	8484	0.06821411304824167
M1	string	0	network_modules	58	TRUE	0.0050617857769684445	150	44	6	0.13636363636363635	0.04	GO:0051897	GO:BP	positive regulation of phosphatidylinositol 3-kinase/protein kinase B signal transduction	16175	13981		0.8275862068965517	0.8333333333333334	150	16025	6	38	144	15987	16175	0.06924795279926557
M1	string	0	network_modules	58	TRUE	0.005193587959401175	236	44	7	0.1590909090909091	0.029661016949152543	GO:0050678	GO:BP	regulation of epithelial cell proliferation	16175	13212		0.8620689655172413	0.8666666666666667	236	15939	7	37	229	15902	16175	0.06293942490417109
M1	string	0	network_modules	58	TRUE	0.005744842817430521	14	39	3	0.07692307692307693	0.21428571428571427	REAC:R-HSA-3656237	REAC	Defective EXT2 causes exostoses 2	10916	539		0.9354838709677419	0.96875	14	10902	3	36	11	10866	10916	0.12655487266926044
M1	string	0	network_modules	58	TRUE	0.005744842817430521	14	39	3	0.07692307692307693	0.21428571428571427	REAC:R-HSA-3656253	REAC	Defective EXT1 causes exostoses 1, TRPS2 and CHDS	10916	538		0.9354838709677419	0.96875	14	10902	3	36	11	10866	10916	0.12655487266926044
M1	string	0	network_modules	58	TRUE	0.005754385002522589	744	44	11	0.25	0.01478494623655914	GO:0072359	GO:BP	circulatory system development	16175	17370		0.896551724137931	0.9	744	15431	11	33	733	15398	16175	0.05086197578486014
M1	string	0	network_modules	58	TRUE	0.006059400547979379	748	44	11	0.25	0.014705882352941176	GO:0097435	GO:BP	supramolecular fiber organization	16175	18657		0.9310344827586207	0.9333333333333333	748	15427	11	33	737	15394	16175	0.050670876262098874
M1	string	0	network_modules	58	TRUE	0.007163304917134877	15	39	3	0.07692307692307693	0.2	REAC:R-HSA-75892	REAC	Platelet Adhesion to exposed collagen	10916	1760		1	1	15	10901	3	36	12	10865	10916	0.12212114951031841
M1	string	0	network_modules	58	TRUE	0.007398776638528415	249	44	7	0.1590909090909091	0.028112449799196786	GO:0050878	GO:BP	regulation of body fluid levels	16175	13323		0.9655172413793104	0.9666666666666667	249	15926	7	37	242	15889	16175	0.06095846132674222
M1	string	0	network_modules	58	TRUE	0.009168787485620248	781	44	11	0.25	0.014084507042253521	GO:0030334	GO:BP	regulation of cell migration	16175	6780		1	1	781	15394	11	33	770	15361	16175	0.049144874791695596
M1	string	0	network_modules	59	TRUE	1.0282074765194841e-5	41	25	5	0.2	0.12195121951219512	REAC:R-HSA-6782315	REAC	tRNA modification in the nucleus and cytosol	10916	2742		0	0.3333333333333333	41	10875	5	20	36	10855	10916	0.15370556055678397
M1	string	0	network_modules	59	TRUE	5.931743814659379e-5	248	20	7	0.35	0.028225806451612902	KEGG:04144	KEGG	Endocytosis	8484	280		0	0.25	248	8236	7	13	241	8223	8484	0.09256259925320227
M1	string	0	network_modules	59	TRUE	1.1502854409637165e-4	170	20	6	0.3	0.03529411764705882	KEGG:04530	KEGG	Tight junction	8484	317		0.3333333333333333	0.5	170	8314	6	14	164	8300	8484	0.0971175872211933
M1	string	0	network_modules	59	TRUE	0.0010922594259318295	103	25	5	0.2	0.04854368932038835	REAC:R-HSA-72306	REAC	tRNA processing	10916	2743		0.5	0.6666666666666666	103	10813	5	20	98	10793	10916	0.0944385920038303
M1	string	0	network_modules	59	TRUE	0.0017204385763701512	77	20	4	0.2	0.05194805194805195	KEGG:05100	KEGG	Bacterial invasion of epithelial cells	8484	423		0.6666666666666666	0.75	77	8407	4	16	73	8391	8484	0.0978639360249419
M1	string	0	network_modules	59	TRUE	0.0041034409252754	96	20	4	0.2	0.041666666666666664	KEGG:04666	KEGG	Fc gamma R-mediated phagocytosis	8484	341		1	1	96	8388	4	16	92	8372	8484	0.08671603633995364
M1	string	0	network_modules	59	TRUE	0.007250088671857502	182	40	6	0.15	0.03296703296703297	GO:0006457	GO:BP	protein folding	16175	2203		0	0.5	182	15993	6	34	176	15959	16175	0.06549619675518464
M1	string	0	network_modules	59	TRUE	0.007326627975176828	24	25	3	0.12	0.125	REAC:R-HSA-163560	REAC	Triglyceride catabolism	10916	2606		1	1	24	10892	3	22	21	10870	10916	0.12050099670074804
M1	string	0	network_modules	59	TRUE	0.00828190746599305	2	40	2	0.05	1	GO:0106004	GO:BP	tRNA (guanine-N7)-methylation	16175	19204		1	1	2	16173	2	38	0	16135	16175	0.2233439505556375
M1	string	0	network_modules	60	TRUE	0.0025976306122133075	223	16	5	0.3125	0.02242152466367713	KEGG:04024	KEGG	cAMP signaling pathway	8484	252		NA	1	223	8261	5	11	218	8250	8484	0.07776679870575248
M1	string	0	network_modules	61	TRUE	3.661783245338477e-16	52	40	11	0.275	0.21153846153846154	GO:0001836	GO:BP	release of cytochrome c from mitochondria	16175	493		0	0.03225806451612903	52	16123	11	29	41	16094	16175	0.23905120912070218
M1	string	0	network_modules	61	TRUE	3.2344827734945686e-15	91	40	12	0.3	0.13186813186813187	GO:0008637	GO:BP	apoptotic mitochondrial changes	16175	3220		0.03333333333333333	0.06451612903225806	91	16084	12	28	79	16056	16175	0.19596186817255679
M1	string	0	network_modules	61	TRUE	1.5145626314982232e-10	24	40	7	0.175	0.2916666666666667	GO:0090200	GO:BP	positive regulation of release of cytochrome c from mitochondria	16175	18102		0.06666666666666667	0.0967741935483871	24	16151	7	33	17	16118	16175	0.22445256393555946
M1	string	0	network_modules	61	TRUE	1.531559773475583e-10	44	40	8	0.2	0.18181818181818182	GO:0097192	GO:BP	extrinsic apoptotic signaling pathway in absence of ligand	16175	18536		0.1	0.12903225806451613	44	16131	8	32	36	16099	16175	0.18858855424669405
M1	string	0	network_modules	61	TRUE	2.2469196893955643e-10	46	40	8	0.2	0.17391304347826086	GO:0038034	GO:BP	signal transduction in absence of ligand	16175	9674		0.13333333333333333	0.16129032258064516	46	16129	8	32	38	16097	16175	0.18433907047480164
M1	string	0	network_modules	61	TRUE	2.8761500170901485e-10	32	27	7	0.25925925925925924	0.21875	KEGG:04215	KEGG	Apoptosis - multiple species	8484	292		0	0.14285714285714285	32	8452	7	20	25	8432	8484	0.23549908328567767
M1	string	0	network_modules	61	TRUE	3.323123096779892e-10	79	40	9	0.225	0.11392405063291139	GO:0008630	GO:BP	intrinsic apoptotic signaling pathway in response to DNA damage	16175	3218		0.16666666666666666	0.1935483870967742	79	16096	9	31	70	16065	16175	0.15720585840215734
M1	string	0	network_modules	61	TRUE	1.074832166904169e-9	9	23	5	0.21739130434782608	0.5555555555555556	REAC:R-HSA-111453	REAC	BH3-only proteins associate with and inactivate anti-apoptotic BCL-2 members	10916	202		0	0.14285714285714285	9	10907	5	18	4	10889	10916	0.34671426830156665
M1	string	0	network_modules	61	TRUE	2.9621740129656784e-9	364	40	13	0.325	0.03571428571428571	GO:0007005	GO:BP	mitochondrion organization	16175	2617		0.2	0.22580645161290322	364	15811	13	27	351	15784	16175	0.101549846310251
M1	string	0	network_modules	61	TRUE	3.329809764957397e-9	463	40	14	0.35	0.03023758099352052	GO:0097190	GO:BP	apoptotic signaling pathway	16175	18534		0.23333333333333334	0.25806451612903225	463	15712	14	26	449	15686	16175	0.09596137060172225
M1	string	0	network_modules	61	TRUE	3.6758947457407772e-09	54	23	7	0.30434782608695654	0.12962962962962962	REAC:R-HSA-109606	REAC	Intrinsic Pathway for Apoptosis	10916	1268		0.16666666666666666	0.2857142857142857	54	10862	7	16	47	10846	10916	0.1960898441196687
M1	string	0	network_modules	61	TRUE	9.543514032263751e-9	41	40	7	0.175	0.17073170731707318	GO:0090199	GO:BP	regulation of release of cytochrome c from mitochondria	16175	18101		0.26666666666666666	0.2903225806451613	41	16134	7	33	34	16101	16175	0.1707766077273347
M1	string	0	network_modules	61	TRUE	1.1672530630272753e-8	135	27	9	0.3333333333333333	0.06666666666666667	KEGG:04210	KEGG	Apoptosis	8484	287		0.16666666666666666	0.2857142857142857	135	8349	9	18	126	8331	8484	0.1433263217197377
M1	string	0	network_modules	61	TRUE	1.6044623899804924e-8	244	40	11	0.275	0.045081967213114756	GO:0097193	GO:BP	intrinsic apoptotic signaling pathway	16175	18537		0.3	0.3225806451612903	244	15931	11	29	233	15902	16175	0.10617070449118642
M1	string	0	network_modules	61	TRUE	1.1864038471662403e-7	385	40	12	0.3	0.03116883116883117	GO:0043065	GO:BP	positive regulation of apoptotic process	16175	10511		0.3333333333333333	0.3548387096774194	385	15790	12	28	373	15762	16175	0.09021705419193157
M1	string	0	network_modules	61	TRUE	1.8973239433944368e-7	401	40	12	0.3	0.029925187032418952	GO:0043068	GO:BP	positive regulation of programmed cell death	16175	10514		0.36666666666666664	0.3870967741935484	401	15774	12	28	389	15746	16175	0.08812695895637349
M1	string	0	network_modules	61	TRUE	2.520298574478839e-7	107	40	8	0.2	0.07476635514018691	GO:0010821	GO:BP	regulation of mitochondrion organization	16175	4433		0.4	0.41935483870967744	107	16068	8	32	99	16036	16175	0.11877894261362745
M1	string	0	network_modules	61	TRUE	3.6328301253882834e-7	170	40	9	0.225	0.052941176470588235	GO:0097191	GO:BP	extrinsic apoptotic signaling pathway	16175	18535		0.43333333333333335	0.45161290322580644	170	16005	9	31	161	15974	16175	0.1047235740406264
M1	string	0	network_modules	61	TRUE	1.1809994698097337e-6	30	23	5	0.21739130434782608	0.16666666666666666	REAC:R-HSA-114452	REAC	Activation of BH3-only proteins	10916	77		0.3333333333333333	0.42857142857142855	30	10886	5	18	25	10868	10916	0.18839775417865126
M1	string	0	network_modules	61	TRUE	1.6305906508150626e-5	176	23	7	0.30434782608695654	0.03977272727272727	REAC:R-HSA-109581	REAC	Apoptosis	10916	158		0.5	0.5714285714285714	176	10740	7	16	169	10724	10916	0.105154150817007
M1	string	0	network_modules	61	TRUE	3.132569227385839e-5	13	40	4	0.1	0.3076923076923077	GO:1900103	GO:BP	positive regulation of endoplasmic reticulum unfolded protein response	16175	20395		0.4666666666666667	0.4838709677419355	13	16162	4	36	9	16126	16175	0.174287405483458
M1	string	0	network_modules	61	TRUE	4.7887521418098135e-5	56	27	5	0.18518518518518517	0.08928571428571429	KEGG:04340	KEGG	Hedgehog signaling pathway	8484	302		0.3333333333333333	0.42857142857142855	56	8428	5	22	51	8406	8484	0.12461259007447449
M1	string	0	network_modules	61	TRUE	5.13227569635755e-5	208	23	7	0.30434782608695654	0.03365384615384615	REAC:R-HSA-5357801	REAC	Programmed Cell Death	10916	1803		0.6666666666666666	0.7142857142857143	208	10708	7	16	201	10692	10916	0.09588690621626964
M1	string	0	network_modules	61	TRUE	5.4973605214236444e-5	137	40	7	0.175	0.051094890510948905	GO:2001242	GO:BP	regulation of intrinsic apoptotic signaling pathway	16175	26431		0.5	0.5161290322580645	137	16038	7	33	130	16005	16175	0.09047888850108106
M1	string	0	network_modules	61	TRUE	1.0031845207771341e-4	44	40	5	0.125	0.11363636363636363	GO:2001244	GO:BP	positive regulation of intrinsic apoptotic signaling pathway	16175	26433		0.5333333333333333	0.5483870967741935	44	16131	5	35	39	16096	16175	0.11689269405536822
M1	string	0	network_modules	61	TRUE	3.1502670012052925e-4	55	40	5	0.125	0.09090909090909091	GO:0070059	GO:BP	intrinsic apoptotic signaling pathway in response to endoplasmic reticulum stress	16175	15896		0.5666666666666667	0.5806451612903226	55	16120	5	35	50	16085	16175	0.10400600324324749
M1	string	0	network_modules	61	TRUE	4.203008571168827e-4	275	40	8	0.2	0.02909090909090909	GO:2001233	GO:BP	regulation of apoptotic signaling pathway	16175	26422		0.6	0.6129032258064516	275	15900	8	32	267	15868	16175	0.07048104145885462
M1	string	0	network_modules	61	TRUE	0.0010803950985109232	8	40	3	0.075	0.375	GO:1903896	GO:BP	positive regulation of IRE1-mediated unfolded protein response	16175	23363		0.6333333333333333	0.6774193548387096	8	16167	3	37	5	16130	16175	0.16684680476007893
M1	string	0	network_modules	61	TRUE	0.0010803950985109232	8	40	3	0.075	0.375	GO:1902237	GO:BP	positive regulation of endoplasmic reticulum stress-induced intrinsic apoptotic signaling pathway	16175	22136		0.6333333333333333	0.6774193548387096	8	16167	3	37	5	16130	16175	0.16684680476007893
M1	string	0	network_modules	61	TRUE	0.0011648473921005494	30	40	4	0.1	0.13333333333333333	GO:1900101	GO:BP	regulation of endoplasmic reticulum unfolded protein response	16175	20393		0.7	0.7096774193548387	30	16145	4	36	26	16109	16175	0.11357417550416586
M1	string	0	network_modules	61	TRUE	0.0013969783197711086	2	23	2	0.08695652173913043	1	REAC:R-HSA-111452	REAC	Activation and oligomerization of BAK protein	10916	70		0.8333333333333334	0.8571428571428571	2	10914	2	21	0	10893	10916	0.29460007760859136
M1	string	0	network_modules	61	TRUE	0.0015230408846023259	32	40	4	0.1	0.125	GO:1905898	GO:BP	positive regulation of response to endoplasmic reticulum stress	16175	24996		0.7333333333333333	0.7419354838709677	32	16143	4	36	28	16107	16175	0.10983598386566454
M1	string	0	network_modules	61	TRUE	0.0024366152214626044	310	27	7	0.25925925925925924	0.02258064516129032	KEGG:05206	KEGG	MicroRNAs in cancer	8484	458		0.5	0.5714285714285714	310	8174	7	20	303	8154	8484	0.06707106748048697
M1	string	0	network_modules	61	TRUE	0.0029715539232616508	156	40	6	0.15	0.038461538461538464	GO:0006839	GO:BP	mitochondrial transport	16175	2508		0.7666666666666667	0.7741935483870968	156	16019	6	34	150	15985	16175	0.07150545842471542
M1	string	0	network_modules	61	TRUE	0.0029934803241665796	20	23	3	0.13043478260869565	0.15	REAC:R-HSA-6803204	REAC	TP53 Regulates Transcription of Genes Involved in Cytochrome C Release	10916	2458		1	1	20	10896	3	20	17	10876	10916	0.13818309942561657
M1	string	0	network_modules	61	TRUE	0.003389385700145731	798	40	11	0.275	0.013784461152882205	GO:0006974	GO:BP	DNA damage response	16175	2601		0.8	0.8064516129032258	798	15377	11	29	787	15348	16175	0.0518819146890684
M1	string	0	network_modules	61	TRUE	0.003736210115392576	90	40	5	0.125	0.05555555555555555	GO:2001235	GO:BP	positive regulation of apoptotic signaling pathway	16175	26424		0.8333333333333334	0.8387096774193549	90	16085	5	35	85	16050	16175	0.07994526489366949
M1	string	0	network_modules	61	TRUE	0.0038159433223050043	40	40	4	0.1	0.1	GO:0046902	GO:BP	regulation of mitochondrial membrane permeability	16175	12429		0.8666666666666667	0.8709677419354839	40	16135	4	36	36	16099	16175	0.0977688255345522
M1	string	0	network_modules	61	TRUE	0.004581437452479542	72	27	4	0.14814814814814814	0.05555555555555555	KEGG:01524	KEGG	Platinum drug resistance	8484	198		0.6666666666666666	0.7142857142857143	72	8412	4	23	68	8389	8484	0.0860271357702754
M1	string	0	network_modules	61	TRUE	0.00488136896721284	95	40	5	0.125	0.05263157894736842	GO:0007006	GO:BP	mitochondrial membrane organization	16175	2618		0.9	0.9032258064516129	95	16080	5	35	90	16045	16175	0.07762367999934784
M1	string	0	network_modules	61	TRUE	0.00510178093998154	74	27	4	0.14814814814814814	0.05405405405405406	KEGG:04115	KEGG	p53 signaling pathway	8484	269		0.8333333333333334	0.8571428571428571	74	8410	4	23	70	8387	8484	0.08472348495355365
M1	string	0	network_modules	61	TRUE	0.005412020283635787	173	40	6	0.15	0.03468208092485549	GO:0031334	GO:BP	positive regulation of protein-containing complex assembly	16175	7125		0.9333333333333333	0.9354838709677419	173	16002	6	34	167	15968	16175	0.06742868745627949
M1	string	0	network_modules	61	TRUE	0.008673366523155058	15	40	3	0.075	0.2	GO:1903894	GO:BP	regulation of IRE1-mediated unfolded protein response	16175	23361		0.9666666666666667	0.967741935483871	15	16160	3	37	12	16123	16175	0.12116615688344903
M1	string	0	network_modules	61	TRUE	0.009173319373445472	86	27	4	0.14814814814814814	0.046511627906976744	KEGG:05210	KEGG	Colorectal cancer	8484	461		1	1	86	8398	4	23	82	8375	8484	0.07784885705341049
M1	string	0	network_modules	61	TRUE	0.009960533478422594	420	40	8	0.2	0.01904761904761905	GO:0010638	GO:BP	positive regulation of organelle organization	16175	4284		1	1	420	15755	8	32	412	15723	16175	0.05448664422991174
M1	string	0	network_modules	63	TRUE	6.71385317615002e-12	12	21	6	0.2857142857142857	0.5	REAC:R-HSA-4641265	REAC	Repression of WNT target genes	10916	2063		0	0.16666666666666666	12	10904	6	15	6	10889	10916	0.37708023577117344
M1	string	0	network_modules	63	TRUE	3.678999564007887e-8	42	21	6	0.2857142857142857	0.14285714285714285	REAC:R-HSA-3769402	REAC	Deactivation of the beta-catenin transactivating complex	10916	452		0.2	0.3333333333333333	42	10874	6	15	36	10859	10916	0.19988677135298819
M1	string	0	network_modules	63	TRUE	2.521817368734967e-6	83	21	6	0.2857142857142857	0.07228915662650602	REAC:R-HSA-195253	REAC	Degradation of beta-catenin by the destruction complex	10916	724		0.4	0.5	83	10833	6	15	77	10818	10916	0.14056071045080518
M1	string	0	network_modules	63	TRUE	3.419147286513473e-6	174	19	7	0.3684210526315789	0.040229885057471264	KEGG:04310	KEGG	Wnt signaling pathway	8484	299		0	0.5	174	8310	7	12	167	8298	8484	0.11629420531884606
M1	string	0	network_modules	63	TRUE	4.1254956843962e-6	90	21	6	0.2857142857142857	0.06666666666666667	REAC:R-HSA-201722	REAC	Formation of the beta-catenin:TCF transactivating complex	10916	968		0.6	0.6666666666666666	90	10826	6	15	84	10811	10916	0.13471611629320632
M1	string	0	network_modules	63	TRUE	4.417054223493919e-5	543	38	11	0.2894736842105263	0.020257826887661142	GO:0009887	GO:BP	animal organ morphogenesis	16175	3747		0	0.05555555555555555	543	15632	11	27	532	15605	16175	0.0689435254989842
M1	string	0	network_modules	63	TRUE	4.5796607745791524e-5	309	38	9	0.23684210526315788	0.02912621359223301	GO:0048598	GO:BP	embryonic morphogenesis	16175	12865		0.058823529411764705	0.1111111111111111	309	15866	9	29	300	15837	16175	0.07718751346797273
M1	string	0	network_modules	63	TRUE	2.9841198917479394e-4	512	38	10	0.2631578947368421	0.01953125	GO:0009790	GO:BP	embryo development	16175	3677		0.11764705882352941	0.16666666666666666	512	15663	10	28	502	15635	16175	0.06416688186772682
M1	string	0	network_modules	63	TRUE	4.995771577056866e-4	60	19	4	0.21052631578947367	0.06666666666666667	KEGG:04330	KEGG	Notch signaling pathway	8484	301		1	1	60	8424	4	15	56	8409	8484	0.11502594019195285
M1	string	0	network_modules	63	TRUE	5.202714954876891e-4	327	21	7	0.3333333333333333	0.021406727828746176	REAC:R-HSA-195721	REAC	Signaling by WNT	10916	2314		0.8	0.8333333333333334	327	10589	7	14	320	10575	10916	0.07813422275151355
M1	string	0	network_modules	63	TRUE	0.0011075056200902254	231	21	6	0.2857142857142857	0.025974025974025976	REAC:R-HSA-201681	REAC	TCF dependent signaling in response to WNT	10916	2421		1	1	231	10685	6	15	225	10670	10916	0.08070091940101949
M1	string	0	network_modules	63	TRUE	0.0012164048342505937	225	38	7	0.18421052631578946	0.03111111111111111	GO:0003002	GO:BP	regionalization	16175	1453		0.17647058823529413	0.2222222222222222	225	15950	7	31	218	15919	16175	0.07056155922588539
M1	string	0	network_modules	63	TRUE	0.0016083415700141198	146	38	6	0.15789473684210525	0.0410958904109589	GO:0030178	GO:BP	negative regulation of Wnt signaling pathway	16175	6698		0.23529411764705882	0.2777777777777778	146	16029	6	32	140	15997	16175	0.07638318202897419
M1	string	0	network_modules	63	TRUE	0.0016743155861489339	345	38	8	0.21052631578947367	0.02318840579710145	GO:0016055	GO:BP	Wnt signaling pathway	16175	5087		0.29411764705882354	0.3333333333333333	345	15830	8	30	337	15800	16175	0.0635461389048805
M1	string	0	network_modules	63	TRUE	0.0024613034991174095	250	38	7	0.18421052631578946	0.028	GO:0007389	GO:BP	pattern specification process	16175	2889		0.35294117647058826	0.3888888888888889	250	15925	7	31	243	15894	16175	0.06638508579272122
M1	string	0	network_modules	63	TRUE	0.0027345801585723657	38	38	4	0.10526315789473684	0.10526315789473684	GO:2000027	GO:BP	regulation of animal organ morphogenesis	16175	25390		0.4117647058823529	0.4444444444444444	38	16137	4	34	34	16103	16175	0.10315619873256297
M1	string	0	network_modules	63	TRUE	0.0029521105086528763	11	38	3	0.07894736842105263	0.2727272727272727	GO:0051256	GO:BP	mitotic spindle midzone assembly	16175	13603		0.47058823529411764	0.5	11	16164	3	35	8	16129	16175	0.14569153312358943
M1	string	0	network_modules	63	TRUE	0.0029579399315379797	257	38	7	0.18421052631578946	0.027237354085603113	GO:0060070	GO:BP	canonical Wnt signaling pathway	16175	14332		0.5294117647058824	0.5555555555555556	257	15918	7	31	250	15887	16175	0.06532121688080704
M1	string	0	network_modules	63	TRUE	0.003929761309149143	12	38	3	0.07894736842105263	0.25	GO:0051255	GO:BP	spindle midzone assembly	16175	13602		0.5882352941176471	0.6666666666666666	12	16163	3	35	9	16128	16175	0.13938315158677447
M1	string	0	network_modules	63	TRUE	0.003929761309149143	12	38	3	0.07894736842105263	0.25	GO:0000022	GO:BP	mitotic spindle elongation	16175	8		0.5882352941176471	0.6666666666666666	12	16163	3	35	9	16128	16175	0.13938315158677447
M1	string	0	network_modules	63	TRUE	0.0048610918039648544	277	38	7	0.18421052631578946	0.02527075812274368	GO:0030111	GO:BP	regulation of Wnt signaling pathway	16175	6681		0.7058823529411765	0.7222222222222222	277	15898	7	31	270	15867	16175	0.062495951725902166
M1	string	0	network_modules	63	TRUE	0.005100401817253113	13	38	3	0.07894736842105263	0.23076923076923078	GO:0072074	GO:BP	kidney mesenchyme development	16175	17108		0.7647058823529411	0.8333333333333334	13	16162	3	35	10	16127	16175	0.1338132761058742
M1	string	0	network_modules	63	TRUE	0.005100401817253113	13	38	3	0.07894736842105263	0.23076923076923078	GO:0051231	GO:BP	spindle elongation	16175	13582		0.7647058823529411	0.8333333333333334	13	16162	3	35	10	16127	16175	0.1338132761058742
M1	string	0	network_modules	63	TRUE	0.008087971561124991	15	38	3	0.07894736842105263	0.2	GO:0090189	GO:BP	regulation of branching involved in ureteric bud morphogenesis	16175	18095		0.8823529411764706	0.8888888888888888	15	16160	3	35	12	16125	16175	0.1243839630022159
M1	string	0	network_modules	63	TRUE	0.008142910417612755	2	38	2	0.05263157894736842	1	GO:0072095	GO:BP	regulation of branch elongation involved in ureteric bud branching	16175	17128		0.9411764705882353	0.9444444444444444	2	16173	2	36	0	16137	16175	0.22916025970014609
M1	string	0	network_modules	63	TRUE	0.009938280245601163	16	38	3	0.07894736842105263	0.1875	GO:0110110	GO:BP	positive regulation of animal organ morphogenesis	16175	19421		1	1	16	16159	3	35	13	16124	16175	0.12034254458480281
M1	string	0	network_modules	64	TRUE	2.3957635569900364e-20	182	33	18	0.5454545454545454	0.0989010989010989	KEGG:04621	KEGG	NOD-like receptor signaling pathway	8484	326		0	0.1111111111111111	182	8302	18	15	164	8287	8484	0.22600070646573198
M1	string	0	network_modules	64	TRUE	2.9647368014646817e-18	594	36	21	0.5833333333333334	0.03535353535353535	GO:0006954	GO:BP	inflammatory response	16175	2585		0	0.012195121951219513	594	15581	21	15	573	15566	16175	0.1372599736631098
M1	string	0	network_modules	64	TRUE	2.081808318109603e-16	81	36	12	0.3333333333333333	0.14814814814814814	GO:0032611	GO:BP	interleukin-1 beta production	16175	7659		0.012345679012345678	0.036585365853658534	81	16094	12	24	69	16070	16175	0.2196784596348961
M1	string	0	network_modules	64	TRUE	2.081808318109603e-16	81	36	12	0.3333333333333333	0.14814814814814814	GO:0032651	GO:BP	regulation of interleukin-1 beta production	16175	7698		0.012345679012345678	0.036585365853658534	81	16094	12	24	69	16070	16175	0.2196784596348961
M1	string	0	network_modules	64	TRUE	1.0519519449057231e-15	92	36	12	0.3333333333333333	0.13043478260869565	GO:0032612	GO:BP	interleukin-1 production	16175	7660		0.037037037037037035	0.06097560975609756	92	16083	12	24	80	16059	16175	0.20577094381178512
M1	string	0	network_modules	64	TRUE	1.0519519449057231e-15	92	36	12	0.3333333333333333	0.13043478260869565	GO:0032652	GO:BP	regulation of interleukin-1 production	16175	7699		0.037037037037037035	0.06097560975609756	92	16083	12	24	80	16059	16175	0.20577094381178512
M1	string	0	network_modules	64	TRUE	1.813629096455217e-14	55	28	10	0.35714285714285715	0.18181818181818182	REAC:R-HSA-168643	REAC	Nucleotide-binding domain, leucine rich repeat containing receptor (NLR) signaling pathways	10916	1628		0	0.058823529411764705	55	10861	10	18	45	10843	10916	0.25218756268165815
M1	string	0	network_modules	64	TRUE	4.3303999499943036e-14	56	36	10	0.2777777777777778	0.17857142857142858	GO:0032731	GO:BP	positive regulation of interleukin-1 beta production	16175	7776		0.06172839506172839	0.07317073170731707	56	16119	10	26	46	16093	16175	0.22056913747922122
M1	string	0	network_modules	64	TRUE	1.5384504239227838e-13	63	36	10	0.2777777777777778	0.15873015873015872	GO:0032732	GO:BP	positive regulation of interleukin-1 production	16175	7777		0.07407407407407407	0.08536585365853659	63	16112	10	26	53	16086	16175	0.20767160090937645
M1	string	0	network_modules	64	TRUE	1.8247416470242786e-12	299	36	14	0.3888888888888889	0.046822742474916385	GO:0050727	GO:BP	regulation of inflammatory response	16175	13226		0.08641975308641975	0.0975609756097561	299	15876	14	22	285	15854	16175	0.12987520792746918
M1	string	0	network_modules	64	TRUE	1.216383728111344e-11	654	36	17	0.4722222222222222	0.02599388379204893	GO:0031347	GO:BP	regulation of defense response	16175	7138		0.09876543209876543	0.10975609756097561	654	15521	17	19	637	15502	16175	0.10353341467316737
M1	string	0	network_modules	64	TRUE	4.893644182399061e-11	12	28	6	0.21428571428571427	0.5	REAC:R-HSA-6803207	REAC	TP53 Regulates Transcription of Caspase Activators and Caspases	10916	2453		0.0625	0.11764705882352941	12	10904	6	22	6	10882	10916	0.32624544696043073
M1	string	0	network_modules	64	TRUE	1.5647302732340805e-10	634	36	16	0.4444444444444444	0.025236593059936908	GO:0001817	GO:BP	regulation of cytokine production	16175	474		0.1111111111111111	0.12195121951219512	634	15541	16	20	618	15521	16175	0.09862662341192067
M1	string	0	network_modules	64	TRUE	1.7241341101606303e-10	638	36	16	0.4444444444444444	0.025078369905956112	GO:0001816	GO:BP	cytokine production	16175	473		0.12345679012345678	0.13414634146341464	638	15537	16	20	622	15517	16175	0.09826961411890052
M1	string	0	network_modules	64	TRUE	2.1908722637518227e-10	423	36	14	0.3888888888888889	0.03309692671394799	GO:0031349	GO:BP	positive regulation of defense response	16175	7140		0.13580246913580246	0.14634146341463414	423	15752	14	22	409	15730	16175	0.1073523495720498
M1	string	0	network_modules	64	TRUE	1.0282909264779e-9	33	36	7	0.19444444444444445	0.21212121212121213	GO:0070269	GO:BP	pyroptotic inflammatory response	16175	16029		0.14814814814814814	0.15853658536585366	33	16142	7	29	26	16113	16175	0.20138924263529667
M1	string	0	network_modules	64	TRUE	1.4141734078345487e-9	8	28	5	0.17857142857142858	0.625	REAC:R-HSA-9012546	REAC	Interleukin-18 signaling	10916	1239		0.125	0.17647058823529413	8	10908	5	23	3	10885	10916	0.333255142716289
M1	string	0	network_modules	64	TRUE	1.999850776154829e-9	36	36	7	0.19444444444444445	0.19444444444444445	GO:0140632	GO:BP	canonical inflammasome complex assembly	16175	19839		0.16049382716049382	0.17073170731707318	36	16139	7	29	29	16110	16175	0.19264755492216917
M1	string	0	network_modules	64	TRUE	2.4838515932187406e-9	227	36	11	0.3055555555555556	0.048458149779735685	GO:0002221	GO:BP	pattern recognition receptor signaling pathway	16175	755		0.1728395061728395	0.18292682926829268	227	15948	11	25	216	15923	16175	0.11704742260157572
M1	string	0	network_modules	64	TRUE	2.787851203913269e-9	403	36	13	0.3611111111111111	0.03225806451612903	GO:0001819	GO:BP	positive regulation of cytokine production	16175	476		0.18518518518518517	0.1951219512195122	403	15772	13	23	390	15749	16175	0.10187180873934593
M1	string	0	network_modules	64	TRUE	3.66746794971056e-9	39	36	7	0.19444444444444445	0.1794871794871795	GO:0141084	GO:BP	inflammasome-mediated signaling pathway	16175	20015		0.19753086419753085	0.2073170731707317	39	16136	7	29	32	16107	16175	0.18492837969522916
M1	string	0	network_modules	64	TRUE	4.802278432594022e-9	531	36	14	0.3888888888888889	0.026365348399246705	GO:0032103	GO:BP	positive regulation of response to external stimulus	16175	7367		0.20987654320987653	0.21951219512195122	531	15644	14	22	517	15622	16175	0.09437561637367223
M1	string	0	network_modules	64	TRUE	5.2202280693672715e-9	243	36	11	0.3055555555555556	0.04526748971193416	GO:0002758	GO:BP	innate immune response-activating signaling pathway	16175	1269		0.2222222222222222	0.23170731707317074	243	15932	11	25	232	15907	16175	0.11280113578434367
M1	string	0	network_modules	64	TRUE	9.98896969655109e-9	345	36	12	0.3333333333333333	0.034782608695652174	GO:0051090	GO:BP	regulation of DNA-binding transcription factor activity	16175	13485		0.2345679012345679	0.24390243902439024	345	15830	12	24	333	15806	16175	0.10199233981002352
M1	string	0	network_modules	64	TRUE	1.2324188172908863e-8	263	36	11	0.3055555555555556	0.04182509505703422	GO:0002218	GO:BP	activation of innate immune response	16175	753		0.24691358024691357	0.25609756097560976	263	15912	11	25	252	15887	16175	0.10803369786325881
M1	string	0	network_modules	64	TRUE	2.685667572972541e-8	151	28	9	0.32142857142857145	0.059602649006622516	REAC:R-HSA-446652	REAC	Interleukin-1 family signaling	10916	1231		0.1875	0.23529411764705882	151	10765	9	19	142	10746	10916	0.13355286446450818
M1	string	0	network_modules	64	TRUE	3.705975832950445e-8	386	36	12	0.3333333333333333	0.031088082901554404	GO:0045088	GO:BP	regulation of innate immune response	16175	11271		0.25925925925925924	0.2682926829268293	386	15789	12	24	374	15765	16175	0.09576435786971771
M1	string	0	network_modules	64	TRUE	4.916984185071676e-8	149	36	9	0.25	0.06040268456375839	GO:0002753	GO:BP	cytoplasmic pattern recognition receptor signaling pathway	16175	1264		0.2716049382716049	0.2804878048780488	149	16026	9	27	140	15999	16175	0.119038329089899
M1	string	0	network_modules	64	TRUE	9.870110118478037e-8	319	36	11	0.3055555555555556	0.034482758620689655	GO:0045089	GO:BP	positive regulation of innate immune response	16175	11272		0.2839506172839506	0.2926829268292683	319	15856	11	25	308	15831	16175	0.09709091526463239
M1	string	0	network_modules	64	TRUE	9.895961634059272e-8	36	28	6	0.21428571428571427	0.16666666666666666	REAC:R-HSA-168638	REAC	NOD1/2 Signaling Pathway	10916	1529		0.25	0.29411764705882354	36	10880	6	22	30	10858	10916	0.18662083931664525
M1	string	0	network_modules	64	TRUE	1.17497265307439e-7	32	36	6	0.16666666666666666	0.1875	GO:2000116	GO:BP	regulation of cysteine-type endopeptidase activity	16175	25465		0.2962962962962963	0.3048780487804878	32	16143	6	30	26	16113	16175	0.17504627610530893
M1	string	0	network_modules	64	TRUE	1.7382634716983206e-7	34	36	6	0.16666666666666666	0.17647058823529413	GO:0044546	GO:BP	NLRP3 inflammasome complex assembly	16175	11065		0.30864197530864196	0.3170731707317073	34	16141	6	30	28	16111	16175	0.16970284439703978
M1	string	0	network_modules	64	TRUE	1.8915870259909887e-7	339	36	11	0.3055555555555556	0.032448377581120944	GO:0002833	GO:BP	positive regulation of response to biotic stimulus	16175	1343		0.32098765432098764	0.32926829268292684	339	15836	11	25	328	15811	16175	0.09383511453859077
M1	string	0	network_modules	64	TRUE	2.2458208750723995e-7	451	36	12	0.3333333333333333	0.026607538802660754	GO:0002831	GO:BP	regulation of response to biotic stimulus	16175	1341		0.3333333333333333	0.34146341463414637	451	15724	12	24	439	15700	16175	0.08762513605180725
M1	string	0	network_modules	64	TRUE	2.836466147685332e-7	721	36	14	0.3888888888888889	0.019417475728155338	GO:0045087	GO:BP	innate immune response	16175	11270		0.345679012345679	0.35365853658536583	721	15454	14	22	707	15432	16175	0.0787995491925618
M1	string	0	network_modules	64	TRUE	3.5370613694168334e-7	44	28	6	0.21428571428571427	0.13636363636363635	REAC:R-HSA-5633008	REAC	TP53 Regulates Transcription of Cell Death Genes	10916	2455		0.3125	0.35294117647058826	44	10872	6	22	38	10850	10916	0.16828043348741376
M1	string	0	network_modules	64	TRUE	3.8334815891282114e-7	20	28	5	0.17857142857142858	0.25	REAC:R-HSA-622312	REAC	Inflammasomes	10916	1184		0.375	0.4117647058823529	20	10896	5	23	15	10873	10916	0.2095815089933895
M1	string	0	network_modules	64	TRUE	4.139362110243669e-7	124	36	8	0.2222222222222222	0.06451612903225806	GO:0051092	GO:BP	positive regulation of NF-kappaB transcription factor activity	16175	13487		0.35802469135802467	0.3780487804878049	124	16051	8	28	116	16023	16175	0.1161812771250032
M1	string	0	network_modules	64	TRUE	4.139362110243669e-7	124	36	8	0.2222222222222222	0.06451612903225806	GO:0050729	GO:BP	positive regulation of inflammatory response	16175	13228		0.35802469135802467	0.3780487804878049	124	16051	8	28	116	16023	16175	0.1161812771250032
M1	string	0	network_modules	64	TRUE	5.290294258804082e-7	756	36	14	0.3888888888888889	0.018518518518518517	GO:0050776	GO:BP	regulation of immune response	16175	13250		0.38271604938271603	0.3902439024390244	756	15419	14	22	742	15397	16175	0.0765569972773021
M1	string	0	network_modules	64	TRUE	6.907952758258257e-7	627	36	13	0.3611111111111111	0.02073365231259968	GO:0050778	GO:BP	positive regulation of immune response	16175	13252		0.3950617283950617	0.4024390243902439	627	15548	13	23	614	15525	16175	0.07886977762020822
M1	string	0	network_modules	64	TRUE	1.658361854228977e-6	416	36	11	0.3055555555555556	0.026442307692307692	GO:0002757	GO:BP	immune response-activating signaling pathway	16175	1268		0.4074074074074074	0.4146341463414634	416	15759	11	25	405	15734	16175	0.08349320749557791
M1	string	0	network_modules	64	TRUE	1.7647130199548705e-6	49	36	6	0.16666666666666666	0.12244897959183673	GO:0010803	GO:BP	regulation of tumor necrosis factor-mediated signaling pathway	16175	4417		0.41975308641975306	0.4268292682926829	49	16126	6	30	43	16096	16175	0.14063006166836658
M1	string	0	network_modules	64	TRUE	1.9716821040422335e-6	27	28	5	0.17857142857142858	0.18518518518518517	REAC:R-HSA-5620971	REAC	Pyroptosis	10916	1831		0.4375	0.47058823529411764	27	10889	5	23	22	10866	10916	0.17978233513103217
M1	string	0	network_modules	64	TRUE	2.7832964538759047e-6	437	36	11	0.3055555555555556	0.02517162471395881	GO:0002764	GO:BP	immune response-regulating signaling pathway	16175	1275		0.43209876543209874	0.43902439024390244	437	15738	11	25	426	15713	16175	0.08113851531370059
M1	string	0	network_modules	64	TRUE	5.4940137925702364e-6	27	36	5	0.1388888888888889	0.18518518518518517	GO:0032692	GO:BP	negative regulation of interleukin-1 production	16175	7738		0.4444444444444444	0.45121951219512196	27	16148	5	31	22	16117	16175	0.15875677638169897
M1	string	0	network_modules	64	TRUE	6.6592597070984544e-6	475	36	11	0.3055555555555556	0.023157894736842106	GO:0002253	GO:BP	activation of immune response	16175	785		0.4567901234567901	0.4634146341463415	475	15700	11	25	464	15675	16175	0.07726225294153384
M1	string	0	network_modules	64	TRUE	7.409866752885943e-6	10	36	4	0.1111111111111111	0.4	GO:0035655	GO:BP	interleukin-18-mediated signaling pathway	16175	9141		0.4691358024691358	0.5	10	16165	4	32	6	16133	16175	0.2099440838649764
M1	string	0	network_modules	64	TRUE	7.409866752885943e-6	10	36	4	0.1111111111111111	0.4	GO:0071351	GO:BP	cellular response to interleukin-18	16175	16603		0.4691358024691358	0.5	10	16165	4	32	6	16133	16175	0.2099440838649764
M1	string	0	network_modules	64	TRUE	7.409866752885943e-6	10	36	4	0.1111111111111111	0.4	GO:0070673	GO:BP	response to interleukin-18	16175	16254		0.4691358024691358	0.5	10	16165	4	32	6	16133	16175	0.2099440838649764
M1	string	0	network_modules	64	TRUE	9.191893449733033e-6	625	36	12	0.3333333333333333	0.0192	GO:0034097	GO:BP	response to cytokine	16175	8408		0.5061728395061729	0.524390243902439	625	15550	12	24	613	15526	16175	0.07221418545890616
M1	string	0	network_modules	64	TRUE	9.191893449733033e-6	625	36	12	0.3333333333333333	0.0192	GO:1901652	GO:BP	response to peptide	16175	21619		0.5061728395061729	0.524390243902439	625	15550	12	24	613	15526	16175	0.07221418545890616
M1	string	0	network_modules	64	TRUE	1.5997472399004815e-5	33	36	5	0.1388888888888889	0.15151515151515152	GO:1900225	GO:BP	regulation of NLRP3 inflammasome complex assembly	16175	20497		0.5308641975308642	0.5365853658536586	33	16142	5	31	28	16111	16175	0.143239327881672
M1	string	0	network_modules	64	TRUE	2.5030511521305337e-5	208	36	8	0.2222222222222222	0.038461538461538464	GO:0051091	GO:BP	positive regulation of DNA-binding transcription factor activity	16175	13486		0.5432098765432098	0.5487804878048781	208	15967	8	28	200	15939	16175	0.08776342527104768
M1	string	0	network_modules	64	TRUE	2.5109216033831086e-5	13	36	4	0.1111111111111111	0.3076923076923077	GO:1900226	GO:BP	negative regulation of NLRP3 inflammasome complex assembly	16175	20498		0.5555555555555556	0.5609756097560976	13	16162	4	32	9	16130	16175	0.1838411196575415
M1	string	0	network_modules	64	TRUE	2.5289270474484963e-5	36	36	5	0.1388888888888889	0.1388888888888889	GO:0141085	GO:BP	regulation of inflammasome-mediated signaling pathway	16175	20016		0.5679012345679012	0.573170731707317	36	16139	5	31	31	16108	16175	0.1369680759512843
M1	string	0	network_modules	64	TRUE	2.552521294131574e-5	302	36	9	0.25	0.029801324503311258	GO:0030522	GO:BP	intracellular receptor signaling pathway	16175	6836		0.5802469135802469	0.5853658536585366	302	15873	9	27	293	15846	16175	0.08071508850553837
M1	string	0	network_modules	64	TRUE	2.8614864861802177e-5	77	36	6	0.16666666666666666	0.07792207792207792	GO:0052548	GO:BP	regulation of endopeptidase activity	16175	14134		0.5925925925925926	0.5975609756097561	77	16098	6	30	71	16068	16175	0.11109371133527808
M1	string	0	network_modules	64	TRUE	2.9333011300340907e-5	419	36	10	0.2777777777777778	0.02386634844868735	GO:0019221	GO:BP	cytokine-mediated signaling pathway	16175	5598		0.6049382716049383	0.6097560975609756	419	15756	10	26	409	15730	16175	0.07488759593702371
M1	string	0	network_modules	64	TRUE	3.34114577331494e-5	555	36	11	0.3055555555555556	0.01981981981981982	GO:0071345	GO:BP	cellular response to cytokine stimulus	16175	16597		0.6172839506172839	0.6219512195121951	555	15620	11	25	544	15595	16175	0.07037676740926245
M1	string	0	network_modules	64	TRUE	4.7730039026714374e-5	197	33	8	0.24242424242424243	0.04060913705583756	KEGG:05130	KEGG	Pathogenic Escherichia coli infection	8484	427		0.125	0.2222222222222222	197	8287	8	25	189	8262	8484	0.09095370538537972
M1	string	0	network_modules	64	TRUE	4.7784144941800365e-5	15	36	4	0.1111111111111111	0.26666666666666666	GO:0141086	GO:BP	negative regulation of inflammasome-mediated signaling pathway	16175	20017		0.6296296296296297	0.6341463414634146	15	16160	4	32	11	16128	16175	0.17096550220996462
M1	string	0	network_modules	64	TRUE	4.8513930080323225e-5	84	36	6	0.16666666666666666	0.07142857142857142	GO:0033209	GO:BP	tumor necrosis factor-mediated signaling pathway	16175	8075		0.6419753086419753	0.6463414634146342	84	16091	6	30	78	16061	16175	0.10610289638027932
M1	string	0	network_modules	64	TRUE	4.969140677962438e-5	443	36	10	0.2777777777777778	0.022573363431151242	GO:0009617	GO:BP	response to bacterium	16175	3543		0.654320987654321	0.6585365853658537	443	15732	10	26	433	15706	16175	0.07245695655222818
M1	string	0	network_modules	64	TRUE	6.704406417267944e-5	21	28	4	0.14285714285714285	0.19047619047619047	REAC:R-HSA-9008059	REAC	Interleukin-37 signaling	10916	1250		0.5	0.5294117647058824	21	10895	4	24	17	10871	10916	0.163101904366655
M1	string	0	network_modules	64	TRUE	8.662202633491421e-5	244	36	8	0.2222222222222222	0.03278688524590164	GO:0042742	GO:BP	defense response to bacterium	16175	10335		0.6666666666666666	0.6707317073170732	244	15931	8	28	236	15903	16175	0.08025995809811945
M1	string	0	network_modules	64	TRUE	1.0596759071129926e-4	58	28	5	0.17857142857142858	0.08620689655172414	REAC:R-HSA-5218859	REAC	Regulated Necrosis	10916	1959		0.5625	0.5882352941176471	58	10858	5	23	53	10835	10916	0.12085738308870352
M1	string	0	network_modules	64	TRUE	1.1115525892257441e-4	252	36	8	0.2222222222222222	0.031746031746031744	GO:0043122	GO:BP	regulation of canonical NF-kappaB signal transduction	16175	10541		0.6790123456790124	0.6829268292682927	252	15923	8	28	244	15895	16175	0.07880693175171152
M1	string	0	network_modules	64	TRUE	1.1206975381410375e-4	483	36	10	0.2777777777777778	0.020703933747412008	GO:0051604	GO:BP	protein maturation	16175	13821		0.691358024691358	0.6951219512195121	483	15692	10	26	473	15666	16175	0.06879400820885515
M1	string	0	network_modules	64	TRUE	1.4071074149802672e-4	25	28	4	0.14285714285714285	0.16	REAC:R-HSA-9664424	REAC	Cell recruitment (pro-inflammatory response)	10916	325		0.625	0.7058823529411765	25	10891	4	24	21	10867	10916	0.1491240715591102
M1	string	0	network_modules	64	TRUE	1.4071074149802672e-4	25	28	4	0.14285714285714285	0.16	REAC:R-HSA-9660826	REAC	Purinergic signaling in leishmaniasis infection	10916	1826		0.625	0.7058823529411765	25	10891	4	24	21	10867	10916	0.1491240715591102
M1	string	0	network_modules	64	TRUE	1.6556044960526253e-4	103	36	6	0.16666666666666666	0.05825242718446602	GO:0052547	GO:BP	regulation of peptidase activity	16175	14133		0.7037037037037037	0.7073170731707317	103	16072	6	30	97	16042	16175	0.09517742846113547
M1	string	0	network_modules	64	TRUE	1.6612036176579965e-4	56	33	5	0.15151515151515152	0.08928571428571429	KEGG:05134	KEGG	Legionellosis	8484	431		0.25	0.3333333333333333	56	8428	5	28	51	8400	8484	0.11183020449284153
M1	string	0	network_modules	64	TRUE	2.0753327428221153e-4	21	36	4	0.1111111111111111	0.19047619047619047	GO:2001056	GO:BP	positive regulation of cysteine-type endopeptidase activity	16175	26298		0.7160493827160493	0.7195121951219512	21	16154	4	32	17	16122	16175	0.1440325176618291
M1	string	0	network_modules	64	TRUE	2.3163797480100265e-4	208	28	7	0.25	0.03365384615384615	REAC:R-HSA-5357801	REAC	Programmed Cell Death	10916	1803		0.75	0.7647058823529411	208	10708	7	21	201	10687	10916	0.0856627389995038
M1	string	0	network_modules	64	TRUE	2.500349068223484e-4	280	36	8	0.2222222222222222	0.02857142857142857	GO:0007249	GO:BP	canonical NF-kappaB signal transduction	16175	2783		0.7283950617283951	0.7317073170731707	280	15895	8	28	272	15867	16175	0.07420179335660745
M1	string	0	network_modules	64	TRUE	2.790261384813282e-4	249	33	8	0.24242424242424243	0.0321285140562249	KEGG:05132	KEGG	Salmonella infection	8484	429		0.375	0.4444444444444444	249	8235	8	25	241	8210	8484	0.07888680262480066
M1	string	0	network_modules	64	TRUE	3.0608099912709396e-4	23	36	4	0.1111111111111111	0.17391304347826086	GO:0032691	GO:BP	negative regulation of interleukin-1 beta production	16175	7737		0.7407407407407407	0.7439024390243902	23	16152	4	32	19	16120	16175	0.13748138009506247
M1	string	0	network_modules	64	TRUE	3.9465673318980825e-4	198	36	7	0.19444444444444445	0.03535353535353535	GO:0016485	GO:BP	protein processing	16175	5233		0.7530864197530864	0.7560975609756098	198	15977	7	29	191	15948	16175	0.07825882627182594
M1	string	0	network_modules	64	TRUE	5.404150626666033e-4	472	28	9	0.32142857142857145	0.019067796610169493	REAC:R-HSA-449147	REAC	Signaling by Interleukins	10916	2261		0.8125	0.8235294117647058	472	10444	9	19	463	10425	10916	0.06935926163533268
M1	string	0	network_modules	64	TRUE	7.238324415233935e-4	132	36	6	0.16666666666666666	0.045454545454545456	GO:0001959	GO:BP	regulation of cytokine-mediated signaling pathway	16175	568		0.7654320987654321	0.7682926829268293	132	16043	6	30	126	16013	16175	0.083209511403873615
M1	string	0	network_modules	64	TRUE	8.718289431065903e-4	135	33	6	0.18181818181818182	0.044444444444444446	KEGG:04210	KEGG	Apoptosis	8484	287		0.5	0.5555555555555556	135	8349	6	27	129	8322	8484	0.0828478481874971
M1	string	0	network_modules	64	TRUE	9.095635046232753e-4	136	33	6	0.18181818181818182	0.04411764705882353	KEGG:05135	KEGG	Yersinia infection	8484	432		0.625	0.6666666666666666	136	8348	6	27	130	8321	8484	0.08248899573149515
M1	string	0	network_modules	64	TRUE	9.701339779040485e-4	8	36	3	0.08333333333333333	0.375	GO:0002579	GO:BP	positive regulation of antigen processing and presentation	16175	1100		0.7777777777777778	0.7804878048780488	8	16167	3	33	5	16134	16175	0.17596691334509712
M1	string	0	network_modules	64	TRUE	0.0010168827469334955	74	36	5	0.1388888888888889	0.06756756756756757	GO:1901222	GO:BP	regulation of non-canonical NF-kappaB signal transduction	16175	21316		0.7901234567901234	0.7926829268292683	74	16101	5	31	69	16070	16175	0.09400176167466856
M1	string	0	network_modules	64	TRUE	0.0010249618828295634	228	36	7	0.19444444444444445	0.03070175438596491	GO:0001818	GO:BP	negative regulation of cytokine production	16175	475		0.8024691358024691	0.8048780487804879	228	15947	7	29	221	15918	16175	0.0722542048331202
M1	string	0	network_modules	64	TRUE	0.0011044692805991766	82	33	5	0.15151515151515152	0.06097560975609756	KEGG:04623	KEGG	Cytosolic DNA-sensing pathway	8484	328		0.75	0.7777777777777778	82	8402	5	28	77	8374	8484	0.09060128261315743
M1	string	0	network_modules	64	TRUE	0.001160080211778172	143	36	6	0.16666666666666666	0.04195804195804196	GO:0060759	GO:BP	regulation of response to cytokine stimulus	16175	14927		0.8148148148148148	0.8170731707317073	143	16032	6	30	137	16002	16175	0.07962941601858928
M1	string	0	network_modules	64	TRUE	0.0012412620020314112	77	36	5	0.1388888888888889	0.06493506493506493	GO:0032088	GO:BP	negative regulation of NF-kappaB transcription factor activity	16175	7355		0.8271604938271605	0.8292682926829268	77	16098	5	31	72	16067	16175	0.09203368905173237
M1	string	0	network_modules	64	TRUE	0.0019535209579725067	251	36	7	0.19444444444444445	0.027888446215139442	GO:0071214	GO:BP	cellular response to abiotic stimulus	16175	16476		0.8395061728395061	0.8536585365853658	251	15924	7	29	244	15895	16175	0.06837059562115153
M1	string	0	network_modules	64	TRUE	0.0019535209579725067	251	36	7	0.19444444444444445	0.027888446215139442	GO:0104004	GO:BP	cellular response to environmental stimulus	16175	19202		0.8395061728395061	0.8536585365853658	251	15924	7	29	244	15895	16175	0.06837059562115153
M1	string	0	network_modules	64	TRUE	0.0021150141328265793	2	28	2	0.07142857142857142	1	REAC:R-HSA-844623	REAC	The IPAF inflammasome	10916	2495		0.875	0.8823529411764706	2	10914	2	26	0	10888	10916	0.26694270903326517
M1	string	0	network_modules	64	TRUE	0.002245713298572184	15	28	3	0.10714285714285714	0.2	REAC:R-HSA-844456	REAC	The NLRP3 inflammasome	10916	2497		0.9375	0.9411764705882353	15	10901	3	25	12	10876	10916	0.14479279991507416
M1	string	0	network_modules	64	TRUE	0.0025879373867681733	164	36	6	0.16666666666666666	0.036585365853658534	GO:0071356	GO:BP	cellular response to tumor necrosis factor	16175	16608		0.8641975308641975	0.8658536585365854	164	16011	6	30	158	15981	16175	0.07379329455268832
M1	string	0	network_modules	64	TRUE	0.0027359282491605966	246	33	7	0.21212121212121213	0.028455284552845527	KEGG:05131	KEGG	Shigellosis	8484	428		0.875	0.8888888888888888	246	8238	7	26	239	8212	8484	0.06819834715489086
M1	string	0	network_modules	64	TRUE	0.0030750633831819535	40	36	4	0.1111111111111111	0.1	GO:0010950	GO:BP	positive regulation of endopeptidase activity	16175	4528		0.8765432098765432	0.8780487804878049	40	16135	4	32	36	16103	16175	0.10330590481434206
M1	string	0	network_modules	64	TRUE	0.004446701482554502	180	36	6	0.16666666666666666	0.03333333333333333	GO:0034612	GO:BP	response to tumor necrosis factor	16175	8690		0.8888888888888888	0.8902439024390244	180	15995	6	30	174	15965	16175	0.07002714681188613
M1	string	0	network_modules	64	TRUE	0.005027558747146411	102	36	5	0.1388888888888889	0.049019607843137254	GO:0038061	GO:BP	non-canonical NF-kappaB signal transduction	16175	9680		0.9012345679012346	0.9024390243902439	102	16073	5	31	97	16042	16175	0.0791035651487685
M1	string	0	network_modules	64	TRUE	0.005275619884776061	103	36	5	0.1388888888888889	0.04854368932038835	GO:0039531	GO:BP	regulation of cytoplasmic pattern recognition receptor signaling pathway	16175	9804		0.9135802469135802	0.9146341463414634	103	16072	5	31	98	16041	16175	0.0786843716875623
M1	string	0	network_modules	64	TRUE	0.00624821086171651	14	36	3	0.08333333333333333	0.21428571428571427	GO:0032495	GO:BP	response to muramyl dipeptide	16175	7606		0.9259259259259259	0.926829268292683	14	16161	3	33	11	16128	16175	0.13244742079327596
M1	string	0	network_modules	64	TRUE	0.0063349653657779805	3	28	2	0.07142857142857142	0.6666666666666666	REAC:R-HSA-844615	REAC	The AIM2 inflammasome	10916	2494		1	1	3	10913	2	26	1	10887	10916	0.21768752796802934
M1	string	0	network_modules	64	TRUE	0.006464759329523797	48	36	4	0.1111111111111111	0.08333333333333333	GO:0071260	GO:BP	cellular response to mechanical stimulus	16175	16518		0.9382716049382716	0.9512195121951219	48	16127	4	32	44	16095	16175	0.09389890200670173
M1	string	0	network_modules	64	TRUE	0.006464759329523797	48	36	4	0.1111111111111111	0.08333333333333333	GO:0071496	GO:BP	cellular response to external stimulus	16175	16729		0.9382716049382716	0.9512195121951219	48	16127	4	32	44	16095	16175	0.09389890200670173
M1	string	0	network_modules	64	TRUE	0.006966066260638264	62	33	4	0.12121212121212122	0.06451612903225806	KEGG:05321	KEGG	Inflammatory bowel disease	8484	483		1	1	62	8422	4	29	58	8393	8484	0.08356800513135396
M1	string	0	network_modules	64	TRUE	0.007028268158106259	49	36	4	0.1111111111111111	0.08163265306122448	GO:0039532	GO:BP	negative regulation of cytoplasmic pattern recognition receptor signaling pathway	16175	9805		0.9629629629629629	0.9634146341463414	49	16126	4	32	45	16094	16175	0.09288556095502297
M1	string	0	network_modules	64	TRUE	0.007627336423873511	50	36	4	0.1111111111111111	0.08	GO:1901224	GO:BP	positive regulation of non-canonical NF-kappaB signal transduction	16175	21318		0.9753086419753086	0.975609756097561	50	16125	4	32	46	16093	16175	0.09190226614565224
M1	string	0	network_modules	64	TRUE	0.008937831716048512	52	36	4	0.1111111111111111	0.07692307692307693	GO:0010952	GO:BP	positive regulation of peptidase activity	16175	4530		0.9876543209876543	0.9878048780487805	52	16123	4	32	48	16091	16175	0.0900200137786174
M1	string	0	network_modules	64	TRUE	0.009583249739264846	16	36	3	0.08333333333333333	0.1875	GO:0016045	GO:BP	detection of bacterium	16175	5078		1	1	16	16159	3	33	13	16126	16175	0.12371511443697349
M1	string	0	network_modules	65	TRUE	4.711763958306687e-4	8	30	3	0.1	0.375	GO:0032060	GO:BP	bleb assembly	16175	7334		NA	1	8	16167	3	27	5	16140	16175	0.1929180533726307
M1	string	0	network_modules	66	TRUE	1.3278537685794202e-70	34	30	28	0.9333333333333333	0.8235294117647058	KEGG:03020	KEGG	RNA polymerase	8484	212		0	0.25	34	8450	28	2	6	8448	8484	0.8762546626001074
M1	string	0	network_modules	66	TRUE	4.1253174279035116e-41	18	36	17	0.4722222222222222	0.9444444444444444	REAC:R-HSA-73780	REAC	RNA Polymerase III Chain Elongation	10916	1897		0	0.012048192771084338	18	10898	17	19	1	10879	10916	0.6671414529858496
M1	string	0	network_modules	66	TRUE	2.294559266744935e-37	23	36	17	0.4722222222222222	0.7391304347826086	REAC:R-HSA-73980	REAC	RNA Polymerase III Transcription Termination	10916	1903		0.012195121951219513	0.024096385542168676	23	10893	17	19	6	10874	10916	0.5897486761420467
M1	string	0	network_modules	66	TRUE	1.9049906453976827e-35	27	36	17	0.4722222222222222	0.6296296296296297	REAC:R-HSA-76066	REAC	RNA Polymerase III Transcription Initiation From Type 2 Promoter	10916	1901		0.024390243902439025	0.03614457831325301	27	10889	17	19	10	10870	10916	0.5439889996526851
M1	string	0	network_modules	66	TRUE	4.841076909928817e-35	28	36	17	0.4722222222222222	0.6071428571428571	REAC:R-HSA-76071	REAC	RNA Polymerase III Transcription Initiation From Type 3 Promoter	10916	1902		0.036585365853658534	0.060240963855421686	28	10888	17	19	11	10869	10916	0.5341069437358471
M1	string	0	network_modules	66	TRUE	4.841076909928817e-35	28	36	17	0.4722222222222222	0.6071428571428571	REAC:R-HSA-76061	REAC	RNA Polymerase III Transcription Initiation From Type 1 Promoter	10916	1900		0.036585365853658534	0.060240963855421686	28	10888	17	19	11	10869	10916	0.5341069437358471
M1	string	0	network_modules	66	TRUE	1.9127825564599965e-32	36	36	17	0.4722222222222222	0.4722222222222222	REAC:R-HSA-76046	REAC	RNA Polymerase III Transcription Initiation	10916	1899		0.06097560975609756	0.07228915662650602	36	10880	17	19	19	10861	10916	0.4704758986928105
M1	string	0	network_modules	66	TRUE	3.3447529325758807e-31	41	36	17	0.4722222222222222	0.4146341463414634	REAC:R-HSA-749476	REAC	RNA Polymerase III Abortive And Retractive Initiation	10916	1896		0.07317073170731707	0.0963855421686747	41	10875	17	19	24	10856	10916	0.440526555243987
M1	string	0	network_modules	66	TRUE	3.3447529325758807e-31	41	36	17	0.4722222222222222	0.4146341463414634	REAC:R-HSA-74158	REAC	RNA Polymerase III Transcription	10916	1898		0.07317073170731707	0.0963855421686747	41	10875	17	19	24	10856	10916	0.440526555243987
M1	string	0	network_modules	66	TRUE	1.3410063393784502e-29	64	36	18	0.5	0.28125	REAC:R-HSA-1834949	REAC	Cytosolic sensors of pathogen-associated DNA 	10916	428		0.0975609756097561	0.10843373493975904	64	10852	18	18	46	10834	10916	0.3723084260846248
M1	string	0	network_modules	66	TRUE	7.45639876575419e-26	82	30	17	0.5666666666666667	0.2073170731707317	KEGG:04623	KEGG	Cytosolic DNA-sensing pathway	8484	328		0.3333333333333333	0.5	82	8402	17	13	65	8389	8484	0.3391471709425565
M1	string	0	network_modules	66	TRUE	6.50612627597471e-22	26	36	12	0.3333333333333333	0.46153846153846156	REAC:R-HSA-77075	REAC	RNA Pol II CTD phosphorylation and interaction with CE	10916	1879		0.10975609756097561	0.13253012048192772	26	10890	12	24	14	10866	10916	0.3905387040641217
M1	string	0	network_modules	66	TRUE	6.50612627597471e-22	26	36	12	0.3333333333333333	0.46153846153846156	REAC:R-HSA-167160	REAC	RNA Pol II CTD phosphorylation and interaction with CE during HIV infection	10916	1880		0.10975609756097561	0.13253012048192772	26	10890	12	24	14	10866	10916	0.3905387040641217
M1	string	0	network_modules	66	TRUE	8.502666075007762e-22	73	36	15	0.4166666666666667	0.2054794520547945	REAC:R-HSA-6807505	REAC	RNA polymerase II transcribes snRNA genes	10916	1904		0.13414634146341464	0.14457831325301204	73	10843	15	21	58	10822	10916	0.28935169574228686
M1	string	0	network_modules	66	TRUE	9.48121595591468e-22	18	36	11	0.3055555555555556	0.6111111111111112	REAC:R-HSA-8851708	REAC	Signaling by FGFR2 IIIa TM	10916	2245		0.14634146341463414	0.1566265060240964	18	10898	11	25	7	10873	10916	0.4308546724448641
M1	string	0	network_modules	66	TRUE	2.0411017068243104e-21	28	36	12	0.3333333333333333	0.42857142857142855	REAC:R-HSA-72086	REAC	mRNA Capping	10916	2702		0.15853658536585366	0.1686746987951807	28	10888	12	24	16	10864	10916	0.37615871445439175
M1	string	0	network_modules	66	TRUE	5.779547233278331e-21	30	36	12	0.3333333333333333	0.4	REAC:R-HSA-167238	REAC	Pausing and recovery of Tat-mediated HIV elongation	10916	1720		0.17073170731707318	0.1927710843373494	30	10886	12	24	18	10862	10916	0.3632359112280299
M1	string	0	network_modules	66	TRUE	5.779547233278331e-21	30	36	12	0.3333333333333333	0.4	REAC:R-HSA-167243	REAC	Tat-mediated HIV elongation arrest and recovery	10916	2484		0.17073170731707318	0.1927710843373494	30	10886	12	24	18	10862	10916	0.3632359112280299
M1	string	0	network_modules	66	TRUE	8.57932790815483e-21	56	36	13	0.3611111111111111	0.23214285714285715	GO:0006383	GO:BP	transcription by RNA polymerase III	16175	2148		0	0.09090909090909091	56	16119	13	23	43	16096	16175	0.28757501848250927
M1	string	0	network_modules	66	TRUE	9.410603724855455e-21	31	36	12	0.3333333333333333	0.3870967741935484	REAC:R-HSA-73863	REAC	RNA Polymerase I Transcription Termination	10916	1886		0.1951219512195122	0.20481927710843373	31	10885	12	24	19	10861	10916	0.3572466317719182
M1	string	0	network_modules	66	TRUE	1.502633198027874e-20	32	36	12	0.3333333333333333	0.375	REAC:R-HSA-167287	REAC	HIV elongation arrest and recovery	10916	1106		0.2073170731707317	0.2289156626506024	32	10884	12	24	20	10860	10916	0.35153903242312917
M1	string	0	network_modules	66	TRUE	1.502633198027874e-20	32	36	12	0.3333333333333333	0.375	REAC:R-HSA-167290	REAC	Pausing and recovery of HIV elongation	10916	1719		0.2073170731707317	0.2289156626506024	32	10884	12	24	20	10860	10916	0.35153903242312917
M1	string	0	network_modules	66	TRUE	2.0840482263853378e-20	22	36	11	0.3055555555555556	0.5	REAC:R-HSA-167242	REAC	Abortive elongation of HIV-1 transcript in the absence of Tat	10916	51		0.23170731707317074	0.24096385542168675	22	10894	11	25	11	10869	10916	0.3893242629826494
M1	string	0	network_modules	66	TRUE	3.98602509438703e-20	23	36	11	0.3055555555555556	0.4782608695652174	REAC:R-HSA-203927	REAC	MicroRNA (miRNA) biogenesis	10916	1449		0.24390243902439024	0.25301204819277107	23	10893	11	25	12	10868	10916	0.3806691970109275
M1	string	0	network_modules	66	TRUE	1.3085521845252937e-19	25	36	11	0.3055555555555556	0.44	REAC:R-HSA-6803529	REAC	FGFR2 alternative splicing	10916	905		0.25609756097560976	0.26506024096385544	25	10891	11	25	14	10866	10916	0.36493811404174265
M1	string	0	network_modules	66	TRUE	6.264440392196043e-19	28	36	11	0.3055555555555556	0.39285714285714285	REAC:R-HSA-5601884	REAC	PIWI-interacting RNA (piRNA) biogenesis	10916	1685		0.2682926829268293	0.27710843373493976	28	10888	11	25	17	10863	10916	0.34456906859810066
M1	string	0	network_modules	66	TRUE	7.210668702349704e-19	42	36	12	0.3333333333333333	0.2857142857142857	REAC:R-HSA-167169	REAC	HIV Transcription Elongation	10916	1104		0.2804878048780488	0.3132530120481928	42	10874	12	24	30	10850	10916	0.30613831192760643
M1	string	0	network_modules	66	TRUE	7.210668702349704e-19	42	36	12	0.3333333333333333	0.2857142857142857	REAC:R-HSA-167200	REAC	Formation of HIV-1 elongation complex containing HIV-1 Tat	10916	947		0.2804878048780488	0.3132530120481928	42	10874	12	24	30	10850	10916	0.30613831192760643
M1	string	0	network_modules	66	TRUE	7.210668702349704e-19	42	36	12	0.3333333333333333	0.2857142857142857	REAC:R-HSA-167246	REAC	Tat-mediated elongation of the HIV-1 transcript	10916	2485		0.2804878048780488	0.3132530120481928	42	10874	12	24	30	10850	10916	0.30613831192760643
M1	string	0	network_modules	66	TRUE	1.007147465071803e-18	29	36	11	0.3055555555555556	0.3793103448275862	REAC:R-HSA-1839126	REAC	FGFR2 mutant receptor activation	10916	907		0.3170731707317073	0.3253012048192771	29	10887	11	25	18	10862	10916	0.3384892825049823
M1	string	0	network_modules	66	TRUE	1.3696655613107524e-18	44	36	12	0.3333333333333333	0.2727272727272727	REAC:R-HSA-167152	REAC	Formation of HIV elongation complex in the absence of HIV Tat	10916	946		0.32926829268292684	0.3373493975903614	44	10872	12	24	32	10848	10916	0.2989608826619746
M1	string	0	network_modules	66	TRUE	3.3726063523122477e-18	47	36	12	0.3333333333333333	0.2553191489361702	REAC:R-HSA-73762	REAC	RNA Polymerase I Transcription Initiation	10916	1885		0.34146341463414637	0.3493975903614458	47	10869	12	24	35	10845	10916	0.2890607355579694
M1	string	0	network_modules	66	TRUE	3.7323175383130025e-18	32	36	11	0.3055555555555556	0.34375	REAC:R-HSA-167158	REAC	Formation of the HIV-1 Early Elongation Complex	10916	965		0.35365853658536583	0.37349397590361444	32	10884	11	25	21	10859	10916	0.3219841951008026
M1	string	0	network_modules	66	TRUE	3.7323175383130025e-18	32	36	11	0.3055555555555556	0.34375	REAC:R-HSA-113418	REAC	Formation of the Early Elongation Complex	10916	963		0.35365853658536583	0.37349397590361444	32	10884	11	25	21	10859	10916	0.3219841951008026
M1	string	0	network_modules	66	TRUE	5.282236634616112e-18	69	36	13	0.3611111111111111	0.18840579710144928	REAC:R-HSA-167172	REAC	Transcription of the HIV genome	10916	2540		0.3780487804878049	0.3855421686746988	69	10847	13	23	56	10824	10916	0.2575090370035906
M1	string	0	network_modules	66	TRUE	2.4473333393616815e-17	37	36	11	0.3055555555555556	0.2972972972972973	REAC:R-HSA-5655253	REAC	Signaling by FGFR2 in disease	10916	2248		0.3902439024390244	0.39759036144578314	37	10879	11	25	26	10854	10916	0.29905469566927523
M1	string	0	network_modules	66	TRUE	4.4730559077239403e-17	57	36	12	0.3333333333333333	0.21052631578947367	REAC:R-HSA-112382	REAC	Formation of RNA Pol II elongation complex 	10916	949		0.4024390243902439	0.42168674698795183	57	10859	12	24	45	10835	10916	0.26187233666926846
M1	string	0	network_modules	66	TRUE	4.4730559077239403e-17	57	36	12	0.3333333333333333	0.21052631578947367	REAC:R-HSA-75955	REAC	RNA Polymerase II Transcription Elongation	10916	1891		0.4024390243902439	0.42168674698795183	57	10859	12	24	45	10835	10916	0.26187233666926846
M1	string	0	network_modules	66	TRUE	6.57560137977489e-17	40	36	11	0.3055555555555556	0.275	REAC:R-HSA-168325	REAC	Viral Messenger RNA Synthesis	10916	2648		0.4268292682926829	0.43373493975903615	40	10876	11	25	29	10851	10916	0.2873996283267445
M1	string	0	network_modules	66	TRUE	1.0927663996417844e-16	61	36	12	0.3333333333333333	0.19672131147540983	REAC:R-HSA-6796648	REAC	TP53 Regulates Transcription of DNA Repair Genes	10916	2456		0.43902439024390244	0.4457831325301205	61	10855	12	24	49	10831	10916	0.2529046682988625
M1	string	0	network_modules	66	TRUE	3.7469029573728313e-16	46	36	11	0.3055555555555556	0.2391304347826087	REAC:R-HSA-73779	REAC	RNA Polymerase II Transcription Pre-Initiation And Promoter Opening	10916	1894		0.45121951219512196	0.5180722891566265	46	10870	11	25	35	10845	10916	0.2675874067937687
M1	string	0	network_modules	66	TRUE	3.7469029573728313e-16	46	36	11	0.3055555555555556	0.2391304347826087	REAC:R-HSA-167161	REAC	HIV Transcription Initiation	10916	1105		0.45121951219512196	0.5180722891566265	46	10870	11	25	35	10845	10916	0.2675874067937687
M1	string	0	network_modules	66	TRUE	3.7469029573728313e-16	46	36	11	0.3055555555555556	0.2391304347826087	REAC:R-HSA-76042	REAC	RNA Polymerase II Transcription Initiation And Promoter Clearance	10916	1893		0.45121951219512196	0.5180722891566265	46	10870	11	25	35	10845	10916	0.2675874067937687
M1	string	0	network_modules	66	TRUE	3.7469029573728313e-16	46	36	11	0.3055555555555556	0.2391304347826087	REAC:R-HSA-75953	REAC	RNA Polymerase II Transcription Initiation	10916	1892		0.45121951219512196	0.5180722891566265	46	10870	11	25	35	10845	10916	0.2675874067937687
M1	string	0	network_modules	66	TRUE	3.7469029573728313e-16	46	36	11	0.3055555555555556	0.2391304347826087	REAC:R-HSA-167162	REAC	RNA Polymerase II HIV Promoter Escape	10916	1887		0.45121951219512196	0.5180722891566265	46	10870	11	25	35	10845	10916	0.2675874067937687
M1	string	0	network_modules	66	TRUE	3.7469029573728313e-16	46	36	11	0.3055555555555556	0.2391304347826087	REAC:R-HSA-73776	REAC	RNA Polymerase II Promoter Escape	10916	1889		0.45121951219512196	0.5180722891566265	46	10870	11	25	35	10845	10916	0.2675874067937687
M1	string	0	network_modules	66	TRUE	6.319395361023814e-16	48	36	11	0.3055555555555556	0.22916666666666666	REAC:R-HSA-72165	REAC	mRNA Splicing - Minor Pathway	10916	2708		0.524390243902439	0.5301204819277109	48	10868	11	25	37	10843	10916	0.26181817507936506
M1	string	0	network_modules	66	TRUE	1.6751694082493032e-15	52	36	11	0.3055555555555556	0.21153846153846154	REAC:R-HSA-6781823	REAC	Formation of TC-NER Pre-Incision Complex	10916	951		0.5365853658536586	0.54216867469879515	52	10864	11	25	41	10839	10916	0.2512869440825189
M1	string	0	network_modules	66	TRUE	3.606911204478004e-15	61	30	11	0.36666666666666664	0.18032786885245902	KEGG:03420	KEGG	Nucleotide excision repair	8484	238		0.6666666666666666	0.75	61	8423	11	19	50	8404	8484	0.2534559832059874
M1	string	0	network_modules	66	TRUE	3.635331756394119e-15	80	36	12	0.3333333333333333	0.15	REAC:R-HSA-674695	REAC	RNA Polymerase II Pre-transcription Events	10916	1888		0.5487804878048781	0.5542168674698795	80	10836	12	24	68	10812	10916	0.21985918888769157
M1	string	0	network_modules	66	TRUE	4.094781872292936e-15	56	36	11	0.3055555555555556	0.19642857142857142	REAC:R-HSA-1226099	REAC	Signaling by FGFR in disease	10916	2240		0.5609756097560976	0.5662650602409639	56	10860	11	25	45	10835	10916	0.24189570355943268
M1	string	0	network_modules	66	TRUE	1.4062423099605921e-14	89	36	12	0.3333333333333333	0.1348314606741573	REAC:R-HSA-5250924	REAC	B-WICH complex positively regulates rRNA expression	10916	198		0.573170731707317	0.5783132530120482	89	10827	12	24	77	10803	10916	0.20800573216995336
M1	string	0	network_modules	66	TRUE	1.619272047907147e-14	90	36	12	0.3333333333333333	0.13333333333333333	REAC:R-HSA-73772	REAC	RNA Polymerase I Promoter Escape	10916	1882		0.5853658536585366	0.5903614457831325	90	10826	12	24	78	10802	10916	0.20679819497309276
M1	string	0	network_modules	66	TRUE	1.668574336932803e-14	63	36	11	0.3055555555555556	0.1746031746031746	REAC:R-HSA-6782210	REAC	Gap-filling DNA repair synthesis and ligation in TC-NER	10916	1038		0.5975609756097561	0.6024096385542169	63	10853	11	25	52	10828	10916	0.2276480365176673
M1	string	0	network_modules	66	TRUE	2.0106325663650982e-14	64	36	11	0.3055555555555556	0.171875	REAC:R-HSA-5654738	REAC	Signaling by FGFR2	10916	2244		0.6097560975609756	0.6265060240963856	64	10852	11	25	53	10827	10916	0.22580391771123484
M1	string	0	network_modules	66	TRUE	2.0106325663650982e-14	64	36	11	0.3055555555555556	0.171875	REAC:R-HSA-6782135	REAC	Dual incision in TC-NER	10916	808		0.6097560975609756	0.6265060240963856	64	10852	11	25	53	10827	10916	0.22580391771123484
M1	string	0	network_modules	66	TRUE	2.8920078005390454e-14	66	36	11	0.3055555555555556	0.16666666666666666	REAC:R-HSA-9670095	REAC	Inhibition of DNA recombination at telomere	10916	1189		0.6341463414634146	0.6385542168674698	66	10850	11	25	55	10825	10916	0.2222408696921456
M1	string	0	network_modules	66	TRUE	3.887797436643011e-14	132	36	13	0.3611111111111111	0.09848484848484848	REAC:R-HSA-162599	REAC	Late Phase of HIV Life Cycle	10916	1304		0.6463414634146342	0.6506024096385542	132	10784	13	23	119	10761	10916	0.1836843719444288
M1	string	0	network_modules	66	TRUE	9.930774726981881e-14	104	36	12	0.3333333333333333	0.11538461538461539	REAC:R-HSA-5250913	REAC	Positive epigenetic regulation of rRNA expression	10916	1771		0.6585365853658537	0.6626506024096386	104	10812	12	24	92	10788	10916	0.19174126085346876
M1	string	0	network_modules	66	TRUE	1.1189231459945052e-13	105	36	12	0.3333333333333333	0.11428571428571428	REAC:R-HSA-427413	REAC	NoRC negatively regulates rRNA expression	10916	1602		0.6707317073170732	0.6746987951807228	105	10811	12	24	93	10787	10916	0.19078085873476444
M1	string	0	network_modules	66	TRUE	1.3594026039072518e-13	145	36	13	0.3611111111111111	0.0896551724137931	REAC:R-HSA-162587	REAC	HIV Life Cycle	10916	1103		0.6829268292682927	0.6867469879518072	145	10771	13	23	132	10748	10916	0.17476428192963475
M1	string	0	network_modules	66	TRUE	1.5098253755054385e-13	76	36	11	0.3055555555555556	0.14473684210526316	REAC:R-HSA-190236	REAC	Signaling by FGFR	10916	2239		0.6951219512195121	0.6987951807228916	76	10840	11	25	65	10815	10916	0.20656605173700593
M1	string	0	network_modules	66	TRUE	1.5889963687022702e-13	108	36	12	0.3333333333333333	0.1111111111111111	REAC:R-HSA-5250941	REAC	Negative epigenetic regulation of rRNA expression	10916	1566		0.7073170731707317	0.7108433734939759	108	10808	12	24	96	10784	10916	0.1879788439152052
M1	string	0	network_modules	66	TRUE	1.7577444073870773e-13	77	36	11	0.3055555555555556	0.14285714285714285	REAC:R-HSA-6781827	REAC	Transcription-Coupled Nucleotide Excision Repair (TC-NER)	10916	2541		0.7195121951219512	0.7228915662650602	77	10839	11	25	66	10814	10916	0.20516683211619344
M1	string	0	network_modules	66	TRUE	1.7819199295025328e-13	109	36	12	0.3333333333333333	0.11009174311926606	REAC:R-HSA-73854	REAC	RNA Polymerase I Promoter Clearance	10916	1881		0.7317073170731707	0.7349397590361446	109	10807	12	24	97	10783	10916	0.1870702262876043
M1	string	0	network_modules	66	TRUE	1.9960216440147587e-13	110	36	12	0.3333333333333333	0.10909090909090909	REAC:R-HSA-73864	REAC	RNA Polymerase I Transcription	10916	1884		0.7439024390243902	0.7469879518072289	110	10806	12	24	98	10782	10916	0.1861738215271737
M1	string	0	network_modules	66	TRUE	4.445252271355184e-12	102	36	11	0.3055555555555556	0.10784313725490197	REAC:R-HSA-5578749	REAC	Transcriptional regulation by small RNAs	10916	2555		0.7560975609756098	0.7590361445783133	102	10814	11	25	91	10789	10916	0.17709607570183267
M1	string	0	network_modules	66	TRUE	9.433380907884976e-12	109	36	11	0.3055555555555556	0.10091743119266056	REAC:R-HSA-5696398	REAC	Nucleotide Excision Repair	10916	1622		0.7682926829268293	0.7710843373493976	109	10807	11	25	98	10782	10916	0.17099962951929532
M1	string	0	network_modules	66	TRUE	1.1585318294510961e-11	111	36	11	0.3055555555555556	0.0990990990990991	REAC:R-HSA-157579	REAC	Telomere Maintenance	10916	2489		0.7804878048780488	0.7831325301204819	111	10805	11	25	100	10780	10916	0.16936272250994933
M1	string	0	network_modules	66	TRUE	2.7877722610296236e-11	120	36	11	0.3055555555555556	0.09166666666666666	REAC:R-HSA-5619507	REAC	Activation of HOX genes during differentiation	10916	84		0.7926829268292683	0.8072289156626506	120	10796	11	25	109	10771	10916	0.1625008930663032
M1	string	0	network_modules	66	TRUE	2.7877722610296236e-11	120	36	11	0.3055555555555556	0.09166666666666666	REAC:R-HSA-5617472	REAC	Activation of anterior HOX genes in hindbrain development during early embryogenesis	10916	99		0.7926829268292683	0.8072289156626506	120	10796	11	25	109	10771	10916	0.1625008930663032
M1	string	0	network_modules	66	TRUE	4.286839916912463e-11	225	36	13	0.3611111111111111	0.057777777777777775	REAC:R-HSA-162906	REAC	HIV Infection	10916	1102		0.8170731707317073	0.8192771084337349	225	10691	13	23	212	10668	10916	0.1378529161223787
M1	string	0	network_modules	66	TRUE	8.815895662839148e-11	133	36	11	0.3055555555555556	0.08270676691729323	REAC:R-HSA-168273	REAC	Influenza Viral RNA Transcription and Replication	10916	1186		0.8292682926829268	0.8313253012048193	133	10783	11	25	122	10758	10916	0.15382353372999003
M1	string	0	network_modules	66	TRUE	9.583953176772954e-11	134	36	11	0.3055555555555556	0.08208955223880597	REAC:R-HSA-211000	REAC	Gene Silencing by RNA	10916	1041		0.8414634146341463	0.8433734939759037	134	10782	11	25	123	10757	10916	0.15320774116925887
M1	string	0	network_modules	66	TRUE	1.1337663315051773e-10	185	36	12	0.3333333333333333	0.06486486486486487	REAC:R-HSA-212165	REAC	Epigenetic regulation of gene expression	10916	852		0.8536585365853658	0.8554216867469879	185	10731	12	24	173	10707	10916	0.14099745056087284
M1	string	0	network_modules	66	TRUE	1.3299172691196089e-10	138	36	11	0.3055555555555556	0.07971014492753623	REAC:R-HSA-73886	REAC	Chromosome Maintenance	10916	357		0.8658536585365854	0.8674698795180723	138	10778	11	25	127	10753	10916	0.15081036019869593
M1	string	0	network_modules	66	TRUE	2.6822302081473753e-10	147	36	11	0.3055555555555556	0.07482993197278912	REAC:R-HSA-9018519	REAC	Estrogen-dependent gene expression	10916	866		0.8780487804878049	0.8795180722891566	147	10769	11	25	136	10744	10916	0.14577038508715173
M1	string	0	network_modules	66	TRUE	4.17601714646931e-10	153	36	11	0.3055555555555556	0.0718954248366013	REAC:R-HSA-168255	REAC	Influenza Infection	10916	1185		0.8902439024390244	0.891566265060241	153	10763	11	25	142	10738	10916	0.142654425174312
M1	string	0	network_modules	66	TRUE	8.753820671066462e-9	202	36	11	0.3055555555555556	0.054455445544554455	REAC:R-HSA-72163	REAC	mRNA Splicing - Major Pathway	10916	2707		0.9024390243902439	0.9036144578313253	202	10714	11	25	191	10689	10916	0.12252008687574821
M1	string	0	network_modules	66	TRUE	1.2663681147024871e-8	209	36	11	0.3055555555555556	0.05263157894736842	REAC:R-HSA-72172	REAC	mRNA Splicing	10916	2706		0.9146341463414634	0.9156626506024096	209	10707	11	25	198	10682	10916	0.12022103821642131
M1	string	0	network_modules	66	TRUE	1.80836826248993e-8	216	36	11	0.3055555555555556	0.05092592592592592	REAC:R-HSA-8939211	REAC	ESR-mediated signaling	10916	830		0.926829268292683	0.927710843373494	216	10700	11	25	205	10675	10916	0.11803078452058602
M1	string	0	network_modules	66	TRUE	3.22558163264923e-8	11	36	5	0.1388888888888889	0.45454545454545453	GO:0042797	GO:BP	tRNA transcription by RNA polymerase III	16175	10374		0.1	0.18181818181818182	11	16164	5	31	6	16133	16175	0.25039303642798627
M1	string	0	network_modules	66	TRUE	5.520734043358147e-8	12	36	5	0.1388888888888889	0.4166666666666667	GO:0009304	GO:BP	tRNA transcription	16175	3451		0.2	0.2727272727272727	12	16163	5	31	7	16132	16175	0.23963325554474074
M1	string	0	network_modules	66	TRUE	2.2969307778259844e-7	305	30	11	0.36666666666666664	0.036065573770491806	KEGG:05016	KEGG	Huntington disease	8484	414		1	1	305	8179	11	19	294	8160	8484	0.10582449208951092
M1	string	0	network_modules	66	TRUE	2.4965012397916234e-7	276	36	11	0.3055555555555556	0.03985507246376811	REAC:R-HSA-72203	REAC	Processing of Capped Intron-Containing Pre-mRNA	10916	1796		0.9390243902439024	0.9397590361445783	276	10640	11	25	265	10615	10916	0.1026961160749482
M1	string	0	network_modules	66	TRUE	2.694672672785129e-7	359	36	12	0.3333333333333333	0.033426183844011144	REAC:R-HSA-3700989	REAC	Transcriptional Regulation by TP53	10916	2546		0.9512195121951219	0.9518072289156626	359	10557	12	24	347	10533	10916	0.0969056331610412
M1	string	0	network_modules	66	TRUE	4.2165675031388563e-7	290	36	11	0.3055555555555556	0.03793103448275862	REAC:R-HSA-9006931	REAC	Signaling by Nuclear Receptors	10916	2289		0.9634146341463414	0.963855421686747	290	10626	11	25	279	10601	10916	0.0997938044039097
M1	string	0	network_modules	66	TRUE	1.589820865989209e-6	329	36	11	0.3055555555555556	0.03343465045592705	REAC:R-HSA-73894	REAC	DNA Repair	10916	444		0.975609756097561	0.9759036144578314	329	10587	11	25	318	10562	10916	0.0926628343542477
M1	string	0	network_modules	66	TRUE	5.885096581246125e-6	173	36	8	0.2222222222222222	0.046242774566473986	GO:0006352	GO:BP	DNA-templated transcription initiation	16175	2129		0.3	0.36363636363636365	173	16002	8	28	165	15974	16175	0.097120799203281
M1	string	0	network_modules	66	TRUE	6.874432316227722e-6	61	36	6	0.16666666666666666	0.09836065573770492	GO:0006360	GO:BP	transcription by RNA polymerase I	16175	2136		0.4	0.45454545454545453	61	16114	6	30	55	16084	16175	0.1255161158914455
M1	string	0	network_modules	66	TRUE	1.894539152110242e-5	418	36	11	0.3055555555555556	0.02631578947368421	REAC:R-HSA-5663202	REAC	Diseases of signal transduction by growth factor receptors and second messengers	10916	773		0.9878048780487805	0.9879518072289156	418	10498	11	25	407	10473	10916	0.08011207346675264
M1	string	0	network_modules	66	TRUE	3.356360681420224e-5	38	36	5	0.1388888888888889	0.13157894736842105	GO:0032728	GO:BP	positive regulation of interferon-beta production	16175	7773		0.5	0.5454545454545454	38	16137	5	31	33	16106	16175	0.13320257110139058
M1	string	0	network_modules	66	TRUE	1.3364052768580957e-4	507	36	11	0.3055555555555556	0.021696252465483234	REAC:R-HSA-9006934	REAC	Signaling by Receptor Tyrosine Kinases	10916	2302		1	1	507	10409	11	25	496	10384	10916	0.07082326948143937
M1	string	0	network_modules	66	TRUE	1.5384370992568326e-4	51	36	5	0.1388888888888889	0.09803921568627451	GO:0032648	GO:BP	regulation of interferon-beta production	16175	7695		0.6	0.7272727272727273	51	16124	5	31	46	16093	16175	0.11434847919016622
M1	string	0	network_modules	66	TRUE	1.5384370992568326e-4	51	36	5	0.1388888888888889	0.09803921568627451	GO:0032608	GO:BP	interferon-beta production	16175	7656		0.6	0.7272727272727273	51	16124	5	31	46	16093	16175	0.11434847919016622
M1	string	0	network_modules	66	TRUE	5.714186068143112e-4	66	36	5	0.1388888888888889	0.07575757575757576	GO:0032481	GO:BP	positive regulation of type I interferon production	16175	7592		0.8	0.8181818181818182	66	16109	5	31	61	16078	16175	0.09987764751893267
M1	string	0	network_modules	66	TRUE	0.007293707938707739	110	36	5	0.1388888888888889	0.045454545454545456	GO:0032606	GO:BP	type I interferon production	16175	7654		0.9	1	110	16065	5	31	105	16034	16175	0.07590751528062199
M1	string	0	network_modules	66	TRUE	0.007293707938707739	110	36	5	0.1388888888888889	0.045454545454545456	GO:0032479	GO:BP	regulation of type I interferon production	16175	7590		0.9	1	110	16065	5	31	105	16034	16175	0.07590751528062199
M1	string	0	network_modules	67	TRUE	3.41246326765007e-24	236	38	20	0.5263157894736842	0.0847457627118644	GO:0030198	GO:BP	extracellular matrix organization	16175	6707		0	0.1111111111111111	236	15939	20	18	216	15921	16175	0.20709761710632252
M1	string	0	network_modules	67	TRUE	3.722972169285729e-24	237	38	20	0.5263157894736842	0.08438818565400844	GO:0043062	GO:BP	extracellular structure organization	16175	10509		0.125	0.2222222222222222	237	15938	20	18	217	15920	16175	0.20664175528065945
M1	string	0	network_modules	67	TRUE	4.06016252797707e-24	238	38	20	0.5263157894736842	0.08403361344537816	GO:0045229	GO:BP	external encapsulating structure organization	16175	11340		0.25	0.3333333333333333	238	15937	20	18	218	15919	16175	0.20618872973034835
M1	string	0	network_modules	67	TRUE	8.266648276454316e-24	298	31	21	0.6774193548387096	0.07046979865771812	REAC:R-HSA-1474244	REAC	Extracellular matrix organization	10916	889		0	0.05	298	10618	21	10	277	10608	10916	0.21290907666664896
M1	string	0	network_modules	67	TRUE	6.653658425754846e-22	30	31	12	0.3870967741935484	0.4	REAC:R-HSA-3000157	REAC	Laminin interactions	10916	1303		0.05263157894736842	0.1	30	10886	12	19	18	10867	10916	0.39179651804562843
M1	string	0	network_modules	67	TRUE	2.0634190792965357e-21	67	31	14	0.45161290322580644	0.208955223880597	REAC:R-HSA-1650814	REAC	Collagen biosynthesis and modifying enzymes	10916	384		0.10526315789473684	0.15	67	10849	14	17	53	10832	10916	0.30438367659345816
M1	string	0	network_modules	67	TRUE	1.8951155499175054e-20	140	31	16	0.5161290322580645	0.11428571428571428	REAC:R-HSA-1474228	REAC	Degradation of the extracellular matrix	10916	726		0.15789473684210525	0.2	140	10776	16	15	124	10761	10916	0.2387083308464971
M1	string	0	network_modules	67	TRUE	1.5583250649092545e-19	89	31	14	0.45161290322580644	0.15730337078651685	REAC:R-HSA-1474290	REAC	Collagen formation	10916	387		0.21052631578947367	0.25	89	10827	14	17	75	10810	10916	0.26316933148111005
M1	string	0	network_modules	67	TRUE	1.5862202351614048e-19	44	31	12	0.3870967741935484	0.2727272727272727	REAC:R-HSA-8948216	REAC	Collagen chain trimerization	10916	385		0.2631578947368421	0.3	44	10872	12	19	32	10853	10916	0.3226433339896694
M1	string	0	network_modules	67	TRUE	2.3915441656222832e-17	64	31	12	0.3870967741935484	0.1875	REAC:R-HSA-1442490	REAC	Collagen degradation	10916	386		0.3157894736842105	0.35	64	10852	12	19	52	10833	10916	0.2664874120778298
M1	string	0	network_modules	67	TRUE	2.2156059595138884e-16	76	31	12	0.3870967741935484	0.15789473684210525	REAC:R-HSA-3000178	REAC	ECM proteoglycans	10916	812		0.3684210526315789	0.4	76	10840	12	19	64	10821	10916	0.24397539295614123
M1	string	0	network_modules	67	TRUE	1.3624200475732392e-15	60	31	11	0.3548387096774194	0.18333333333333332	REAC:R-HSA-2022090	REAC	Assembly of collagen fibrils and other multimeric structures	10916	177		0.42105263157894735	0.45	60	10856	11	20	49	10836	10916	0.25215678244651996
M1	string	0	network_modules	67	TRUE	1.5891196203977923e-15	103	25	12	0.48	0.11650485436893204	KEGG:04974	KEGG	Protein digestion and absorption	8484	405		0	0.1111111111111111	103	8381	12	13	91	8368	8484	0.2322523257124208
M1	string	0	network_modules	67	TRUE	2.322080732495498e-14	89	25	11	0.44	0.12359550561797752	KEGG:04512	KEGG	ECM-receptor interaction	8484	314		0.125	0.2222222222222222	89	8395	11	14	78	8381	8484	0.2291810682139601
M1	string	0	network_modules	67	TRUE	7.090728151401524e-14	84	31	11	0.3548387096774194	0.13095238095238096	REAC:R-HSA-216083	REAC	Integrin cell surface interactions	10916	1216		0.47368421052631576	0.5	84	10832	11	20	73	10812	10916	0.21200462261120268
M1	string	0	network_modules	67	TRUE	1.292771281214151e-13	59	31	10	0.3225806451612903	0.1694915254237288	REAC:R-HSA-3000171	REAC	Non-integrin membrane-ECM interactions	10916	1603		0.5263157894736842	0.55	59	10857	10	21	49	10836	10916	0.230860263674912
M1	string	0	network_modules	67	TRUE	2.5544092199197545e-12	92	25	10	0.4	0.10869565217391304	KEGG:05222	KEGG	Small cell lung cancer	8484	473		0.25	0.3333333333333333	92	8392	10	15	82	8377	8484	0.20427174385574165
M1	string	0	network_modules	67	TRUE	6.707387844440809e-12	101	25	10	0.4	0.09900990099009901	KEGG:05146	KEGG	Amoebiasis	8484	438		0.375	0.4444444444444444	101	8383	10	15	91	8368	8484	0.19453110141814065
M1	string	0	network_modules	67	TRUE	2.3191524869674817e-10	202	25	11	0.44	0.054455445544554455	KEGG:04510	KEGG	Focal adhesion	8484	313		0.5	0.5555555555555556	202	8282	11	14	191	8268	8484	0.1484089156064841
M1	string	0	network_modules	67	TRUE	5.142671842047649e-10	15	31	6	0.1935483870967742	0.4	REAC:R-HSA-2214320	REAC	Anchoring fibril formation	10916	146		0.5789473684210527	0.6	15	10901	6	25	9	10876	10916	0.27685130141511277
M1	string	0	network_modules	67	TRUE	1.8962419475561427e-9	18	31	6	0.1935483870967742	0.3333333333333333	REAC:R-HSA-2243919	REAC	Crosslinking of collagen fibrils	10916	417		0.631578947368421	0.65	18	10898	6	25	12	10873	10916	0.2524028130747012
M1	string	0	network_modules	67	TRUE	5.165811426665944e-9	356	25	12	0.48	0.033707865168539325	KEGG:04151	KEGG	PI3K-Akt signaling pathway	8484	285		0.625	0.6666666666666666	356	8128	12	13	344	8115	8484	0.11876999768045059
M1	string	0	network_modules	67	TRUE	4.686981726273887e-8	330	25	11	0.44	0.03333333333333333	KEGG:05165	KEGG	Human papillomavirus infection	8484	446		0.75	0.7777777777777778	330	8154	11	14	319	8140	8484	0.11277816204639281
M1	string	0	network_modules	67	TRUE	5.111185930597946e-7	42	31	6	0.1935483870967742	0.14285714285714285	REAC:R-HSA-419037	REAC	NCAM1 interactions	10916	1512		0.6842105263157895	0.7	42	10874	6	25	36	10849	10916	0.16352345885445438
M1	string	0	network_modules	67	TRUE	1.6332513430906879e-6	21	38	5	0.13157894736842105	0.23809523809523808	GO:0071711	GO:BP	basement membrane organization	16175	16875		0.375	0.4444444444444444	21	16154	5	33	16	16121	16175	0.17557185995528032
M1	string	0	network_modules	67	TRUE	2.4576791582923447e-6	54	31	6	0.1935483870967742	0.1111111111111111	REAC:R-HSA-186797	REAC	Signaling by PDGF	10916	2291		0.7368421052631579	0.75	54	10862	6	25	48	10837	10916	0.1434576019580529
M1	string	0	network_modules	67	TRUE	4.245587448914026e-6	59	31	6	0.1935483870967742	0.1016949152542373	REAC:R-HSA-375165	REAC	NCAM signaling for neurite out-growth	10916	1511		0.7894736842105263	0.8	59	10857	6	25	53	10832	10916	0.13694254602482622
M1	string	0	network_modules	67	TRUE	2.2321940666644962e-5	100	25	6	0.24	0.06	KEGG:04933	KEGG	AGE-RAGE signaling pathway in diabetic complications	8484	390		0.875	0.8888888888888888	100	8384	6	19	94	8365	8484	0.11495453277826309
M1	string	0	network_modules	67	TRUE	1.0070016655787134e-4	129	25	6	0.24	0.046511627906976744	KEGG:04926	KEGG	Relaxin signaling pathway	8484	383		1	1	129	8355	6	19	123	8336	8484	0.09986873273866817
M1	string	0	network_modules	67	TRUE	2.615192092717141e-4	507	31	10	0.3225806451612903	0.01972386587771203	REAC:R-HSA-9006934	REAC	Signaling by Receptor Tyrosine Kinases	10916	2302		0.8421052631578947	0.85	507	10409	10	21	497	10388	10916	0.07002340505291225
M1	string	0	network_modules	67	TRUE	4.617005339340362e-4	30	31	4	0.12903225806451613	0.13333333333333333	REAC:R-HSA-8874081	REAC	MET activates PTK2 signaling	10916	1362		0.8947368421052632	0.9	30	10886	4	27	26	10859	10916	0.12873116207779278
M1	string	0	network_modules	67	TRUE	0.0015094747926098953	40	31	4	0.12903225806451613	0.1	REAC:R-HSA-8875878	REAC	MET promotes cell motility	10916	1368		0.9473684210526315	0.95	40	10876	4	27	36	10849	10916	0.1107265976603141
M1	string	0	network_modules	67	TRUE	0.0029521105086528763	11	38	3	0.07894736842105263	0.2727272727272727	GO:0110011	GO:BP	regulation of basement membrane organization	16175	19343		0.5	0.5555555555555556	11	16164	3	35	8	16129	16175	0.14569153312358943
M1	string	0	network_modules	67	TRUE	0.003929761309149143	12	38	3	0.07894736842105263	0.25	GO:2001046	GO:BP	positive regulation of integrin-mediated signaling pathway	16175	26291		0.625	0.6666666666666666	12	16163	3	35	9	16128	16175	0.13938315158677447
M1	string	0	network_modules	67	TRUE	0.005547962492363157	101	38	5	0.13157894736842105	0.04950495049504951	GO:0007229	GO:BP	integrin-mediated signaling pathway	16175	2779		0.75	0.7777777777777778	101	16074	5	33	96	16041	16175	0.07720998984104917
M1	string	0	network_modules	67	TRUE	0.006495812607064542	19	31	3	0.0967741935483871	0.15789473684210525	REAC:R-HSA-3000480	REAC	Scavenging by Class A Receptors	10916	2180		1	1	19	10897	3	28	16	10869	10916	0.12166823169955589
M1	string	0	network_modules	67	TRUE	0.008142910417612755	2	38	2	0.05263157894736842	1	GO:0001507	GO:BP	acetylcholine catabolic process in synaptic cleft	16175	322		0.875	0.8888888888888888	2	16173	2	36	0	16137	16175	0.22916025970014609
M1	string	0	network_modules	67	TRUE	0.008361292427594808	50	38	4	0.10526315789473684	0.08	GO:0030199	GO:BP	collagen fibril organization	16175	6708		1	1	50	16125	4	34	46	16091	16175	0.08931441995969656
M1	string	0	network_modules	68	TRUE	0.0061866264410517	44	18	3	0.16666666666666666	0.06818181818181818	KEGG:00970	KEGG	Aminoacyl-tRNA biosynthesis	8484	153		NA	1	44	8440	3	15	41	8425	8484	0.10366212947776716
M1	string	0	network_modules	68	TRUE	0.007726227540900469	24	26	3	0.11538461538461539	0.125	REAC:R-HSA-379716	REAC	Cytosolic tRNA aminoacylation	10916	430		NA	1	24	10892	3	23	21	10869	10916	0.11807815706818106
M1	string	0	network_modules	68	TRUE	0.008122640014723953	2	35	2	0.05714285714285714	1	GO:0019075	GO:BP	virus maturation	16175	5567		NA	1	2	16173	2	33	0	16140	16175	0.23880171837541012
M1	string	0	network_modules	69	TRUE	5.4203043947080575e-24	324	41	22	0.5365853658536586	0.06790123456790123	GO:0006816	GO:BP	calcium ion transport	16175	2495		0	0.025	324	15851	22	19	302	15832	16175	0.18585765953684558
M1	string	0	network_modules	69	TRUE	1.4186471274686912e-17	249	41	17	0.4146341463414634	0.06827309236947791	GO:0070588	GO:BP	calcium ion transmembrane transport	16175	16193		0.02564102564102564	0.05	249	15926	17	24	232	15902	16175	0.16347307440707115
M1	string	0	network_modules	69	TRUE	5.814220242518306e-17	677	41	22	0.5365853658536586	0.03249630723781388	GO:0030001	GO:BP	metal ion transport	16175	6646		0.05128205128205128	0.075	677	15498	22	19	655	15479	16175	0.12453798864316924
M1	string	0	network_modules	69	TRUE	4.961313007873801e-16	748	41	22	0.5365853658536586	0.029411764705882353	GO:0006812	GO:BP	monoatomic cation transport	16175	2492		0.07692307692307693	0.1	748	15427	22	19	726	15408	16175	0.117698791720656
M1	string	0	network_modules	69	TRUE	9.027259460099437e-15	16	32	8	0.25	0.5	REAC:R-HSA-139853	REAC	Elevation of cytosolic Ca2+ levels	10916	839		0	0.045454545454545456	16	10900	8	24	8	10876	10916	0.35225508902141833
M1	string	0	network_modules	69	TRUE	1.015462016952488e-14	233	41	15	0.36585365853658536	0.06437768240343347	GO:0006874	GO:BP	intracellular calcium ion homeostasis	16175	2532		0.10256410256410256	0.125	233	15942	15	26	218	15916	16175	0.1486886386874766
M1	string	0	network_modules	69	TRUE	2.3041383550555195e-14	246	41	15	0.36585365853658536	0.06097560975609756	GO:0055074	GO:BP	calcium ion homeostasis	16175	14230		0.1282051282051282	0.15	246	15929	15	26	231	15903	16175	0.14443453120600033
M1	string	0	network_modules	69	TRUE	9.334080622619976e-13	577	41	18	0.43902439024390244	0.03119584055459272	GO:0098655	GO:BP	monoatomic cation transmembrane transport	16175	18811		0.15384615384615385	0.175	577	15598	18	23	559	15575	16175	0.10962941641336071
M1	string	0	network_modules	69	TRUE	1.4064006164008465e-12	105	32	11	0.34375	0.10476190476190476	REAC:R-HSA-2672351	REAC	Stimuli-sensing channels	10916	2354		0.047619047619047616	0.09090909090909091	105	10811	11	21	94	10790	10916	0.18562375611434603
M1	string	0	network_modules	69	TRUE	2.1294263568538033e-12	28	32	8	0.25	0.2857142857142857	REAC:R-HSA-3295583	REAC	TRP channels	10916	2474		0.09523809523809523	0.18181818181818182	28	10888	8	24	20	10864	10916	0.26524807150044055
M1	string	0	network_modules	69	TRUE	2.1294263568538033e-12	28	32	8	0.25	0.2857142857142857	REAC:R-HSA-418360	REAC	Platelet calcium homeostasis	10916	1763		0.09523809523809523	0.18181818181818182	28	10888	8	24	20	10864	10916	0.26524807150044055
M1	string	0	network_modules	69	TRUE	7.652644365278705e-12	54	32	9	0.28125	0.16666666666666666	REAC:R-HSA-5578775	REAC	Ion homeostasis	10916	1273		0.19047619047619047	0.22727272727272727	54	10862	9	23	45	10839	10916	0.21353952871626358
M1	string	0	network_modules	69	TRUE	9.010679790374685e-12	85	32	10	0.3125	0.11764705882352941	REAC:R-HSA-418346	REAC	Platelet homeostasis	10916	1765		0.23809523809523808	0.2727272727272727	85	10831	10	22	75	10809	10916	0.1879714404066213
M1	string	0	network_modules	69	TRUE	1.286386254672375e-11	671	41	18	0.43902439024390244	0.026825633383010434	GO:0034220	GO:BP	monoatomic ion transmembrane transport	16175	8508		0.1794871794871795	0.2	671	15504	18	23	653	15481	16175	0.10049942131659689
M1	string	0	network_modules	69	TRUE	1.8294313560467256e-11	182	32	12	0.375	0.06593406593406594	REAC:R-HSA-983712	REAC	Ion channel transport	10916	1272		0.2857142857142857	0.3181818181818182	182	10734	12	20	170	10714	10916	0.1517426162840082
M1	string	0	network_modules	69	TRUE	1.847813693921517e-11	575	41	17	0.4146341463414634	0.029565217391304348	GO:0098662	GO:BP	inorganic cation transmembrane transport	16175	18818		0.20512820512820512	0.225	575	15600	17	24	558	15576	16175	0.10320627350761602
M1	string	0	network_modules	69	TRUE	2.717338106898195e-11	10	32	6	0.1875	0.6	REAC:R-HSA-418890	REAC	Role of second messengers in netrin-1 signaling	10916	2110		0.3333333333333333	0.36363636363636365	10	10906	6	26	4	10880	10916	0.33441496278539823
M1	string	0	network_modules	69	TRUE	4.0816892308132103e-11	407	41	15	0.36585365853658536	0.036855036855036855	GO:0098771	GO:BP	inorganic ion homeostasis	16175	18886		0.23076923076923078	0.25	407	15768	15	26	392	15742	16175	0.10965812484123988
M1	string	0	network_modules	69	TRUE	6.928617334364878e-11	422	41	15	0.36585365853658536	0.035545023696682464	GO:0030003	GO:BP	intracellular monoatomic cation homeostasis	16175	6648		0.2564102564102564	0.275	422	15753	15	26	407	15727	16175	0.10744957653386542
M1	string	0	network_modules	69	TRUE	7.951755010119639e-11	426	41	15	0.36585365853658536	0.035211267605633804	GO:0006873	GO:BP	intracellular monoatomic ion homeostasis	16175	2531		0.28205128205128205	0.3	426	15749	15	26	411	15723	16175	0.10687966045914438
M1	string	0	network_modules	69	TRUE	8.233873534530417e-11	630	41	17	0.4146341463414634	0.026984126984126985	GO:0098660	GO:BP	inorganic ion transmembrane transport	16175	18816		0.3076923076923077	0.325	630	15545	17	24	613	15521	16175	0.09788667648977205
M1	string	0	network_modules	69	TRUE	8.78887973282552e-11	40	41	8	0.1951219512195122	0.2	GO:0051480	GO:BP	regulation of cytosolic calcium ion concentration	16175	13738		0.3333333333333333	0.35	40	16135	8	33	32	16102	16175	0.19553183136841223
M1	string	0	network_modules	69	TRUE	3.0282016244833166e-10	467	41	15	0.36585365853658536	0.032119914346895075	GO:0055080	GO:BP	monoatomic cation homeostasis	16175	14233		0.358974358974359	0.375	467	15708	15	26	452	15682	16175	0.10145020636093748
M1	string	0	network_modules	69	TRUE	3.8738531865253543e-10	475	41	15	0.36585365853658536	0.031578947368421054	GO:0050801	GO:BP	monoatomic ion homeostasis	16175	13267		0.38461538461538464	0.4	475	15700	15	26	460	15674	16175	0.10047020895563312
M1	string	0	network_modules	69	TRUE	2.098876223492194e-9	534	41	15	0.36585365853658536	0.028089887640449437	GO:0055082	GO:BP	intracellular chemical homeostasis	16175	14235		0.41025641025641024	0.425	534	15641	15	26	519	15615	16175	0.09390689686993768
M1	string	0	network_modules	69	TRUE	3.2265032434214096e-9	17	41	6	0.14634146341463414	0.35294117647058826	GO:0002115	GO:BP	store-operated calcium entry	16175	693		0.4358974358974359	0.45	17	16158	6	35	11	16123	16175	0.22603933655352515
M1	string	0	network_modules	69	TRUE	4.380722238939737e-9	101	41	9	0.21951219512195122	0.0891089108910891	GO:0051209	GO:BP	release of sequestered calcium ion into cytosol	16175	13568		0.46153846153846156	0.475	101	16074	9	32	92	16042	16175	0.13647974443985544
M1	string	0	network_modules	69	TRUE	4.796073578838554e-9	102	41	9	0.21951219512195122	0.08823529411764706	GO:0051283	GO:BP	negative regulation of sequestering of calcium ion	16175	13619		0.48717948717948717	0.5	102	16073	9	32	93	16041	16175	0.13577393231068519
M1	string	0	network_modules	69	TRUE	5.245876662123629e-9	103	41	9	0.21951219512195122	0.08737864077669903	GO:0051282	GO:BP	regulation of sequestering of calcium ion	16175	13618		0.5128205128205128	0.525	103	16072	9	32	94	16040	16175	0.13507825103579574
M1	string	0	network_modules	69	TRUE	5.9913768739044864e-9	115	29	9	0.3103448275862069	0.0782608695652174	KEGG:04724	KEGG	Glutamatergic synapse	8484	354		0	0.058823529411764705	115	8369	9	20	106	8349	8484	0.15031636575928548
M1	string	0	network_modules	69	TRUE	6.827291285079435e-9	106	41	9	0.21951219512195122	0.08490566037735849	GO:0051208	GO:BP	sequestering of calcium ion	16175	13567		0.5384615384615384	0.55	106	16069	9	32	97	16037	16175	0.13304959942302563
M1	string	0	network_modules	69	TRUE	8.559268196772565e-9	160	41	10	0.24390243902439024	0.0625	GO:0097553	GO:BP	calcium ion transmembrane import into cytosol	16175	18700		0.5641025641025641	0.575	160	16015	10	31	150	15984	16175	0.1192002910006215
M1	string	0	network_modules	69	TRUE	1.8988741109604484e-8	623	41	15	0.36585365853658536	0.024077046548956663	GO:0019725	GO:BP	cellular homeostasis	16175	6020		0.5897435897435898	0.6	623	15552	15	26	608	15526	16175	0.0857479433469145
M1	string	0	network_modules	69	TRUE	2.5801306309225228e-8	763	41	16	0.3902439024390244	0.020969855832241154	GO:0048878	GO:BP	chemical homeostasis	16175	13119		0.6153846153846154	0.625	763	15412	16	25	747	15387	16175	0.08157538436133743
M1	string	0	network_modules	69	TRUE	2.7402249187065532e-8	130	32	9	0.28125	0.06923076923076923	REAC:R-HSA-5576891	REAC	Cardiac conduction	10916	306		0.38095238095238093	0.4090909090909091	130	10786	9	23	121	10763	10916	0.13463086415216838
M1	string	0	network_modules	69	TRUE	3.6993667692354113e-8	27	32	6	0.1875	0.2222222222222222	REAC:R-HSA-114508	REAC	Effects of PIP2 hydrolysis	10916	833		0.42857142857142855	0.45454545454545453	27	10889	6	26	21	10863	10916	0.20197725168019998
M1	string	0	network_modules	69	TRUE	6.050411225786843e-8	203	32	10	0.3125	0.04926108374384237	REAC:R-HSA-397014	REAC	Muscle contraction	10916	1496		0.47619047619047616	0.5	203	10713	10	22	193	10691	10916	0.11796287648445208
M1	string	0	network_modules	69	TRUE	3.4982327850489476e-7	251	29	10	0.3448275862068966	0.0398406374501992	KEGG:04020	KEGG	Calcium signaling pathway	8484	250		0.0625	0.11764705882352941	251	8233	10	19	241	8214	8484	0.10896114955843443
M1	string	0	network_modules	69	TRUE	4.1221494968413757e-7	110	41	8	0.1951219512195122	0.07272727272727272	GO:0051592	GO:BP	response to calcium ion	16175	13809		0.6410256410256411	0.65	110	16065	8	33	102	16032	16175	0.11551223938714922
M1	string	0	network_modules	69	TRUE	7.730379298808699e-7	179	41	9	0.21951219512195122	0.05027932960893855	GO:0051924	GO:BP	regulation of calcium ion transport	16175	13997		0.6666666666666666	0.675	179	15996	9	32	170	15964	16175	0.10044446055130513
M1	string	0	network_modules	69	TRUE	8.96013157411208e-7	182	41	9	0.21951219512195122	0.04945054945054945	GO:0051651	GO:BP	maintenance of location in cell	16175	13864		0.6923076923076923	0.7	182	15993	9	32	173	15961	16175	0.0995338817448695
M1	string	0	network_modules	69	TRUE	1.6706559673300047e-6	49	32	6	0.1875	0.12244897959183673	REAC:R-HSA-373752	REAC	Netrin-1 signaling	10916	1586		0.5238095238095238	0.5454545454545454	49	10867	6	26	43	10841	10916	0.148446167053931
M1	string	0	network_modules	69	TRUE	2.0347464193697995e-6	154	29	8	0.27586206896551724	0.05194805194805195	KEGG:04921	KEGG	Oxytocin signaling pathway	8484	378		0.125	0.17647058823529413	154	8330	8	21	146	8309	8484	0.11305549877073114
M1	string	0	network_modules	69	TRUE	2.4390585779173422e-6	59	29	6	0.20689655172413793	0.1016949152542373	KEGG:04730	KEGG	Long-term depression	8484	359		0.1875	0.23529411764705882	59	8425	6	23	53	8402	8484	0.1409082895021714
M1	string	0	network_modules	69	TRUE	4.0114177732247215e-6	64	29	6	0.20689655172413793	0.09375	KEGG:04929	KEGG	GnRH secretion	8484	386		0.25	0.29411764705882354	64	8420	6	23	58	8397	8484	0.13493340055199785
M1	string	0	network_modules	69	TRUE	1.0849572374284117e-5	10	41	4	0.0975609756097561	0.4	GO:0071415	GO:BP	cellular response to purine-containing compound	16175	16667		0.717948717948718	0.725	10	16165	4	37	6	16128	16175	0.19660412092219542
M1	string	0	network_modules	69	TRUE	3.230047693587923e-5	274	41	9	0.21951219512195122	0.032846715328467155	GO:0051235	GO:BP	maintenance of location	16175	13585		0.7435897435897436	0.75	274	15901	9	32	265	15869	16175	0.0791330895331119
M1	string	0	network_modules	69	TRUE	3.673776698829782e-5	13	41	4	0.0975609756097561	0.3076923076923077	GO:0007216	GO:BP	G protein-coupled glutamate receptor signaling pathway	16175	2770		0.7692307692307693	0.775	13	16162	4	37	9	16125	16175	0.17211929286660982
M1	string	0	network_modules	69	TRUE	4.400959749657866e-5	284	41	9	0.21951219512195122	0.03169014084507042	GO:0010959	GO:BP	regulation of metal ion transport	16175	4536		0.7948717948717948	0.8	284	15891	9	32	275	15859	16175	0.07751457549930255
M1	string	0	network_modules	69	TRUE	4.520142165594229e-5	84	32	6	0.1875	0.07142857142857142	REAC:R-HSA-983695	REAC	Antigen activates B Cell Receptor (BCR) leading to generation of second messengers	10916	152		0.5714285714285714	0.5909090909090909	84	10832	6	26	78	10806	10916	0.11157110643469123
M1	string	0	network_modules	69	TRUE	4.8946340861145206e-5	97	29	6	0.20689655172413793	0.061855670103092786	KEGG:04713	KEGG	Circadian entrainment	8484	348		0.3125	0.35294117647058826	97	8387	6	23	91	8364	8484	0.10767597532865199
M1	string	0	network_modules	69	TRUE	6.454044300876842e-5	164	29	7	0.2413793103448276	0.042682926829268296	KEGG:04022	KEGG	cGMP-PKG signaling pathway	8484	251		0.375	0.4117647058823529	164	8320	7	22	157	8298	8484	0.09445124950584982
M1	string	0	network_modules	69	TRUE	7.669331607679285e-5	213	41	8	0.1951219512195122	0.03755868544600939	GO:0010038	GO:BP	response to metal ion	16175	3847		0.8205128205128205	0.825	213	15962	8	33	205	15929	16175	0.08046223761197567
M1	string	0	network_modules	69	TRUE	1.2086219573483075e-4	163	32	7	0.21875	0.04294478527607362	REAC:R-HSA-983705	REAC	Signaling by the B Cell Receptor (BCR)	10916	2328		0.6190476190476191	0.6363636363636364	163	10753	7	25	156	10728	10916	0.09112293793291464
M1	string	0	network_modules	69	TRUE	1.812495026421408e-4	56	32	5	0.15625	0.08928571428571429	REAC:R-HSA-6794361	REAC	Neurexins and neuroligins	10916	1587		0.6666666666666666	0.6818181818181818	56	10860	5	27	51	10833	10916	0.1146983119175307
M1	string	0	network_modules	69	TRUE	2.104762145405257e-4	341	41	9	0.21951219512195122	0.026392961876832845	GO:0043269	GO:BP	regulation of monoatomic ion transport	16175	10593		0.8461538461538461	0.85	341	15834	9	32	332	15802	16175	0.06963067795916751
M1	string	0	network_modules	69	TRUE	3.1216675883529403e-4	133	29	6	0.20689655172413793	0.045112781954887216	KEGG:04270	KEGG	Vascular smooth muscle contraction	8484	298		0.4375	0.47058823529411764	133	8351	6	23	127	8328	8484	0.09015318370445947
M1	string	0	network_modules	69	TRUE	3.866212450389478e-4	138	29	6	0.20689655172413793	0.043478260869565216	KEGG:04371	KEGG	Apelin signaling pathway	8484	308		0.5	0.5294117647058824	138	8346	6	23	132	8323	8484	0.08825855729398993
M1	string	0	network_modules	69	TRUE	6.966742221082527e-4	88	29	5	0.1724137931034483	0.056818181818181816	KEGG:04540	KEGG	Gap junction	8484	318		0.5625	0.5882352941176471	88	8396	5	24	83	8372	8484	0.09366796686596017
M1	string	0	network_modules	69	TRUE	7.330223775240272e-4	213	32	7	0.21875	0.03286384976525822	REAC:R-HSA-416476	REAC	G alpha (q) signalling events	10916	988		0.7142857142857143	0.7272727272727273	213	10703	7	25	206	10678	10916	0.07810385306831921
M1	string	0	network_modules	69	TRUE	7.725942075722762e-4	7	41	3	0.07317073170731707	0.42857142857142855	GO:0071313	GO:BP	cellular response to caffeine	16175	16569		0.8717948717948718	0.9	7	16168	3	38	4	16130	16175	0.17629872369489144
M1	string	0	network_modules	69	TRUE	7.725942075722762e-4	7	41	3	0.07317073170731707	0.42857142857142855	GO:0031000	GO:BP	response to caffeine	16175	6991		0.8717948717948718	0.9	7	16168	3	38	4	16130	16175	0.17629872369489144
M1	string	0	network_modules	69	TRUE	8.211490749991e-4	91	29	5	0.1724137931034483	0.054945054945054944	KEGG:04970	KEGG	Salivary secretion	8484	401		0.625	0.6470588235294118	91	8393	5	24	86	8369	8484	0.09192647000169385
M1	string	0	network_modules	69	TRUE	0.0012555209874463358	11	32	3	0.09375	0.2727272727272727	REAC:R-HSA-5607763	REAC	CLEC7A (Dectin-1) induces NFAT activation	10916	274		0.7619047619047619	0.7727272727272727	11	10905	3	29	8	10876	10916	0.15849404779724957
M1	string	0	network_modules	69	TRUE	0.001432897403660437	102	29	5	0.1724137931034483	0.049019607843137254	KEGG:04972	KEGG	Pancreatic secretion	8484	403		0.6875	0.7058823529411765	102	8382	5	24	97	8358	8484	0.08618851007289571
M1	string	0	network_modules	69	TRUE	0.001553153912454601	86	32	5	0.15625	0.05813953488372093	REAC:R-HSA-6794362	REAC	Protein-protein interactions at synapses	10916	1819		0.8095238095238095	0.8181818181818182	86	10830	5	27	81	10803	10916	0.09099797761465699
M1	string	0	network_modules	69	TRUE	0.0018113593834347002	75	41	5	0.12195121951219512	0.06666666666666667	GO:0014074	GO:BP	response to purine-containing compound	16175	4639		0.9230769230769231	0.925	75	16100	5	36	70	16064	16175	0.0870508613273959
M1	string	0	network_modules	69	TRUE	0.00263491938270513	10	41	3	0.07317073170731707	0.3	GO:2001256	GO:BP	regulation of store-operated calcium entry	16175	26442		0.9487179487179487	0.95	10	16165	3	38	7	16127	16175	0.14713963724018406
M1	string	0	network_modules	69	TRUE	0.0034346912485302894	15	32	3	0.09375	0.2	REAC:R-HSA-418457	REAC	cGMP effects	10916	2691		0.8571428571428571	0.8636363636363636	15	10901	3	29	12	10872	10916	0.13521472624020145
M1	string	0	network_modules	69	TRUE	0.003676606036808788	124	29	5	0.1724137931034483	0.04032258064516129	KEGG:04611	KEGG	Platelet activation	8484	321		0.75	0.7647058823529411	124	8360	5	24	119	8336	8484	0.07700705095963843
M1	string	0	network_modules	69	TRUE	0.004047727143470174	64	29	4	0.13793103448275862	0.0625	KEGG:04927	KEGG	Cortisol synthesis and secretion	8484	384		0.8125	0.8235294117647058	64	8420	4	25	60	8395	8484	0.08825361869409744
M1	string	0	network_modules	69	TRUE	0.004218893227789602	16	32	3	0.09375	0.1875	REAC:R-HSA-5218921	REAC	VEGFR2 mediated cell proliferation	10916	2635		0.9047619047619048	0.9090909090909091	16	10900	3	29	13	10871	10916	0.13079726144598278
M1	string	0	network_modules	69	TRUE	0.004848476485684712	67	29	4	0.13793103448275862	0.05970149253731343	KEGG:04720	KEGG	Long-term potentiation	8484	350		0.875	0.8823529411764706	67	8417	4	25	63	8392	8484	0.08603657158720056
M1	string	0	network_modules	69	TRUE	0.004943349632117241	41	41	4	0.0975609756097561	0.0975609756097561	GO:0007215	GO:BP	glutamate receptor signaling pathway	16175	2769		0.9743589743589743	0.975	41	16134	4	37	37	16097	16175	0.09526768194420508
M1	string	0	network_modules	69	TRUE	0.005275058024608577	93	41	5	0.12195121951219512	0.053763440860215055	GO:0051928	GO:BP	positive regulation of calcium ion transport	16175	13999		1	1	93	16082	5	36	88	16046	16175	0.07747575520849097
M1	string	0	network_modules	69	TRUE	0.005442762155766013	69	29	4	0.13793103448275862	0.057971014492753624	KEGG:04924	KEGG	Renin secretion	8484	381		0.9375	0.9411764705882353	69	8415	4	25	65	8390	8484	0.08463685361702787
M1	string	0	network_modules	69	TRUE	0.00678035934305064	141	29	5	0.1724137931034483	0.03546099290780142	KEGG:05017	KEGG	Spinocerebellar ataxia	8484	415		1	1	141	8343	5	24	136	8319	8484	0.07137130971995362
M1	string	0	network_modules	69	TRUE	0.008351907684839992	59	32	4	0.125	0.06779661016949153	REAC:R-HSA-4086398	REAC	Ca2+ pathway	10916	296		0.9523809523809523	0.9545454545454546	59	10857	4	28	55	10829	10916	0.08844568992723187
M1	string	0	network_modules	69	TRUE	0.009920508792888107	21	32	3	0.09375	0.14285714285714285	REAC:R-HSA-392154	REAC	Nitric oxide stimulates guanylate cyclase	10916	1601		1	1	21	10895	3	29	18	10866	10916	0.11362860748159069
M1	string	0	network_modules	70	TRUE	2.830633763218672e-26	73	22	15	0.6818181818181818	0.2054794520547945	REAC:R-HSA-6807505	REAC	RNA polymerase II transcribes snRNA genes	10916	1904		NA	1	73	10843	15	7	58	10836	10916	0.37224846233387093
M1	string	0	network_modules	70	TRUE	1.687767963714729e-24	34	34	13	0.38235294117647056	0.38235294117647056	GO:0016180	GO:BP	snRNA processing	16175	5161		0	0.125	34	16141	13	21	21	16120	16175	0.38105190654416776
M1	string	0	network_modules	70	TRUE	4.089598926499332e-21	81	34	14	0.4117647058823529	0.1728395061728395	GO:0034243	GO:BP	regulation of transcription elongation by RNA polymerase II	16175	8519		0.14285714285714285	0.25	81	16094	14	20	67	16074	16175	0.26447159423266653
M1	string	0	network_modules	70	TRUE	4.3306919706501014e-21	57	34	13	0.38235294117647056	0.22807017543859648	GO:0016073	GO:BP	snRNA metabolic process	16175	5100		0.2857142857142857	0.375	57	16118	13	21	44	16097	16175	0.2934058207072557
M1	string	0	network_modules	70	TRUE	5.2747598060566515e-20	96	34	14	0.4117647058823529	0.14583333333333334	GO:0032784	GO:BP	regulation of DNA-templated transcription elongation	16175	7819		0.42857142857142855	0.5	96	16079	14	20	82	16059	16175	0.24249184469516832
M1	string	0	network_modules	70	TRUE	1.5045218356451185e-19	103	34	14	0.4117647058823529	0.13592233009708737	GO:0006368	GO:BP	transcription elongation by RNA polymerase II	16175	2143		0.5714285714285714	0.625	103	16072	14	20	89	16052	16175	0.23390813664054252
M1	string	0	network_modules	70	TRUE	1.1210682913675714e-18	118	34	14	0.4117647058823529	0.11864406779661017	GO:0006354	GO:BP	DNA-templated transcription elongation	16175	2131		0.7142857142857143	0.75	118	16057	14	20	104	16037	16175	0.21813788445616408
M1	string	0	network_modules	70	TRUE	2.0492440853760278e-16	22	34	9	0.2647058823529412	0.4090909090909091	GO:0034472	GO:BP	snRNA 3'-end processing	16175	8649		0.8571428571428571	0.875	22	16153	9	25	13	16128	16175	0.32794946021163973
M1	string	0	network_modules	70	TRUE	8.81104743785928e-11	80	34	9	0.2647058823529412	0.1125	GO:0031123	GO:BP	RNA 3'-end processing	16175	7048		1	1	80	16095	9	25	71	16070	16175	0.16994182751146264
M1	string	0	network_modules	70	TRUE	0.004066132813019068	116	7	3	0.42857142857142855	0.02586206896551724	KEGG:03082	KEGG	ATP-dependent chromatin remodeling	8484	219		NA	1	116	8368	3	4	113	8364	8484	0.10266697392656453
M1	string	0	network_modules	71	TRUE	1.9383242235159076e-5	17	26	4	0.15384615384615385	0.23529411764705882	REAC:R-HSA-1482922	REAC	Acyl chain remodelling of PI	10916	115		0	0.16666666666666666	17	10899	4	22	13	10877	10916	0.18870632552317113
M1	string	0	network_modules	71	TRUE	5.0701321606311e-5	61	25	5	0.2	0.08196721311475409	KEGG:00590	KEGG	Arachidonic acid metabolism	8484	92		0	0.25	61	8423	5	20	56	8403	8484	0.1240630283137452
M1	string	0	network_modules	71	TRUE	5.499744248379872e-5	26	25	4	0.16	0.15384615384615385	KEGG:00592	KEGG	alpha-Linolenic acid metabolism	8484	94		0.3333333333333333	0.5	26	8458	4	21	22	8437	8484	0.154351757063656
M1	string	0	network_modules	71	TRUE	1.0001955319154897e-4	30	25	4	0.16	0.13333333333333333	KEGG:00591	KEGG	Linoleic acid metabolism	8484	93		0.6666666666666666	0.75	30	8454	4	21	26	8433	8484	0.14329585989212185
M1	string	0	network_modules	71	TRUE	1.4064202561890133e-4	27	26	4	0.15384615384615385	0.14814814814814814	REAC:R-HSA-1482788	REAC	Acyl chain remodelling of PC	10916	112		0.2	0.3333333333333333	27	10889	4	22	23	10867	10916	0.14890455941410885
M1	string	0	network_modules	71	TRUE	1.897219269191588e-4	29	26	4	0.15384615384615385	0.13793103448275862	REAC:R-HSA-1482839	REAC	Acyl chain remodelling of PE	10916	113		0.4	0.5	29	10887	4	22	25	10865	10916	0.14351747676105897
M1	string	0	network_modules	71	TRUE	8.078211229569186e-4	50	25	4	0.16	0.08	KEGG:00565	KEGG	Ether lipid metabolism	8484	89		1	1	50	8434	4	21	46	8413	8484	0.10945370299833476
M1	string	0	network_modules	71	TRUE	0.0017945373672949001	2	26	2	0.07692307692307693	1	REAC:R-HSA-1299316	REAC	TWIK-releated acid-sensitive K+ channel (TASK)	10916	2478		0.6	0.6666666666666666	2	10914	2	24	0	10890	10916	0.2770449824007619
M1	string	0	network_modules	71	TRUE	0.003144610988714724	18	26	3	0.11538461538461539	0.16666666666666666	REAC:R-HSA-1482925	REAC	Acyl chain remodelling of PG	10916	114		0.8	0.8333333333333334	18	10898	3	23	15	10875	10916	0.13696930681376612
M1	string	0	network_modules	71	TRUE	0.004202241672183774	14	33	3	0.09090909090909091	0.21428571428571427	GO:0036151	GO:BP	phosphatidylcholine acyl-chain remodeling	16175	9464		0	0.3333333333333333	14	16161	3	30	11	16131	16175	0.13844494424757176
M1	string	0	network_modules	71	TRUE	0.005557877208625463	117	33	5	0.15151515151515152	0.042735042735042736	GO:0098659	GO:BP	inorganic cation import across plasma membrane	16175	18815		0.5	1	117	16058	5	28	112	16030	16175	0.07698309751971487
M1	string	0	network_modules	71	TRUE	0.005557877208625463	117	33	5	0.15151515151515152	0.042735042735042736	GO:0099587	GO:BP	inorganic ion import across plasma membrane	16175	19152		0.5	1	117	16058	5	28	112	16030	16175	0.07698309751971487
M1	string	0	network_modules	71	TRUE	0.005897268153902691	22	26	3	0.11538461538461539	0.13636363636363635	REAC:R-HSA-1482801	REAC	Acyl chain remodelling of PS	10916	116		1	1	22	10894	3	23	19	10871	10916	0.12351690859159996
M1	string	0	network_modules	72	TRUE	1.7193364247377962e-4	42	18	4	0.2222222222222222	0.09523809523809523	REAC:R-HSA-3769402	REAC	Deactivation of the beta-catenin transactivating complex	10916	452		0	0.5	42	10874	4	14	38	10860	10916	0.1433538324928174
M1	string	0	network_modules	72	TRUE	0.0029439707684876517	192	10	4	0.4	0.020833333333333332	KEGG:05202	KEGG	Transcriptional misregulation in cancer	8484	454		NA	1	192	8292	4	6	188	8286	8484	0.08716508949483322
M1	string	0	network_modules	72	TRUE	0.003735826217301812	90	18	4	0.2222222222222222	0.044444444444444446	REAC:R-HSA-201722	REAC	Formation of the beta-catenin:TCF transactivating complex	10916	968		1	1	90	10826	4	14	86	10812	10916	0.09616988727322665
M1	string	0	network_modules	73	TRUE	1.3701036330407592e-18	516	39	21	0.5384615384615384	0.040697674418604654	GO:0099536	GO:BP	synaptic signaling	16175	19115		0	0.011764705882352941	516	15659	21	18	495	15641	16175	0.14171083987858363
M1	string	0	network_modules	73	TRUE	7.492632212949257e-17	18	32	9	0.28125	0.5	REAC:R-HSA-442982	REAC	Ras activation upon Ca2+ influx through NMDA receptor	10916	1941		0	0.03225806451612903	18	10898	9	23	9	10875	10916	0.37365722528380096
M1	string	0	network_modules	73	TRUE	2.578542480127589e-16	20	32	9	0.28125	0.45	REAC:R-HSA-9617324	REAC	Negative regulation of NMDA receptor-mediated neuronal transmission	10916	1575		0.03333333333333333	0.0967741935483871	20	10896	9	23	11	10873	10916	0.35428259365285025
M1	string	0	network_modules	73	TRUE	2.578542480127589e-16	20	32	9	0.28125	0.45	REAC:R-HSA-438066	REAC	Unblocking of NMDA receptors, glutamate binding and activation	10916	2621		0.03333333333333333	0.0967741935483871	20	10896	9	23	11	10873	10916	0.35428259365285025
M1	string	0	network_modules	73	TRUE	4.503879284725251e-16	21	32	9	0.28125	0.42857142857142855	REAC:R-HSA-9620244	REAC	Long-term potentiation	10916	1321		0.1	0.12903225806451613	21	10895	9	23	12	10872	10916	0.34564691636094796
M1	string	0	network_modules	73	TRUE	5.545119280935718e-16	196	32	15	0.46875	0.07653061224489796	REAC:R-HSA-112314	REAC	Neurotransmitter receptors and postsynaptic signal transmission	10916	1594		0.13333333333333333	0.16129032258064516	196	10720	15	17	181	10703	10916	0.18407619454941493
M1	string	0	network_modules	73	TRUE	6.192997141960879e-16	492	39	19	0.48717948717948717	0.03861788617886179	GO:0099537	GO:BP	trans-synaptic signaling	16175	19116		0.011904761904761904	0.023529411764705882	492	15683	19	20	473	15663	16175	0.13075902131562836
M1	string	0	network_modules	73	TRUE	9.193439391104508e-16	259	32	16	0.5	0.06177606177606178	REAC:R-HSA-112315	REAC	Transmission across Chemical Synapses	10916	2580		0.16666666666666666	0.1935483870967742	259	10657	16	16	243	10641	10916	0.16968098441791493
M1	string	0	network_modules	73	TRUE	9.688179956213465e-16	400	32	18	0.5625	0.045	REAC:R-HSA-112316	REAC	Neuronal System	10916	1590		0.2	0.22580645161290322	400	10516	18	14	382	10502	10916	0.15175962525902859
M1	string	0	network_modules	73	TRUE	2.6744323491905695e-15	89	32	12	0.375	0.1348314606741573	REAC:R-HSA-442755	REAC	Activation of NMDA receptors and postsynaptic events	10916	89		0.23333333333333334	0.25806451612903225	89	10827	12	20	77	10807	10916	0.22119736486550895
M1	string	0	network_modules	73	TRUE	4.742436498220494e-15	26	32	9	0.28125	0.34615384615384615	REAC:R-HSA-442742	REAC	CREB1 phosphorylation through NMDA receptor-mediated activation of RAS signaling	10916	283		0.26666666666666666	0.2903225806451613	26	10890	9	23	17	10867	10916	0.3102005692923329
M1	string	0	network_modules	73	TRUE	5.96529071133635e-15	43	32	10	0.3125	0.23255813953488372	REAC:R-HSA-9609736	REAC	Assembly and cell surface presentation of NMDA receptors	10916	173		0.3	0.3225806451612903	43	10873	10	22	33	10851	10916	0.26710137225777186
M1	string	0	network_modules	73	TRUE	1.5504456219451337e-14	487	39	18	0.46153846153846156	0.03696098562628337	GO:0098916	GO:BP	anterograde trans-synaptic signaling	16175	18949		0.023809523809523808	0.047058823529411764	487	15688	18	21	469	15667	16175	0.12411977853064378
M1	string	0	network_modules	73	TRUE	1.5504456219451337e-14	487	39	18	0.46153846153846156	0.03696098562628337	GO:0007268	GO:BP	chemical synaptic transmission	16175	2796		0.023809523809523808	0.047058823529411764	487	15688	18	21	469	15667	16175	0.12411977853064378
M1	string	0	network_modules	73	TRUE	3.4038821653647606e-14	76	32	11	0.34375	0.14473684210526316	REAC:R-HSA-438064	REAC	Post NMDA receptor activation events	10916	1772		0.3333333333333333	0.3548387096774194	76	10840	11	21	65	10819	10916	0.21962364219755282
M1	string	0	network_modules	73	TRUE	6.692042101841946e-13	13	39	7	0.1794871794871795	0.5384615384615384	GO:0035235	GO:BP	ionotropic glutamate receptor signaling pathway	16175	8919		0.047619047619047616	0.07058823529411765	13	16162	7	32	6	16130	16175	0.30998722820996344
M1	string	0	network_modules	73	TRUE	6.692042101841946e-13	13	39	7	0.1794871794871795	0.5384615384615384	GO:1990806	GO:BP	ligand-gated ion channel signaling pathway	16175	25299		0.047619047619047616	0.07058823529411765	13	16162	7	32	6	16130	16175	0.30998722820996344
M1	string	0	network_modules	73	TRUE	9.348613833592521e-13	262	39	14	0.358974358974359	0.05343511450381679	GO:0050804	GO:BP	modulation of chemical synaptic transmission	16175	13270		0.07142857142857142	0.08235294117647059	262	15913	14	25	248	15888	16175	0.13349439827194537
M1	string	0	network_modules	73	TRUE	9.859798395151904e-13	263	39	14	0.358974358974359	0.053231939163498096	GO:0099177	GO:BP	regulation of trans-synaptic signaling	16175	19085		0.08333333333333333	0.09411764705882353	263	15912	14	25	249	15887	16175	0.1332205194250263
M1	string	0	network_modules	73	TRUE	1.2135134271761398e-12	69	30	10	0.3333333333333333	0.14492753623188406	KEGG:05031	KEGG	Amphetamine addiction	8484	419		0	0.045454545454545456	69	8415	10	20	59	8395	8484	0.2156897964365691
M1	string	0	network_modules	73	TRUE	5.4883594776469375e-12	115	30	11	0.36666666666666664	0.09565217391304348	KEGG:04724	KEGG	Glutamatergic synapse	8484	354		0.047619047619047616	0.09090909090909091	115	8369	11	19	104	8350	8484	0.18191001846609958
M1	string	0	network_modules	73	TRUE	1.0177500494316231e-11	86	32	10	0.3125	0.11627906976744186	REAC:R-HSA-6794362	REAC	Protein-protein interactions at synapses	10916	1819		0.36666666666666664	0.3870967741935484	86	10830	10	22	76	10808	10916	0.1868278305553064
M1	string	0	network_modules	73	TRUE	1.0860547250970245e-11	56	32	9	0.28125	0.16071428571428573	REAC:R-HSA-6794361	REAC	Neurexins and neuroligins	10916	1587		0.4	0.41935483870967744	56	10860	9	23	47	10837	10916	0.2095719023465498
M1	string	0	network_modules	73	TRUE	2.8657239244325853e-11	37	39	8	0.20512820512820512	0.21621621621621623	GO:0048168	GO:BP	regulation of neuronal synaptic plasticity	16175	12562		0.09523809523809523	0.10588235294117647	37	16138	8	31	29	16107	16175	0.20874115666163615
M1	string	0	network_modules	73	TRUE	3.514974328364346e-11	21	32	7	0.21875	0.3333333333333333	REAC:R-HSA-8849932	REAC	Synaptic adhesion-like molecules	10916	2366		0.43333333333333335	0.45161290322580644	21	10895	7	25	14	10870	10916	0.26830748006782884
M1	string	0	network_modules	73	TRUE	4.2246655733996666e-11	97	30	10	0.3333333333333333	0.10309278350515463	KEGG:04713	KEGG	Circadian entrainment	8484	348		0.09523809523809523	0.13636363636363635	97	8387	10	20	87	8367	8484	0.18036904968664202
M1	string	0	network_modules	73	TRUE	6.141401198700317e-11	67	30	9	0.3	0.13432835820895522	KEGG:04720	KEGG	Long-term potentiation	8484	350		0.14285714285714285	0.18181818181818182	67	8417	9	21	58	8396	8484	0.19658473586434833
M1	string	0	network_modules	73	TRUE	1.2998966091240215e-10	44	39	8	0.20512820512820512	0.18181818181818182	GO:0060079	GO:BP	excitatory postsynaptic potential	16175	14338		0.10714285714285714	0.11764705882352941	44	16131	8	31	36	16100	16175	0.19105097111402614
M1	string	0	network_modules	73	TRUE	2.584381870777421e-10	49	30	8	0.26666666666666666	0.16326530612244897	KEGG:05030	KEGG	Cocaine addiction	8484	418		0.19047619047619047	0.22727272727272727	49	8435	8	22	41	8413	8484	0.20509205077685097
M1	string	0	network_modules	73	TRUE	4.6147700721929016e-10	51	39	8	0.20512820512820512	0.1568627450980392	GO:0099565	GO:BP	chemical synaptic transmission, postsynaptic	16175	19143		0.11904761904761904	0.12941176470588237	51	16124	8	31	43	16093	16175	0.1771149396266104
M1	string	0	network_modules	73	TRUE	4.792487685256977e-10	127	39	10	0.2564102564102564	0.07874015748031496	GO:0048167	GO:BP	regulation of synaptic plasticity	16175	12561		0.13095238095238096	0.1411764705882353	127	16048	10	29	117	16019	16175	0.1384507091725546
M1	string	0	network_modules	73	TRUE	9.93966396912918e-10	31	39	7	0.1794871794871795	0.22580645161290322	GO:0098815	GO:BP	modulation of excitatory postsynaptic potential	16175	18902		0.14285714285714285	0.15294117647058825	31	16144	7	32	24	16112	16175	0.19960131255408273
M1	string	0	network_modules	73	TRUE	1.3333952746163343e-9	251	30	12	0.4	0.04780876494023904	KEGG:04020	KEGG	Calcium signaling pathway	8484	250		0.23809523809523808	0.2727272727272727	251	8233	12	18	239	8215	8484	0.1302274969788619
M1	string	0	network_modules	73	TRUE	1.5177921501697235e-9	354	39	13	0.3333333333333333	0.03672316384180791	GO:0034762	GO:BP	regulation of transmembrane transport	16175	8731		0.15476190476190477	0.16470588235294117	354	15821	13	26	341	15795	16175	0.10465143606409069
M1	string	0	network_modules	73	TRUE	2.0980290860662288e-9	61	39	8	0.20512820512820512	0.13114754098360656	GO:0060078	GO:BP	regulation of postsynaptic membrane potential	16175	14337		0.16666666666666666	0.17647058823529413	61	16114	8	31	53	16083	16175	0.16150228980914216
M1	string	0	network_modules	73	TRUE	3.8484915679044115e-9	381	39	13	0.3333333333333333	0.03412073490813648	GO:0044057	GO:BP	regulation of system process	16175	10893		0.17857142857142858	0.18823529411764706	381	15794	13	26	368	15768	16175	0.10042025471128023
M1	string	0	network_modules	73	TRUE	8.351920738304066e-9	41	39	7	0.1794871794871795	0.17073170731707318	GO:0007215	GO:BP	glutamate receptor signaling pathway	16175	2769		0.19047619047619047	0.2	41	16134	7	32	34	16102	16175	0.17301038069327457
M1	string	0	network_modules	73	TRUE	9.470571857489848e-9	308	32	12	0.375	0.03896103896103896	REAC:R-HSA-5683057	REAC	MAPK family signaling cascades	10916	1348		0.4666666666666667	0.4838709677419355	308	10608	12	20	296	10588	10916	0.11355646364556227
M1	string	0	network_modules	73	TRUE	1.400792660323182e-8	22	39	6	0.15384615384615385	0.2727272727272727	GO:2000463	GO:BP	positive regulation of excitatory postsynaptic potential	16175	25775		0.20238095238095238	0.21176470588235294	22	16153	6	33	16	16120	16175	0.2034092841938423
M1	string	0	network_modules	73	TRUE	2.1937406517898255e-8	341	39	12	0.3076923076923077	0.03519061583577713	GO:0043269	GO:BP	regulation of monoatomic ion transport	16175	10593		0.21428571428571427	0.2235294117647059	341	15834	12	27	329	15807	16175	0.09808397823522726
M1	string	0	network_modules	73	TRUE	3.6993667692354113e-8	27	32	6	0.1875	0.2222222222222222	REAC:R-HSA-399721	REAC	Glutamate binding, activation of AMPA receptors and synaptic plasticity	10916	1057		0.5	0.5483870967741935	27	10889	6	26	21	10863	10916	0.20197725168019998
M1	string	0	network_modules	73	TRUE	3.6993667692354113e-8	27	32	6	0.1875	0.2222222222222222	REAC:R-HSA-399719	REAC	Trafficking of AMPA receptors	10916	2532		0.5	0.5483870967741935	27	10889	6	26	21	10863	10916	0.20197725168019998
M1	string	0	network_modules	73	TRUE	3.7402489864674744e-8	264	32	11	0.34375	0.041666666666666664	REAC:R-HSA-5673001	REAC	RAF/MAP kinase cascade	10916	1841		0.5666666666666667	0.5806451612903226	264	10652	11	21	253	10631	10916	0.11279409022940456
M1	string	0	network_modules	73	TRUE	4.5745843661481034e-8	269	32	11	0.34375	0.040892193308550186	REAC:R-HSA-5684996	REAC	MAPK1/MAPK3 signaling	10916	1351		0.6	0.6129032258064516	269	10647	11	21	258	10626	10916	0.11160693620027011
M1	string	0	network_modules	73	TRUE	1.735306814641513e-7	229	39	10	0.2564102564102564	0.043668122270742356	GO:1904062	GO:BP	regulation of monoatomic cation transmembrane transport	16175	23501		0.2261904761904762	0.23529411764705882	229	15946	10	29	219	15917	16175	0.1008099701864679
M1	string	0	network_modules	73	TRUE	2.6294164444411365e-7	324	39	11	0.28205128205128205	0.033950617283950615	GO:0006816	GO:BP	calcium ion transport	16175	2495		0.23809523809523808	0.24705882352941178	324	15851	11	28	313	15823	16175	0.0919417716408709
M1	string	0	network_modules	73	TRUE	2.899298027460057e-7	235	30	10	0.3333333333333333	0.0425531914893617	KEGG:04014	KEGG	Ras signaling pathway	8484	247		0.2857142857142857	0.3181818181818182	235	8249	10	20	225	8229	8484	0.1109423700541728
M1	string	0	network_modules	73	TRUE	3.722900715456647e-7	677	39	14	0.358974358974359	0.0206794682422452	GO:0030001	GO:BP	metal ion transport	16175	6646		0.25	0.25882352941176473	677	15498	14	25	663	15473	16175	0.07785197493351875
M1	string	0	network_modules	73	TRUE	4.727522667154623e-7	118	39	8	0.20512820512820512	0.06779661016949153	GO:0007611	GO:BP	learning or memory	16175	3068		0.2619047619047619	0.27058823529411763	118	16057	8	31	110	16026	16175	0.11428893137419638
M1	string	0	network_modules	73	TRUE	5.725923287542083e-7	73	39	7	0.1794871794871795	0.0958904109589041	GO:0031644	GO:BP	regulation of nervous system process	16175	7254		0.27380952380952384	0.2823529411764706	73	16102	7	32	66	16070	16175	0.12833671933510116
M1	string	0	network_modules	73	TRUE	6.478005264382886e-7	262	39	10	0.2564102564102564	0.03816793893129771	GO:0034765	GO:BP	regulation of monoatomic ion transmembrane transport	16175	8734		0.2857142857142857	0.29411764705882354	262	15913	10	29	252	15884	16175	0.09355078415287481
M1	string	0	network_modules	73	TRUE	1.1910706004796004e-6	740	39	14	0.358974358974359	0.01891891891891892	GO:0098657	GO:BP	import into cell	16175	18813		0.2976190476190476	0.3058823529411765	740	15435	14	25	726	15410	16175	0.07369966916627907
M1	string	0	network_modules	73	TRUE	1.3243403385426307e-6	282	39	10	0.2564102564102564	0.03546099290780142	GO:0042391	GO:BP	regulation of membrane potential	16175	10141		0.30952380952380953	0.3176470588235294	282	15893	10	29	272	15864	16175	0.08976464973404473
M1	string	0	network_modules	73	TRUE	1.3698735086042933e-6	748	39	14	0.358974358974359	0.01871657754010695	GO:0006812	GO:BP	monoatomic cation transport	16175	2492		0.32142857142857145	0.32941176470588235	748	15427	14	25	734	15402	16175	0.07320771836685365
M1	string	0	network_modules	73	TRUE	1.4645854026250943e-6	141	30	8	0.26666666666666666	0.05673758865248227	KEGG:05017	KEGG	Spinocerebellar ataxia	8484	415		0.3333333333333333	0.36363636363636365	141	8343	8	22	133	8321	8484	0.11651487994286534
M1	string	0	network_modules	73	TRUE	1.4771944547823097e-6	7	39	4	0.10256410256410256	0.5714285714285714	GO:0098976	GO:BP	excitatory chemical synaptic transmission	16175	18986		0.3333333333333333	0.3411764705882353	7	16168	4	35	3	16133	16175	0.24141291096175882
M1	string	0	network_modules	73	TRUE	2.297894496790909e-6	638	39	13	0.3333333333333333	0.02037617554858934	GO:0018193	GO:BP	peptidyl-amino acid modification	16175	5353		0.34523809523809523	0.35294117647058826	638	15537	13	26	625	15511	16175	0.0742282400981365
M1	string	0	network_modules	73	TRUE	3.2162747304964854e-6	150	39	8	0.20512820512820512	0.05333333333333334	GO:0016358	GO:BP	dendrite development	16175	5220		0.35714285714285715	0.36470588235294116	150	16025	8	31	142	15994	16175	0.10045414347855018
M1	string	0	network_modules	73	TRUE	4.330152681732472e-6	97	39	7	0.1794871794871795	0.07216494845360824	GO:0050806	GO:BP	positive regulation of synaptic transmission	16175	13272		0.36904761904761907	0.3764705882352941	97	16078	7	32	90	16046	16175	0.11047191833523816
M1	string	0	network_modules	73	TRUE	5.103197407023458e-6	159	39	8	0.20512820512820512	0.050314465408805034	GO:0050890	GO:BP	cognition	16175	13334		0.38095238095238093	0.38823529411764707	159	16016	8	31	151	15985	16175	0.09731983061107186
M1	string	0	network_modules	73	TRUE	5.362584106936548e-6	160	39	8	0.20512820512820512	0.05	GO:0097553	GO:BP	calcium ion transmembrane import into cytosol	16175	18700		0.39285714285714285	0.4	160	16015	8	31	152	15984	16175	0.09698754609624123
M1	string	0	network_modules	73	TRUE	1.2261102112725551e-5	593	39	12	0.3076923076923077	0.02023608768971332	GO:0007417	GO:BP	central nervous system development	16175	2912		0.40476190476190477	0.4117647058823529	593	15582	12	27	581	15555	16175	0.07090197607429151
M1	string	0	network_modules	73	TRUE	1.4793224192073548e-5	182	39	8	0.20512820512820512	0.04395604395604396	GO:0032412	GO:BP	regulation of monoatomic ion transmembrane transporter activity	16175	7550		0.4166666666666667	0.4235294117647059	182	15993	8	31	174	15962	16175	0.09036549884330164
M1	string	0	network_modules	73	TRUE	1.6086677567620722e-5	35	32	5	0.15625	0.14285714285714285	REAC:R-HSA-111933	REAC	Calmodulin induced events	10916	301		0.6333333333333333	0.6774193548387096	35	10881	5	27	30	10854	10916	0.14678824273374155
M1	string	0	network_modules	73	TRUE	1.6086677567620722e-5	35	32	5	0.15625	0.14285714285714285	REAC:R-HSA-111997	REAC	CaM pathway	10916	297		0.6333333333333333	0.6774193548387096	35	10881	5	27	30	10854	10916	0.14678824273374155
M1	string	0	network_modules	73	TRUE	1.679628272138159e-5	40	30	5	0.16666666666666666	0.125	KEGG:05033	KEGG	Nicotine addiction	8484	421		0.38095238095238093	0.4090909090909091	40	8444	5	25	35	8419	8484	0.14083549688259306
M1	string	0	network_modules	73	TRUE	1.927751352068351e-5	131	30	7	0.23333333333333334	0.05343511450381679	KEGG:04728	KEGG	Dopaminergic synapse	8484	358		0.42857142857142855	0.45454545454545453	131	8353	7	23	124	8330	8484	0.1052726525046337
M1	string	0	network_modules	73	TRUE	2.0722846155100684e-5	190	39	8	0.20512820512820512	0.042105263157894736	GO:0022898	GO:BP	regulation of transmembrane transporter activity	16175	6629		0.42857142857142855	0.43529411764705883	190	15985	8	31	182	15954	16175	0.08823905826103219
M1	string	0	network_modules	73	TRUE	2.1511211563898217e-5	37	32	5	0.15625	0.13513513513513514	REAC:R-HSA-111996	REAC	Ca-dependent events	10916	294		0.7	0.7096774193548387	37	10879	5	27	32	10852	10916	0.14260807522364538
M1	string	0	network_modules	73	TRUE	2.7451874204990314e-5	284	39	9	0.23076923076923078	0.03169014084507042	GO:0010959	GO:BP	regulation of metal ion transport	16175	4536		0.44047619047619047	0.4470588235294118	284	15891	9	30	275	15861	16175	0.07980939624582732
M1	string	0	network_modules	73	TRUE	3.227129799412123e-5	210	30	8	0.26666666666666666	0.0380952380952381	KEGG:04015	KEGG	Rap1 signaling pathway	8484	248		0.47619047619047616	0.5	210	8274	8	22	202	8252	8484	0.09275217575137412
M1	string	0	network_modules	73	TRUE	3.474583331809597e-5	203	39	8	0.20512820512820512	0.03940886699507389	GO:0032409	GO:BP	regulation of transporter activity	16175	7547		0.4523809523809524	0.4588235294117647	203	15972	8	31	195	15941	16175	0.08504672461099423
M1	string	0	network_modules	73	TRUE	3.6677966321561934e-5	41	32	5	0.15625	0.12195121951219512	REAC:R-HSA-1489509	REAC	DAG and IP3 signaling	10916	431		0.7333333333333333	0.7419354838709677	41	10875	5	27	36	10848	10916	0.13517319348661117
M1	string	0	network_modules	73	TRUE	3.7338330465684996e-5	76	39	6	0.15384615384615385	0.07894736842105263	GO:0035249	GO:BP	synaptic transmission, glutamatergic	16175	8924		0.4642857142857143	0.4823529411764706	76	16099	6	33	70	16066	16175	0.10722313789772288
M1	string	0	network_modules	73	TRUE	3.7338330465684996e-5	76	39	6	0.15384615384615385	0.07894736842105263	GO:0018107	GO:BP	peptidyl-threonine phosphorylation	16175	5326		0.4642857142857143	0.4823529411764706	76	16099	6	33	70	16066	16175	0.10722313789772288
M1	string	0	network_modules	73	TRUE	5.101615367177106e-5	223	30	8	0.26666666666666666	0.03587443946188341	KEGG:04024	KEGG	cAMP signaling pathway	8484	252		0.5238095238095238	0.5454545454545454	223	8261	8	22	215	8239	8484	0.08950827303630293
M1	string	0	network_modules	73	TRUE	5.973172601702177e-5	684	39	12	0.3076923076923077	0.017543859649122806	GO:0031175	GO:BP	neuron projection development	16175	7086		0.4880952380952381	0.49411764705882355	684	15491	12	27	672	15464	16175	0.06483651895089038
M1	string	0	network_modules	73	TRUE	7.890317939806896e-5	86	39	6	0.15384615384615385	0.06976744186046512	GO:0018210	GO:BP	peptidyl-threonine modification	16175	5369		0.5	0.5058823529411764	86	16089	6	33	80	16056	16175	0.10041001989499862
M1	string	0	network_modules	73	TRUE	9.179936193944476e-5	49	32	5	0.15625	0.10204081632653061	REAC:R-HSA-112043	REAC	PLC beta mediated events	10916	1693		0.7666666666666667	0.7741935483870968	49	10867	5	27	44	10840	10916	0.12309830133686318
M1	string	0	network_modules	73	TRUE	9.872370811882671e-5	17	39	4	0.10256410256410256	0.23529411764705882	GO:0045471	GO:BP	response to ethanol	16175	11399		0.5119047619047619	0.5176470588235295	17	16158	4	35	13	16123	16175	0.15402189741998215
M1	string	0	network_modules	73	TRUE	1.506818490184385e-4	54	32	5	0.15625	0.09259259259259259	REAC:R-HSA-112040	REAC	G-protein mediated events	10916	998		0.8	0.8064516129032258	54	10862	5	27	49	10835	10916	0.11693388838857767
M1	string	0	network_modules	73	TRUE	1.688575702004473e-4	249	39	8	0.20512820512820512	0.0321285140562249	GO:0070588	GO:BP	calcium ion transmembrane transport	16175	16193		0.5238095238095238	0.5294117647058824	249	15926	8	31	241	15895	16175	0.07576540744910949
M1	string	0	network_modules	73	TRUE	1.9188395194957153e-4	761	39	12	0.3076923076923077	0.01576872536136662	GO:0048666	GO:BP	neuron development	16175	12924		0.5357142857142857	0.5411764705882353	761	15414	12	27	749	15387	16175	0.060516950217024724
M1	string	0	network_modules	73	TRUE	2.0273939669930173e-4	255	39	8	0.20512820512820512	0.03137254901960784	GO:0007610	GO:BP	behavior	16175	3067		0.5476190476190477	0.5529411764705883	255	15920	8	31	247	15889	16175	0.07473644994632284
M1	string	0	network_modules	73	TRUE	2.1385185616535103e-4	187	30	7	0.23333333333333334	0.0374331550802139	KEGG:05034	KEGG	Alcoholism	8484	422		0.5714285714285714	0.5909090909090909	187	8297	7	23	180	8274	8484	0.08572974844480254
M1	string	0	network_modules	73	TRUE	2.197651809462851e-4	52	39	5	0.1282051282051282	0.09615384615384616	GO:0060291	GO:BP	long-term synaptic potentiation	16175	14506		0.5595238095238095	0.5647058823529412	52	16123	5	34	47	16089	16175	0.10855012523922737
M1	string	0	network_modules	73	TRUE	2.422321543325066e-4	53	39	5	0.1282051282051282	0.09433962264150944	GO:0007612	GO:BP	learning	16175	3069		0.5714285714285714	0.5764705882352941	53	16122	5	34	48	16088	16175	0.10747134070573786
M1	string	0	network_modules	73	TRUE	2.6139302845088825e-4	630	39	11	0.28205128205128205	0.01746031746031746	GO:0098660	GO:BP	inorganic ion transmembrane transport	16175	18816		0.5833333333333334	0.5882352941176471	630	15545	11	28	619	15517	16175	0.06177347834289548
M1	string	0	network_modules	73	TRUE	2.6845570824267064e-4	7	32	3	0.09375	0.42857142857142855	REAC:R-HSA-447038	REAC	NrCAM interactions	10916	1611		0.8333333333333334	0.8387096774193549	7	10909	3	29	4	10880	10916	0.19943124745186702
M1	string	0	network_modules	73	TRUE	2.9261642620087076e-4	55	39	5	0.1282051282051282	0.09090909090909091	GO:0051966	GO:BP	regulation of synaptic transmission, glutamatergic	16175	14035		0.5952380952380952	0.6	55	16120	5	34	50	16086	16175	0.1054013423328822
M1	string	0	network_modules	73	TRUE	3.0321201915238744e-4	179	39	7	0.1794871794871795	0.03910614525139665	GO:0051924	GO:BP	regulation of calcium ion transport	16175	13997		0.6071428571428571	0.611764705882353	179	15996	7	32	172	15964	16175	0.07914836608173782
M1	string	0	network_modules	73	TRUE	3.046669067293333e-4	382	30	9	0.3	0.02356020942408377	KEGG:05010	KEGG	Alzheimer disease	8484	411		0.6190476190476191	0.6363636363636364	382	8102	9	21	373	8081	8484	0.07324843986608867
M1	string	0	network_modules	73	TRUE	3.635120073262838e-4	23	39	4	0.10256410256410256	0.17391304347826086	GO:0051968	GO:BP	positive regulation of synaptic transmission, glutamatergic	16175	14037		0.6190476190476191	0.6235294117647059	23	16152	4	35	19	16117	16175	0.13195740990793545
M1	string	0	network_modules	73	TRUE	3.74635071689287e-4	653	39	11	0.28205128205128205	0.016845329249617153	GO:0051050	GO:BP	positive regulation of transport	16175	13460		0.6309523809523809	0.6352941176470588	653	15522	11	28	642	15494	16175	0.060365602821902564
M1	string	0	network_modules	73	TRUE	3.7943086956858184e-4	185	39	7	0.1794871794871795	0.03783783783783784	GO:0018105	GO:BP	peptidyl-serine phosphorylation	16175	5324		0.6428571428571429	0.6470588235294118	185	15990	7	32	178	15958	16175	0.07769740109817487
M1	string	0	network_modules	73	TRUE	4.041629803040751e-4	75	30	5	0.16666666666666666	0.06666666666666667	KEGG:05214	KEGG	Glioma	8484	465		0.6666666666666666	0.6818181818181818	75	8409	5	25	70	8384	8484	0.10044013197493531
M1	string	0	network_modules	73	TRUE	4.2867327174201194e-4	8	32	3	0.09375	0.375	REAC:R-HSA-9010642	REAC	ROBO receptors bind AKAP5	10916	1908		0.8666666666666667	0.8709677419354839	8	10908	3	29	5	10879	10916	0.18637584724291806
M1	string	0	network_modules	73	TRUE	4.3156003233588e-4	76	30	5	0.16666666666666666	0.06578947368421052	KEGG:04971	KEGG	Gastric acid secretion	8484	402		0.7142857142857143	0.7272727272727273	76	8408	5	25	71	8383	8484	0.09970856624788825
M1	string	0	network_modules	73	TRUE	4.835592143739337e-4	301	30	8	0.26666666666666666	0.026578073089700997	KEGG:04010	KEGG	MAPK signaling pathway	8484	243		0.7619047619047619	0.7727272727272727	301	8183	8	22	293	8161	8484	0.07444853449892598
M1	string	0	network_modules	73	TRUE	4.91708278745739e-4	671	39	11	0.28205128205128205	0.01639344262295082	GO:0034220	GO:BP	monoatomic ion transmembrane transport	16175	8508		0.6547619047619048	0.6588235294117647	671	15504	11	28	660	15476	16175	0.05931062285041696
M1	string	0	network_modules	73	TRUE	5.483199366087264e-4	533	39	10	0.2564102564102564	0.01876172607879925	GO:0006897	GO:BP	endocytosis	16175	2551		0.6666666666666666	0.6705882352941176	533	15642	10	29	523	15613	16175	0.06154108410554897
M1	string	0	network_modules	73	TRUE	5.810184796174348e-4	197	39	7	0.1794871794871795	0.03553299492385787	GO:0018209	GO:BP	peptidyl-serine modification	16175	5368		0.6785714285714286	0.6823529411764706	197	15978	7	32	190	15946	16175	0.07498955079911104
M1	string	0	network_modules	73	TRUE	6.312923967763455e-4	64	39	5	0.1282051282051282	0.078125	GO:0060996	GO:BP	dendritic spine development	16175	15120		0.6904761904761905	0.6941176470588235	64	16111	5	34	59	16077	16175	0.09730120894040557
M1	string	0	network_modules	73	TRUE	9.149288908454639e-4	10	32	3	0.09375	0.3	REAC:R-HSA-451308	REAC	Activation of Ca-permeable Kainate Receptor	10916	81		0.9	0.9354838709677419	10	10906	3	29	7	10877	10916	0.16638652898620496
M1	string	0	network_modules	73	TRUE	9.149288908454639e-4	10	32	3	0.09375	0.3	REAC:R-HSA-451306	REAC	Ionotropic activity of kainate receptors	10916	1276		0.9	0.9354838709677419	10	10906	3	29	7	10877	10916	0.16638652898620496
M1	string	0	network_modules	73	TRUE	0.0010468713704938936	91	30	5	0.16666666666666666	0.054945054945054944	KEGG:04970	KEGG	Salivary secretion	8484	401		0.8095238095238095	0.8181818181818182	91	8393	5	25	86	8368	8484	0.09017996077820381
M1	string	0	network_modules	73	TRUE	0.0010648642890167188	71	39	5	0.1282051282051282	0.07042253521126761	GO:0106027	GO:BP	neuron projection organization	16175	19219		0.7023809523809523	0.7058823529411765	71	16104	5	34	66	16070	16175	0.092078470284626
M1	string	0	network_modules	73	TRUE	0.001098210611806856	575	39	10	0.2564102564102564	0.017391304347826087	GO:0098662	GO:BP	inorganic cation transmembrane transport	16175	18818		0.7142857142857143	0.7176470588235294	575	15600	10	29	565	15571	16175	0.05864116424672458
M1	string	0	network_modules	73	TRUE	0.0011335285368173494	577	39	10	0.2564102564102564	0.01733102253032929	GO:0098655	GO:BP	monoatomic cation transmembrane transport	16175	18811		0.7261904761904762	0.7294117647058823	577	15598	10	29	567	15569	16175	0.058510422834147036
M1	string	0	network_modules	73	TRUE	0.0011562403214806763	441	39	9	0.23076923076923078	0.02040816326530612	GO:0048812	GO:BP	neuron projection morphogenesis	16175	13058		0.7380952380952381	0.7411764705882353	441	15734	9	30	432	15704	16175	0.06143483919360243
M1	string	0	network_modules	73	TRUE	0.0015025894134940777	98	30	5	0.16666666666666666	0.05102040816326531	KEGG:04750	KEGG	Inflammatory mediator regulation of TRP channels	8484	364		0.8571428571428571	0.9090909090909091	98	8386	5	25	93	8361	8484	0.08647586761764668
M1	string	0	network_modules	73	TRUE	0.0015025894134940777	98	30	5	0.16666666666666666	0.05102040816326531	KEGG:04925	KEGG	Aldosterone synthesis and secretion	8484	382		0.8571428571428571	0.9090909090909091	98	8386	5	25	93	8361	8484	0.08647586761764668
M1	string	0	network_modules	73	TRUE	0.0015271860643215715	456	39	9	0.23076923076923078	0.019736842105263157	GO:0120039	GO:BP	plasma membrane bounded cell projection morphogenesis	16175	19473		0.75	0.7529411764705882	456	15719	9	30	447	15689	16175	0.06016932565796822
M1	string	0	network_modules	73	TRUE	0.0016420135735479432	460	39	9	0.23076923076923078	0.01956521739130435	GO:0048858	GO:BP	cell projection morphogenesis	16175	13102		0.7619047619047619	0.7647058823529411	460	15715	9	30	451	15685	16175	0.05984163186075167
M1	string	0	network_modules	73	TRUE	0.0017055511037688486	78	39	5	0.1282051282051282	0.0641025641025641	GO:0006942	GO:BP	regulation of striated muscle contraction	16175	2580		0.7738095238095238	0.7764705882352941	78	16097	5	34	73	16063	16175	0.08756161249846749
M1	string	0	network_modules	73	TRUE	0.0017396444726189124	101	30	5	0.16666666666666666	0.04950495049504951	KEGG:04916	KEGG	Melanogenesis	8484	373		0.9523809523809523	0.9545454545454546	101	8383	5	25	96	8358	8484	0.08500291353736769
M1	string	0	network_modules	73	TRUE	0.0018396776105920496	89	32	5	0.15625	0.056179775280898875	REAC:R-HSA-111885	REAC	Opioid Signalling	10916	1642		0.9666666666666667	0.967741935483871	89	10827	5	27	84	10800	10916	0.08929783742682068
M1	string	0	network_modules	73	TRUE	0.0022604302531899416	10	39	3	0.07692307692307693	0.3	GO:0048169	GO:BP	regulation of long-term neuronal synaptic plasticity	16175	12563		0.7857142857142857	0.788235294117647	10	16165	3	36	7	16129	16175	0.15091863744597775
M1	string	0	network_modules	73	TRUE	0.0023643042630567077	36	39	4	0.10256410256410256	0.1111111111111111	GO:0043113	GO:BP	receptor clustering	16175	10537		0.7976190476190477	0.8117647058823529	36	16139	4	35	32	16104	16175	0.1046782511441431
M1	string	0	network_modules	73	TRUE	0.0023643042630567077	36	39	4	0.10256410256410256	0.1111111111111111	GO:0097120	GO:BP	receptor localization to synapse	16175	18510		0.7976190476190477	0.8117647058823529	36	16139	4	35	32	16104	16175	0.1046782511441431
M1	string	0	network_modules	73	TRUE	0.002500492452752465	154	39	6	0.15384615384615385	0.03896103896103896	GO:0090257	GO:BP	regulation of muscle system process	16175	18146		0.8214285714285714	0.8235294117647058	154	16021	6	33	148	15988	16175	0.07306609771997014
M1	string	0	network_modules	73	TRUE	0.002646299743691299	37	39	4	0.10256410256410256	0.10810810810810811	GO:0099601	GO:BP	regulation of neurotransmitter receptor activity	16175	19157		0.8333333333333334	0.8352941176470589	37	16138	4	35	33	16103	16175	0.10319356773717044
M1	string	0	network_modules	73	TRUE	0.0031196805825365434	366	39	8	0.20512820512820512	0.02185792349726776	GO:0051336	GO:BP	regulation of hydrolase activity	16175	13663		0.8452380952380952	0.8470588235294118	366	15809	8	31	358	15778	16175	0.060332375729320244
M1	string	0	network_modules	73	TRUE	0.003284249159000495	39	39	4	0.10256410256410256	0.10256410256410256	GO:0045197	GO:BP	establishment or maintenance of epithelial cell apical/basal polarity	16175	11321		0.8571428571428571	0.8588235294117647	39	16136	4	35	35	16101	16175	0.10039503959930333
M1	string	0	network_modules	73	TRUE	0.003377282899959573	651	39	10	0.2564102564102564	0.015360983102918587	GO:0000902	GO:BP	cell morphogenesis	16175	240		0.8690476190476191	0.8705882352941177	651	15524	10	29	641	15495	16175	0.05407140070752345
M1	string	0	network_modules	73	TRUE	0.0034798245311590485	163	39	6	0.15384615384615385	0.03680981595092025	GO:0043270	GO:BP	positive regulation of monoatomic ion transport	16175	10594		0.8809523809523809	0.8823529411764706	163	16012	6	33	157	15979	16175	0.07076637165634785
M1	string	0	network_modules	73	TRUE	0.0040437384337193545	379	39	8	0.20512820512820512	0.021108179419525065	GO:0048667	GO:BP	cell morphogenesis involved in neuron differentiation	16175	12925		0.8928571428571429	0.8941176470588236	379	15796	8	31	371	15765	16175	0.05905180833350689
M1	string	0	network_modules	73	TRUE	0.004089697557556455	93	39	5	0.1282051282051282	0.053763440860215055	GO:0048813	GO:BP	dendrite morphogenesis	16175	13059		0.9047619047619048	0.9058823529411765	93	16082	5	34	88	16048	16175	0.07962427569722813
M1	string	0	network_modules	73	TRUE	0.004130302474991433	12	39	3	0.07692307692307693	0.25	GO:0008542	GO:BP	visual learning	16175	3190		0.9166666666666666	0.9176470588235294	12	16163	3	36	9	16127	16175	0.13755449933414057
M1	string	0	network_modules	73	TRUE	0.004543459032281708	95	39	5	0.1282051282051282	0.05263157894736842	GO:2001257	GO:BP	regulation of cation channel activity	16175	26443		0.9285714285714286	0.9294117647058824	95	16080	5	34	90	16046	16175	0.0787070127155184
M1	string	0	network_modules	73	TRUE	0.004893697318389281	43	39	4	0.10256410256410256	0.09302325581395349	GO:0061245	GO:BP	establishment or maintenance of bipolar cell polarity	16175	15338		0.9404761904761905	0.9529411764705882	43	16132	4	35	39	16097	16175	0.09538728592728409
M1	string	0	network_modules	73	TRUE	0.004893697318389281	43	39	4	0.10256410256410256	0.09302325581395349	GO:0035088	GO:BP	establishment or maintenance of apical/basal cell polarity	16175	8802		0.9404761904761905	0.9529411764705882	43	16132	4	35	39	16097	16175	0.09538728592728409
M1	string	0	network_modules	73	TRUE	0.005518532340385687	533	39	9	0.23076923076923078	0.016885553470919325	GO:0034330	GO:BP	cell junction organization	16175	8572		0.9642857142857143	0.9647058823529412	533	15642	9	30	524	15612	16175	0.05447946484796184
M1	string	0	network_modules	73	TRUE	0.007493578544189484	412	39	8	0.20512820512820512	0.019417475728155338	GO:0045859	GO:BP	regulation of protein kinase activity	16175	11671		0.9761904761904762	0.9764705882352941	412	15763	8	31	404	15732	16175	0.0560601507189007
M1	string	0	network_modules	73	TRUE	0.0076493605353096196	48	39	4	0.10256410256410256	0.08333333333333333	GO:0061097	GO:BP	regulation of protein tyrosine kinase activity	16175	15207		0.9880952380952381	0.9882352941176471	48	16127	4	35	44	16092	16175	0.09001721601739512
M1	string	0	network_modules	73	TRUE	0.008351907684839992	59	32	4	0.125	0.06779661016949153	REAC:R-HSA-8986944	REAC	Transcriptional Regulation by MECP2	10916	2544		1	1	59	10857	4	28	55	10829	10916	0.08844568992723187
M1	string	0	network_modules	73	TRUE	0.00926500184705202	75	30	4	0.13333333333333333	0.05333333333333334	KEGG:04918	KEGG	Thyroid hormone synthesis	8484	375		1	1	75	8409	4	26	71	8383	8484	0.07922693606566593
M1	string	0	network_modules	73	TRUE	0.0097720233986875	111	39	5	0.1282051282051282	0.04504504504504504	GO:0060048	GO:BP	cardiac muscle contraction	16175	14311		1	1	111	16064	5	34	106	16030	16175	0.07226099175871069
M1	string	0	network_modules	74	TRUE	1.550375181324001e-4	20	35	4	0.11428571428571428	0.2	GO:0002475	GO:BP	antigen processing and presentation via MHC class Ib	16175	998		0	0.1111111111111111	20	16155	4	31	16	16124	16175	0.14980479257980603
M1	string	0	network_modules	74	TRUE	2.7835374430697316e-4	124	18	5	0.2777777777777778	0.04032258064516129	KEGG:04650	KEGG	Natural killer cell mediated cytotoxicity	8484	334		NA	1	124	8360	5	13	119	8347	8484	0.10111300737266166
M1	string	0	network_modules	74	TRUE	6.471960710752141e-4	28	35	4	0.11428571428571428	0.14285714285714285	GO:0019883	GO:BP	antigen processing and presentation of endogenous antigen	16175	6061		0.125	0.2222222222222222	28	16147	4	31	24	16116	16175	0.12608546993699354
M1	string	0	network_modules	74	TRUE	0.0014524705015336405	34	35	4	0.11428571428571428	0.11764705882352941	GO:0001916	GO:BP	positive regulation of T cell mediated cytotoxicity	16175	533		0.25	0.3333333333333333	34	16141	4	31	30	16110	16175	0.11406480125136916
M1	string	0	network_modules	74	TRUE	0.0034628244021072344	42	35	4	0.11428571428571428	0.09523809523809523	GO:0001914	GO:BP	regulation of T cell mediated cytotoxicity	16175	531		0.375	0.4444444444444444	42	16133	4	31	38	16102	16175	0.10220100873264833
M1	string	0	network_modules	74	TRUE	0.004588355241707486	45	35	4	0.11428571428571428	0.08888888888888889	GO:0001913	GO:BP	T cell mediated cytotoxicity	16175	530		0.5	0.5555555555555556	45	16130	4	31	41	16099	16175	0.09858076026974474
M1	string	0	network_modules	74	TRUE	0.005935110373289289	14	35	3	0.08571428571428572	0.21428571428571427	GO:0002486	GO:BP	antigen processing and presentation of endogenous peptide antigen via MHC class I via ER pathway, TAP-independent	16175	1009		0.625	0.7777777777777778	14	16161	3	32	11	16129	16175	0.1343612002356167
M1	string	0	network_modules	74	TRUE	0.005935110373289289	14	35	3	0.08571428571428572	0.21428571428571427	GO:0002484	GO:BP	antigen processing and presentation of endogenous peptide antigen via MHC class I via ER pathway	16175	1007		0.625	0.7777777777777778	14	16161	3	32	11	16129	16175	0.1343612002356167
M1	string	0	network_modules	74	TRUE	0.007407884034981109	15	35	3	0.08571428571428572	0.2	GO:0002428	GO:BP	antigen processing and presentation of peptide antigen via MHC class Ib	16175	951		0.875	1	15	16160	3	32	12	16128	16175	0.12971468407795753
M1	string	0	network_modules	74	TRUE	0.007407884034981109	15	35	3	0.08571428571428572	0.2	GO:0002476	GO:BP	antigen processing and presentation of endogenous peptide antigen via MHC class Ib	16175	999		0.875	1	15	16160	3	32	12	16128	16175	0.12971468407795753
M1	string	0	network_modules	75	TRUE	9.261003396538385e-17	32	30	10	0.3333333333333333	0.3125	REAC:R-HSA-8963899	REAC	Plasma lipoprotein remodeling	10916	1758		0	0.1111111111111111	32	10884	10	20	22	10864	10916	0.3208213136028671
M1	string	0	network_modules	75	TRUE	2.6962201639134165e-16	51	20	10	0.5	0.19607843137254902	KEGG:04979	KEGG	Cholesterol metabolism	8484	410		0	0.5	51	8433	10	10	41	8423	8484	0.31064809384998543
M1	string	0	network_modules	75	TRUE	6.352223560473489e-15	71	30	11	0.36666666666666664	0.15492957746478872	REAC:R-HSA-174824	REAC	Plasma lipoprotein assembly, remodeling, and clearance	10916	1756		0.125	0.2222222222222222	71	10845	11	19	60	10826	10916	0.23520387473183504
M1	string	0	network_modules	75	TRUE	2.2270726070348826e-13	67	35	10	0.2857142857142857	0.14925373134328357	GO:0097006	GO:BP	regulation of plasma lipoprotein particle levels	16175	18441		0	0.015625	67	16108	10	25	57	16083	16175	0.2041540220709626
M1	string	0	network_modules	75	TRUE	2.6161411452194e-13	346	35	15	0.42857142857142855	0.04335260115606936	GO:0010876	GO:BP	lipid localization	16175	4462		0.015873015873015872	0.03125	346	15829	15	20	331	15809	16175	0.13105349716934278
M1	string	0	network_modules	75	TRUE	5.089132250623385e-13	45	35	9	0.2571428571428571	0.2	GO:0071827	GO:BP	plasma lipoprotein particle organization	16175	16930		0.031746031746031744	0.046875	45	16130	9	26	36	16104	16175	0.22488125907078405
M1	string	0	network_modules	75	TRUE	7.802863646404236e-13	47	35	9	0.2571428571428571	0.19148936170212766	GO:0071825	GO:BP	protein-lipid complex organization	16175	16928		0.047619047619047616	0.0625	47	16128	9	26	38	16102	16175	0.2199512080780045
M1	string	0	network_modules	75	TRUE	2.091500536091077e-12	52	35	9	0.2571428571428571	0.17307692307692307	GO:0033344	GO:BP	cholesterol efflux	16175	8154		0.06349206349206349	0.078125	52	16123	9	26	43	16097	16175	0.20888755800530265
M1	string	0	network_modules	75	TRUE	2.7619816136407613e-12	31	35	8	0.22857142857142856	0.25806451612903225	GO:0034368	GO:BP	protein-lipid complex remodeling	16175	8593		0.07936507936507936	0.109375	31	16144	8	27	23	16117	16175	0.24132661406070172
M1	string	0	network_modules	75	TRUE	2.7619816136407613e-12	31	35	8	0.22857142857142856	0.25806451612903225	GO:0034369	GO:BP	plasma lipoprotein particle remodeling	16175	8594		0.07936507936507936	0.109375	31	16144	8	27	23	16117	16175	0.24132661406070172
M1	string	0	network_modules	75	TRUE	4.846653187787922e-12	33	35	8	0.22857142857142856	0.24242424242424243	GO:0034367	GO:BP	protein-containing complex remodeling	16175	8592		0.1111111111111111	0.125	33	16142	8	27	25	16115	16175	0.23378627599920832
M1	string	0	network_modules	75	TRUE	6.2509242251220364e-12	92	35	10	0.2857142857142857	0.10869565217391304	GO:0030301	GO:BP	cholesterol transport	16175	6760		0.12698412698412698	0.140625	92	16083	10	25	82	16058	16175	0.17339965442176503
M1	string	0	network_modules	75	TRUE	9.723482076124574e-12	96	35	10	0.2857142857142857	0.10416666666666667	GO:0015918	GO:BP	sterol transport	16175	5013		0.14285714285714285	0.15625	96	16079	10	25	86	16054	16175	0.16961991346706426
M1	string	0	network_modules	75	TRUE	4.5287782635987054e-11	301	35	13	0.37142857142857144	0.04318936877076412	GO:0006869	GO:BP	lipid transport	16175	2530		0.15873015873015872	0.171875	301	15874	13	22	288	15852	16175	0.12157739184544644
M1	string	0	network_modules	75	TRUE	1.0678385432577629e-10	12	35	6	0.17142857142857143	0.5	GO:0034372	GO:BP	very-low-density lipoprotein particle remodeling	16175	8597		0.1746031746031746	0.203125	12	16163	6	29	6	16134	16175	0.2919272140429509
M1	string	0	network_modules	75	TRUE	1.0678385432577629e-10	12	35	6	0.17142857142857143	0.5	GO:0034370	GO:BP	triglyceride-rich lipoprotein particle remodeling	16175	8595		0.1746031746031746	0.203125	12	16163	6	29	6	16134	16175	0.2919272140429509
M1	string	0	network_modules	75	TRUE	2.1640757303666224e-10	51	35	8	0.22857142857142856	0.1568627450980392	GO:0032371	GO:BP	regulation of sterol transport	16175	7525		0.20634920634920634	0.234375	51	16124	8	27	43	16097	16175	0.18723819880772752
M1	string	0	network_modules	75	TRUE	2.1640757303666224e-10	51	35	8	0.22857142857142856	0.1568627450980392	GO:0032374	GO:BP	regulation of cholesterol transport	16175	7528		0.20634920634920634	0.234375	51	16124	8	27	43	16097	16175	0.18723819880772752
M1	string	0	network_modules	75	TRUE	5.304337983966489e-10	31	35	7	0.2	0.22580645161290322	GO:0070328	GO:BP	triglyceride homeostasis	16175	16059		0.23809523809523808	0.265625	31	16144	7	28	24	16116	16175	0.21090571251036191
M1	string	0	network_modules	75	TRUE	5.304337983966489e-10	31	35	7	0.2	0.22580645161290322	GO:0055090	GO:BP	acylglycerol homeostasis	16175	14240		0.23809523809523808	0.265625	31	16144	7	28	24	16116	16175	0.21090571251036191
M1	string	0	network_modules	75	TRUE	1.5006593720223438e-9	18	30	6	0.2	0.3333333333333333	REAC:R-HSA-8963889	REAC	Assembly of active LPL and LIPC lipase complexes	10916	176		0.25	0.3333333333333333	18	10898	6	24	12	10874	10916	0.25663437426679736
M1	string	0	network_modules	75	TRUE	4.94972751874999e-9	74	35	8	0.22857142857142856	0.10810810810810811	GO:0042632	GO:BP	cholesterol homeostasis	16175	10265		0.2698412698412698	0.28125	74	16101	8	27	66	16074	16175	0.154570079505515
M1	string	0	network_modules	75	TRUE	5.532494441180705e-9	75	35	8	0.22857142857142856	0.10666666666666667	GO:0055092	GO:BP	sterol homeostasis	16175	14242		0.2857142857142857	0.296875	75	16100	8	27	67	16073	16175	0.15349854462842327
M1	string	0	network_modules	75	TRUE	9.007897512734627e-9	10	30	5	0.16666666666666666	0.5	REAC:R-HSA-8963901	REAC	Chylomicron remodeling	10916	360		0.375	0.4444444444444444	10	10906	5	25	5	10881	10916	0.2876155085336913
M1	string	0	network_modules	75	TRUE	9.703603447348136e-9	128	35	9	0.2571428571428571	0.0703125	GO:1905952	GO:BP	regulation of lipid localization	16175	25042		0.30158730158730157	0.3125	128	16047	9	26	119	16021	16175	0.13098571207433213
M1	string	0	network_modules	75	TRUE	1.2839580116515809e-8	132	35	9	0.2571428571428571	0.06818181818181818	GO:0055088	GO:BP	lipid homeostasis	16175	14238		0.31746031746031744	0.328125	132	16043	9	26	123	16017	16175	0.12887389103602628
M1	string	0	network_modules	75	TRUE	3.929171405195968e-8	218	35	10	0.2857142857142857	0.045871559633027525	GO:0015850	GO:BP	organic hydroxy compound transport	16175	4959		0.3333333333333333	0.34375	218	15957	10	25	208	15932	16175	0.10994344563222269
M1	string	0	network_modules	75	TRUE	4.925529069780972e-8	12	35	5	0.14285714285714285	0.4166666666666667	GO:0051004	GO:BP	regulation of lipoprotein lipase activity	16175	13435		0.3492063492063492	0.359375	12	16163	5	30	7	16133	16175	0.2430612025853836
M1	string	0	network_modules	75	TRUE	5.41695479162384e-8	99	35	8	0.22857142857142856	0.08080808080808081	GO:0032368	GO:BP	regulation of lipid transport	16175	7522		0.36507936507936506	0.375	99	16076	8	27	91	16049	16175	0.13281712131316595
M1	string	0	network_modules	75	TRUE	7.99160924095097e-8	13	35	5	0.14285714285714285	0.38461538461538464	GO:0033700	GO:BP	phospholipid efflux	16175	8356		0.38095238095238093	0.390625	13	16162	5	30	8	16132	16175	0.23343128138302716
M1	string	0	network_modules	75	TRUE	1.502518632098897e-7	34	35	6	0.17142857142857143	0.17647058823529413	GO:0060191	GO:BP	regulation of lipase activity	16175	14423		0.3968253968253968	0.40625	34	16141	6	29	28	16112	16175	0.17216582975840417
M1	string	0	network_modules	75	TRUE	2.699741945078739e-7	16	35	5	0.14285714285714285	0.3125	GO:0034375	GO:BP	high-density lipoprotein particle remodeling	16175	8600		0.4126984126984127	0.421875	16	16159	5	30	11	16129	16175	0.21015689560960785
M1	string	0	network_modules	75	TRUE	4.962075215638108e-7	78	35	7	0.2	0.08974358974358974	GO:0006641	GO:BP	triglyceride metabolic process	16175	2352		0.42857142857142855	0.4375	78	16097	7	28	71	16069	16175	0.13120097592367325
M1	string	0	network_modules	75	TRUE	5.9484658697478e-7	80	35	7	0.2	0.0875	GO:0015914	GO:BP	phospholipid transport	16175	5010		0.4444444444444444	0.453125	80	16095	7	28	73	16067	16175	0.12947655529888483
M1	string	0	network_modules	75	TRUE	3.913034481200964e-6	57	35	6	0.17142857142857143	0.10526315789473684	GO:0046503	GO:BP	glycerolipid catabolic process	16175	12206		0.4603174603174603	0.46875	57	16118	6	29	51	16089	16175	0.1319459836934438
M1	string	0	network_modules	75	TRUE	4.386466568781676e-6	106	35	7	0.2	0.0660377358490566	GO:0006639	GO:BP	acylglycerol metabolic process	16175	2350		0.47619047619047616	0.5	106	16069	7	28	99	16041	16175	0.11164530439234198
M1	string	0	network_modules	75	TRUE	4.386466568781676e-6	106	35	7	0.2	0.0660377358490566	GO:0006638	GO:BP	neutral lipid metabolic process	16175	2349		0.47619047619047616	0.5	106	16069	7	28	99	16041	16175	0.11164530439234198
M1	string	0	network_modules	75	TRUE	1.2142108267622959e-5	32	35	5	0.14285714285714285	0.15625	GO:0046461	GO:BP	neutral lipid catabolic process	16175	12169		0.5079365079365079	0.53125	32	16143	5	30	27	16113	16175	0.14764033415274747
M1	string	0	network_modules	75	TRUE	1.2142108267622959e-5	32	35	5	0.14285714285714285	0.15625	GO:0046464	GO:BP	acylglycerol catabolic process	16175	12172		0.5079365079365079	0.53125	32	16143	5	30	27	16113	16175	0.14764033415274747
M1	string	0	network_modules	75	TRUE	1.4288211983481544e-5	33	35	5	0.14285714285714285	0.15151515151515152	GO:0010874	GO:BP	regulation of cholesterol efflux	16175	4460		0.5396825396825397	0.546875	33	16142	5	30	28	16112	16175	0.14532685034626602
M1	string	0	network_modules	75	TRUE	1.6453973426397214e-5	128	35	7	0.2	0.0546875	GO:0015748	GO:BP	organophosphate ester transport	16175	4867		0.5555555555555556	0.5625	128	16047	7	28	121	16019	16175	0.10095355086660227
M1	string	0	network_modules	75	TRUE	4.1688032069949606e-5	75	20	5	0.25	0.06666666666666667	KEGG:03320	KEGG	PPAR signaling pathway	8484	236		1	1	75	8409	5	15	70	8394	8484	0.12523623184544405
M1	string	0	network_modules	75	TRUE	5.2020169517471464e-5	337	35	9	0.2571428571428571	0.026706231454005934	GO:0046486	GO:BP	glycerolipid metabolic process	16175	12190		0.5714285714285714	0.578125	337	15838	9	26	328	15812	16175	0.07704425934706827
M1	string	0	network_modules	75	TRUE	7.651018916292062e-5	17	35	4	0.11428571428571428	0.23529411764705882	GO:0043691	GO:BP	reverse cholesterol transport	16175	10840		0.5873015873015873	0.59375	17	16158	4	31	13	16127	16175	0.1627375803989863
M1	string	0	network_modules	75	TRUE	8.018453133182883e-5	248	35	8	0.22857142857142856	0.03225806451612903	GO:0016042	GO:BP	lipid catabolic process	16175	5076		0.6031746031746031	0.609375	248	15927	8	27	240	15900	16175	0.08081660623001057
M1	string	0	network_modules	75	TRUE	8.293322578580874e-5	94	35	6	0.17142857142857143	0.06382978723404255	GO:0008203	GO:BP	cholesterol metabolic process	16175	3130		0.6190476190476191	0.625	94	16081	6	29	88	16052	16175	0.10146385493795201
M1	string	0	network_modules	75	TRUE	1.2424218475632213e-4	50	35	5	0.14285714285714285	0.1	GO:0050994	GO:BP	regulation of lipid catabolic process	16175	13429		0.6349206349206349	0.640625	50	16125	5	30	45	16095	16175	0.11724466007581706
M1	string	0	network_modules	75	TRUE	1.4363181992280166e-4	103	35	6	0.17142857142857143	0.05825242718446602	GO:1902652	GO:BP	secondary alcohol metabolic process	16175	22418		0.6507936507936508	0.65625	103	16072	6	29	97	16043	16175	0.09663105180940247
M1	string	0	network_modules	75	TRUE	1.804271895614262e-4	107	35	6	0.17142857142857143	0.056074766355140186	GO:0016125	GO:BP	sterol metabolic process	16175	5143		0.6666666666666666	0.671875	107	16068	6	29	101	16039	16175	0.09467740141777178
M1	string	0	network_modules	75	TRUE	1.9122328177606558e-4	21	35	4	0.11428571428571428	0.19047619047619047	GO:0019433	GO:BP	triglyceride catabolic process	16175	5785		0.6825396825396826	0.6875	21	16154	4	31	17	16123	16175	0.14611908036550386
M1	string	0	network_modules	75	TRUE	2.82054073942172e-4	23	35	4	0.11428571428571428	0.17391304347826086	GO:0050996	GO:BP	positive regulation of lipid catabolic process	16175	13431		0.6984126984126984	0.703125	23	16152	4	31	19	16121	16175	0.13947745557324262
M1	string	0	network_modules	75	TRUE	3.300013189308656e-4	6	35	3	0.08571428571428572	0.5	GO:0010901	GO:BP	regulation of very-low-density lipoprotein particle remodeling	16175	4487		0.7142857142857143	0.75	6	16169	3	32	3	16137	16175	0.20638540920552684
M1	string	0	network_modules	75	TRUE	3.300013189308656e-4	6	35	3	0.08571428571428572	0.5	GO:0071830	GO:BP	triglyceride-rich lipoprotein particle clearance	16175	16933		0.7142857142857143	0.75	6	16169	3	32	3	16137	16175	0.20638540920552684
M1	string	0	network_modules	75	TRUE	3.300013189308656e-4	6	35	3	0.08571428571428572	0.5	GO:0034382	GO:BP	chylomicron remnant clearance	16175	8607		0.7142857142857143	0.75	6	16169	3	32	3	16137	16175	0.20638540920552684
M1	string	0	network_modules	75	TRUE	3.429630142524581e-4	61	35	5	0.14285714285714285	0.08196721311475409	GO:0046470	GO:BP	phosphatidylcholine metabolic process	16175	12178		0.7619047619047619	0.765625	61	16114	5	30	56	16084	16175	0.10566788768996697
M1	string	0	network_modules	75	TRUE	5.085396598619778e-4	9	30	3	0.1	0.3333333333333333	REAC:R-HSA-8964058	REAC	HDL remodeling	10916	1095		0.5	0.5555555555555556	9	10907	3	27	6	10880	10916	0.1813930210169564
M1	string	0	network_modules	75	TRUE	5.766453956058552e-4	7	35	3	0.08571428571428572	0.42857142857142855	GO:0051006	GO:BP	positive regulation of lipoprotein lipase activity	16175	13437		0.7777777777777778	0.78125	7	16168	3	32	4	16136	16175	0.19094324713370853
M1	string	0	network_modules	75	TRUE	6.847012631805867e-4	328	35	8	0.22857142857142856	0.024390243902439025	GO:0006644	GO:BP	phospholipid metabolic process	16175	2355		0.7936507936507936	0.796875	328	15847	8	27	320	15820	16175	0.06881628634698364
M1	string	0	network_modules	75	TRUE	9.21263675524132e-4	8	35	3	0.08571428571428572	0.375	GO:0051838	GO:BP	cytolysis by host of symbiont cells	16175	13951		0.8095238095238095	0.828125	8	16167	3	32	5	16135	16175	0.1784870907077148
M1	string	0	network_modules	75	TRUE	9.21263675524132e-4	8	35	3	0.08571428571428572	0.375	GO:0061365	GO:BP	positive regulation of triglyceride lipase activity	16175	15437		0.8095238095238095	0.828125	8	16167	3	32	5	16135	16175	0.1784870907077148
M1	string	0	network_modules	75	TRUE	9.900125356697622e-4	31	35	4	0.11428571428571428	0.12903225806451613	GO:0032373	GO:BP	positive regulation of sterol transport	16175	7527		0.8412698412698413	0.859375	31	16144	4	31	27	16113	16175	0.11964300785934255
M1	string	0	network_modules	75	TRUE	9.900125356697622e-4	31	35	4	0.11428571428571428	0.12903225806451613	GO:0032376	GO:BP	positive regulation of cholesterol transport	16175	7530		0.8412698412698413	0.859375	31	16144	4	31	27	16113	16175	0.11964300785934255
M1	string	0	network_modules	75	TRUE	0.0013289745051443746	243	35	7	0.2	0.02880658436213992	GO:0019216	GO:BP	regulation of lipid metabolic process	16175	5593		0.873015873015873	0.875	243	15932	7	28	236	15904	16175	0.07081178800513395
M1	string	0	network_modules	75	TRUE	0.00134571526788668	80	35	5	0.14285714285714285	0.0625	GO:1905954	GO:BP	positive regulation of lipid localization	16175	25044		0.8888888888888888	0.890625	80	16095	5	30	75	16065	16175	0.09154523029169512
M1	string	0	network_modules	75	TRUE	0.0018392197536800541	36	35	4	0.11428571428571428	0.1111111111111111	GO:0034381	GO:BP	plasma lipoprotein particle clearance	16175	8606		0.9047619047619048	0.90625	36	16139	4	31	32	16108	16175	0.11073574345695641
M1	string	0	network_modules	75	TRUE	0.0019050432796793107	44	30	4	0.13333333333333333	0.09090909090909091	REAC:R-HSA-975634	REAC	Retinoid metabolism and transport	10916	2093		0.625	0.6666666666666666	44	10872	4	26	40	10846	10916	0.10713121454427156
M1	string	0	network_modules	75	TRUE	0.001968282975880127	10	35	3	0.08571428571428572	0.3	GO:0060192	GO:BP	negative regulation of lipase activity	16175	14424		0.9206349206349206	0.953125	10	16165	3	32	7	16133	16175	0.15942193696978257
M1	string	0	network_modules	75	TRUE	0.001968282975880127	10	35	3	0.08571428571428572	0.3	GO:0032375	GO:BP	negative regulation of cholesterol transport	16175	7529		0.9206349206349206	0.953125	10	16165	3	32	7	16133	16175	0.15942193696978257
M1	string	0	network_modules	75	TRUE	0.001968282975880127	10	35	3	0.08571428571428572	0.3	GO:0032372	GO:BP	negative regulation of sterol transport	16175	7526		0.9206349206349206	0.953125	10	16165	3	32	7	16133	16175	0.15942193696978257
M1	string	0	network_modules	75	TRUE	0.0020869162505113997	45	30	4	0.13333333333333333	0.08888888888888889	REAC:R-HSA-9024446	REAC	NR1H2 and NR1H3-mediated signaling	10916	1546		0.75	0.7777777777777778	45	10871	4	26	41	10845	10916	0.10586399637302968
M1	string	0	network_modules	75	TRUE	0.002709855315446501	48	30	4	0.13333333333333333	0.08333333333333333	REAC:R-HSA-6806667	REAC	Metabolism of fat-soluble vitamins	10916	1424		0.875	0.8888888888888888	48	10868	4	26	44	10842	10916	0.10229847202919441
M1	string	0	network_modules	75	TRUE	0.0041869191713587274	44	35	4	0.11428571428571428	0.09090909090909091	GO:0009395	GO:BP	phospholipid catabolic process	16175	3464		0.9682539682539683	0.96875	44	16131	4	31	40	16100	16175	0.09974688687372761
M1	string	0	network_modules	75	TRUE	0.0045409280368233895	185	35	6	0.17142857142857143	0.032432432432432434	GO:0046434	GO:BP	organophosphate catabolic process	16175	12142		0.9841269841269841	0.984375	185	15990	6	29	179	15961	16175	0.0700668283709691
M1	string	0	network_modules	75	TRUE	0.004858249804910806	18	30	3	0.1	0.16666666666666666	REAC:R-HSA-8963898	REAC	Plasma lipoprotein assembly	10916	1755		1	1	18	10898	3	27	15	10871	10916	0.1272504453227571
M1	string	0	network_modules	75	TRUE	0.008122640014723953	2	35	2	0.05714285714285714	1	GO:0010902	GO:BP	positive regulation of very-low-density lipoprotein particle remodeling	16175	4488		1	1	2	16173	2	33	0	16140	16175	0.23880171837541012
M1	string	0	network_modules	76	TRUE	4.236715328913903e-29	44	32	16	0.5	0.36363636363636365	REAC:R-HSA-1566948	REAC	Elastic fibre formation	10916	836		0	0.1111111111111111	44	10872	16	16	28	10856	10916	0.4244415715873678
M1	string	0	network_modules	76	TRUE	3.500288051087422e-27	298	32	23	0.71875	0.07718120805369127	REAC:R-HSA-1474244	REAC	Extracellular matrix organization	10916	889		0.125	0.2222222222222222	298	10618	23	9	275	10609	10916	0.23007844276544143
M1	string	0	network_modules	76	TRUE	2.419288472801948e-25	37	32	14	0.4375	0.3783783783783784	REAC:R-HSA-2129379	REAC	Molecules associated with elastic fibres	10916	1490		0.25	0.3333333333333333	37	10879	14	18	23	10861	10916	0.4049945412936098
M1	string	0	network_modules	76	TRUE	2.886518809226339e-12	236	36	13	0.3611111111111111	0.05508474576271186	GO:0030198	GO:BP	extracellular matrix organization	16175	6707		0	0.045454545454545456	236	15939	13	23	223	15916	16175	0.13648969629006055
M1	string	0	network_modules	76	TRUE	3.0499580485834885e-12	237	36	13	0.3611111111111111	0.05485232067510549	GO:0043062	GO:BP	extracellular structure organization	16175	10509		0.047619047619047616	0.09090909090909091	237	15938	13	23	224	15915	16175	0.13618141086734575
M1	string	0	network_modules	76	TRUE	3.221865610431583e-12	238	36	13	0.3611111111111111	0.0546218487394958	GO:0045229	GO:BP	external encapsulating structure organization	16175	11340		0.09523809523809523	0.13636363636363635	238	15937	13	23	225	15914	16175	0.13587502722619746
M1	string	0	network_modules	76	TRUE	1.0669888613611438e-6	20	36	5	0.1388888888888889	0.25	GO:0048048	GO:BP	embryonic eye morphogenesis	16175	12484		0.14285714285714285	0.18181818181818182	20	16155	5	31	15	16124	16175	0.18500036202228937
M1	string	0	network_modules	76	TRUE	1.452098648549196e-5	283	36	9	0.25	0.03180212014134275	GO:0001501	GO:BP	skeletal system development	16175	318		0.19047619047619047	0.22727272727272727	283	15892	9	27	274	15865	16175	0.0837538746808826
M1	string	0	network_modules	76	TRUE	1.745698159094821e-5	3	36	3	0.08333333333333333	1	GO:0048050	GO:BP	post-embryonic eye morphogenesis	16175	12485		0.23809523809523808	0.2727272727272727	3	16172	3	33	0	16139	16175	0.2883804541547979
M1	string	0	network_modules	76	TRUE	2.4712832883121154e-5	76	32	6	0.1875	0.07894736842105263	REAC:R-HSA-3000178	REAC	ECM proteoglycans	10916	812		0.375	0.4444444444444444	76	10840	6	26	70	10814	10916	0.11773099666405827
M1	string	0	network_modules	76	TRUE	6.639976309429611e-5	46	32	5	0.15625	0.10869565217391304	REAC:R-HSA-2173789	REAC	TGF-beta receptor signaling activates SMADs	10916	2428		0.5	0.5555555555555556	46	10870	5	27	41	10843	10916	0.12726148978295934
M1	string	0	network_modules	76	TRUE	6.97210601025076e-5	4	36	3	0.08333333333333333	0.75	GO:0035583	GO:BP	sequestering of TGFbeta in extracellular matrix	16175	9104		0.2857142857142857	0.3181818181818182	4	16171	3	33	1	16138	16175	0.24956682001728187
M1	string	0	network_modules	76	TRUE	3.338575062712125e-4	543	36	10	0.2777777777777778	0.01841620626151013	GO:0009887	GO:BP	animal organ morphogenesis	16175	3747		0.3333333333333333	0.36363636363636365	543	15632	10	26	533	15606	16175	0.0640337528472659
M1	string	0	network_modules	76	TRUE	6.072629089234312e-4	7	36	3	0.08333333333333333	0.42857142857142855	GO:0071694	GO:BP	maintenance of protein location in extracellular region	16175	16862		0.38095238095238093	0.4090909090909091	7	16168	3	33	4	16135	16175	0.18825111540602296
M1	string	0	network_modules	76	TRUE	9.701339779040485e-4	8	36	3	0.08333333333333333	0.375	GO:0048251	GO:BP	elastic fiber assembly	16175	12607		0.42857142857142855	0.45454545454545453	8	16167	3	33	5	16134	16175	0.17596691334509712
M1	string	0	network_modules	76	TRUE	0.0010093976436382228	35	32	4	0.125	0.11428571428571428	REAC:R-HSA-5083635	REAC	Defective B3GALTL causes PpS	10916	491		0.625	0.6666666666666666	35	10881	4	28	31	10853	10916	0.1168155443109671
M1	string	0	network_modules	76	TRUE	0.0011332420043905019	36	32	4	0.125	0.1111111111111111	REAC:R-HSA-5173214	REAC	O-glycosylation of TSR domain-containing proteins	10916	1630		0.75	0.7777777777777778	36	10880	4	28	32	10852	10916	0.11510033384451684
M1	string	0	network_modules	76	TRUE	0.0013922113439977111	33	36	4	0.1111111111111111	0.12121212121212122	GO:0085029	GO:BP	extracellular matrix assembly	16175	17872		0.47619047619047616	0.5	33	16142	4	32	29	16110	16175	0.11416437050485967
M1	string	0	network_modules	76	TRUE	0.0015030559567975445	80	36	5	0.1388888888888889	0.0625	GO:0048592	GO:BP	eye morphogenesis	16175	12861		0.5238095238095238	0.5454545454545454	80	16095	5	31	75	16064	16175	0.09017511756989377
M1	string	0	network_modules	76	TRUE	0.0020725021747958904	10	36	3	0.08333333333333333	0.3	GO:0035581	GO:BP	sequestering of extracellular ligand from receptor	16175	9102		0.5714285714285714	0.5909090909090909	10	16165	3	33	7	16132	16175	0.15716438917246794
M1	string	0	network_modules	76	TRUE	0.0021661235172884784	92	32	5	0.15625	0.05434782608695652	REAC:R-HSA-170834	REAC	Signaling by TGF-beta Receptor Complex	10916	2308		0.875	0.8888888888888888	92	10824	5	27	87	10797	10916	0.08767898849496364
M1	string	0	network_modules	76	TRUE	0.003787970877251623	12	36	3	0.08333333333333333	0.25	GO:1900116	GO:BP	extracellular negative regulation of signal transduction	16175	20402		0.6190476190476191	0.6818181818181818	12	16163	3	33	9	16130	16175	0.14326519596376586
M1	string	0	network_modules	76	TRUE	0.003787970877251623	12	36	3	0.08333333333333333	0.25	GO:1900115	GO:BP	extracellular regulation of signal transduction	16175	20401		0.6190476190476191	0.6818181818181818	12	16163	3	33	9	16130	16175	0.14326519596376586
M1	string	0	network_modules	76	TRUE	0.0039031330192886003	176	36	6	0.16666666666666666	0.03409090909090909	GO:0007179	GO:BP	transforming growth factor beta receptor signaling pathway	16175	2741		0.7142857142857143	0.7272727272727273	176	15999	6	30	170	15969	16175	0.07092216802810504
M1	string	0	network_modules	76	TRUE	0.007627336423873511	50	36	4	0.1111111111111111	0.08	GO:0030199	GO:BP	collagen fibril organization	16175	6708		0.7619047619047619	0.7727272727272727	50	16125	4	32	46	16093	16175	0.09190226614565224
M1	string	0	network_modules	76	TRUE	0.007798317540910174	15	36	3	0.08333333333333333	0.2	GO:0032331	GO:BP	negative regulation of chondrocyte differentiation	16175	7490		0.8095238095238095	0.8181818181818182	15	16160	3	33	12	16127	16175	0.12786439562882096
M1	string	0	network_modules	76	TRUE	0.007940809633361103	199	36	6	0.16666666666666666	0.03015075376884422	GO:0001654	GO:BP	eye development	16175	368		0.8571428571428571	0.8636363636363636	199	15976	6	30	193	15946	16175	0.06613660981781257
M1	string	0	network_modules	76	TRUE	0.008581260989676215	122	32	5	0.15625	0.040983606557377046	REAC:R-HSA-9006936	REAC	Signaling by TGFB family members	10916	2310		1	1	122	10794	5	27	117	10767	10916	0.07482762301075627
M1	string	0	network_modules	76	TRUE	0.008655023169049682	202	36	6	0.16666666666666666	0.0297029702970297	GO:0071560	GO:BP	cellular response to transforming growth factor beta stimulus	16175	16762		0.9047619047619048	0.9545454545454546	202	15973	6	30	196	15943	16175	0.06557094377393446
M1	string	0	network_modules	76	TRUE	0.008655023169049682	202	36	6	0.16666666666666666	0.0297029702970297	GO:0150063	GO:BP	visual system development	16175	20119		0.9047619047619048	0.9545454545454546	202	15973	6	30	196	15943	16175	0.06557094377393446
M1	string	0	network_modules	76	TRUE	0.009583249739264846	16	36	3	0.08333333333333333	0.1875	GO:0061037	GO:BP	negative regulation of cartilage development	16175	15154		1	1	16	16159	3	33	13	16126	16175	0.12371511443697349
M1	string	0	network_modules	77	TRUE	1.0687249122699227e-22	33	25	12	0.48	0.36363636363636365	REAC:R-HSA-68962	REAC	Activation of the pre-replicative complex	10916	107		0	0.058823529411764705	33	10883	12	13	21	10870	10916	0.41626100435698954
M1	string	0	network_modules	77	TRUE	5.555192613894923e-22	37	25	12	0.48	0.32432432432432434	REAC:R-HSA-176187	REAC	Activation of ATR in response to replication stress	10916	75		0.0625	0.11764705882352941	37	10879	12	13	25	10866	10916	0.39288720864197296
M1	string	0	network_modules	77	TRUE	7.635981130209737e-20	8	25	8	0.32	1	REAC:R-HSA-68689	REAC	CDC6 association with the ORC:origin complex	10916	270		0.125	0.17647058823529413	8	10908	8	17	0	10891	10916	0.5652444457592479
M1	string	0	network_modules	77	TRUE	9.77038548668259e-16	231	36	15	0.4166666666666667	0.06493506493506493	GO:0006260	GO:BP	DNA replication	16175	2077		0	0.25	231	15944	15	21	216	15923	16175	0.16017501618631896
M1	string	0	network_modules	77	TRUE	1.661211027043437e-15	9	25	7	0.28	0.7777777777777778	REAC:R-HSA-113507	REAC	E2F-enabled inhibition of pre-replication complex formation	10916	810		0.1875	0.23529411764705882	9	10907	7	18	2	10889	10916	0.46601841467900734
M1	string	0	network_modules	77	TRUE	5.598817470901831e-15	147	36	13	0.3611111111111111	0.08843537414965986	GO:0006261	GO:BP	DNA-templated DNA replication	16175	2078		0.3333333333333333	0.5	147	16028	13	23	134	16005	16175	0.17519832488912337
M1	string	0	network_modules	77	TRUE	7.79672519073712e-15	130	25	12	0.48	0.09230769230769231	REAC:R-HSA-69206	REAC	G1/S Transition	10916	1002		0.25	0.29411764705882354	130	10786	12	13	118	10773	10916	0.20674163376710814
M1	string	0	network_modules	77	TRUE	2.1104450784219885e-14	32	36	9	0.25	0.28125	GO:0006270	GO:BP	DNA replication initiation	16175	2085		0.6666666666666666	0.75	32	16143	9	27	23	16116	16175	0.26362080892153156
M1	string	0	network_modules	77	TRUE	3.557947013955797e-14	147	25	12	0.48	0.08163265306122448	REAC:R-HSA-453279	REAC	Mitotic G1 phase and G1/S transition	10916	1480		0.3125	0.35294117647058826	147	10769	12	13	135	10756	10916	0.1939260526318592
M1	string	0	network_modules	77	TRUE	9.329394555332066e-14	159	25	12	0.48	0.07547169811320754	REAC:R-HSA-69002	REAC	DNA Replication Pre-Initiation	10916	446		0.375	0.4117647058823529	159	10757	12	13	147	10744	10916	0.1861289044651353
M1	string	0	network_modules	77	TRUE	1.7016852781214206e-13	167	25	12	0.48	0.0718562874251497	REAC:R-HSA-69481	REAC	G2/M Checkpoints	10916	1005		0.4375	0.47058823529411764	167	10749	12	13	155	10736	10916	0.18139751148727207
M1	string	0	network_modules	77	TRUE	6.759075093520985e-13	187	25	12	0.48	0.06417112299465241	REAC:R-HSA-69306	REAC	DNA Replication	10916	445		0.5	0.5294117647058824	187	10729	12	13	175	10716	10916	0.17090607228436108
M1	string	0	network_modules	77	TRUE	7.723209325922234e-12	22	25	7	0.28	0.3181818181818182	REAC:R-HSA-113510	REAC	E2F mediated regulation of DNA replication	10916	809		0.5625	0.5882352941176471	22	10894	7	18	15	10876	10916	0.29697191457477523
M1	string	0	network_modules	77	TRUE	1.7464435780121333e-11	157	19	10	0.5263157894736842	0.06369426751592357	KEGG:04110	KEGG	Cell cycle	8484	264		NA	1	157	8327	10	9	147	8318	8484	0.17851365158491114
M1	string	0	network_modules	77	TRUE	1.2732248919757704e-10	289	25	12	0.48	0.04152249134948097	REAC:R-HSA-69620	REAC	Cell Cycle Checkpoints	10916	321		0.625	0.6470588235294118	289	10627	12	13	277	10614	10916	0.1353464032488671
M1	string	0	network_modules	77	TRUE	7.443283558842103e-10	71	25	8	0.32	0.11267605633802817	REAC:R-HSA-68949	REAC	Orc1 removal from chromatin	10916	1644		0.6875	0.7058823529411765	71	10845	8	17	63	10828	10916	0.18684754982309254
M1	string	0	network_modules	77	TRUE	1.1588170419138502e-9	121	25	9	0.36	0.0743801652892562	REAC:R-HSA-69239	REAC	Synthesis of DNA	10916	2376		0.75	0.7647058823529411	121	10795	9	16	112	10779	10916	0.15966720549348598
M1	string	0	network_modules	77	TRUE	6.324347490931187e-9	92	25	8	0.32	0.08695652173913043	REAC:R-HSA-69052	REAC	Switching of origins to a post-replicative state	10916	2365		0.8125	0.8235294117647058	92	10824	8	17	84	10807	10916	0.1632940178715908
M1	string	0	network_modules	77	TRUE	1.6403762034912414e-8	162	25	9	0.36	0.05555555555555555	REAC:R-HSA-69242	REAC	S Phase	10916	2111		0.875	0.8823529411764706	162	10754	9	16	153	10738	10916	0.13676558678834566
M1	string	0	network_modules	77	TRUE	2.125402604376891e-7	142	25	8	0.32	0.056338028169014086	REAC:R-HSA-68867	REAC	Assembly of the pre-replicative complex	10916	181		0.9375	0.9411764705882353	142	10774	8	17	134	10757	10916	0.1298056054677817
M1	string	0	network_modules	77	TRUE	2.650902413576738e-6	68	25	6	0.24	0.08823529411764706	REAC:R-HSA-68616	REAC	Assembly of the ORC complex at the origin of replication	10916	178		1	1	68	10848	6	19	62	10829	10916	0.14235091774061834
M1	string	0	network_modules	77	TRUE	2.730678065737382e-4	112	36	6	0.16666666666666666	0.05357142857142857	GO:0006275	GO:BP	regulation of DNA replication	16175	2090		1	1	112	16063	6	30	106	16033	16175	0.09098191951285886
M1	string	0	network_modules	78	TRUE	1.533094729137738e-18	744	38	23	0.6052631578947368	0.030913978494623656	GO:0001932	GO:BP	regulation of protein phosphorylation	16175	546		0	0.014705882352941176	744	15431	23	15	721	15416	16175	0.12955667567434168
M1	string	0	network_modules	78	TRUE	1.778306852018685e-18	301	36	20	0.5555555555555556	0.0664451827242525	KEGG:04010	KEGG	MAPK signaling pathway	8484	243		0	0.013157894736842105	301	8183	20	16	281	8167	8484	0.18352831974912293
M1	string	0	network_modules	78	TRUE	6.306731965584083e-18	792	38	23	0.6052631578947368	0.02904040404040404	GO:0042325	GO:BP	regulation of phosphorylation	16175	10093		0.014925373134328358	0.029411764705882353	792	15383	23	15	769	15368	16175	0.12509778714362668
M1	string	0	network_modules	78	TRUE	1.348830201656868e-15	632	38	20	0.5263157894736842	0.03164556962025317	GO:0031401	GO:BP	positive regulation of protein modification process	16175	7157		0.029850746268656716	0.04411764705882353	632	15543	20	18	612	15525	16175	0.12202377729124252
M1	string	0	network_modules	78	TRUE	1.4107491027297549e-14	500	38	18	0.47368421052631576	0.036	GO:0001934	GO:BP	positive regulation of protein phosphorylation	16175	548		0.04477611940298507	0.058823529411764705	500	15675	18	20	482	15655	16175	0.12414132142313977
M1	string	0	network_modules	78	TRUE	3.0217978802260144e-14	522	38	18	0.47368421052631576	0.034482758620689655	GO:0042327	GO:BP	positive regulation of phosphorylation	16175	10095		0.05970149253731343	0.07352941176470588	522	15653	18	20	504	15633	16175	0.12120902626181394
M1	string	0	network_modules	78	TRUE	1.1826743572310903e-13	564	38	18	0.47368421052631576	0.031914893617021274	GO:0045937	GO:BP	positive regulation of phosphate metabolic process	16175	11731		0.07462686567164178	0.10294117647058823	564	15611	18	20	546	15591	16175	0.11607850844761623
M1	string	0	network_modules	78	TRUE	1.1826743572310903e-13	564	38	18	0.47368421052631576	0.031914893617021274	GO:0010562	GO:BP	positive regulation of phosphorus metabolic process	16175	4215		0.07462686567164178	0.10294117647058823	564	15611	18	20	546	15591	16175	0.11607850844761623
M1	string	0	network_modules	78	TRUE	3.027662891252595e-13	595	38	18	0.47368421052631576	0.030252100840336135	GO:0000165	GO:BP	MAPK cascade	16175	55		0.1044776119402985	0.11764705882352941	595	15580	18	20	577	15560	16175	0.11263246197568763
M1	string	0	network_modules	78	TRUE	9.087392719803216e-12	182	38	12	0.3157894736842105	0.06593406593406594	GO:0006457	GO:BP	protein folding	16175	2203		0.11940298507462686	0.1323529411764706	182	15993	12	26	170	15967	16175	0.14010862248289613
M1	string	0	network_modules	78	TRUE	5.975919801298393e-11	35	37	8	0.21621621621621623	0.22857142857142856	REAC:R-HSA-6802948	REAC	Signaling by high-kinase activity BRAF mutants	10916	2321		0	0.012048192771084338	35	10881	8	29	27	10852	10916	0.21973603790825527
M1	string	0	network_modules	78	TRUE	6.210842502862091e-11	87	37	10	0.2702702702702703	0.11494252873563218	REAC:R-HSA-3371556	REAC	Cellular response to heat stress	10916	334		0.012195121951219513	0.024096385542168676	87	10829	10	27	77	10802	10916	0.17203424841214748
M1	string	0	network_modules	78	TRUE	1.0588120537280263e-10	58	36	9	0.25	0.15517241379310345	KEGG:05213	KEGG	Endometrial cancer	8484	464		0.013333333333333334	0.02631578947368421	58	8426	9	27	49	8399	8484	0.19264103441124314
M1	string	0	network_modules	78	TRUE	1.5473974285682529e-10	39	37	8	0.21621621621621623	0.20512820512820512	REAC:R-HSA-5674135	REAC	MAP2K and MAPK activation	10916	1346		0.024390243902439025	0.03614457831325301	39	10877	8	29	31	10848	10916	0.20784285615411358
M1	string	0	network_modules	78	TRUE	1.5536513087245758e-10	25	38	7	0.18421052631578946	0.28	GO:0042026	GO:BP	protein refolding	16175	9932		0.13432835820895522	0.14705882352941177	25	16150	7	31	18	16119	16175	0.22564390044064325
M1	string	0	network_modules	78	TRUE	1.9043629666881045e-10	119	38	10	0.2631578947368421	0.08403361344537816	GO:0035966	GO:BP	response to topologically incorrect protein	16175	9369		0.14925373134328357	0.16176470588235295	119	16056	10	28	109	16028	16175	0.14525615092842425
M1	string	0	network_modules	78	TRUE	1.929668304930462e-10	40	37	8	0.21621621621621623	0.2	REAC:R-HSA-9656223	REAC	Signaling by RAF1 mutants	10916	2296		0.036585365853658534	0.04819277108433735	40	10876	8	29	32	10847	10916	0.20514939301027935
M1	string	0	network_modules	78	TRUE	1.962327467920485e-10	235	38	12	0.3157894736842105	0.05106382978723404	GO:0071900	GO:BP	regulation of protein serine/threonine kinase activity	16175	16971		0.16417910447761194	0.17647058823529413	235	15940	12	26	223	15914	16175	0.12217696682315707
M1	string	0	network_modules	78	TRUE	2.6681997570715346e-10	123	38	10	0.2631578947368421	0.08130081300813008	GO:0071902	GO:BP	positive regulation of protein serine/threonine kinase activity	16175	16973		0.1791044776119403	0.19117647058823528	123	16052	10	28	113	16024	16175	0.1427544003892324
M1	string	0	network_modules	78	TRUE	2.9475715161717506e-10	42	37	8	0.21621621621621623	0.19047619047619047	REAC:R-HSA-5675221	REAC	Negative regulation of MAPK pathway	10916	1573		0.04878048780487805	0.060240963855421686	42	10874	8	29	34	10845	10916	0.20005112756533494
M1	string	0	network_modules	78	TRUE	3.2645452012243997e-10	412	38	14	0.3684210526315789	0.03398058252427184	GO:0045859	GO:BP	regulation of protein kinase activity	16175	11671		0.19402985074626866	0.20588235294117646	412	15763	14	24	398	15739	16175	0.10562993229872586
M1	string	0	network_modules	78	TRUE	3.5941384549550023e-10	97	36	10	0.2777777777777778	0.10309278350515463	KEGG:05215	KEGG	Prostate cancer	8484	466		0.02666666666666667	0.039473684210526314	97	8387	10	26	87	8361	8484	0.16354206920658698
M1	string	0	network_modules	78	TRUE	3.8764021787528425e-10	136	36	11	0.3055555555555556	0.08088235294117647	KEGG:04915	KEGG	Estrogen signaling pathway	8484	372		0.04	0.05263157894736842	136	8348	11	25	125	8323	8484	0.15048767247507822
M1	string	0	network_modules	78	TRUE	5.344873346577339e-10	45	37	8	0.21621621621621623	0.17777777777777778	REAC:R-HSA-9649948	REAC	Signaling downstream of RAS mutants	10916	2329		0.06097560975609756	0.10843373493975904	45	10871	8	29	37	10842	10916	0.19304427412324732
M1	string	0	network_modules	78	TRUE	5.344873346577339e-10	45	37	8	0.21621621621621623	0.17777777777777778	REAC:R-HSA-6802955	REAC	Paradoxical activation of RAF signaling by kinase inactive BRAF	10916	1715		0.06097560975609756	0.10843373493975904	45	10871	8	29	37	10842	10916	0.19304427412324732
M1	string	0	network_modules	78	TRUE	5.344873346577339e-10	45	37	8	0.21621621621621623	0.17777777777777778	REAC:R-HSA-6802949	REAC	Signaling by RAS mutants	10916	2299		0.06097560975609756	0.10843373493975904	45	10871	8	29	37	10842	10916	0.19304427412324732
M1	string	0	network_modules	78	TRUE	5.344873346577339e-10	45	37	8	0.21621621621621623	0.17777777777777778	REAC:R-HSA-6802946	REAC	Signaling by moderate kinase activity BRAF mutants	10916	2325		0.06097560975609756	0.10843373493975904	45	10871	8	29	37	10842	10916	0.19304427412324732
M1	string	0	network_modules	78	TRUE	6.588564399560887e-10	418	37	15	0.40540540540540543	0.03588516746411483	REAC:R-HSA-5663202	REAC	Diseases of signal transduction by growth factor receptors and second messengers	10916	773		0.10975609756097561	0.12048192771084337	418	10498	15	22	403	10476	10916	0.11156506638715724
M1	string	0	network_modules	78	TRUE	7.069161315162969e-10	6	37	5	0.13513513513513514	0.8333333333333334	REAC:R-HSA-5674499	REAC	Negative feedback regulation of MAPK pathway	10916	1567		0.12195121951219512	0.13253012048192772	6	10910	5	32	1	10878	10916	0.33487298887629374
M1	string	0	network_modules	78	TRUE	8.763789446719397e-10	443	38	14	0.3684210526315789	0.03160270880361174	GO:0043549	GO:BP	regulation of kinase activity	16175	10763		0.208955223880597	0.22058823529411764	443	15732	14	24	429	15708	16175	0.10139753551169235
M1	string	0	network_modules	78	TRUE	2.625160990750278e-9	118	36	10	0.2777777777777778	0.0847457627118644	KEGG:04722	KEGG	Neurotrophin signaling pathway	8484	352		0.05333333333333334	0.06578947368421052	118	8366	10	26	108	8340	8484	0.14708344613940846
M1	string	0	network_modules	78	TRUE	2.6472933540392707e-9	162	36	11	0.3055555555555556	0.06790123456790123	KEGG:05161	KEGG	Hepatitis B	8484	442		0.06666666666666667	0.07894736842105263	162	8322	11	25	151	8297	8484	0.13663714479323094
M1	string	0	network_modules	78	TRUE	2.7231829077645246e-9	214	36	12	0.3333333333333333	0.056074766355140186	KEGG:05417	KEGG	Lipid and atherosclerosis	8484	494		0.08	0.09210526315789473	214	8270	12	24	202	8246	8484	0.12826856602506714
M1	string	0	network_modules	78	TRUE	6.1235596303544325e-9	71	38	8	0.21052631578947367	0.11267605633802817	GO:0009408	GO:BP	response to heat	16175	3473		0.22388059701492538	0.23529411764705882	71	16104	8	30	63	16074	16175	0.15131577871620366
M1	string	0	network_modules	78	TRUE	6.201496787900087e-9	512	38	14	0.3684210526315789	0.02734375	GO:0051338	GO:BP	regulation of transferase activity	16175	13665		0.23880597014925373	0.25	512	15663	14	24	498	15639	16175	0.09334307521981422
M1	string	0	network_modules	78	TRUE	8.179994101677184e-9	241	38	11	0.2894736842105263	0.04564315352697095	GO:0045860	GO:BP	positive regulation of protein kinase activity	16175	11672		0.2537313432835821	0.2647058823529412	241	15934	11	27	230	15907	16175	0.10997992139233184
M1	string	0	network_modules	78	TRUE	9.865391418519583e-9	530	38	14	0.3684210526315789	0.026415094339622643	GO:0043408	GO:BP	regulation of MAPK cascade	16175	10676		0.26865671641791045	0.27941176470588236	530	15645	14	24	516	15621	16175	0.09149373621812362
M1	string	0	network_modules	78	TRUE	1.0491558986079572e-8	64	37	8	0.21621621621621623	0.125	REAC:R-HSA-6802952	REAC	Signaling by BRAF and RAF1 fusions	10916	2225		0.13414634146341464	0.14457831325301204	64	10852	8	29	56	10823	10916	0.16068460657924782
M1	string	0	network_modules	78	TRUE	1.7126309030442424e-8	258	38	11	0.2894736842105263	0.04263565891472868	GO:0033674	GO:BP	positive regulation of kinase activity	16175	8346		0.2835820895522388	0.29411764705882354	258	15917	11	27	247	15890	16175	0.10594447315559696
M1	string	0	network_modules	78	TRUE	2.005665198363325e-8	102	36	9	0.25	0.08823529411764706	KEGG:04914	KEGG	Progesterone-mediated oocyte maturation	8484	371		0.09333333333333334	0.10526315789473684	102	8382	9	27	93	8355	8484	0.14253998297953333
M1	string	0	network_modules	78	TRUE	2.0565368696380194e-8	41	36	7	0.19444444444444445	0.17073170731707318	KEGG:05219	KEGG	Bladder cancer	8484	470		0.10666666666666667	0.11842105263157894	41	8443	7	29	34	8414	8484	0.17848430712113053
M1	string	0	network_modules	78	TRUE	3.434873104114126e-8	72	36	8	0.2222222222222222	0.1111111111111111	KEGG:05218	KEGG	Melanoma	8484	469		0.12	0.14473684210526316	72	8412	8	28	64	8384	8484	0.15210239851947566
M1	string	0	network_modules	78	TRUE	3.434873104114126e-8	72	36	8	0.2222222222222222	0.1111111111111111	KEGG:05223	KEGG	Non-small cell lung cancer	8484	474		0.12	0.14473684210526316	72	8412	8	28	64	8384	8484	0.15210239851947566
M1	string	0	network_modules	78	TRUE	4.7989461186407366e-8	75	36	8	0.2222222222222222	0.10666666666666667	KEGG:05214	KEGG	Glioma	8484	465		0.14666666666666667	0.15789473684210525	75	8409	8	28	67	8381	8484	0.1488092877192681
M1	string	0	network_modules	78	TRUE	5.306869843567963e-8	483	38	13	0.34210526315789475	0.026915113871635612	GO:0051604	GO:BP	protein maturation	16175	13821		0.29850746268656714	0.3088235294117647	483	15692	13	25	470	15667	16175	0.08902389360397905
M1	string	0	network_modules	78	TRUE	7.084853409712935e-8	308	37	12	0.32432432432432434	0.03896103896103896	REAC:R-HSA-5683057	REAC	MAPK family signaling cascades	10916	1348		0.14634146341463414	0.1566265060240964	308	10608	12	25	296	10583	10916	0.10428676369582786
M1	string	0	network_modules	78	TRUE	7.333728740464337e-8	79	36	8	0.2222222222222222	0.10126582278481013	KEGG:01521	KEGG	EGFR tyrosine kinase inhibitor resistance	8484	195		0.16	0.17105263157894737	79	8405	8	28	71	8377	8484	0.14470708314326922
M1	string	0	network_modules	78	TRUE	8.09486408260879e-8	82	37	8	0.21621621621621623	0.0975609756097561	REAC:R-HSA-6802957	REAC	Oncogenic MAPK signaling	10916	1641		0.15853658536585366	0.1686746987951807	82	10834	8	29	74	10805	10916	0.1409613241281135
M1	string	0	network_modules	78	TRUE	9.008954970660367e-8	301	38	11	0.2894736842105263	0.036544850498338874	GO:0051347	GO:BP	positive regulation of transferase activity	16175	13674		0.31343283582089554	0.3235294117647059	301	15874	11	27	290	15847	16175	0.09726367929372717
M1	string	0	network_modules	78	TRUE	9.741487611728749e-8	27	37	6	0.16216216216216217	0.2222222222222222	REAC:R-HSA-8863795	REAC	Downregulation of ERBB2 signaling	10916	784		0.17073170731707318	0.18072289156626506	27	10889	6	31	21	10858	10916	0.18748575802930745
M1	string	0	network_modules	78	TRUE	1.0208669983181615e-7	100	38	8	0.21052631578947367	0.08	GO:0009266	GO:BP	response to temperature stimulus	16175	3431		0.3283582089552239	0.3382352941176471	100	16075	8	30	92	16045	16175	0.12650594955507707
M1	string	0	network_modules	78	TRUE	1.2075117691285156e-7	84	36	8	0.2222222222222222	0.09523809523809523	KEGG:04012	KEGG	ErbB signaling pathway	8484	245		0.17333333333333334	0.18421052631578946	84	8400	8	28	76	8372	8484	0.13998744833104032
M1	string	0	network_modules	78	TRUE	1.4037137488557095e-7	104	38	8	0.21052631578947367	0.07692307692307693	GO:0006986	GO:BP	response to unfolded protein	16175	2608		0.34328358208955223	0.35294117647058826	104	16071	8	30	96	16041	16175	0.12391458416442797
M1	string	0	network_modules	78	TRUE	1.4504044833122452e-7	507	37	14	0.3783783783783784	0.027613412228796843	REAC:R-HSA-9006934	REAC	Signaling by Receptor Tyrosine Kinases	10916	2302		0.18292682926829268	0.1927710843373494	507	10409	14	23	493	10386	10916	0.09198384895912798
M1	string	0	network_modules	78	TRUE	1.4610184557576216e-7	86	36	8	0.2222222222222222	0.09302325581395349	KEGG:05210	KEGG	Colorectal cancer	8484	461		0.18666666666666668	0.19736842105263158	86	8398	8	28	78	8370	8484	0.13821295824840385
M1	string	0	network_modules	78	TRUE	1.6595464005392137e-7	129	36	9	0.25	0.06976744186046512	KEGG:04926	KEGG	Relaxin signaling pathway	8484	383		0.2	0.21052631578947367	129	8355	9	27	120	8328	8484	0.1252551379507054
M1	string	0	network_modules	78	TRUE	1.9274951976737818e-7	89	36	8	0.2222222222222222	0.0898876404494382	KEGG:05235	KEGG	PD-L1 expression and PD-1 checkpoint pathway in cancer	8484	480		0.21333333333333335	0.2236842105263158	89	8395	8	28	81	8367	8484	0.1356612683404775
M1	string	0	network_modules	78	TRUE	2.304180818920424e-7	264	37	11	0.2972972972972973	0.041666666666666664	REAC:R-HSA-5673001	REAC	RAF/MAP kinase cascade	10916	1841		0.1951219512195122	0.20481927710843373	264	10652	11	26	253	10626	10916	0.10367979210957459
M1	string	0	network_modules	78	TRUE	2.3494665101011945e-7	66	38	7	0.18421052631578946	0.10606060606060606	GO:0061077	GO:BP	chaperone-mediated protein folding	16175	15193		0.3582089552238806	0.36764705882352944	66	16109	7	31	59	16078	16175	0.1371212782928006
M1	string	0	network_modules	78	TRUE	2.67669034099678e-7	95	37	8	0.21621621621621623	0.08421052631578947	REAC:R-HSA-975871	REAC	MyD88 cascade initiated on plasma membrane	10916	1497		0.2073170731707317	0.24096385542168675	95	10821	8	29	87	10792	10916	0.1302928351871131
M1	string	0	network_modules	78	TRUE	2.67669034099678e-7	95	37	8	0.21621621621621623	0.08421052631578947	REAC:R-HSA-168142	REAC	Toll Like Receptor 10 (TLR10) Cascade	10916	2513		0.2073170731707317	0.24096385542168675	95	10821	8	29	87	10792	10916	0.1302928351871131
M1	string	0	network_modules	78	TRUE	2.67669034099678e-7	95	37	8	0.21621621621621623	0.08421052631578947	REAC:R-HSA-168176	REAC	Toll Like Receptor 5 (TLR5) Cascade	10916	2517		0.2073170731707317	0.24096385542168675	95	10821	8	29	87	10792	10916	0.1302928351871131
M1	string	0	network_modules	78	TRUE	2.746757379847948e-7	93	36	8	0.2222222222222222	0.08602150537634409	KEGG:04912	KEGG	GnRH signaling pathway	8484	369		0.22666666666666666	0.23684210526315788	93	8391	8	28	85	8363	8484	0.13244779871902726
M1	string	0	network_modules	78	TRUE	2.812161340794e-7	269	37	11	0.2972972972972973	0.040892193308550186	REAC:R-HSA-5684996	REAC	MAPK1/MAPK3 signaling	10916	1351		0.24390243902439024	0.25301204819277107	269	10647	11	26	258	10621	10916	0.1025635197874985
M1	string	0	network_modules	78	TRUE	2.834583798674968e-7	137	36	9	0.25	0.06569343065693431	KEGG:04910	KEGG	Insulin signaling pathway	8484	367		0.24	0.25	137	8347	9	27	128	8320	8484	0.12111292008324201
M1	string	0	network_modules	78	TRUE	2.9563485518355637e-7	59	36	7	0.19444444444444445	0.11864406779661017	KEGG:04730	KEGG	Long-term depression	8484	359		0.25333333333333335	0.2631578947368421	59	8425	7	29	52	8396	8484	0.14727957337448053
M1	string	0	network_modules	78	TRUE	3.2590030809166806e-7	95	36	8	0.2222222222222222	0.08421052631578947	KEGG:01522	KEGG	Endocrine resistance	8484	196		0.26666666666666666	0.27631578947368424	95	8389	8	28	87	8361	8484	0.13091556838301105
M1	string	0	network_modules	78	TRUE	3.5919547355959986e-7	33	37	6	0.16216216216216217	0.18181818181818182	REAC:R-HSA-5673000	REAC	RAF activation	10916	1839		0.25609756097560976	0.26506024096385544	33	10883	6	31	27	10852	10916	0.1690501071521073
M1	string	0	network_modules	78	TRUE	4.387349312534304e-7	101	37	8	0.21621621621621623	0.07920792079207921	REAC:R-HSA-975138	REAC	TRAF6 mediated induction of NFkB and MAP kinases upon TLR7/8 or 9 activation	10916	2468		0.2682926829268293	0.27710843373493976	101	10815	8	29	93	10786	10916	0.12606374990277014
M1	string	0	network_modules	78	TRUE	4.749435376519502e-7	102	37	8	0.21621621621621623	0.0784313725490196	REAC:R-HSA-975155	REAC	MyD88 dependent cascade initiated on endosome	10916	1500		0.2804878048780488	0.2891566265060241	102	10814	8	29	94	10785	10916	0.12539454008232323
M1	string	0	network_modules	78	TRUE	4.757492415954951e-7	63	37	7	0.1891891891891892	0.1111111111111111	REAC:R-HSA-450294	REAC	MAP kinase activation	10916	1345		0.2926829268292683	0.30120481927710846	63	10853	7	30	56	10823	10916	0.14121027848031606
M1	string	0	network_modules	78	TRUE	4.788409762513153e-7	577	38	13	0.34210526315789475	0.022530329289428077	GO:0043085	GO:BP	positive regulation of catalytic activity	16175	10518		0.373134328358209	0.38235294117647056	577	15598	13	25	564	15573	16175	0.08017477620873312
M1	string	0	network_modules	78	TRUE	5.114664725296173e-7	185	38	9	0.23684210526315788	0.04864864864864865	GO:0018105	GO:BP	peptidyl-serine phosphorylation	16175	5324		0.3880597014925373	0.39705882352941174	185	15990	9	29	176	15961	16175	0.10286735263729929
M1	string	0	network_modules	78	TRUE	5.137158908790687e-7	103	37	8	0.21621621621621623	0.07766990291262135	REAC:R-HSA-168181	REAC	Toll Like Receptor 7/8 (TLR7/8) Cascade	10916	2518		0.3048780487804878	0.3132530120481928	103	10813	8	29	95	10784	10916	0.12473485354520629
M1	string	0	network_modules	78	TRUE	5.303029786161252e-7	64	36	7	0.19444444444444445	0.109375	KEGG:04929	KEGG	GnRH secretion	8484	386		0.28	0.2894736842105263	64	8420	7	29	57	8391	8484	0.14100683405845935
M1	string	0	network_modules	78	TRUE	6.469702854891615e-7	106	37	8	0.21621621621621623	0.07547169811320754	REAC:R-HSA-168138	REAC	Toll Like Receptor 9 (TLR9) Cascade	10916	2519		0.3170731707317073	0.3253012048192771	106	10810	8	29	98	10781	10916	0.12281068781894117
M1	string	0	network_modules	78	TRUE	7.257666547994304e-7	105	36	8	0.2222222222222222	0.0761904761904762	KEGG:04928	KEGG	Parathyroid hormone synthesis, secretion and action	8484	385		0.29333333333333333	0.3026315789473684	105	8379	8	28	97	8351	8484	0.1239038714260468
M1	string	0	network_modules	78	TRUE	7.357092867140815e-7	67	36	7	0.19444444444444445	0.1044776119402985	KEGG:05221	KEGG	Acute myeloid leukemia	8484	472		0.30666666666666664	0.3157894736842105	67	8417	7	29	60	8388	8484	0.13757758712928916
M1	string	0	network_modules	78	TRUE	7.406084067606273e-7	67	37	7	0.1891891891891892	0.1044776119402985	REAC:R-HSA-3371453	REAC	Regulation of HSF1-mediated heat shock response	10916	1977		0.32926829268292684	0.3373493975903614	67	10849	7	30	60	10819	10916	0.13668181044103722
M1	string	0	network_modules	78	TRUE	8.036716245536438e-7	211	36	10	0.2777777777777778	0.04739336492890995	KEGG:05207	KEGG	Chemical carcinogenesis - receptor activation	8484	459		0.32	0.32894736842105265	211	8273	10	26	201	8247	8484	0.10601414433031252
M1	string	0	network_modules	78	TRUE	8.176716659685846e-7	68	36	7	0.19444444444444445	0.10294117647058823	KEGG:05211	KEGG	Renal cell carcinoma	8484	462		0.3333333333333333	0.34210526315789475	68	8416	7	29	61	8387	8484	0.13648406222291115
M1	string	0	network_modules	78	TRUE	8.939068397572559e-7	197	38	9	0.23684210526315788	0.04568527918781726	GO:0018209	GO:BP	peptidyl-serine modification	16175	5368		0.40298507462686567	0.4117647058823529	197	15978	9	29	188	15949	16175	0.09939431964066887
M1	string	0	network_modules	78	TRUE	9.466782551203752e-7	610	38	13	0.34210526315789475	0.021311475409836064	GO:0043066	GO:BP	negative regulation of apoptotic process	16175	10512		0.417910447761194	0.4264705882352941	610	15565	13	25	597	15540	16175	0.07753887642344508
M1	string	0	network_modules	78	TRUE	9.616256574622952e-7	376	38	11	0.2894736842105263	0.02925531914893617	GO:0043410	GO:BP	positive regulation of MAPK cascade	16175	10678		0.43283582089552236	0.4411764705882353	376	15799	11	27	365	15772	16175	0.08573725780397697
M1	string	0	network_modules	78	TRUE	9.982278051417226e-7	158	36	9	0.25	0.056962025316455694	KEGG:05160	KEGG	Hepatitis C	8484	441		0.3466666666666667	0.35526315789473684	158	8326	9	27	149	8299	8484	0.11172435359489193
M1	string	0	network_modules	78	TRUE	1.0056041535184526e-6	112	37	8	0.21621621621621623	0.07142857142857142	REAC:R-HSA-168188	REAC	Toll Like Receptor TLR6:TLR2 Cascade	10916	2521		0.34146341463414637	0.3614457831325301	112	10804	8	29	104	10775	10916	0.11919091412817859
M1	string	0	network_modules	78	TRUE	1.0056041535184526e-6	112	37	8	0.21621621621621623	0.07142857142857142	REAC:R-HSA-166058	REAC	MyD88:MAL(TIRAP) cascade initiated on plasma membrane	10916	1502		0.34146341463414637	0.3614457831325301	112	10804	8	29	104	10775	10916	0.11919091412817859
M1	string	0	network_modules	78	TRUE	1.1216693506590994e-6	71	37	7	0.1891891891891892	0.09859154929577464	REAC:R-HSA-448424	REAC	Interleukin-17 signaling	10916	1238		0.36585365853658536	0.37349397590361444	71	10845	7	30	64	10815	10916	0.13253444954457902
M1	string	0	network_modules	78	TRUE	1.242023144626057e-6	115	37	8	0.21621621621621623	0.06956521739130435	REAC:R-HSA-168179	REAC	Toll Like Receptor TLR1:TLR2 Cascade	10916	2520		0.3780487804878049	0.39759036144578314	115	10801	8	29	107	10772	10916	0.11748532989830701
M1	string	0	network_modules	78	TRUE	1.242023144626057e-6	115	37	8	0.21621621621621623	0.06956521739130435	REAC:R-HSA-181438	REAC	Toll Like Receptor 2 (TLR2) Cascade	10916	2514		0.3780487804878049	0.39759036144578314	115	10801	8	29	107	10772	10916	0.11748532989830701
M1	string	0	network_modules	78	TRUE	1.403638756789325e-6	630	38	13	0.34210526315789475	0.020634920634920634	GO:0043069	GO:BP	negative regulation of programmed cell death	16175	10515		0.44776119402985076	0.45588235294117646	630	15545	13	25	617	15520	16175	0.07603711000733768
M1	string	0	network_modules	78	TRUE	1.8000746650241024e-6	76	36	7	0.19444444444444445	0.09210526315789473	KEGG:05220	KEGG	Chronic myeloid leukemia	8484	471		0.36	0.3815789473684211	76	8408	7	29	69	8379	8484	0.12850910407956068
M1	string	0	network_modules	78	TRUE	1.8000746650241024e-6	76	36	7	0.19444444444444445	0.09210526315789473	KEGG:05212	KEGG	Pancreatic cancer	8484	463		0.36	0.3815789473684211	76	8408	7	29	69	8379	8484	0.12850910407956068
M1	string	0	network_modules	78	TRUE	2.092164730364843e-6	120	36	8	0.2222222222222222	0.06666666666666667	KEGG:04071	KEGG	Sphingolipid signaling pathway	8484	260		0.38666666666666666	0.39473684210526316	120	8364	8	28	112	8336	8484	0.11502795117436528
M1	string	0	network_modules	78	TRUE	2.1880096067386953e-6	49	38	6	0.15789473684210525	0.12244897959183673	GO:0034605	GO:BP	cellular response to heat	16175	8685		0.4626865671641791	0.47058823529411764	49	16126	6	32	43	16094	16175	0.1367469461444014
M1	string	0	network_modules	78	TRUE	2.4821534145544846e-6	50	38	6	0.15789473684210525	0.12	GO:0031098	GO:BP	stress-activated protein kinase signaling cascade	16175	7024		0.47761194029850745	0.4852941176470588	50	16125	6	32	44	16093	16175	0.13532272387205618
M1	string	0	network_modules	78	TRUE	2.942877849957168e-6	46	37	6	0.16216216216216217	0.13043478260869565	REAC:R-HSA-1227986	REAC	Signaling by ERBB2	10916	2232		0.4024390243902439	0.40963855421686746	46	10870	6	31	40	10839	10916	0.1421971184601692
M1	string	0	network_modules	78	TRUE	2.9835184045728125e-6	22	37	5	0.13513513513513514	0.22727272727272727	REAC:R-HSA-9613829	REAC	Chaperone Mediated Autophagy	10916	344		0.4146341463414634	0.42168674698795183	22	10894	5	32	17	10862	10916	0.1731040988364527
M1	string	0	network_modules	78	TRUE	3.9068957236695385e-6	249	36	10	0.2777777777777778	0.040160642570281124	KEGG:05132	KEGG	Salmonella infection	8484	429		0.4	0.40789473684210525	249	8235	10	26	239	8209	8484	0.09608260066308304
M1	string	0	network_modules	78	TRUE	4.16888541384795e-6	131	36	8	0.2222222222222222	0.061068702290076333	KEGG:04068	KEGG	FoxO signaling pathway	8484	258		0.41333333333333333	0.42105263157894735	131	8353	8	28	123	8325	8484	0.10947867297598284
M1	string	0	network_modules	78	TRUE	5.234888350882191e-6	26	38	5	0.13157894736842105	0.19230769230769232	GO:0051085	GO:BP	chaperone cofactor-dependent protein refolding	16175	13482		0.4925373134328358	0.5	26	16149	5	33	21	16116	16175	0.15743939903008405
M1	string	0	network_modules	78	TRUE	6.512633877799259e-6	168	38	8	0.21052631578947367	0.047619047619047616	GO:0031396	GO:BP	regulation of protein ubiquitination	16175	7152		0.5074626865671642	0.5147058823529411	168	16007	8	30	160	15977	16175	0.09579631209594032
M1	string	0	network_modules	78	TRUE	6.979707789381923e-6	143	37	8	0.21621621621621623	0.055944055944055944	REAC:R-HSA-166016	REAC	Toll Like Receptor 4 (TLR4) Cascade	10916	2516		0.4268292682926829	0.43373493975903615	143	10773	8	29	135	10744	10916	0.10417849310398275
M1	string	0	network_modules	78	TRUE	8.97341036894725e-6	472	37	12	0.32432432432432434	0.025423728813559324	REAC:R-HSA-449147	REAC	Signaling by Interleukins	10916	2261		0.43902439024390244	0.4457831325301205	472	10444	12	25	460	10419	10916	0.08059409181332154
M1	string	0	network_modules	78	TRUE	1.0238951934147786e-5	147	36	8	0.2222222222222222	0.05442176870748299	KEGG:05224	KEGG	Breast cancer	8484	475		0.4266666666666667	0.4342105263157895	147	8337	8	28	139	8309	8484	0.10250470207300447
M1	string	0	network_modules	78	TRUE	1.0791950202300813e-5	148	36	8	0.2222222222222222	0.05405405405405406	KEGG:05226	KEGG	Gastric cancer	8484	477		0.44	0.4473684210526316	148	8336	8	28	140	8308	8484	0.10210517157403105
M1	string	0	network_modules	78	TRUE	1.0978911932682946e-5	59	36	6	0.16666666666666666	0.1016949152542373	KEGG:04370	KEGG	VEGF signaling pathway	8484	307		0.4533333333333333	0.4605263157894737	59	8425	6	30	53	8395	8484	0.12545923423454805
M1	string	0	network_modules	78	TRUE	1.177245170636424e-5	210	36	9	0.25	0.04285714285714286	KEGG:04015	KEGG	Rap1 signaling pathway	8484	248		0.4666666666666667	0.47368421052631576	210	8274	9	27	201	8247	8484	0.09463844138079734
M1	string	0	network_modules	78	TRUE	1.2671276632879784e-5	11	37	4	0.10810810810810811	0.36363636363636365	REAC:R-HSA-170968	REAC	Frs2-mediated activation	10916	980		0.45121951219512196	0.4578313253012048	11	10905	4	33	7	10872	10916	0.1968574560942926
M1	string	0	network_modules	78	TRUE	1.3407215240637094e-5	31	38	5	0.13157894736842105	0.16129032258064516	GO:0051084	GO:BP	'de novo' post-translational protein folding	16175	13481		0.5223880597014925	0.5294117647058824	31	16144	5	33	26	16111	16175	0.1438640739693686
M1	string	0	network_modules	78	TRUE	1.5467350922729765e-5	103	37	7	0.1891891891891892	0.06796116504854369	REAC:R-HSA-168164	REAC	Toll Like Receptor 3 (TLR3) Cascade	10916	2515		0.4634146341463415	0.46987951807228917	103	10813	7	30	96	10783	10916	0.10843151816079986
M1	string	0	network_modules	78	TRUE	1.8209316778708792e-5	221	36	9	0.25	0.04072398190045249	KEGG:05208	KEGG	Chemical carcinogenesis - reactive oxygen species	8484	460		0.48	0.4868421052631579	221	8263	9	27	212	8236	8484	0.09178313455304667
M1	string	0	network_modules	78	TRUE	1.8332343606120197e-5	106	36	7	0.19444444444444445	0.0660377358490566	KEGG:04620	KEGG	Toll-like receptor signaling pathway	8484	325		0.49333333333333335	0.5	106	8378	7	29	99	8349	8484	0.10693126717844977
M1	string	0	network_modules	78	TRUE	2.0160106180938598e-5	107	37	7	0.1891891891891892	0.06542056074766354	REAC:R-HSA-937061	REAC	TRIF (TICAM1)-mediated TLR4 signaling 	10916	2471		0.47560975609756095	0.4939759036144578	107	10809	7	30	100	10779	10916	0.10618822832528559
M1	string	0	network_modules	78	TRUE	2.0160106180938598e-5	107	37	7	0.1891891891891892	0.06542056074766354	REAC:R-HSA-166166	REAC	MyD88-independent TLR4 cascade 	10916	1501		0.47560975609756095	0.4939759036144578	107	10809	7	30	100	10779	10916	0.10618822832528559
M1	string	0	network_modules	78	TRUE	2.0389997713826908e-5	164	37	8	0.21621621621621623	0.04878048780487805	REAC:R-HSA-168898	REAC	Toll-like Receptor Cascades	10916	2522		0.5	0.5060240963855421	164	10752	8	29	156	10723	10916	0.09645281689674594
M1	string	0	network_modules	78	TRUE	2.0470508784025265e-5	638	38	12	0.3157894736842105	0.018808777429467086	GO:0018193	GO:BP	peptidyl-amino acid modification	16175	5353		0.5373134328358209	0.5441176470588235	638	15537	12	26	626	15511	16175	0.06889437624374123
M1	string	0	network_modules	78	TRUE	2.084902643646946e-5	108	36	7	0.19444444444444445	0.06481481481481481	KEGG:05145	KEGG	Toxoplasmosis	8484	437		0.5066666666666667	0.5131578947368421	108	8376	7	29	101	8347	8484	0.10581191346018172
M1	string	0	network_modules	78	TRUE	2.3731620826219304e-5	67	36	6	0.16666666666666666	0.08955223880597014	KEGG:04664	KEGG	Fc epsilon RI signaling pathway	8484	340		0.52	0.5394736842105263	67	8417	6	30	61	8387	8484	0.11709162375515111
M1	string	0	network_modules	78	TRUE	2.3731620826219304e-5	67	36	6	0.16666666666666666	0.08955223880597014	KEGG:04720	KEGG	Long-term potentiation	8484	350		0.52	0.5394736842105263	67	8417	6	30	61	8387	8484	0.11709162375515111
M1	string	0	network_modules	78	TRUE	2.5441996511777043e-5	35	38	5	0.13157894736842105	0.14285714285714285	GO:0006458	GO:BP	'de novo' protein folding	16175	2204		0.5522388059701493	0.5588235294117647	35	16140	5	33	30	16107	16175	0.13515244319735376
M1	string	0	network_modules	78	TRUE	2.6173054532614642e-5	166	36	8	0.2222222222222222	0.04819277108433735	KEGG:05225	KEGG	Hepatocellular carcinoma	8484	476		0.5466666666666666	0.5526315789473685	166	8318	8	28	158	8290	8484	0.0955148457878174
M1	string	0	network_modules	78	TRUE	2.718545644329455e-5	66	37	6	0.16216216216216217	0.09090909090909091	REAC:R-HSA-9824439	REAC	Bacterial Infection Pathways	10916	204		0.5121951219512195	0.5180722891566265	66	10850	6	31	60	10819	10916	0.11744389744958077
M1	string	0	network_modules	78	TRUE	2.7763391890472888e-5	519	38	11	0.2894736842105263	0.02119460500963391	GO:0070848	GO:BP	response to growth factor	16175	16340		0.5671641791044776	0.5735294117647058	519	15656	11	27	508	15629	16175	0.0708740795490129
M1	string	0	network_modules	78	TRUE	2.8334037267489106e-5	69	36	6	0.16666666666666666	0.08695652173913043	KEGG:04612	KEGG	Antigen processing and presentation	8484	322		0.56	0.5657894736842105	69	8415	6	30	63	8385	8484	0.11522453830073984
M1	string	0	network_modules	78	TRUE	2.8445354883140642e-5	113	36	7	0.19444444444444445	0.061946902654867256	KEGG:04668	KEGG	TNF signaling pathway	8484	342		0.5733333333333334	0.5789473684210527	113	8371	7	29	106	8342	8484	0.10313975032422391
M1	string	0	network_modules	78	TRUE	2.8693348307958957e-5	168	36	8	0.2222222222222222	0.047619047619047616	KEGG:04141	KEGG	Protein processing in endoplasmic reticulum	8484	278		0.5866666666666667	0.5921052631578947	168	8316	8	28	160	8288	8484	0.09484556243099848
M1	string	0	network_modules	78	TRUE	3.0896131294269236e-5	70	36	6	0.16666666666666666	0.08571428571428572	KEGG:05230	KEGG	Central carbon metabolism in cancer	8484	478		0.6	0.6052631578947368	70	8414	6	30	64	8384	8484	0.11432028346807949
M1	string	0	network_modules	78	TRUE	3.225022644318938e-5	206	38	8	0.21052631578947367	0.038834951456310676	GO:1903320	GO:BP	regulation of protein modification by small protein conjugation or removal	16175	22904		0.582089552238806	0.5882352941176471	206	15969	8	30	198	15939	16175	0.0855968717218767
M1	string	0	network_modules	78	TRUE	3.609674482549524e-5	209	38	8	0.21052631578947367	0.03827751196172249	GO:1901873	GO:BP	regulation of post-translational protein modification	16175	21817		0.5970149253731343	0.6029411764705882	209	15966	8	30	201	15936	16175	0.08490860821265282
M1	string	0	network_modules	78	TRUE	3.815796325305738e-5	14	37	4	0.10810810810810811	0.2857142857142857	REAC:R-HSA-1295596	REAC	Spry regulation of FGF signaling	10916	2350		0.524390243902439	0.54216867469879515	14	10902	4	33	10	10869	10916	0.17407166446454447
M1	string	0	network_modules	78	TRUE	3.815796325305738e-5	14	37	4	0.10810810810810811	0.2857142857142857	REAC:R-HSA-169893	REAC	Prolonged ERK activation events	10916	1807		0.524390243902439	0.54216867469879515	14	10902	4	33	10	10869	10916	0.17407166446454447
M1	string	0	network_modules	78	TRUE	4.0519143111721586e-5	119	36	7	0.19444444444444445	0.058823529411764705	KEGG:04660	KEGG	T cell receptor signaling pathway	8484	338		0.6133333333333333	0.618421052631579	119	8365	7	29	112	8336	8484	0.10014942706255832
M1	string	0	network_modules	78	TRUE	4.2899575400832284e-5	120	36	7	0.19444444444444445	0.058333333333333334	KEGG:04935	KEGG	Growth hormone synthesis, secretion and action	8484	392		0.6266666666666667	0.631578947368421	120	8364	7	29	113	8335	8484	0.09967206720905632
M1	string	0	network_modules	78	TRUE	4.80918720401855e-5	81	38	6	0.15789473684210525	0.07407407407407407	GO:0033138	GO:BP	positive regulation of peptidyl-serine phosphorylation	16175	8053		0.6119402985074627	0.6176470588235294	81	16094	6	32	75	16062	16175	0.10510436779609791
M1	string	0	network_modules	78	TRUE	5.002407003607553e-5	4	37	3	0.08108108108108109	0.75	REAC:R-HSA-9652169	REAC	Signaling by MAP2K mutants	10916	2268		0.5487804878048781	0.5542168674698795	4	10912	3	34	1	10878	10916	0.24594617648151854
M1	string	0	network_modules	78	TRUE	5.007035454513614e-5	73	37	6	0.16216216216216217	0.0821917808219178	REAC:R-HSA-9009391	REAC	Extra-nuclear estrogen signaling	10916	888		0.5609756097560976	0.5662650602409639	73	10843	6	31	67	10812	10916	0.11124834411671304
M1	string	0	network_modules	78	TRUE	7.238457911627569e-5	4	38	3	0.07894736842105263	0.75	GO:0090170	GO:BP	regulation of Golgi inheritance	16175	18078		0.6268656716417911	0.6323529411764706	4	16171	3	35	1	16136	16175	0.24288538905699725
M1	string	0	network_modules	78	TRUE	7.337313856586994e-5	190	36	8	0.2222222222222222	0.042105263157894736	KEGG:04062	KEGG	Chemokine signaling pathway	8484	255		0.64	0.6447368421052632	190	8294	8	28	182	8266	8484	0.08815979729069329
M1	string	0	network_modules	78	TRUE	9.006851071686659e-5	17	37	4	0.10810810810810811	0.23529411764705882	REAC:R-HSA-5637815	REAC	Signaling by Ligand-Responsive EGFR Variants in Cancer	10916	2267		0.573170731707317	0.5903614457831325	17	10899	4	33	13	10866	10916	0.15758274809983527
M1	string	0	network_modules	78	TRUE	9.006851071686659e-5	17	37	4	0.10810810810810811	0.23529411764705882	REAC:R-HSA-1236382	REAC	Constitutive Signaling by Ligand-Responsive EGFR Cancer Variants	10916	403		0.573170731707317	0.5903614457831325	17	10899	4	33	13	10866	10916	0.15758274809983527
M1	string	0	network_modules	78	TRUE	9.413522461030988e-5	45	38	5	0.13157894736842105	0.1111111111111111	GO:0051403	GO:BP	stress-activated MAPK cascade	16175	13696		0.6417910447761194	0.6470588235294118	45	16130	5	33	40	16097	16175	0.11866061030655828
M1	string	0	network_modules	78	TRUE	1.0028673229421739e-4	136	36	7	0.19444444444444445	0.051470588235294115	KEGG:05135	KEGG	Yersinia infection	8484	432		0.6533333333333333	0.6578947368421053	136	8348	7	29	129	8319	8484	0.09273504148586378
M1	string	0	network_modules	78	TRUE	1.0850239020783356e-4	356	36	10	0.2777777777777778	0.028089887640449437	KEGG:04151	KEGG	PI3K-Akt signaling pathway	8484	285		0.6666666666666666	0.6710526315789473	356	8128	10	26	346	8102	8484	0.07677718550114206
M1	string	0	network_modules	78	TRUE	1.1066388982271369e-4	138	36	7	0.19444444444444445	0.050724637681159424	KEGG:05418	KEGG	Fluid shear stress and atherosclerosis	8484	495		0.68	0.6842105263157895	138	8346	7	29	131	8317	8484	0.09194997194731133
M1	string	0	network_modules	78	TRUE	1.2088733519038693e-4	88	36	6	0.16666666666666666	0.06818181818181818	KEGG:04540	KEGG	Gap junction	8484	318		0.6933333333333334	0.6973684210526315	88	8396	6	30	82	8366	8484	0.100702504294033
M1	string	0	network_modules	78	TRUE	1.3029929022102243e-4	205	36	8	0.2222222222222222	0.03902439024390244	KEGG:05205	KEGG	Proteoglycans in cancer	8484	457		0.7066666666666667	0.7105263157894737	205	8279	8	28	197	8251	8484	0.08419840579458866
M1	string	0	network_modules	78	TRUE	1.3177304170638513e-4	290	37	9	0.24324324324324326	0.03103448275862069	REAC:R-HSA-9006931	REAC	Signaling by Nuclear Receptors	10916	2289		0.5975609756097561	0.6024096385542169	290	10626	9	28	281	10598	10916	0.07857751305076187
M1	string	0	network_modules	78	TRUE	1.561856726349545e-4	210	36	8	0.2222222222222222	0.0380952380952381	KEGG:05170	KEGG	Human immunodeficiency virus 1 infection	8484	451		0.72	0.7236842105263158	210	8274	8	28	202	8246	8484	0.08296752248035713
M1	string	0	network_modules	78	TRUE	1.6831256071423963e-4	255	38	8	0.21052631578947367	0.03137254901960784	GO:0070371	GO:BP	ERK1 and ERK2 cascade	16175	16082		0.6567164179104478	0.6617647058823529	255	15920	8	30	247	15890	16175	0.07587271257285834
M1	string	0	network_modules	78	TRUE	1.7010042607396183e-4	216	37	8	0.21621621621621623	0.037037037037037035	REAC:R-HSA-8939211	REAC	ESR-mediated signaling	10916	830		0.6097560975609756	0.6144578313253012	216	10700	8	29	208	10671	10916	0.08225384063850297
M1	string	0	network_modules	78	TRUE	1.820266457520256e-4	20	37	4	0.10810810810810811	0.2	REAC:R-HSA-445144	REAC	Signal transduction by L1	10916	2216		0.6219512195121951	0.6265060240963856	20	10896	4	33	16	10863	10916	0.14492933206126182
M1	string	0	network_modules	78	TRUE	1.925382983911171e-4	102	38	6	0.15789473684210525	0.058823529411764705	GO:0033135	GO:BP	regulation of peptidyl-serine phosphorylation	16175	8051		0.6716417910447762	0.6764705882352942	102	16073	6	32	96	16041	16175	0.09292722839939423
M1	string	0	network_modules	78	TRUE	2.2175712241184766e-4	175	38	7	0.18421052631578946	0.04	GO:0070374	GO:BP	positive regulation of ERK1 and ERK2 cascade	16175	16085		0.6865671641791045	0.6911764705882353	175	16000	7	31	168	15969	16175	0.08133418661263074
M1	string	0	network_modules	78	TRUE	2.2775722573944537e-4	98	36	6	0.16666666666666666	0.061224489795918366	KEGG:05231	KEGG	Choline metabolism in cancer	8484	479		0.7333333333333333	0.7368421052631579	98	8386	6	30	92	8356	8484	0.0947632005381015
M1	string	0	network_modules	78	TRUE	2.4852793889871655e-4	502	38	10	0.2631578947368421	0.0199203187250996	GO:0071363	GO:BP	cellular response to growth factor stimulus	16175	16615		0.7014925373134329	0.7058823529411765	502	15673	10	28	492	15645	16175	0.06495516855660063
M1	string	0	network_modules	78	TRUE	2.7958445797738907e-4	227	36	8	0.2222222222222222	0.03524229074889868	KEGG:04810	KEGG	Regulation of actin cytoskeleton	8484	365		0.7466666666666667	0.75	227	8257	8	28	219	8229	8484	0.07907187865668733
M1	string	0	network_modules	78	TRUE	3.302745857493572e-4	23	37	4	0.10810810810810811	0.17391304347826086	REAC:R-HSA-1643713	REAC	Signaling by EGFR in Cancer	10916	2230		0.6341463414634146	0.6626506024096386	23	10893	4	33	19	10860	10916	0.1348163734968643
M1	string	0	network_modules	78	TRUE	3.302745857493572e-4	23	37	4	0.10810810810810811	0.17391304347826086	REAC:R-HSA-5654732	REAC	Negative regulation of FGFR3 signaling	10916	1570		0.6341463414634146	0.6626506024096386	23	10893	4	33	19	10860	10916	0.1348163734968643
M1	string	0	network_modules	78	TRUE	3.302745857493572e-4	23	37	4	0.10810810810810811	0.17391304347826086	REAC:R-HSA-450302	REAC	activated TAK1 mediates p38 MAPK activation	10916	2685		0.6341463414634146	0.6626506024096386	23	10893	4	33	19	10860	10916	0.1348163734968643
M1	string	0	network_modules	78	TRUE	3.364308032029628e-4	23	38	4	0.10526315789473684	0.17391304347826086	GO:0051131	GO:BP	chaperone-mediated protein complex assembly	16175	13515		0.7164179104477612	0.7205882352941176	23	16152	4	34	19	16118	16175	0.13372646337388627
M1	string	0	network_modules	78	TRUE	3.655487139457675e-4	165	36	7	0.19444444444444445	0.04242424242424243	KEGG:04140	KEGG	Autophagy - animal	8484	277		0.76	0.7631578947368421	165	8319	7	29	158	8290	8484	0.08272289438489049
M1	string	0	network_modules	78	TRUE	4.3543260015464855e-4	57	37	5	0.13513513513513514	0.08771929824561403	REAC:R-HSA-3371497	REAC	HSP90 chaperone cycle for steroid hormone receptors (SHR) in the presence of ligand	10916	1111		0.6707317073170732	0.6746987951807228	57	10859	5	32	52	10827	10916	0.10512152348326724
M1	string	0	network_modules	78	TRUE	4.695417254843731e-4	25	37	4	0.10810810810810811	0.16	REAC:R-HSA-5339562	REAC	Uptake and actions of bacterial toxins	10916	2626		0.6829268292682927	0.6867469879518072	25	10891	4	33	21	10858	10916	0.1290996671726824
M1	string	0	network_modules	78	TRUE	5.535711366911018e-4	26	37	4	0.10810810810810811	0.15384615384615385	REAC:R-HSA-5654726	REAC	Negative regulation of FGFR1 signaling	10916	1568		0.6951219512195121	0.6987951807228916	26	10890	4	33	22	10857	10916	0.12648885227834766
M1	string	0	network_modules	78	TRUE	5.849561068995854e-4	701	38	11	0.2894736842105263	0.015691868758915834	GO:0009628	GO:BP	response to abiotic stimulus	16175	3549		0.7313432835820896	0.7352941176470589	701	15474	11	27	690	15447	16175	0.05865946637842891
M1	string	0	network_modules	78	TRUE	6.39701942259309e-4	112	37	6	0.16216216216216217	0.05357142857142857	REAC:R-HSA-187037	REAC	Signaling by NTRK1 (TRKA)	10916	2284		0.7073170731707317	0.7108433734939759	112	10804	6	31	106	10773	10916	0.08790874403241022
M1	string	0	network_modules	78	TRUE	6.482730580958914e-4	27	37	4	0.10810810810810811	0.14814814814814814	REAC:R-HSA-5654733	REAC	Negative regulation of FGFR4 signaling	10916	1571		0.7195121951219512	0.7228915662650602	27	10889	4	33	23	10856	10916	0.12402251060235983
M1	string	0	network_modules	78	TRUE	6.93815431576393e-4	8	37	3	0.08108108108108109	0.375	REAC:R-HSA-9726842	REAC	Gain-of-function MRAS complexes activate RAF signaling	10916	1028		0.7317073170731707	0.7590361445783133	8	10908	3	34	5	10874	10916	0.17315241724166633
M1	string	0	network_modules	78	TRUE	6.93815431576393e-4	8	37	3	0.08108108108108109	0.375	REAC:R-HSA-9726840	REAC	SHOC2 M1731 mutant abolishes MRAS complex function	10916	2141		0.7317073170731707	0.7590361445783133	8	10908	3	34	5	10874	10916	0.17315241724166633
M1	string	0	network_modules	78	TRUE	6.93815431576393e-4	8	37	3	0.08108108108108109	0.375	REAC:R-HSA-9660537	REAC	Signaling by MRAS-complex mutants	10916	2271		0.7317073170731707	0.7590361445783133	8	10908	3	34	5	10874	10916	0.17315241724166633
M1	string	0	network_modules	78	TRUE	7.544898425679928e-4	28	37	4	0.10810810810810811	0.14285714285714285	REAC:R-HSA-5654727	REAC	Negative regulation of FGFR2 signaling	10916	1569		0.7682926829268293	0.7710843373493976	28	10888	4	33	24	10855	10916	0.12168765860815779
M1	string	0	network_modules	78	TRUE	7.77120321089139e-4	70	36	5	0.1388888888888889	0.07142857142857142	KEGG:04917	KEGG	Prolactin signaling pathway	8484	374		0.7733333333333333	0.7763157894736842	70	8414	5	31	65	8383	8484	0.09427453931829471
M1	string	0	network_modules	78	TRUE	8.63724079416768e-4	188	36	7	0.19444444444444445	0.03723404255319149	KEGG:04613	KEGG	Neutrophil extracellular trap formation	8484	323		0.7866666666666666	0.7894736842105263	188	8296	7	29	181	8267	8484	0.07640281224661495
M1	string	0	network_modules	78	TRUE	8.925557813073557e-4	124	36	6	0.16666666666666666	0.04838709677419355	KEGG:04650	KEGG	Natural killer cell mediated cytotoxicity	8484	334		0.8	0.8026315789473685	124	8360	6	30	118	8330	8484	0.08270847757494401
M1	string	0	network_modules	78	TRUE	0.0011510741367041194	31	37	4	0.10810810810810811	0.12903225806451613	REAC:R-HSA-187687	REAC	Signalling to ERKs	10916	2331		0.7804878048780488	0.8072289156626506	31	10885	4	33	27	10852	10916	0.11536450290820204
M1	string	0	network_modules	78	TRUE	0.0011510741367041194	31	37	4	0.10810810810810811	0.12903225806451613	REAC:R-HSA-5213460	REAC	RIPK1-mediated regulated necrosis	10916	1877		0.7804878048780488	0.8072289156626506	31	10885	4	33	27	10852	10916	0.11536450290820204
M1	string	0	network_modules	78	TRUE	0.0011510741367041194	31	37	4	0.10810810810810811	0.12903225806451613	REAC:R-HSA-5675482	REAC	Regulation of necroptotic cell death	10916	2045		0.7804878048780488	0.8072289156626506	31	10885	4	33	27	10852	10916	0.11536450290820204
M1	string	0	network_modules	78	TRUE	0.001187219783591593	595	38	10	0.2631578947368421	0.01680672268907563	GO:0051248	GO:BP	negative regulation of protein metabolic process	16175	13595		0.746268656716418	0.75	595	15580	10	28	585	15552	16175	0.058358832052197725
M1	string	0	network_modules	78	TRUE	0.0012403416305474364	37	36	4	0.1111111111111111	0.10810810810810811	KEGG:05216	KEGG	Thyroid cancer	8484	467		0.8133333333333334	0.8157894736842105	37	8447	4	32	33	8415	8484	0.10575248281528978
M1	string	0	network_modules	78	TRUE	0.0013123328202577988	32	37	4	0.10810810810810811	0.125	REAC:R-HSA-5654741	REAC	Signaling by FGFR3	10916	2249		0.8170731707317073	0.8192771084337349	32	10884	4	33	28	10851	10916	0.1134540234380938
M1	string	0	network_modules	78	TRUE	0.0013333639273788568	133	36	6	0.16666666666666666	0.045112781954887216	KEGG:04270	KEGG	Vascular smooth muscle contraction	8484	298		0.8266666666666667	0.8289473684210527	133	8351	6	30	127	8321	8484	0.07934660789761741
M1	string	0	network_modules	78	TRUE	0.001379608107243369	202	36	7	0.19444444444444445	0.034653465346534656	KEGG:04510	KEGG	Focal adhesion	8484	313		0.84	0.8421052631578947	202	8282	7	29	195	8253	8484	0.07306334892675807
M1	string	0	network_modules	78	TRUE	0.001451900329057541	135	36	6	0.16666666666666666	0.044444444444444446	KEGG:04210	KEGG	Apoptosis	8484	287		0.8533333333333334	0.8552631578947368	135	8349	6	30	129	8319	8484	0.07864311866164961
M1	string	0	network_modules	78	TRUE	0.001479810587909716	10	37	3	0.08108108108108109	0.3	REAC:R-HSA-937042	REAC	IRAK2 mediated activation of TAK1 complex	10916	1156		0.8292682926829268	0.8313253012048193	10	10906	3	34	7	10872	10916	0.1545332440460732
M1	string	0	network_modules	78	TRUE	0.0015907887494532856	81	36	5	0.1388888888888889	0.06172839506172839	KEGG:04662	KEGG	B cell receptor signaling pathway	8484	339		0.8666666666666667	0.868421052631579	81	8403	5	31	76	8372	8484	0.0868266766447554
M1	string	0	network_modules	78	TRUE	0.0015951944837969976	131	37	6	0.16216216216216217	0.04580152671755725	REAC:R-HSA-166520	REAC	Signaling by NTRKs	10916	2287		0.8414634146341463	0.8433734939759037	131	10785	6	31	125	10754	10916	0.08042342629939339
M1	string	0	network_modules	78	TRUE	0.0017110849122252696	346	38	8	0.21052631578947367	0.023121387283236993	GO:0043254	GO:BP	regulation of protein-containing complex assembly	16175	10588		0.7611940298507462	0.7647058823529411	346	15829	8	30	338	15799	16175	0.06343551156008702
M1	string	0	network_modules	78	TRUE	0.0018227791775824425	239	38	7	0.18421052631578946	0.029288702928870293	GO:0070372	GO:BP	regulation of ERK1 and ERK2 cascade	16175	16083		0.7761194029850746	0.7794117647058824	239	15936	7	31	232	15905	16175	0.0681456714746655
M1	string	0	network_modules	78	TRUE	0.0018970132206983963	35	37	4	0.10810810810810811	0.11428571428571428	REAC:R-HSA-5654743	REAC	Signaling by FGFR4	10916	2252		0.8536585365853658	0.8554216867469879	35	10881	4	33	31	10848	10916	0.10821424558175197
M1	string	0	network_modules	78	TRUE	0.0019356589909345528	142	36	6	0.16666666666666666	0.04225352112676056	KEGG:04936	KEGG	Alcoholic liver disease	8484	393		0.88	0.881578947368421	142	8342	6	30	136	8312	8484	0.07629255231365951
M1	string	0	network_modules	78	TRUE	0.0020299878296385315	11	37	3	0.08108108108108109	0.2727272727272727	REAC:R-HSA-9645460	REAC	Alpha-protein kinase 1 signaling pathway	10916	135		0.8658536585365854	0.8795180722891566	11	10905	3	34	8	10871	10916	0.1471800399367852
M1	string	0	network_modules	78	TRUE	0.0020299878296385315	11	37	3	0.08108108108108109	0.2727272727272727	REAC:R-HSA-9014325	REAC	TICAM1,TRAF6-dependent induction of TAK1 complex	10916	2441		0.8658536585365854	0.8795180722891566	11	10905	3	34	8	10871	10916	0.1471800399367852
M1	string	0	network_modules	78	TRUE	0.0020969253727291153	83	38	5	0.13157894736842105	0.060240963855421686	GO:0043535	GO:BP	regulation of blood vessel endothelial cell migration	16175	10756		0.7910447761194029	0.7941176470588235	83	16092	5	33	78	16059	16175	0.08587981967916666
M1	string	0	network_modules	78	TRUE	0.002354912308023025	147	36	6	0.16666666666666666	0.04081632653061224	KEGG:04072	KEGG	Phospholipase D signaling pathway	8484	261		0.8933333333333333	0.8947368421052632	147	8337	6	30	141	8307	8484	0.07471148083978715
M1	string	0	network_modules	78	TRUE	0.002700330126680394	12	37	3	0.08108108108108109	0.25	REAC:R-HSA-3371511	REAC	HSF1 activation	10916	1109		0.8902439024390244	0.891566265060241	12	10904	3	34	9	10870	10916	0.1407593999366883
M1	string	0	network_modules	78	TRUE	0.0030618025369238038	154	36	6	0.16666666666666666	0.03896103896103896	KEGG:04921	KEGG	Oxytocin signaling pathway	8484	378		0.9066666666666666	0.9078947368421053	154	8330	6	30	148	8300	8484	0.07262095934625609
M1	string	0	network_modules	78	TRUE	0.0031753846295824516	155	36	6	0.16666666666666666	0.03870967741935484	KEGG:04218	KEGG	Cellular senescence	8484	295		0.92	0.9342105263157895	155	8329	6	30	149	8299	8484	0.07233321152279147
M1	string	0	network_modules	78	TRUE	0.0031753846295824516	155	36	6	0.16666666666666666	0.03870967741935484	KEGG:04150	KEGG	mTOR signaling pathway	8484	284		0.92	0.9342105263157895	155	8329	6	30	149	8299	8484	0.07233321152279147
M1	string	0	network_modules	78	TRUE	0.0035022326324226846	13	37	3	0.08108108108108109	0.23076923076923078	REAC:R-HSA-5637812	REAC	Signaling by EGFRvIII in Cancer	10916	2231		0.9024390243902439	0.9156626506024096	13	10903	3	34	10	10869	10916	0.13508855508585005
M1	string	0	network_modules	78	TRUE	0.0035022326324226846	13	37	3	0.08108108108108109	0.23076923076923078	REAC:R-HSA-5637810	REAC	Constitutive Signaling by EGFRvIII	10916	402		0.9024390243902439	0.9156626506024096	13	10903	3	34	10	10869	10916	0.13508855508585005
M1	string	0	network_modules	78	TRUE	0.003987125058610708	42	37	4	0.10810810810810811	0.09523809523809523	REAC:R-HSA-5654736	REAC	Signaling by FGFR1	10916	2241		0.926829268292683	0.927710843373494	42	10874	4	33	38	10841	10916	0.09821336281129776
M1	string	0	network_modules	78	TRUE	0.004261240573366349	330	36	8	0.2222222222222222	0.024242424242424242	KEGG:05165	KEGG	Human papillomavirus infection	8484	446		0.9466666666666667	0.9473684210526315	330	8154	8	28	322	8126	8484	0.06189498386068281
M1	string	0	network_modules	78	TRUE	0.004446980269468951	14	37	3	0.08108108108108109	0.21428571428571427	REAC:R-HSA-3371568	REAC	Attenuation phase	10916	189		0.9390243902439024	0.9518072289156626	14	10902	3	34	11	10868	10916	0.13003128321726853
M1	string	0	network_modules	78	TRUE	0.004446980269468951	14	37	3	0.08108108108108109	0.21428571428571427	REAC:R-HSA-9665348	REAC	Signaling by ERBB2 ECD mutants	10916	2233		0.9390243902439024	0.9518072289156626	14	10902	3	34	11	10868	10916	0.13003128321726853
M1	string	0	network_modules	78	TRUE	0.004887945044301524	246	36	7	0.19444444444444445	0.028455284552845527	KEGG:05131	KEGG	Shigellosis	8484	428		0.96	0.9605263157894737	246	8238	7	29	239	8209	8484	0.06436649149304972
M1	string	0	network_modules	78	TRUE	0.005437290914742524	180	38	6	0.15789473684210525	0.03333333333333333	GO:0046777	GO:BP	protein autophosphorylation	16175	12365		0.8059701492537313	0.8088235294117647	180	15995	6	32	174	15963	16175	0.0678927046793531
M1	string	0	network_modules	78	TRUE	0.005545748404305549	15	37	3	0.08108108108108109	0.2	REAC:R-HSA-937072	REAC	TRAF6-mediated induction of TAK1 complex within TLR4 complex	10916	2469		0.9634146341463414	0.9759036144578314	15	10901	3	34	12	10867	10916	0.12548369539109486
M1	string	0	network_modules	78	TRUE	0.005545748404305549	15	37	3	0.08108108108108109	0.2	REAC:R-HSA-975163	REAC	IRAK2 mediated activation of TAK1 complex upon TLR7/8 or 9 stimulation	10916	1157		0.9634146341463414	0.9759036144578314	15	10901	3	34	12	10867	10916	0.12548369539109486
M1	string	0	network_modules	78	TRUE	0.005824015285866867	102	38	5	0.13157894736842105	0.049019607843137254	GO:0043534	GO:BP	blood vessel endothelial cell migration	16175	10755		0.8208955223880597	0.8235294117647058	102	16073	5	33	97	16040	16175	0.07679506793230897
M1	string	0	network_modules	78	TRUE	0.005908748812467742	551	38	9	0.23684210526315788	0.016333938294010888	GO:1902532	GO:BP	negative regulation of intracellular signal transduction	16175	22341		0.835820895522388	0.8382352941176471	551	15624	9	29	542	15595	16175	0.0542465189905386
M1	string	0	network_modules	78	TRUE	0.006659092895647893	109	36	5	0.1388888888888889	0.045871559633027525	KEGG:04066	KEGG	HIF-1 signaling pathway	8484	257		0.9733333333333334	0.9736842105263158	109	8375	5	31	104	8344	8484	0.07306034957299999
M1	string	0	network_modules	78	TRUE	0.007370414921572922	107	38	5	0.13157894736842105	0.04672897196261682	GO:0034614	GO:BP	cellular response to reactive oxygen species	16175	8691		0.8507462686567164	0.8529411764705882	107	16068	5	33	102	16035	16175	0.07480594485156807
M1	string	0	network_modules	78	TRUE	0.007576877364854852	112	36	5	0.1388888888888889	0.044642857142857144	KEGG:04726	KEGG	Serotonergic synapse	8484	356		0.9866666666666667	0.9868421052631579	112	8372	5	31	107	8341	8484	0.07188589132299049
M1	string	0	network_modules	78	TRUE	0.007642234339401988	259	37	7	0.1891891891891892	0.02702702702702703	REAC:R-HSA-76002	REAC	Platelet activation, signaling and aggregation	10916	1762		0.9878048780487805	0.9879518072289156	259	10657	7	30	252	10627	10916	0.0634018962652598
M1	string	0	network_modules	78	TRUE	0.007695338090282607	297	38	7	0.18421052631578946	0.02356902356902357	GO:0031647	GO:BP	regulation of protein stability	16175	7257		0.8656716417910447	0.8676470588235294	297	15878	7	31	290	15847	16175	0.05994611571264024
M1	string	0	network_modules	78	TRUE	0.008087971561124991	15	38	3	0.07894736842105263	0.2	GO:1904031	GO:BP	positive regulation of cyclin-dependent protein kinase activity	16175	23472		0.8805970149253731	0.8823529411764706	15	16160	3	35	12	16125	16175	0.1243839630022159
M1	string	0	network_modules	78	TRUE	0.008142910417612755	2	38	2	0.05263157894736842	1	GO:1902949	GO:BP	positive regulation of tau-protein kinase activity	16175	22637		0.8955223880597015	0.8970588235294118	2	16173	2	36	0	16137	16175	0.22916025970014609
M1	string	0	network_modules	78	TRUE	0.008361292427594808	50	38	4	0.10526315789473684	0.08	GO:0043536	GO:BP	positive regulation of blood vessel endothelial cell migration	16175	10757		0.9104477611940298	0.9117647058823529	50	16125	4	34	46	16091	16175	0.08931441995969656
M1	string	0	network_modules	78	TRUE	0.008442219536524069	110	38	5	0.13157894736842105	0.045454545454545456	GO:0072655	GO:BP	establishment of protein localization to mitochondrion	16175	17476		0.9253731343283582	0.9264705882352942	110	16065	5	33	105	16032	16175	0.07367618783738074
M1	string	0	network_modules	78	TRUE	0.009031188467896042	187	36	6	0.16666666666666666	0.03208556149732621	KEGG:05034	KEGG	Alcoholism	8484	422		1	1	187	8297	6	30	181	8267	8484	0.06430392942522845
M1	string	0	network_modules	78	TRUE	0.009679251357659447	437	38	8	0.21052631578947367	0.018306636155606407	GO:0080135	GO:BP	regulation of cellular response to stress	16175	17817		0.9402985074626866	0.9411764705882353	437	15738	8	30	429	15708	16175	0.05492465169006191
M1	string	0	network_modules	78	TRUE	0.00987630019385195	18	37	3	0.08108108108108109	0.16666666666666666	REAC:R-HSA-9665686	REAC	Signaling by ERBB2 TMD/JMD mutants	10916	2235		1	1	18	10898	3	34	15	10864	10916	0.1141711642451983
M1	string	0	network_modules	78	TRUE	0.009938280245601163	16	38	3	0.07894736842105263	0.1875	GO:0048308	GO:BP	organelle inheritance	16175	12646		0.9552238805970149	0.9852941176470589	16	16159	3	35	13	16124	16175	0.12034254458480281
M1	string	0	network_modules	78	TRUE	0.009938280245601163	16	38	3	0.07894736842105263	0.1875	GO:1903358	GO:BP	regulation of Golgi organization	16175	22941		0.9552238805970149	0.9852941176470589	16	16159	3	35	13	16124	16175	0.12034254458480281
M1	string	0	network_modules	78	TRUE	0.009938280245601163	16	38	3	0.07894736842105263	0.1875	GO:0048313	GO:BP	Golgi inheritance	16175	12650		0.9552238805970149	0.9852941176470589	16	16159	3	35	13	16124	16175	0.12034254458480281
M1	string	0	network_modules	78	TRUE	0.009977730485187526	309	38	7	0.18421052631578946	0.022653721682847898	GO:0042176	GO:BP	regulation of protein catabolic process	16175	10004		1	1	309	15866	7	31	302	15835	16175	0.058529812746260464
M1	string	0	network_modules	79	TRUE	5.950143723123936e-34	162	36	25	0.6944444444444444	0.15432098765432098	KEGG:04630	KEGG	JAK-STAT signaling pathway	8484	332		0	0.05	162	8322	25	11	137	8311	8484	0.32213083004400583
M1	string	0	network_modules	79	TRUE	1.8277466659090623e-26	419	37	24	0.6486486486486487	0.057279236276849645	GO:0019221	GO:BP	cytokine-mediated signaling pathway	16175	5598		0	0.00909090909090909	419	15756	24	13	395	15743	16175	0.18771552041386175
M1	string	0	network_modules	79	TRUE	1.6496032486846084e-23	555	37	24	0.6486486486486487	0.043243243243243246	GO:0071345	GO:BP	cellular response to cytokine stimulus	16175	16597		0.009174311926605505	0.01818181818181818	555	15620	24	13	531	15607	16175	0.16159933344410737
M1	string	0	network_modules	79	TRUE	2.857731468660554e-22	625	37	24	0.6486486486486487	0.0384	GO:1901652	GO:BP	response to peptide	16175	21619		0.01834862385321101	0.03636363636363636	625	15550	24	13	601	15537	16175	0.15154833556409794
M1	string	0	network_modules	79	TRUE	2.857731468660554e-22	625	37	24	0.6486486486486487	0.0384	GO:0034097	GO:BP	response to cytokine	16175	8408		0.01834862385321101	0.03636363636363636	625	15550	24	13	601	15537	16175	0.15154833556409794
M1	string	0	network_modules	79	TRUE	9.276128551055261e-21	142	37	16	0.43243243243243246	0.11267605633802817	GO:0007259	GO:BP	cell surface receptor signaling pathway via JAK-STAT	16175	2789		0.03669724770642202	0.045454545454545456	142	16033	16	21	126	16012	16175	0.21746004688629483
M1	string	0	network_modules	79	TRUE	2.0728170404688913e-20	149	37	16	0.43243243243243246	0.10738255033557047	GO:0097696	GO:BP	cell surface receptor signaling pathway via STAT	16175	18727		0.045871559633027525	0.05454545454545454	149	16026	16	21	133	16005	16175	0.21211993194669934
M1	string	0	network_modules	79	TRUE	6.023332034564346e-20	23	37	11	0.2972972972972973	0.4782608695652174	REAC:R-HSA-982772	REAC	Growth hormone receptor signaling	10916	1085		0	0.018867924528301886	23	10893	11	26	12	10867	10916	0.3754346140229287
M1	string	0	network_modules	79	TRUE	2.4775932309892565e-18	199	37	16	0.43243243243243246	0.08040201005025126	GO:0071375	GO:BP	cellular response to peptide hormone stimulus	16175	16627		0.05504587155963303	0.06363636363636363	199	15976	16	21	183	15955	16175	0.18249161078601198
M1	string	0	network_modules	79	TRUE	3.459307737837072e-17	472	37	21	0.5675675675675675	0.04449152542372881	REAC:R-HSA-449147	REAC	Signaling by Interleukins	10916	2261		0.019230769230769232	0.03773584905660377	472	10444	21	16	451	10428	10916	0.1503379960141175
M1	string	0	network_modules	79	TRUE	4.0015266080056974e-17	236	37	16	0.43243243243243246	0.06779661016949153	GO:0043434	GO:BP	response to peptide hormone	16175	10691		0.06422018348623854	0.07272727272727272	236	15939	16	21	220	15918	16175	0.16685755147571857
M1	string	0	network_modules	79	TRUE	4.428267820453578e-15	36	37	10	0.2702702702702703	0.2777777777777778	REAC:R-HSA-1266695	REAC	Interleukin-7 signaling	10916	1255		0.038461538461538464	0.05660377358490566	36	10880	10	27	26	10853	10916	0.27156293980855123
M1	string	0	network_modules	79	TRUE	1.1555496976107681e-14	510	37	18	0.4864864864864865	0.03529411764705882	GO:0007169	GO:BP	cell surface receptor protein tyrosine kinase signaling pathway	16175	2733		0.07339449541284404	0.08181818181818182	510	15665	18	19	492	15646	16175	0.12466362081283566
M1	string	0	network_modules	79	TRUE	3.526237884614133e-14	9	37	7	0.1891891891891892	0.7777777777777778	REAC:R-HSA-2586552	REAC	Signaling by Leptin	10916	2266		0.057692307692307696	0.07547169811320754	9	10907	7	30	2	10877	10916	0.3827326688420865
M1	string	0	network_modules	79	TRUE	4.2435692335781086e-14	451	37	17	0.4594594594594595	0.037694013303769404	GO:0032870	GO:BP	cellular response to hormone stimulus	16175	7867		0.08256880733944955	0.09090909090909091	451	15724	17	20	434	15704	16175	0.12551878401910588
M1	string	0	network_modules	79	TRUE	5.51758802441342e-14	790	37	20	0.5405405405405406	0.02531645569620253	GO:0007167	GO:BP	enzyme-linked receptor protein signaling pathway	16175	2731		0.09174311926605505	0.1	790	15385	20	17	770	15368	16175	0.10923403483609481
M1	string	0	network_modules	79	TRUE	8.799595107233764e-14	47	37	10	0.2702702702702703	0.2127659574468085	REAC:R-HSA-512988	REAC	Interleukin-3, Interleukin-5 and GM-CSF signaling	10916	1246		0.07692307692307693	0.09433962264150944	47	10869	10	27	37	10842	10916	0.2368918487233867
M1	string	0	network_modules	79	TRUE	9.806981223354175e-14	30	37	9	0.24324324324324326	0.3	REAC:R-HSA-9674555	REAC	Signaling by CSF3 (G-CSF)	10916	2227		0.09615384615384616	0.11320754716981132	30	10886	9	28	21	10858	10916	0.26790519223101994
M1	string	0	network_modules	79	TRUE	6.098846738275555e-13	431	37	16	0.43243243243243246	0.037122969837587005	GO:1901699	GO:BP	cellular response to nitrogen compound	16175	21652		0.10091743119266056	0.10909090909090909	431	15744	16	21	415	15723	16175	0.12064840353223617
M1	string	0	network_modules	79	TRUE	8.148604983932776e-13	26	37	8	0.21621621621621623	0.3076923076923077	GO:0071378	GO:BP	cellular response to growth hormone stimulus	16175	16630		0.11009174311926606	0.12727272727272726	26	16149	8	29	18	16120	16175	0.2565123771492145
M1	string	0	network_modules	79	TRUE	8.148604983932776e-13	26	37	8	0.21621621621621623	0.3076923076923077	GO:0060396	GO:BP	growth hormone receptor signaling pathway	16175	14599		0.11009174311926606	0.12727272727272726	26	16149	8	29	18	16120	16175	0.2565123771492145
M1	string	0	network_modules	79	TRUE	8.312018384510495e-13	539	37	17	0.4594594594594595	0.03153988868274583	GO:0009725	GO:BP	response to hormone	16175	3623		0.12844036697247707	0.13636363636363635	539	15636	17	20	522	15616	16175	0.11368724587801934
M1	string	0	network_modules	79	TRUE	1.1463660126679435e-12	214	37	13	0.35135135135135137	0.06074766355140187	GO:0018108	GO:BP	peptidyl-tyrosine phosphorylation	16175	5327		0.13761467889908258	0.14545454545454545	214	15961	13	24	201	15937	16175	0.14169534376330664
M1	string	0	network_modules	79	TRUE	1.2184423515773257e-12	215	37	13	0.35135135135135137	0.06046511627906977	GO:0018212	GO:BP	peptidyl-tyrosine modification	16175	5371		0.14678899082568808	0.15454545454545454	215	15960	13	24	202	15936	16175	0.14134401552237044
M1	string	0	network_modules	79	TRUE	2.2280231177512897e-12	29	37	8	0.21621621621621623	0.27586206896551724	GO:0060416	GO:BP	response to growth hormone	16175	14617		0.1559633027522936	0.16363636363636364	29	16146	8	29	21	16117	16175	0.24269501219909784
M1	string	0	network_modules	79	TRUE	2.812024682612138e-12	25	37	8	0.21621621621621623	0.32	REAC:R-HSA-9705462	REAC	Inactivation of CSF3 (G-CSF) signaling	10916	1178		0.11538461538461539	0.1320754716981132	25	10891	8	29	17	10862	10916	0.2609934379073277
M1	string	0	network_modules	79	TRUE	4.704339594856487e-12	44	37	9	0.24324324324324326	0.20454545454545456	REAC:R-HSA-451927	REAC	Interleukin-2 family signaling	10916	1240		0.1346153846153846	0.1509433962264151	44	10872	9	28	35	10844	10916	0.22017735122583212
M1	string	0	network_modules	79	TRUE	1.7108190026138466e-11	356	36	16	0.4444444444444444	0.0449438202247191	KEGG:04151	KEGG	PI3K-Akt signaling pathway	8484	285		0.05263157894736842	0.1	356	8128	16	20	340	8108	8484	0.13104056785633109
M1	string	0	network_modules	79	TRUE	2.511275108884312e-11	791	37	18	0.4864864864864865	0.022756005056890013	GO:1901701	GO:BP	cellular response to oxygen-containing compound	16175	21654		0.1651376146788991	0.17272727272727273	791	15384	18	19	773	15365	16175	0.09715355849792465
M1	string	0	network_modules	79	TRUE	3.1479116128514804e-11	10	37	6	0.16216216216216217	0.6	GO:0060397	GO:BP	growth hormone receptor signaling pathway via JAK-STAT	16175	14600		0.1743119266055046	0.18181818181818182	10	16165	6	31	4	16134	16175	0.311188163543955
M1	string	0	network_modules	79	TRUE	3.928232533228711e-11	507	37	17	0.4594594594594595	0.03353057199211045	REAC:R-HSA-9006934	REAC	Signaling by Receptor Tyrosine Kinases	10916	2302		0.15384615384615385	0.16981132075471697	507	10409	17	20	490	10389	10916	0.11445270425852395
M1	string	0	network_modules	79	TRUE	1.5473974285682529e-10	39	37	8	0.21621621621621623	0.20512820512820512	REAC:R-HSA-1433557	REAC	Signaling by SCF-KIT	10916	2306		0.17307692307692307	0.18867924528301888	39	10877	8	29	31	10848	10916	0.20784285615411358
M1	string	0	network_modules	79	TRUE	1.5809253201983115e-10	11	37	6	0.16216216216216217	0.5454545454545454	REAC:R-HSA-1059683	REAC	Interleukin-6 signaling	10916	1254		0.19230769230769232	0.20754716981132076	11	10905	6	31	5	10874	10916	0.2962122884093074
M1	string	0	network_modules	79	TRUE	1.7195034182021466e-10	619	37	16	0.43243243243243246	0.025848142164781908	GO:1901698	GO:BP	response to nitrogen compound	16175	21651		0.1834862385321101	0.19090909090909092	619	15556	16	21	603	15535	16175	0.09837900107130719
M1	string	0	network_modules	79	TRUE	2.8193783594487635e-10	83	37	9	0.24324324324324326	0.10843373493975904	GO:0046425	GO:BP	regulation of receptor signaling pathway via JAK-STAT	16175	12135		0.1926605504587156	0.2	83	16092	9	28	74	16064	16175	0.15957221709257424
M1	string	0	network_modules	79	TRUE	3.154148791150915e-10	12	37	6	0.16216216216216217	0.5	REAC:R-HSA-9020558	REAC	Interleukin-2 signaling	10916	1241		0.21153846153846154	0.24528301886792453	12	10904	6	31	6	10873	10916	0.2834534573019269
M1	string	0	network_modules	79	TRUE	3.154148791150915e-10	12	37	6	0.16216216216216217	0.5	REAC:R-HSA-877312	REAC	Regulation of IFNG signaling	10916	1980		0.21153846153846154	0.24528301886792453	12	10904	6	31	6	10873	10916	0.2834534573019269
M1	string	0	network_modules	79	TRUE	3.269755626645058e-10	24	37	7	0.1891891891891892	0.2916666666666667	REAC:R-HSA-912694	REAC	Regulation of IFNA/IFNB signaling	10916	1979		0.25	0.2641509433962264	24	10892	7	30	17	10862	10916	0.23282531326377723
M1	string	0	network_modules	79	TRUE	3.348306401989123e-10	291	36	14	0.3888888888888889	0.048109965635738834	KEGG:04060	KEGG	Cytokine-cytokine receptor interaction	8484	253		0.10526315789473684	0.15	291	8193	14	22	277	8171	8484	0.12718394204006822
M1	string	0	network_modules	79	TRUE	4.530391607685748e-10	25	37	7	0.1891891891891892	0.28	REAC:R-HSA-8854691	REAC	Interleukin-20 family signaling	10916	1242		0.2692307692307692	0.2830188679245283	25	10891	7	30	18	10861	10916	0.22801999522366637
M1	string	0	network_modules	79	TRUE	5.991903389682885e-10	90	37	9	0.24324324324324326	0.1	GO:1904892	GO:BP	regulation of receptor signaling pathway via STAT	16175	24199		0.2018348623853211	0.20909090909090908	90	16085	9	28	81	16057	16175	0.15299579853197198
M1	string	0	network_modules	79	TRUE	6.184554072840832e-10	26	37	7	0.1891891891891892	0.2692307692307692	REAC:R-HSA-912526	REAC	Interleukin receptor SHC signaling	10916	1230		0.28846153846153844	0.3018867924528302	26	10890	7	30	19	10860	10916	0.22349266789380665
M1	string	0	network_modules	79	TRUE	8.06082599986938e-10	105	36	10	0.2777777777777778	0.09523809523809523	KEGG:04659	KEGG	Th17 cell differentiation	8484	337		0.15789473684210525	0.2	105	8379	10	26	95	8353	8484	0.1567067312269137
M1	string	0	network_modules	79	TRUE	1.0201102141818106e-9	14	37	6	0.16216216216216217	0.42857142857142855	REAC:R-HSA-1170546	REAC	Prolactin receptor signaling	10916	1805		0.3076923076923077	0.33962264150943394	14	10902	6	31	8	10871	10916	0.26215242695909635
M1	string	0	network_modules	79	TRUE	1.0201102141818106e-9	14	37	6	0.16216216216216217	0.42857142857142855	REAC:R-HSA-8983432	REAC	Interleukin-15 signaling	10916	1237		0.3076923076923077	0.33962264150943394	14	10902	6	31	8	10871	10916	0.26215242695909635
M1	string	0	network_modules	79	TRUE	2.4681594067378105e-9	7	37	5	0.13513513513513514	0.7142857142857143	REAC:R-HSA-9027283	REAC	Erythropoietin activates STAT5	10916	860		0.34615384615384615	0.3584905660377358	7	10909	5	32	2	10877	10916	0.3098353135211514
M1	string	0	network_modules	79	TRUE	5.779187864471592e-9	89	36	9	0.25	0.10112359550561797	KEGG:04658	KEGG	Th1 and Th2 cell differentiation	8484	336		0.21052631578947367	0.25	89	8395	9	27	80	8368	8484	0.15345910035322896
M1	string	0	network_modules	79	TRUE	9.543854507963985e-9	9	37	5	0.13513513513513514	0.5555555555555556	GO:0071352	GO:BP	cellular response to interleukin-2	16175	16604		0.21100917431192662	0.22727272727272727	9	16166	5	32	4	16134	16175	0.2732587958029459
M1	string	0	network_modules	79	TRUE	9.543854507963985e-9	9	37	5	0.13513513513513514	0.5555555555555556	GO:0038110	GO:BP	interleukin-2-mediated signaling pathway	16175	9704		0.21100917431192662	0.22727272727272727	9	16166	5	32	4	16134	16175	0.2732587958029459
M1	string	0	network_modules	79	TRUE	1.4067521498601663e-8	686	37	15	0.40540540540540543	0.021865889212827987	GO:0008284	GO:BP	positive regulation of cell population proliferation	16175	3151		0.22935779816513763	0.23636363636363636	686	15489	15	22	671	15467	16175	0.08624746243920135
M1	string	0	network_modules	79	TRUE	1.473665669073334e-8	9	37	5	0.13513513513513514	0.5555555555555556	REAC:R-HSA-8985947	REAC	Interleukin-9 signaling	10916	1256		0.36538461538461536	0.37735849056603776	9	10907	5	32	4	10875	10916	0.27290184001730655
M1	string	0	network_modules	79	TRUE	1.9056229899799393e-8	10	37	5	0.13513513513513514	0.5	GO:0070669	GO:BP	response to interleukin-2	16175	16250		0.23853211009174313	0.24545454545454545	10	16165	5	32	5	16133	16175	0.2591249804106961
M1	string	0	network_modules	79	TRUE	2.0725361797613992e-8	84	37	8	0.21621621621621623	0.09523809523809523	GO:0008286	GO:BP	insulin receptor signaling pathway	16175	3153		0.24770642201834864	0.2545454545454545	84	16091	8	29	76	16062	16175	0.14057851873578037
M1	string	0	network_modules	79	TRUE	2.9401277675323608e-8	10	37	5	0.13513513513513514	0.5	REAC:R-HSA-9020958	REAC	Interleukin-21 signaling	10916	1243		0.38461538461538464	0.39622641509433965	10	10906	5	32	5	10874	10916	0.2587326937963317
M1	string	0	network_modules	79	TRUE	3.487880461847977e-8	11	37	5	0.13513513513513514	0.45454545454545453	GO:0070672	GO:BP	response to interleukin-15	16175	16253		0.25688073394495414	0.2818181818181818	11	16164	5	32	6	16132	16175	0.24696006238506493
M1	string	0	network_modules	79	TRUE	3.487880461847977e-8	11	37	5	0.13513513513513514	0.45454545454545453	GO:0035723	GO:BP	interleukin-15-mediated signaling pathway	16175	9193		0.25688073394495414	0.2818181818181818	11	16164	5	32	6	16132	16175	0.24696006238506493
M1	string	0	network_modules	79	TRUE	3.487880461847977e-8	11	37	5	0.13513513513513514	0.45454545454545453	GO:0071350	GO:BP	cellular response to interleukin-15	16175	16602		0.25688073394495414	0.2818181818181818	11	16164	5	32	6	16132	16175	0.24696006238506493
M1	string	0	network_modules	79	TRUE	4.462003074168154e-8	24	37	6	0.16216216216216217	0.25	REAC:R-HSA-6783589	REAC	Interleukin-6 family signaling	10916	1253		0.40384615384615385	0.41509433962264153	24	10892	6	31	18	10861	10916	0.19917347915028494
M1	string	0	network_modules	79	TRUE	8.691813776763822e-8	120	36	9	0.25	0.075	KEGG:04935	KEGG	Growth hormone synthesis, secretion and action	8484	392		0.2631578947368421	0.3	120	8364	9	27	111	8337	8484	0.13038383513967422
M1	string	0	network_modules	79	TRUE	9.359991543918732e-7	111	37	8	0.21621621621621623	0.07207207207207207	REAC:R-HSA-6785807	REAC	Interleukin-4 and Interleukin-13 signaling	10916	1252		0.4230769230769231	0.4339622641509434	111	10805	8	29	103	10776	10916	0.11977431744741063
M1	string	0	network_modules	79	TRUE	1.005034315168805e-6	70	36	7	0.19444444444444445	0.1	KEGG:04917	KEGG	Prolactin signaling pathway	8484	374		0.3157894736842105	0.35	70	8414	7	29	63	8385	8484	0.13436602761786426
M1	string	0	network_modules	79	TRUE	1.1889454223314736e-6	638	37	13	0.35135135135135137	0.02037617554858934	GO:0030097	GO:BP	hemopoiesis	16175	6675		0.28440366972477066	0.3	638	15537	13	24	625	15513	16175	0.07672776734393498
M1	string	0	network_modules	79	TRUE	1.1889454223314736e-6	638	37	13	0.35135135135135137	0.02037617554858934	GO:0018193	GO:BP	peptidyl-amino acid modification	16175	5353		0.28440366972477066	0.3	638	15537	13	24	625	15513	16175	0.07672776734393498
M1	string	0	network_modules	79	TRUE	1.2976674718842138e-6	140	37	8	0.21621621621621623	0.05714285714285714	GO:0032869	GO:BP	cellular response to insulin stimulus	16175	7866		0.30275229357798167	0.3090909090909091	140	16035	8	29	132	16006	16175	0.10729199170199752
M1	string	0	network_modules	79	TRUE	1.301315989137604e-6	7	37	4	0.10810810810810811	0.5714285714285714	GO:0038113	GO:BP	interleukin-9-mediated signaling pathway	16175	9707		0.3119266055045872	0.32727272727272727	7	16168	4	33	3	16135	16175	0.24789021454574503
M1	string	0	network_modules	79	TRUE	1.301315989137604e-6	7	37	4	0.10810810810810811	0.5714285714285714	GO:0071355	GO:BP	cellular response to interleukin-9	16175	16607		0.3119266055045872	0.32727272727272727	7	16168	4	33	3	16135	16175	0.24789021454574503
M1	string	0	network_modules	79	TRUE	1.6700582154591677e-6	406	37	11	0.2972972972972973	0.027093596059113302	GO:0042110	GO:BP	T cell activation	16175	9970		0.3302752293577982	0.33636363636363636	406	15769	11	26	395	15743	16175	0.08331789158793045
M1	string	0	network_modules	79	TRUE	1.8217573822607583e-6	76	37	7	0.1891891891891892	0.09210526315789473	REAC:R-HSA-909733	REAC	Interferon alpha/beta signaling	10916	1228		0.4423076923076923	0.4528301886792453	76	10840	7	30	69	10810	10916	0.12780887928795487
M1	string	0	network_modules	79	TRUE	2.3744623592030938e-6	46	36	6	0.16666666666666666	0.13043478260869565	KEGG:04930	KEGG	Type II diabetes mellitus	8484	387		0.3684210526315789	0.4	46	8438	6	30	40	8408	8484	0.14333812487668596
M1	string	0	network_modules	79	TRUE	2.4982337416740976e-6	152	37	8	0.21621621621621623	0.05263157894736842	GO:0032868	GO:BP	response to insulin	16175	7865		0.3394495412844037	0.34545454545454546	152	16023	8	29	144	15994	16175	0.1026400880235117
M1	string	0	network_modules	79	TRUE	2.598383258285944e-6	8	37	4	0.10810810810810811	0.5	GO:0071104	GO:BP	response to interleukin-9	16175	16454		0.3486238532110092	0.35454545454545455	8	16167	4	33	4	16134	16175	0.231754092007392
M1	string	0	network_modules	79	TRUE	2.70744744926527e-6	8	37	4	0.10810810810810811	0.5	REAC:R-HSA-112411	REAC	MAPK1 (ERK2) activation	10916	1350		0.46153846153846156	0.4716981132075472	8	10908	4	33	4	10875	10916	0.23139634016198032
M1	string	0	network_modules	79	TRUE	3.6107315033784425e-6	699	37	13	0.35135135135135137	0.01859799713876967	GO:0045321	GO:BP	leukocyte activation	16175	11356		0.3577981651376147	0.36363636363636365	699	15476	13	24	686	15452	16175	0.07255970559064695
M1	string	0	network_modules	79	TRUE	3.802954970579981e-6	23	37	5	0.13513513513513514	0.21739130434782608	REAC:R-HSA-9006335	REAC	Signaling by Erythropoietin	10916	2238		0.4807692307692308	0.49056603773584906	23	10893	5	32	18	10861	10916	0.16919040785773065
M1	string	0	network_modules	79	TRUE	4.278207095604011e-6	569	37	12	0.32432432432432434	0.0210896309314587	GO:0046649	GO:BP	lymphocyte activation	16175	12286		0.3669724770642202	0.37272727272727274	569	15606	12	25	557	15581	16175	0.07515128701026627
M1	string	0	network_modules	79	TRUE	4.6694547813083404e-6	9	37	4	0.10810810810810811	0.4444444444444444	GO:0035771	GO:BP	interleukin-4-mediated signaling pathway	16175	9230		0.3761467889908257	0.38181818181818183	9	16166	4	33	5	16133	16175	0.21838107955412353
M1	string	0	network_modules	79	TRUE	4.73376023991644e-6	269	37	10	0.2702702702702703	0.03717472118959108	REAC:R-HSA-5684996	REAC	MAPK1/MAPK3 signaling	10916	1351		0.5	0.5094339622641509	269	10647	10	27	259	10620	10916	0.0923968572192763
M1	string	0	network_modules	79	TRUE	4.8616160833249135e-6	9	37	4	0.10810810810810811	0.4444444444444444	REAC:R-HSA-110056	REAC	MAPK3 (ERK1) activation	10916	1352		0.5192307692307693	0.5283018867924528	9	10907	4	33	5	10874	10916	0.2179864256049166
M1	string	0	network_modules	79	TRUE	6.262629182870523e-6	138	36	8	0.2222222222222222	0.057971014492753624	KEGG:05162	KEGG	Measles	8484	443		0.42105263157894735	0.45	138	8346	8	28	130	8318	8484	0.10628484078231665
M1	string	0	network_modules	79	TRUE	7.620986257590764e-6	175	37	8	0.21621621621621623	0.045714285714285714	GO:0050730	GO:BP	regulation of peptidyl-tyrosine phosphorylation	16175	13229		0.3853211009174312	0.39090909090909093	175	16000	8	29	167	15971	16175	0.0950682465253432
M1	string	0	network_modules	79	TRUE	1.1310134324990675e-5	65	37	6	0.16216216216216217	0.09230769230769231	GO:0007260	GO:BP	tyrosine phosphorylation of STAT protein	16175	2790		0.3944954128440367	0.4	65	16110	6	31	59	16079	16175	0.11969265745600337
M1	string	0	network_modules	79	TRUE	1.2671276632879784e-5	11	37	4	0.10810810810810811	0.36363636363636365	REAC:R-HSA-9020956	REAC	Interleukin-27 signaling	10916	1245		0.5384615384615384	0.5471698113207547	11	10905	4	33	7	10872	10916	0.1968574560942926
M1	string	0	network_modules	79	TRUE	1.4219589526040271e-5	276	37	9	0.24324324324324326	0.03260869565217391	GO:0002460	GO:BP	adaptive immune response based on somatic recombination of immune receptors built from immunoglobulin superfamily domains	16175	983		0.4036697247706422	0.4090909090909091	276	15899	9	28	267	15871	16175	0.08362474521922224
M1	string	0	network_modules	79	TRUE	1.624532675994319e-5	792	37	13	0.35135135135135137	0.016414141414141416	GO:0042325	GO:BP	regulation of phosphorylation	16175	10093		0.41284403669724773	0.41818181818181815	792	15383	13	24	779	15359	16175	0.06709654502337943
M1	string	0	network_modules	79	TRUE	1.7129461133730723e-5	308	37	10	0.2702702702702703	0.032467532467532464	REAC:R-HSA-5683057	REAC	MAPK family signaling cascades	10916	1348		0.5576923076923077	0.5660377358490566	308	10608	10	27	298	10581	10916	0.08524943280677376
M1	string	0	network_modules	79	TRUE	1.896093851295246e-5	12	37	4	0.10810810810810811	0.3333333333333333	REAC:R-HSA-8984722	REAC	Interleukin-35 Signalling	10916	1248		0.5769230769230769	0.5849056603773585	12	10904	4	33	8	10871	10916	0.18832408572510118
M1	string	0	network_modules	79	TRUE	1.9037396189290858e-5	125	37	7	0.1891891891891892	0.056	GO:0046631	GO:BP	alpha-beta T cell activation	16175	12268		0.42201834862385323	0.42727272727272725	125	16050	7	30	118	16020	16175	0.09922282385474208
M1	string	0	network_modules	79	TRUE	3.0896131294269236e-5	70	36	6	0.16666666666666666	0.08571428571428572	KEGG:04920	KEGG	Adipocytokine signaling pathway	8484	377		0.47368421052631576	0.5	70	8414	6	30	64	8384	8484	0.11432028346807949
M1	string	0	network_modules	79	TRUE	3.152569233624709e-5	37	37	5	0.13513513513513514	0.13513513513513514	GO:0072538	GO:BP	T-helper 17 type immune response	16175	17436		0.43119266055045874	0.43636363636363634	37	16138	5	32	32	16106	16175	0.13315223762615014
M1	string	0	network_modules	79	TRUE	4.7354485717486543e-5	40	37	5	0.13513513513513514	0.125	GO:0046427	GO:BP	positive regulation of receptor signaling pathway via JAK-STAT	16175	12137		0.44036697247706424	0.44545454545454544	40	16135	5	32	35	16103	16175	0.1278948199670407
M1	string	0	network_modules	79	TRUE	7.390723291962712e-5	334	37	9	0.24324324324324326	0.02694610778443114	GO:0002250	GO:BP	adaptive immune response	16175	782		0.44954128440366975	0.45454545454545453	334	15841	9	28	325	15813	16175	0.07494961413191775
M1	string	0	network_modules	79	TRUE	7.764172731261166e-5	44	37	5	0.13513513513513514	0.11363636363636363	GO:1904894	GO:BP	positive regulation of receptor signaling pathway via STAT	16175	24201		0.45871559633027525	0.4636363636363636	44	16131	5	32	39	16099	16175	0.12173070268476374
M1	string	0	network_modules	79	TRUE	8.486296335327001e-5	744	37	12	0.32432432432432434	0.016129032258064516	GO:0001932	GO:BP	regulation of protein phosphorylation	16175	546		0.46788990825688076	0.4727272727272727	744	15431	12	25	732	15406	16175	0.06361987028186362
M1	string	0	network_modules	79	TRUE	8.705559613327505e-5	17	37	4	0.10810810810810811	0.23529411764705882	GO:0071353	GO:BP	cellular response to interleukin-4	16175	16605		0.47706422018348627	0.4818181818181818	17	16158	4	33	13	16125	16175	0.15820402268392175
M1	string	0	network_modules	79	TRUE	9.006851071686659e-5	17	37	4	0.10810810810810811	0.23529411764705882	REAC:R-HSA-6788467	REAC	IL-6-type cytokine receptor ligand interactions	10916	1146		0.5961538461538461	0.6037735849056604	17	10899	4	33	13	10866	10916	0.15758274809983527
M1	string	0	network_modules	79	TRUE	1.0536817370330127e-4	137	36	7	0.19444444444444445	0.051094890510948905	KEGG:04910	KEGG	Insulin signaling pathway	8484	367		0.5263157894736842	0.55	137	8347	7	29	130	8318	8484	0.09234046225432666
M1	string	0	network_modules	79	TRUE	1.1174593429080861e-4	18	37	4	0.10810810810810811	0.2222222222222222	GO:0070670	GO:BP	response to interleukin-4	16175	16251		0.48623853211009177	0.4909090909090909	18	16157	4	33	14	16124	16175	0.15366264308356842
M1	string	0	network_modules	79	TRUE	1.1934880968928571e-4	249	37	8	0.21621621621621623	0.0321285140562249	GO:0051251	GO:BP	positive regulation of lymphocyte activation	16175	13598		0.4954128440366973	0.5	249	15926	8	29	241	15897	16175	0.07810498404220141
M1	string	0	network_modules	79	TRUE	1.2062059106117518e-4	96	37	6	0.16216216216216217	0.0625	GO:0140888	GO:BP	interferon-mediated signaling pathway	16175	19923		0.5045871559633027	0.509090909090909	96	16079	6	31	90	16048	16175	0.09738935046445357
M1	string	0	network_modules	79	TRUE	1.2476797586549678e-4	5	37	3	0.08108108108108109	0.6	REAC:R-HSA-74713	REAC	IRS activation	10916	1163		0.6153846153846154	0.6226415094339622	5	10911	3	34	2	10877	10916	0.21974134516370053
M1	string	0	network_modules	79	TRUE	1.3793481884882567e-4	622	37	11	0.2972972972972973	0.017684887459807074	GO:0030155	GO:BP	regulation of cell adhesion	16175	6688		0.5137614678899083	0.5181818181818182	622	15553	11	26	611	15527	16175	0.0644546510486396
M1	string	0	network_modules	79	TRUE	1.4507603863853652e-4	99	37	6	0.16216216216216217	0.06060606060606061	GO:0120162	GO:BP	positive regulation of cold-induced thermogenesis	16175	19528		0.5229357798165137	0.5272727272727272	99	16076	6	31	93	16045	16175	0.09579748565290505
M1	string	0	network_modules	79	TRUE	1.5228162547739976e-4	257	37	8	0.21621621621621623	0.0311284046692607	GO:0022409	GO:BP	positive regulation of cell-cell adhesion	16175	6600		0.5321100917431193	0.5363636363636364	257	15918	8	29	249	15889	16175	0.07670965917824488
M1	string	0	network_modules	79	TRUE	1.7325316056438872e-4	369	37	9	0.24324324324324326	0.024390243902439025	GO:0051249	GO:BP	regulation of lymphocyte activation	16175	13596		0.5412844036697247	0.5454545454545454	369	15806	9	28	360	15778	16175	0.07069152283397107
M1	string	0	network_modules	79	TRUE	1.8762140033945246e-4	91	37	6	0.16216216216216217	0.06593406593406594	REAC:R-HSA-877300	REAC	Interferon gamma signaling	10916	1229		0.6346153846153846	0.6415094339622641	91	10825	6	31	85	10794	10916	0.09866528265377077
M1	string	0	network_modules	79	TRUE	2.489529671138719e-4	6	37	3	0.08108108108108109	0.5	REAC:R-HSA-9645135	REAC	STAT5 Activation	10916	2159		0.6538461538461539	0.660377358490566	6	10910	3	34	3	10876	10916	0.20037674006016282
M1	string	0	network_modules	79	TRUE	2.5406027458767765e-4	386	37	9	0.24324324324324326	0.023316062176165803	GO:0022407	GO:BP	regulation of cell-cell adhesion	16175	6598		0.5504587155963303	0.5545454545454546	386	15789	9	28	377	15761	16175	0.06882478915699028
M1	string	0	network_modules	79	TRUE	2.5610243563453465e-4	275	37	8	0.21621621621621623	0.02909090909090909	GO:0002696	GO:BP	positive regulation of leukocyte activation	16175	1214		0.5596330275229358	0.5636363636363636	275	15900	8	29	267	15871	16175	0.07378646499870109
M1	string	0	network_modules	79	TRUE	2.7349691083130927e-4	22	37	4	0.10810810810810811	0.18181818181818182	REAC:R-HSA-112409	REAC	RAF-independent MAPK1/3 activation	10916	1840		0.6730769230769231	0.6792452830188679	22	10894	4	33	18	10861	10916	0.13795913095900753
M1	string	0	network_modules	79	TRUE	2.7405096265751964e-4	158	36	7	0.19444444444444445	0.04430379746835443	KEGG:04217	KEGG	Necroptosis	8484	294		0.5789473684210527	0.6	158	8326	7	29	151	8297	8484	0.0848983668427817
M1	string	0	network_modules	79	TRUE	3.2363126901502673e-4	162	36	7	0.19444444444444445	0.043209876543209874	KEGG:05161	KEGG	Hepatitis B	8484	442		0.631578947368421	0.65	162	8322	7	29	155	8293	8484	0.08363894900729525
M1	string	0	network_modules	79	TRUE	3.276645168326365e-4	284	37	8	0.21621621621621623	0.028169014084507043	GO:0050863	GO:BP	regulation of T cell activation	16175	13311		0.5688073394495413	0.5727272727272728	284	15891	8	29	276	15862	16175	0.07242560493938226
M1	string	0	network_modules	79	TRUE	3.5375482199905884e-4	6	37	3	0.08108108108108109	0.5	GO:0038043	GO:BP	interleukin-5-mediated signaling pathway	16175	9677		0.5779816513761468	0.5818181818181818	6	16169	3	34	3	16135	16175	0.2006925177790762
M1	string	0	network_modules	79	TRUE	3.550538461042603e-4	287	37	8	0.21621621621621623	0.027874564459930314	GO:1903037	GO:BP	regulation of leukocyte cell-cell adhesion	16175	22717		0.5871559633027523	0.5909090909090909	287	15888	8	29	279	15859	16175	0.07198561107716517
M1	string	0	network_modules	79	TRUE	3.84387860362559e-4	290	37	8	0.21621621621621623	0.027586206896551724	GO:0050867	GO:BP	positive regulation of cell activation	16175	13315		0.5963302752293578	0.6	290	15885	8	29	282	15856	16175	0.07155213817994885
M1	string	0	network_modules	79	TRUE	4.0628296335175904e-4	195	37	7	0.1891891891891892	0.035897435897435895	GO:0050870	GO:BP	positive regulation of T cell activation	16175	13318		0.6055045871559633	0.6090909090909091	195	15980	7	30	188	15950	16175	0.07771689190502572
M1	string	0	network_modules	79	TRUE	4.346499375287203e-4	7	37	3	0.08108108108108109	0.42857142857142855	REAC:R-HSA-9027277	REAC	Erythropoietin activates Phospholipase C gamma (PLCG)	10916	858		0.6923076923076923	0.6981132075471698	7	10909	3	34	4	10875	10916	0.18531027597041086
M1	string	0	network_modules	79	TRUE	4.347121894810335e-4	119	37	6	0.16216216216216217	0.05042016806722689	GO:0070665	GO:BP	positive regulation of leukocyte proliferation	16175	16246		0.6146788990825688	0.6181818181818182	119	16056	6	31	113	16025	16175	0.08673881466432443
M1	string	0	network_modules	79	TRUE	4.695417254843731e-4	25	37	4	0.10810810810810811	0.16	REAC:R-HSA-201556	REAC	Signaling by ALK	10916	2217		0.7115384615384616	0.71698113207547165	25	10891	4	33	21	10858	10916	0.1290996671726824
M1	string	0	network_modules	79	TRUE	4.869938949276848e-4	63	37	5	0.13513513513513514	0.07936507936507936	GO:0042509	GO:BP	regulation of tyrosine phosphorylation of STAT protein	16175	10226		0.6238532110091743	0.6272727272727273	63	16112	5	32	58	16080	16175	0.10088864653526526
M1	string	0	network_modules	79	TRUE	5.290768648236118e-4	421	37	9	0.24324324324324326	0.021377672209026127	GO:0002694	GO:BP	regulation of leukocyte activation	16175	1212		0.6330275229357798	0.6363636363636364	421	15754	9	28	412	15726	16175	0.06532425789786252
M1	string	0	network_modules	79	TRUE	5.388606592238246e-4	26	37	4	0.10810810810810811	0.15384615384615385	GO:0046326	GO:BP	positive regulation of D-glucose import	16175	12059		0.6422018348623854	0.6454545454545455	26	16149	4	33	22	16116	16175	0.1272955503413058
M1	string	0	network_modules	79	TRUE	5.893927100206426e-4	206	37	7	0.1891891891891892	0.03398058252427184	GO:0030217	GO:BP	T cell differentiation	16175	6725		0.6513761467889908	0.6545454545454545	206	15969	7	30	199	15939	16175	0.0753490997243127
M1	string	0	network_modules	79	TRUE	6.180949515065011e-4	7	37	3	0.08108108108108109	0.42857142857142855	GO:0038156	GO:BP	interleukin-3-mediated signaling pathway	16175	9735		0.6605504587155964	0.6636363636363637	7	16168	3	34	4	16134	16175	0.18566858204039244
M1	string	0	network_modules	79	TRUE	6.832192360919056e-4	434	37	9	0.24324324324324326	0.020737327188940093	GO:0002521	GO:BP	leukocyte differentiation	16175	1043		0.6697247706422018	0.6727272727272727	434	15741	9	28	425	15713	16175	0.06412686878199896
M1	string	0	network_modules	79	TRUE	7.518478661069008e-4	263	37	8	0.21621621621621623	0.030418250950570342	REAC:R-HSA-913531	REAC	Interferon Signaling	10916	1227		0.7307692307692307	0.7358490566037735	263	10653	8	29	255	10624	10916	0.07306943395681978
M1	string	0	network_modules	79	TRUE	7.734868393667531e-4	264	37	8	0.21621621621621623	0.030303030303030304	REAC:R-HSA-5673001	REAC	RAF/MAP kinase cascade	10916	1841		0.75	0.7547169811320755	264	10652	8	29	256	10623	10916	0.07289956010460352
M1	string	0	network_modules	79	TRUE	7.868794710777948e-4	215	37	7	0.1891891891891892	0.03255813953488372	GO:1903039	GO:BP	positive regulation of leukocyte cell-cell adhesion	16175	22719		0.6788990825688074	0.6818181818181818	215	15960	7	30	208	15930	16175	0.07354332005753231
M1	string	0	network_modules	79	TRUE	8.925054777784163e-4	324	37	8	0.21621621621621623	0.024691358024691357	GO:0007159	GO:BP	leukocyte cell-cell adhesion	16175	2723		0.6880733944954128	0.6909090909090909	324	15851	8	29	316	15822	16175	0.06704801583455511
M1	string	0	network_modules	79	TRUE	9.551064617730205e-4	72	37	5	0.13513513513513514	0.06944444444444445	GO:0043367	GO:BP	CD4-positive, alpha-beta T cell differentiation	16175	10644		0.6972477064220184	0.7	72	16103	5	32	67	16071	16175	0.09399883617171836
M1	string	0	network_modules	79	TRUE	9.873928924554287e-4	8	37	3	0.08108108108108109	0.375	GO:0019694	GO:BP	alkanesulfonate metabolic process	16175	6011		0.7064220183486238	0.7181818181818181	8	16167	3	34	5	16133	16175	0.17354928425912225
M1	string	0	network_modules	79	TRUE	9.873928924554287e-4	8	37	3	0.08108108108108109	0.375	GO:0019530	GO:BP	taurine metabolic process	16175	5867		0.7064220183486238	0.7181818181818181	8	16167	3	34	5	16133	16175	0.17354928425912225
M1	string	0	network_modules	79	TRUE	0.00103829233932293	9	37	3	0.08108108108108109	0.3333333333333333	REAC:R-HSA-74749	REAC	Signal attenuation	10916	2214		0.7692307692307693	0.7735849056603774	9	10907	3	34	6	10873	10916	0.16307101119252662
M1	string	0	network_modules	79	TRUE	0.0010960093576746213	74	37	5	0.13513513513513514	0.06756756756756757	GO:0060337	GO:BP	type I interferon-mediated signaling pathway	16175	14549		0.7247706422018348	0.7272727272727273	74	16101	5	32	69	16069	16175	0.0926379061604858
M1	string	0	network_modules	79	TRUE	0.0011723584882735987	75	37	5	0.13513513513513514	0.06666666666666667	GO:0071357	GO:BP	cellular response to type I interferon	16175	16609		0.7339449541284404	0.7363636363636363	75	16100	5	32	70	16068	16175	0.09197753082244212
M1	string	0	network_modules	79	TRUE	0.0012403416305474364	37	36	4	0.1111111111111111	0.10810810810810811	KEGG:05340	KEGG	Primary immunodeficiency	8484	488		0.6842105263157895	0.7	37	8447	4	32	33	8415	8484	0.10575248281528978
M1	string	0	network_modules	79	TRUE	0.001283509897981542	32	37	4	0.10810810810810811	0.125	GO:0010828	GO:BP	positive regulation of D-glucose transmembrane transport	16175	4438		0.7431192660550459	0.7454545454545455	32	16143	4	33	28	16110	16175	0.11436425623465432
M1	string	0	network_modules	79	TRUE	0.001284027754689587	468	37	9	0.24324324324324326	0.019230769230769232	GO:0050865	GO:BP	regulation of cell activation	16175	13313		0.7522935779816514	0.7545454545454545	468	15707	9	28	459	15679	16175	0.06121989544046927
M1	string	0	network_modules	79	TRUE	0.001479810587909716	10	37	3	0.08108108108108109	0.3	REAC:R-HSA-9702518	REAC	STAT5 activation downstream of FLT3 ITD mutants	10916	2160		0.7884615384615384	0.7924528301886793	10	10906	3	34	7	10872	10916	0.1545332440460732
M1	string	0	network_modules	79	TRUE	0.0015731158814463637	148	37	6	0.16216216216216217	0.04054054054054054	GO:0120161	GO:BP	regulation of cold-induced thermogenesis	16175	19527		0.7614678899082569	0.7636363636363637	148	16027	6	31	142	15996	16175	0.07694660999383388
M1	string	0	network_modules	79	TRUE	0.001636419908173342	149	37	6	0.16216216216216217	0.040268456375838924	GO:0106106	GO:BP	cold-induced thermogenesis	16175	19254		0.7706422018348624	0.7727272727272727	149	16026	6	31	143	15995	16175	0.0766593714268992
M1	string	0	network_modules	79	TRUE	0.0017017952869923065	150	37	6	0.16216216216216217	0.04	GO:0051897	GO:BP	positive regulation of phosphatidylinositol 3-kinase/protein kinase B signal transduction	16175	13981		0.7798165137614679	0.7818181818181819	150	16025	6	31	144	15994	16175	0.07637491287794834
M1	string	0	network_modules	79	TRUE	0.0017232123032924886	81	37	5	0.13513513513513514	0.06172839506172839	GO:0034340	GO:BP	response to type I interferon	16175	8578		0.7889908256880734	0.7909090909090909	81	16094	5	32	76	16062	16175	0.08827029220566332
M1	string	0	network_modules	79	TRUE	0.001853461908268728	357	37	8	0.21621621621621623	0.022408963585434174	GO:1903131	GO:BP	mononuclear cell differentiation	16175	22787		0.7981651376146789	0.8	357	15818	8	29	349	15789	16175	0.0632756883299248
M1	string	0	network_modules	79	TRUE	0.002128980782751762	36	37	4	0.10810810810810811	0.1111111111111111	REAC:R-HSA-9607240	REAC	FLT3 Signaling	10916	917		0.8076923076923077	0.8113207547169812	36	10880	4	33	32	10847	10916	0.10661240464420736
M1	string	0	network_modules	79	TRUE	0.0021915845204438667	85	37	5	0.13513513513513514	0.058823529411764705	GO:0046632	GO:BP	alpha-beta T cell differentiation	16175	12269		0.8073394495412844	0.8090909090909091	85	16090	5	32	80	16058	16175	0.0860152518344568
M1	string	0	network_modules	79	TRUE	0.0022241537812542358	500	37	9	0.24324324324324326	0.018	GO:0001934	GO:BP	positive regulation of protein phosphorylation	16175	548		0.8165137614678899	0.8181818181818182	500	15675	9	28	491	15647	16175	0.05874158001204696
M1	string	0	network_modules	79	TRUE	0.0023381553993885207	37	37	4	0.10810810810810811	0.10810810810810811	GO:0046324	GO:BP	regulation of D-glucose import	16175	12057		0.8256880733944955	0.8363636363636363	37	16138	4	33	33	16105	16175	0.10606324505196732
M1	string	0	network_modules	79	TRUE	0.0023381553993885207	37	37	4	0.10810810810810811	0.10810810810810811	GO:0050732	GO:BP	negative regulation of peptidyl-tyrosine phosphorylation	16175	13231		0.8256880733944955	0.8363636363636363	37	16138	4	33	33	16105	16175	0.10606324505196732
M1	string	0	network_modules	79	TRUE	0.0025732093433202996	161	37	6	0.16216216216216217	0.037267080745341616	GO:1990845	GO:BP	adaptive thermogenesis	16175	25314		0.8440366972477065	0.8454545454545455	161	16014	6	31	155	15983	16175	0.07341696673265324
M1	string	0	network_modules	79	TRUE	0.0025737380623664084	373	37	8	0.21621621621621623	0.021447721179624665	GO:0045785	GO:BP	positive regulation of cell adhesion	16175	11617		0.8532110091743119	0.8545454545454545	373	15802	8	29	365	15773	16175	0.061619463815163186
M1	string	0	network_modules	79	TRUE	0.0026045360460270665	88	37	5	0.13513513513513514	0.056818181818181816	GO:0035710	GO:BP	CD4-positive, alpha-beta T cell activation	16175	9184		0.8623853211009175	0.8636363636363636	88	16087	5	32	83	16055	16175	0.08442352053341767
M1	string	0	network_modules	79	TRUE	0.002700330126680394	12	37	3	0.08108108108108109	0.25	REAC:R-HSA-9027284	REAC	Erythropoietin activates RAS	10916	859		0.8269230769230769	0.8490566037735849	12	10904	3	34	9	10870	10916	0.1407593999366883
M1	string	0	network_modules	79	TRUE	0.002700330126680394	12	37	3	0.08108108108108109	0.25	REAC:R-HSA-9027276	REAC	Erythropoietin activates Phosphoinositide-3-kinase (PI3K)	10916	857		0.8269230769230769	0.8490566037735849	12	10904	3	34	9	10870	10916	0.1407593999366883
M1	string	0	network_modules	79	TRUE	0.0029686676005153123	165	37	6	0.16216216216216217	0.03636363636363636	GO:0001659	GO:BP	temperature homeostasis	16175	373		0.8715596330275229	0.8727272727272727	165	16010	6	31	159	15979	16175	0.07241282182078844
M1	string	0	network_modules	79	TRUE	0.0031739429237486014	522	37	9	0.24324324324324326	0.017241379310344827	GO:0042327	GO:BP	positive regulation of phosphorylation	16175	10095		0.8807339449541285	0.8818181818181818	522	15653	9	28	513	15625	16175	0.05716226947217289
M1	string	0	network_modules	79	TRUE	0.0035022326324226846	13	37	3	0.08108108108108109	0.23076923076923078	REAC:R-HSA-1433559	REAC	Regulation of KIT signaling	10916	1982		0.8653846153846154	0.8679245283018868	13	10903	3	34	10	10869	10916	0.13508855508585005
M1	string	0	network_modules	79	TRUE	0.004003110295110814	98	36	5	0.1388888888888889	0.05102040816326531	KEGG:04061	KEGG	Viral protein interaction with cytokine and cytokine receptor	8484	254		0.7368421052631579	0.75	98	8386	5	31	93	8355	8484	0.0777931947679805
M1	string	0	network_modules	79	TRUE	0.004385435927748183	43	37	4	0.10810810810810811	0.09302325581395349	REAC:R-HSA-2428928	REAC	IRS-related events triggered by IGF1R	10916	1165		0.8846153846153846	0.9056603773584906	43	10873	4	33	39	10840	10916	0.09698380258185806
M1	string	0	network_modules	79	TRUE	0.004385435927748183	43	37	4	0.10810810810810811	0.09302325581395349	REAC:R-HSA-2428924	REAC	IGF1R signaling cascade	10916	1142		0.8846153846153846	0.9056603773584906	43	10873	4	33	39	10840	10916	0.09698380258185806
M1	string	0	network_modules	79	TRUE	0.004812320555547217	44	37	4	0.10810810810810811	0.09090909090909091	REAC:R-HSA-2404192	REAC	Signaling by Type 1 Insulin-like Growth Factor 1 Receptor (IGF1R)	10916	2312		0.9230769230769231	0.9245283018867925	44	10872	4	33	40	10839	10916	0.09579547006840564
M1	string	0	network_modules	79	TRUE	0.0051452858356177775	248	36	7	0.19444444444444445	0.028225806451612902	KEGG:04144	KEGG	Endocytosis	8484	280		0.7894736842105263	0.8	248	8236	7	29	241	8207	8484	0.06402285454117912
M1	string	0	network_modules	79	TRUE	0.005206333716058509	45	37	4	0.10810810810810811	0.08888888888888889	GO:0046626	GO:BP	regulation of insulin receptor signaling pathway	16175	12263		0.8899082568807339	0.9	45	16130	4	33	41	16097	16175	0.09574863668440194
M1	string	0	network_modules	79	TRUE	0.005206333716058509	45	37	4	0.10810810810810811	0.08888888888888889	GO:1900076	GO:BP	regulation of cellular response to insulin stimulus	16175	20373		0.8899082568807339	0.9	45	16130	4	33	41	16097	16175	0.09574863668440194
M1	string	0	network_modules	79	TRUE	0.005269050102809853	45	37	4	0.10810810810810811	0.08888888888888889	REAC:R-HSA-74751	REAC	Insulin receptor signalling cascade	10916	1211		0.9423076923076923	0.9433962264150944	45	10871	4	33	41	10838	10916	0.09464607203696186
M1	string	0	network_modules	79	TRUE	0.005545748404305549	15	37	3	0.08108108108108109	0.2	REAC:R-HSA-9703648	REAC	Signaling by FLT3 ITD and TKD mutants	10916	2254		0.9615384615384616	0.9622641509433962	15	10901	3	34	12	10867	10916	0.12548369539109486
M1	string	0	network_modules	79	TRUE	0.005954565469640811	104	37	5	0.13513513513513514	0.04807692307692308	GO:0050671	GO:BP	positive regulation of lymphocyte proliferation	16175	13205		0.908256880733945	0.9090909090909091	104	16071	5	32	99	16039	16175	0.07710439712023653
M1	string	0	network_modules	79	TRUE	0.005987858528762102	564	37	9	0.24324324324324326	0.015957446808510637	GO:0045937	GO:BP	positive regulation of phosphate metabolic process	16175	11731		0.9174311926605505	0.9272727272727272	564	15611	9	28	555	15583	16175	0.05438889059724716
M1	string	0	network_modules	79	TRUE	0.005987858528762102	564	37	9	0.24324324324324326	0.015957446808510637	GO:0010562	GO:BP	positive regulation of phosphorus metabolic process	16175	4215		0.9174311926605505	0.9272727272727272	564	15611	9	28	555	15583	16175	0.05438889059724716
M1	string	0	network_modules	79	TRUE	0.006241978063419067	105	37	5	0.13513513513513514	0.047619047619047616	GO:0032946	GO:BP	positive regulation of mononuclear cell proliferation	16175	7931		0.9357798165137615	0.9363636363636364	105	16070	5	32	100	16038	16175	0.0767018809302708
M1	string	0	network_modules	79	TRUE	0.006357598075721754	14	37	3	0.08108108108108109	0.21428571428571427	GO:0045725	GO:BP	positive regulation of glycogen biosynthetic process	16175	11567		0.944954128440367	0.9454545454545454	14	16161	3	34	11	16127	16175	0.13061128938503644
M1	string	0	network_modules	79	TRUE	0.0063730660784705314	108	36	5	0.1388888888888889	0.046296296296296294	KEGG:05145	KEGG	Toxoplasmosis	8484	437		0.8421052631578947	0.9	108	8376	5	31	103	8345	8484	0.0734620657558148
M1	string	0	network_modules	79	TRUE	0.0063730660784705314	108	36	5	0.1388888888888889	0.046296296296296294	KEGG:04931	KEGG	Insulin resistance	8484	388		0.8421052631578947	0.9	108	8376	5	31	103	8345	8484	0.0734620657558148
M1	string	0	network_modules	79	TRUE	0.006723122200880079	190	37	6	0.16216216216216217	0.031578947368421054	GO:0070663	GO:BP	regulation of leukocyte proliferation	16175	16244		0.9541284403669725	0.9545454545454546	190	15985	6	31	184	15954	16175	0.06684673044161496
M1	string	0	network_modules	79	TRUE	0.006788669043819541	297	37	7	0.1891891891891892	0.02356902356902357	GO:0030098	GO:BP	lymphocyte differentiation	16175	6676		0.963302752293578	0.9636363636363636	297	15878	7	30	290	15848	16175	0.06092590770494091
M1	string	0	network_modules	79	TRUE	0.007355391956076502	49	37	4	0.10810810810810811	0.08163265306122448	GO:0010827	GO:BP	regulation of D-glucose transmembrane transport	16175	4437		0.9724770642201835	0.9727272727272728	49	16126	4	33	45	16093	16175	0.09155325555023278
M1	string	0	network_modules	79	TRUE	0.007934474510536641	15	37	3	0.08108108108108109	0.2	GO:0070875	GO:BP	positive regulation of glycogen metabolic process	16175	16351		0.981651376146789	0.9818181818181818	15	16160	3	34	12	16126	16175	0.12608914305468685
M1	string	0	network_modules	79	TRUE	0.007981949253355576	50	37	4	0.10810810810810811	0.08	GO:0046323	GO:BP	D-glucose import	16175	12056		0.9908256880733946	0.990909090909091	50	16125	4	33	46	16092	16175	0.09058258299799783
M1	string	0	network_modules	79	TRUE	0.008249503877492341	17	37	3	0.08108108108108109	0.17647058823529413	REAC:R-HSA-9670439	REAC	Signaling by phosphorylated juxtamembrane, extracellular and kinase domain KIT mutants	10916	2326		0.9807692307692307	1	17	10899	3	34	14	10865	10916	0.11761125331052884
M1	string	0	network_modules	79	TRUE	0.008249503877492341	17	37	3	0.08108108108108109	0.17647058823529413	REAC:R-HSA-9669938	REAC	Signaling by KIT in disease	10916	2262		0.9807692307692307	1	17	10899	3	34	14	10865	10916	0.11761125331052884
M1	string	0	network_modules	79	TRUE	0.009115511344941627	61	36	4	0.1111111111111111	0.06557377049180328	KEGG:04213	KEGG	Longevity regulating pathway - multiple species	8484	290		0.9473684210526315	0.95	61	8423	4	32	57	8391	8484	0.08029350227965755
M1	string	0	network_modules	79	TRUE	0.009702319650643356	118	36	5	0.1388888888888889	0.0423728813559322	KEGG:04722	KEGG	Neurotrophin signaling pathway	8484	352		1	1	118	8366	5	31	113	8335	8484	0.06966534278878177
M1	string	0	network_modules	79	TRUE	0.009750119221205791	16	37	3	0.08108108108108109	0.1875	GO:0034112	GO:BP	positive regulation of homotypic cell-cell adhesion	16175	8420		1	1	16	16159	3	34	13	16125	16175	0.12199489618678971
M1	string	0	network_modules	80	TRUE	1.281705481068751e-7	105	37	8	0.21621621621621623	0.0761904761904762	GO:0006470	GO:BP	protein dephosphorylation	16175	2209		0	0.07142857142857142	105	16070	8	29	97	16041	16175	0.1250452862055194
M1	string	0	network_modules	80	TRUE	2.427942137097482e-7	174	37	9	0.24324324324324326	0.05172413793103448	GO:0016311	GO:BP	dephosphorylation	16175	5199		0.07692307692307693	0.14285714285714285	174	16001	9	28	165	15973	16175	0.10791174881074893
M1	string	0	network_modules	80	TRUE	4.150363309428743e-5	39	37	5	0.13513513513513514	0.1282051282051282	GO:0035337	GO:BP	fatty-acyl-CoA metabolic process	16175	8981		0.15384615384615385	0.21428571428571427	39	16136	5	32	34	16104	16175	0.12958046496828687
M1	string	0	network_modules	80	TRUE	1.3520776275592722e-4	49	37	5	0.13513513513513514	0.10204081632653061	GO:1901570	GO:BP	fatty acid derivative biosynthetic process	16175	21572		0.23076923076923078	0.2857142857142857	49	16126	5	32	44	16094	16175	0.11510142780403745
M1	string	0	network_modules	80	TRUE	1.5040138345034023e-4	7	27	3	0.1111111111111111	0.42857142857142855	REAC:R-HSA-9652817	REAC	Signaling by MAPK mutants	10916	2269		0	0.25	7	10909	3	24	4	10885	10916	0.2172969776674941
M1	string	0	network_modules	80	TRUE	3.842587610768093e-4	24	37	4	0.10810810810810811	0.16666666666666666	GO:0035336	GO:BP	long-chain fatty-acyl-CoA metabolic process	16175	8980		0.3076923076923077	0.35714285714285715	24	16151	4	33	20	16118	16175	0.13263902154438909
M1	string	0	network_modules	80	TRUE	5.388606592238246e-4	26	37	4	0.10810810810810811	0.15384615384615385	GO:0046949	GO:BP	fatty-acyl-CoA biosynthetic process	16175	12443		0.38461538461538464	0.42857142857142855	26	16149	4	33	22	16116	16175	0.1272955503413058
M1	string	0	network_modules	80	TRUE	6.63041986244914e-4	38	27	4	0.14814814814814814	0.10526315789473684	REAC:R-HSA-75105	REAC	Fatty acyl-CoA biosynthesis	10916	937		0.3333333333333333	0.5	38	10878	4	23	34	10855	10916	0.12230793076194232
M1	string	0	network_modules	80	TRUE	8.902482605410346e-4	71	37	5	0.13513513513513514	0.07042253521126761	GO:1901568	GO:BP	fatty acid derivative metabolic process	16175	21570		0.46153846153846156	0.5	71	16104	5	32	66	16072	16175	0.0947003257736385
M1	string	0	network_modules	80	TRUE	0.0014581624715679878	33	37	4	0.10810810810810811	0.12121212121212122	GO:0000038	GO:BP	very long-chain fatty acid metabolic process	16175	15		0.5384615384615384	0.5714285714285714	33	16142	4	33	29	16109	16175	0.11255601730341576
M1	string	0	network_modules	80	TRUE	0.0026045360460270665	88	37	5	0.13513513513513514	0.056818181818181816	GO:0006637	GO:BP	acyl-CoA metabolic process	16175	2348		0.6153846153846154	0.7142857142857143	88	16087	5	32	83	16055	16175	0.08442352053341767
M1	string	0	network_modules	80	TRUE	0.0026045360460270665	88	37	5	0.13513513513513514	0.056818181818181816	GO:0035383	GO:BP	thioester metabolic process	16175	9012		0.6153846153846154	0.7142857142857143	88	16087	5	32	83	16055	16175	0.08442352053341767
M1	string	0	network_modules	80	TRUE	0.00270591857631464	512	37	9	0.24324324324324326	0.017578125	GO:0090407	GO:BP	organophosphate biosynthetic process	16175	18274		0.7692307692307693	0.7857142857142857	512	15663	9	28	503	15635	16175	0.05786845192571059
M1	string	0	network_modules	80	TRUE	0.0034099755947672055	27	24	3	0.125	0.1111111111111111	KEGG:01040	KEGG	Biosynthesis of unsaturated fatty acids	8484	164		0	1	27	8457	3	21	24	8436	8484	0.1151969214159152
M1	string	0	network_modules	80	TRUE	0.0034099755947672055	27	24	3	0.125	0.1111111111111111	KEGG:00062	KEGG	Fatty acid elongation	8484	10		0	1	27	8457	3	21	24	8436	8484	0.1151969214159152
M1	string	0	network_modules	80	TRUE	0.0039303763300128115	42	37	4	0.10810810810810811	0.09523809523809523	GO:0071616	GO:BP	acyl-CoA biosynthetic process	16175	16800		0.8461538461538461	0.9285714285714286	42	16133	4	33	38	16100	16175	0.09927454735520347
M1	string	0	network_modules	80	TRUE	0.0039303763300128115	42	37	4	0.10810810810810811	0.09523809523809523	GO:0035384	GO:BP	thioester biosynthetic process	16175	9013		0.8461538461538461	0.9285714285714286	42	16133	4	33	38	16100	16175	0.09927454735520347
M1	string	0	network_modules	80	TRUE	0.006357598075721754	14	37	3	0.08108108108108109	0.21428571428571427	GO:0030497	GO:BP	fatty acid elongation	16175	6820		1	1	14	16161	3	34	11	16127	16175	0.13061128938503644
M1	string	0	network_modules	80	TRUE	0.006455874978624031	22	27	3	0.1111111111111111	0.13636363636363635	REAC:R-HSA-112409	REAC	RAF-independent MAPK1/3 activation	10916	1840		0.6666666666666666	0.75	22	10894	3	24	19	10870	10916	0.12113066474511494
M1	string	0	network_modules	80	TRUE	0.008456917761153215	24	27	3	0.1111111111111111	0.125	REAC:R-HSA-75876	REAC	Synthesis of very long-chain fatty acyl-CoAs	10916	2412		1	1	24	10892	3	24	21	10868	10916	0.11578964281504067
M1	string	0	network_modules	81	TRUE	5.5262847254101885e-58	66	34	27	0.7941176470588235	0.4090909090909091	GO:0060260	GO:BP	regulation of transcription initiation by RNA polymerase II	16175	14477		0	0.0625	66	16109	27	7	39	16102	16175	0.5688003481592778
M1	string	0	network_modules	81	TRUE	1.624727116038148e-57	55	34	26	0.7647058823529411	0.4727272727272727	GO:0060261	GO:BP	positive regulation of transcription initiation by RNA polymerase II	16175	14478		0.06666666666666667	0.125	55	16120	26	8	29	16112	16175	0.6002244395032373
M1	string	0	network_modules	81	TRUE	1.0573919929521546e-56	72	34	27	0.7941176470588235	0.375	GO:2000142	GO:BP	regulation of DNA-templated transcription initiation	16175	25490		0.13333333333333333	0.1875	72	16103	27	7	45	16096	16175	0.5444305750862733
M1	string	0	network_modules	81	TRUE	5.541979397475949e-56	61	34	26	0.7647058823529411	0.4262295081967213	GO:2000144	GO:BP	positive regulation of DNA-templated transcription initiation	16175	25492		0.2	0.25	61	16114	26	8	35	16106	16175	0.5697696099948878
M1	string	0	network_modules	81	TRUE	7.391451353026307e-56	83	35	29	0.8285714285714286	0.3493975903614458	REAC:R-HSA-381340	REAC	Transcriptional regulation of white adipocyte differentiation	10916	2562		0	0.5	83	10833	29	6	54	10827	10916	0.5360137227607473
M1	string	0	network_modules	81	TRUE	7.391451353026307e-56	83	35	29	0.8285714285714286	0.3493975903614458	REAC:R-HSA-9843745	REAC	Adipogenesis	10916	122		0	0.5	83	10833	29	6	54	10827	10916	0.5360137227607473
M1	string	0	network_modules	81	TRUE	4.2628254443810265e-53	48	34	24	0.7058823529411765	0.5	GO:0032968	GO:BP	positive regulation of transcription elongation by RNA polymerase II	16175	7952		0.26666666666666666	0.3125	48	16127	24	10	24	16117	16175	0.5930943836288702
M1	string	0	network_modules	81	TRUE	3.2606171489887125e-52	64	34	25	0.7352941176470589	0.390625	GO:0051123	GO:BP	RNA polymerase II preinitiation complex assembly	16175	13507		0.3333333333333333	0.375	64	16111	25	9	39	16102	16175	0.5346690847535287
M1	string	0	network_modules	81	TRUE	1.358434774738903e-51	67	34	25	0.7352941176470589	0.373134328358209	GO:0070897	GO:BP	transcription preinitiation complex assembly	16175	16360		0.4	0.4375	67	16108	25	9	42	16099	16175	0.5224779223826587
M1	string	0	network_modules	81	TRUE	2.864910190206035e-51	113	35	29	0.8285714285714286	0.25663716814159293	REAC:R-HSA-1989781	REAC	PPARA activates gene expression	10916	1700		0.6666666666666666	0.75	113	10803	29	6	84	10797	10916	0.4584813139348624
M1	string	0	network_modules	81	TRUE	3.8402878478829767e-51	114	35	29	0.8285714285714286	0.2543859649122807	REAC:R-HSA-400206	REAC	Regulation of lipid metabolism by PPARalpha	10916	2041		1	1	114	10802	29	6	85	10796	10916	0.4564360212516234
M1	string	0	network_modules	81	TRUE	9.890643855334609e-51	57	34	24	0.7058823529411765	0.42105263157894735	GO:0032786	GO:BP	positive regulation of DNA-templated transcription, elongation	16175	7821		0.4666666666666667	0.5	57	16118	24	10	33	16108	16175	0.5439817176882935
M1	string	0	network_modules	81	TRUE	2.2774787250874493e-47	143	34	27	0.7941176470588235	0.1888111888111888	GO:0006367	GO:BP	transcription initiation at RNA polymerase II promoter	16175	2142		0.5333333333333333	0.5625	143	16032	27	7	116	16025	16175	0.38501659529284676
M1	string	0	network_modules	81	TRUE	2.9882875732170143e-46	81	34	24	0.7058823529411765	0.2962962962962963	GO:0034243	GO:BP	regulation of transcription elongation by RNA polymerase II	16175	8519		0.6	0.625	81	16094	24	10	57	16084	16175	0.45570559201149946
M1	string	0	network_modules	81	TRUE	4.4885950807686406e-46	103	34	25	0.7352941176470589	0.24271844660194175	GO:0006368	GO:BP	transcription elongation by RNA polymerase II	16175	2143		0.6666666666666666	0.6875	103	16072	25	9	78	16063	16175	0.4205799399837819
M1	string	0	network_modules	81	TRUE	6.221923646323849e-45	173	34	27	0.7941176470588235	0.15606936416184972	GO:0006352	GO:BP	DNA-templated transcription initiation	16175	2129		0.7333333333333333	0.75	173	16002	27	7	146	15995	16175	0.34954587339705856
M1	string	0	network_modules	81	TRUE	2.061897847242065e-44	118	34	25	0.7352941176470589	0.211864406779661	GO:0006354	GO:BP	DNA-templated transcription elongation	16175	2131		0.8	0.8125	118	16057	25	9	93	16048	16175	0.39262328304751537
M1	string	0	network_modules	81	TRUE	3.3530511034848786e-44	96	34	24	0.7058823529411765	0.25	GO:0032784	GO:BP	regulation of DNA-templated transcription elongation	16175	7819		0.8666666666666667	0.875	96	16079	24	10	72	16069	16175	0.41823340500559764
M1	string	0	network_modules	81	TRUE	3.212478797934985e-39	183	34	25	0.7352941176470589	0.1366120218579235	GO:0065004	GO:BP	protein-DNA complex assembly	16175	15888		0.9333333333333333	0.9375	183	15992	25	9	158	15983	16175	0.31417265320987947
M1	string	0	network_modules	81	TRUE	7.477091086497311e-38	206	34	25	0.7352941176470589	0.12135922330097088	GO:0071824	GO:BP	protein-DNA complex organization	16175	16927		1	1	206	15969	25	9	181	15960	16175	0.29574609663374746
M1	string	0	network_modules	81	TRUE	1.2966453346569286e-17	121	13	11	0.8461538461538461	0.09090909090909091	KEGG:04919	KEGG	Thyroid hormone signaling pathway	8484	376		NA	1	121	8363	11	2	110	8361	8484	0.2748514647564486
M1	string	0	network_modules	82	TRUE	1.999236132869847e-15	18	28	8	0.2857142857142857	0.4444444444444444	GO:0048490	GO:BP	anterograde synaptic vesicle transport	16175	12783		0	0.075	18	16157	8	20	10	16137	16175	0.35546585240331124
M1	string	0	network_modules	82	TRUE	1.999236132869847e-15	18	28	8	0.2857142857142857	0.4444444444444444	GO:0099517	GO:BP	synaptic vesicle transport along microtubule	16175	19106		0	0.075	18	16157	8	20	10	16137	16175	0.35546585240331124
M1	string	0	network_modules	82	TRUE	1.999236132869847e-15	18	28	8	0.2857142857142857	0.4444444444444444	GO:0099514	GO:BP	synaptic vesicle cytoskeletal transport	16175	19104		0	0.075	18	16157	8	20	10	16137	16175	0.35546585240331124
M1	string	0	network_modules	82	TRUE	2.897513281391893e-13	54	28	9	0.32142857142857145	0.16666666666666666	GO:0098930	GO:BP	axonal transport	16175	18959		0.07692307692307693	0.1	54	16121	9	19	45	16102	16175	0.22963318376985423
M1	string	0	network_modules	82	TRUE	6.239554617857865e-13	33	28	8	0.2857142857142857	0.24242424242424243	GO:0048489	GO:BP	synaptic vesicle transport	16175	12782		0.10256410256410256	0.125	33	16142	8	20	25	16122	16175	0.26179504777210555
M1	string	0	network_modules	82	TRUE	9.378883069218334e-13	61	28	9	0.32142857142857145	0.14754098360655737	GO:0008088	GO:BP	axo-dendritic transport	16175	3119		0.1282051282051282	0.15	61	16114	9	19	52	16095	16175	0.21580904955340077
M1	string	0	network_modules	82	TRUE	2.746670858114469e-12	39	28	8	0.2857142857142857	0.20512820512820512	GO:0048753	GO:BP	pigment granule organization	16175	13004		0.15384615384615385	0.2	39	16136	8	20	31	16116	16175	0.24054622795164227
M1	string	0	network_modules	82	TRUE	2.746670858114469e-12	39	28	8	0.2857142857142857	0.20512820512820512	GO:0032438	GO:BP	melanosome organization	16175	7566		0.15384615384615385	0.2	39	16136	8	20	31	16116	16175	0.24054622795164227
M1	string	0	network_modules	82	TRUE	3.429558254139106e-12	40	28	8	0.2857142857142857	0.2	GO:0097479	GO:BP	synaptic vesicle localization	16175	18670		0.20512820512820512	0.225	40	16135	8	20	32	16115	16175	0.2374758946138409
M1	string	0	network_modules	82	TRUE	5.184019907782154e-12	73	28	9	0.32142857142857145	0.1232876712328767	GO:0072384	GO:BP	organelle transport along microtubule	16175	17378		0.23076923076923078	0.25	73	16102	9	19	64	16083	16175	0.19688808328942078
M1	string	0	network_modules	82	TRUE	5.251961297962967e-12	42	28	8	0.2857142857142857	0.19047619047619047	GO:0008089	GO:BP	anterograde axonal transport	16175	3120		0.2564102564102564	0.3	42	16133	8	20	34	16113	16175	0.23166593078287517
M1	string	0	network_modules	82	TRUE	5.251961297962967e-12	42	28	8	0.2857142857142857	0.19047619047619047	GO:0047496	GO:BP	vesicle transport along microtubule	16175	12458		0.2564102564102564	0.3	42	16133	8	20	34	16113	16175	0.23166593078287517
M1	string	0	network_modules	82	TRUE	8.380039751335065e-11	58	28	8	0.2857142857142857	0.13793103448275862	GO:0033059	GO:BP	cellular pigmentation	16175	8013		0.3076923076923077	0.325	58	16117	8	20	50	16097	16175	0.19654782870728604
M1	string	0	network_modules	82	TRUE	2.8233490574169525e-10	67	28	8	0.2857142857142857	0.11940298507462686	GO:0099518	GO:BP	vesicle cytoskeletal trafficking	16175	19107		0.3333333333333333	0.35	67	16108	8	20	59	16088	16175	0.18256132389696805
M1	string	0	network_modules	82	TRUE	1.3709614061763995e-9	81	28	8	0.2857142857142857	0.09876543209876543	GO:0043473	GO:BP	pigmentation	16175	10719		0.358974358974359	0.375	81	16094	8	20	73	16074	16175	0.16559813180435173
M1	string	0	network_modules	82	TRUE	2.814952765193317e-9	144	28	9	0.32142857142857145	0.0625	GO:0010970	GO:BP	transport along microtubule	16175	4546		0.38461538461538464	0.4	144	16031	9	19	135	16012	16175	0.1385485244280295
M1	string	0	network_modules	82	TRUE	9.687188450880025e-9	165	28	9	0.32142857142857145	0.05454545454545454	GO:0099111	GO:BP	microtubule-based transport	16175	19044		0.41025641025641024	0.425	165	16010	9	19	156	15991	16175	0.12897867453237402
M1	string	0	network_modules	82	TRUE	1.0083844687182527e-8	54	14	6	0.42857142857142855	0.1111111111111111	REAC:R-HSA-432722	REAC	Golgi Associated Vesicle Biogenesis	10916	1082		0	0.5	54	10862	6	8	48	10854	10916	0.2163733700027895
M1	string	0	network_modules	82	TRUE	2.720914905160395e-8	185	28	9	0.32142857142857145	0.04864864864864865	GO:0030705	GO:BP	cytoskeleton-dependent intracellular transport	16175	6886		0.4358974358974359	0.45	185	15990	9	19	176	15971	16175	0.1213994185899942
M1	string	0	network_modules	82	TRUE	6.031218385655525e-8	72	14	6	0.42857142857142855	0.08333333333333333	REAC:R-HSA-199992	REAC	trans-Golgi Network Vesicle Budding	10916	2749		1	1	72	10844	6	8	66	10836	10916	0.1868102917892386
M1	string	0	network_modules	82	TRUE	8.158510088470813e-7	178	28	8	0.2857142857142857	0.0449438202247191	GO:0051650	GO:BP	establishment of vesicle localization	16175	13863		0.46153846153846156	0.475	178	15997	8	20	170	15977	16175	0.10965337990402449
M1	string	0	network_modules	82	TRUE	1.1575123755151225e-6	186	28	8	0.2857142857142857	0.043010752688172046	GO:0051648	GO:BP	vesicle localization	16175	13861		0.48717948717948717	0.5	186	15989	8	20	178	15969	16175	0.10710298116135168
M1	string	0	network_modules	82	TRUE	7.398120288159613e-6	348	28	9	0.32142857142857145	0.02586206896551724	GO:0007018	GO:BP	microtubule-based movement	16175	2626		0.5128205128205128	0.525	348	15827	9	19	339	15808	16175	0.08607658660140355
M1	string	0	network_modules	82	TRUE	3.075258524914592e-5	410	28	9	0.32142857142857145	0.02195121951219512	GO:0051656	GO:BP	establishment of organelle localization	16175	13869		0.5384615384615384	0.55	410	15765	9	19	401	15746	16175	0.07844201305145168
M1	string	0	network_modules	82	TRUE	7.227743312959069e-5	315	28	8	0.2857142857142857	0.025396825396825397	GO:0016050	GO:BP	vesicle organization	16175	5082		0.5641025641025641	0.575	315	15860	8	20	307	15840	16175	0.08023123416546461
M1	string	0	network_modules	82	TRUE	1.284818447019468e-4	24	28	4	0.14285714285714285	0.16666666666666666	GO:0060155	GO:BP	platelet dense granule organization	16175	14393		0.5897435897435898	0.6	24	16151	4	24	20	16127	16175	0.1529465441689966
M1	string	0	network_modules	82	TRUE	2.3243310161611587e-4	519	28	9	0.32142857142857145	0.017341040462427744	GO:0051640	GO:BP	organelle localization	16175	13853		0.6153846153846154	0.625	519	15656	9	19	510	15637	16175	0.06836987775488111
M1	string	0	network_modules	82	TRUE	4.4594768412236935e-4	8	28	3	0.10714285714285714	0.375	GO:0062196	GO:BP	regulation of lysosome size	16175	15860		0.6410256410256411	0.65	8	16167	3	25	5	16142	16175	0.19974295534656084
M1	string	0	network_modules	82	TRUE	6.681460795650107e-4	9	28	3	0.10714285714285714	0.3333333333333333	GO:0048757	GO:BP	pigment granule maturation	16175	13008		0.6666666666666666	0.725	9	16166	3	25	6	16141	16175	0.18821611693635254
M1	string	0	network_modules	82	TRUE	6.681460795650107e-4	9	28	3	0.10714285714285714	0.3333333333333333	GO:0043485	GO:BP	endosome to pigment granule transport	16175	10731		0.6666666666666666	0.725	9	16166	3	25	6	16141	16175	0.18821611693635254
M1	string	0	network_modules	82	TRUE	6.681460795650107e-4	9	28	3	0.10714285714285714	0.3333333333333333	GO:0035646	GO:BP	endosome to melanosome transport	16175	9136		0.6666666666666666	0.725	9	16166	3	25	6	16141	16175	0.18821611693635254
M1	string	0	network_modules	82	TRUE	9.533879337877791e-4	10	28	3	0.10714285714285714	0.3	GO:0051036	GO:BP	regulation of endosome size	16175	13449		0.7435897435897436	0.75	10	16165	3	25	7	16140	16175	0.1784594367560398
M1	string	0	network_modules	82	TRUE	0.0013093888251545815	11	28	3	0.10714285714285714	0.2727272727272727	GO:0043476	GO:BP	pigment accumulation	16175	10722		0.7692307692307693	0.8	11	16164	3	25	8	16139	16175	0.17006090420272324
M1	string	0	network_modules	82	TRUE	0.0013093888251545815	11	28	3	0.10714285714285714	0.2727272727272727	GO:0043482	GO:BP	cellular pigment accumulation	16175	10728		0.7692307692307693	0.8	11	16164	3	25	8	16139	16175	0.17006090420272324
M1	string	0	network_modules	82	TRUE	0.0023699259339997514	684	28	9	0.32142857142857145	0.013157894736842105	GO:0031175	GO:BP	neuron projection development	16175	7086		0.8205128205128205	0.825	684	15491	9	19	675	15472	16175	0.05776082341347382
M1	string	0	network_modules	82	TRUE	0.00316630651166928	52	28	4	0.14285714285714285	0.07692307692307693	GO:0033363	GO:BP	secretory granule organization	16175	8173		0.8461538461538461	0.85	52	16123	4	24	48	16099	16175	0.1027234963575564
M1	string	0	network_modules	82	TRUE	0.004418291146288086	16	28	3	0.10714285714285714	0.1875	GO:0097494	GO:BP	regulation of vesicle size	16175	18677		0.8717948717948718	0.875	16	16159	3	25	13	16134	16175	0.14061938357001555
M1	string	0	network_modules	82	TRUE	0.005721003630456214	761	28	9	0.32142857142857145	0.011826544021024968	GO:0048666	GO:BP	neuron development	16175	12924		0.8974358974358975	0.9	761	15414	9	19	752	15395	16175	0.053961109404164244
M1	string	0	network_modules	82	TRUE	0.006423166935591639	18	28	3	0.10714285714285714	0.16666666666666666	GO:0051904	GO:BP	pigment granule transport	16175	13987		0.9230769230769231	0.95	18	16157	3	25	15	16132	16175	0.13243099629359648
M1	string	0	network_modules	82	TRUE	0.006423166935591639	18	28	3	0.10714285714285714	0.16666666666666666	GO:0032402	GO:BP	melanosome transport	16175	7546		0.9230769230769231	0.95	18	16157	3	25	15	16132	16175	0.13243099629359648
M1	string	0	network_modules	82	TRUE	0.00761867105046191	19	28	3	0.10714285714285714	0.15789473684210525	GO:0032401	GO:BP	establishment of melanosome localization	16175	7545		0.9743589743589743	1	19	16156	3	25	16	16131	16175	0.1288276952064913
M1	string	0	network_modules	82	TRUE	0.00761867105046191	19	28	3	0.10714285714285714	0.15789473684210525	GO:0051905	GO:BP	establishment of pigment granule localization	16175	13988		0.9743589743589743	1	19	16156	3	25	16	16131	16175	0.1288276952064913
M1	string	0	network_modules	83	TRUE	8.988207883868644e-15	250	31	14	0.45161290322580644	0.056	GO:0007389	GO:BP	pattern specification process	16175	2889		0	0.1	250	15925	14	17	236	15908	16175	0.1549361060585301
M1	string	0	network_modules	83	TRUE	1.0596712140040375e-8	225	31	10	0.3225806451612903	0.044444444444444446	GO:0003002	GO:BP	regionalization	16175	1453		0.1111111111111111	0.2	225	15950	10	21	215	15929	16175	0.1154895764405781
M1	string	0	network_modules	83	TRUE	2.034046944429465e-7	120	11	6	0.5454545454545454	0.05	REAC:R-HSA-5617472	REAC	Activation of anterior HOX genes in hindbrain development during early embryogenesis	10916	99		0	1	120	10796	6	5	114	10791	10916	0.16279512897420467
M1	string	0	network_modules	83	TRUE	2.034046944429465e-7	120	11	6	0.5454545454545454	0.05	REAC:R-HSA-5619507	REAC	Activation of HOX genes during differentiation	10916	84		0	1	120	10796	6	5	114	10791	10916	0.16279512897420467
M1	string	0	network_modules	83	TRUE	2.2692928269626267e-7	192	13	7	0.5384615384615384	0.036458333333333336	KEGG:05202	KEGG	Transcriptional misregulation in cancer	8484	454		NA	1	192	8292	7	6	185	8286	8484	0.13587261167717415
M1	string	0	network_modules	83	TRUE	8.40301029468491e-7	99	31	7	0.22580645161290322	0.0707070707070707	GO:0009952	GO:BP	anterior/posterior pattern specification	16175	3790		0.2222222222222222	0.3	99	16076	7	24	92	16052	16175	0.12342841155966233
M1	string	0	network_modules	83	TRUE	1.903730499804559e-6	512	31	11	0.3548387096774194	0.021484375	GO:0009790	GO:BP	embryo development	16175	3677		0.3333333333333333	0.4	512	15663	11	20	501	15643	16175	0.08089062658097314
M1	string	0	network_modules	83	TRUE	3.527453441448058e-6	543	31	11	0.3548387096774194	0.020257826887661142	GO:0009887	GO:BP	animal organ morphogenesis	16175	3747		0.4444444444444444	0.5	543	15632	11	20	532	15612	16175	0.07815924653615007
M1	string	0	network_modules	83	TRUE	1.6291580974374444e-4	211	31	7	0.22580645161290322	0.03317535545023697	GO:0048568	GO:BP	embryonic organ development	16175	12840		0.5555555555555556	0.6	211	15964	7	24	204	15940	16175	0.08216763407903044
M1	string	0	network_modules	83	TRUE	3.049822781913359e-4	71	31	5	0.16129032258064516	0.07042253521126761	GO:0045638	GO:BP	negative regulation of myeloid cell differentiation	16175	11489		0.6666666666666666	0.7	71	16104	5	26	66	16078	16175	0.10400369159282653
M1	string	0	network_modules	83	TRUE	0.002545018863335963	199	31	6	0.1935483870967742	0.03015075376884422	GO:0001654	GO:BP	eye development	16175	368		0.7777777777777778	0.8	199	15976	6	25	193	15951	16175	0.07204869378156968
M1	string	0	network_modules	83	TRUE	0.0027761287220950085	202	31	6	0.1935483870967742	0.0297029702970297	GO:0150063	GO:BP	visual system development	16175	20119		0.8888888888888888	0.9	202	15973	6	25	196	15948	16175	0.07144520670438109
M1	string	0	network_modules	83	TRUE	0.0032899207476212292	208	31	6	0.1935483870967742	0.028846153846153848	GO:0048880	GO:BP	sensory system development	16175	13120		1	1	208	15967	6	25	202	15942	16175	0.07027616165340943
M1	string	0	network_modules	85	TRUE	2.810782195033779e-26	84	23	16	0.6956521739130435	0.19047619047619047	KEGG:03083	KEGG	Polycomb repressive complex	8484	220		NA	1	84	8400	16	7	68	8393	8484	0.36111124309137854
M1	string	0	network_modules	85	TRUE	4.167100971330764e-5	36	15	4	0.26666666666666666	0.1111111111111111	REAC:R-HSA-8939243	REAC	RUNX1 interacts with co-factors whose precise effect on RUNX1 targets is not known	10916	1916		0	0.3333333333333333	36	10880	4	11	32	10869	10916	0.17040194200834138
M1	string	0	network_modules	85	TRUE	5.888364091149833e-4	529	31	9	0.2903225806451613	0.017013232514177693	GO:0006325	GO:BP	chromatin organization	16175	2122		NA	1	529	15646	9	22	520	15624	16175	0.06346962201406356
M1	string	0	network_modules	85	TRUE	0.003850748878833555	34	15	3	0.2	0.08823529411764706	REAC:R-HSA-8953750	REAC	Transcriptional Regulation by E2F6	10916	2543		0.5	0.6666666666666666	34	10882	3	12	31	10870	10916	0.1310676377940269
M1	string	0	network_modules	85	TRUE	0.007882738652959702	43	15	3	0.2	0.06976744186046512	REAC:R-HSA-4570464	REAC	SUMOylation of RNA binding proteins	10916	2171		1	1	43	10873	3	12	40	10861	10916	0.11610686467493356
M1	string	0	network_modules	86	TRUE	1.2989013812725157e-12	245	27	13	0.48148148148148145	0.053061224489795916	REAC:R-HSA-425407	REAC	SLC-mediated transmembrane transport	10916	2146		0	0.14285714285714285	245	10671	13	14	232	10657	10916	0.1543170255983648
M1	string	0	network_modules	86	TRUE	1.8822533215530276e-8	87	35	8	0.22857142857142856	0.09195402298850575	GO:0010232	GO:BP	vascular transport	16175	4011		0	0.1	87	16088	8	27	79	16061	16175	0.14210062549971222
M1	string	0	network_modules	86	TRUE	1.8822533215530276e-8	87	35	8	0.22857142857142856	0.09195402298850575	GO:0150104	GO:BP	transport across blood-brain barrier	16175	20143		0	0.1	87	16088	8	27	79	16061	16175	0.14210062549971222
M1	string	0	network_modules	86	TRUE	5.92096900432708e-8	15	27	5	0.18518518518518517	0.3333333333333333	REAC:R-HSA-549132	REAC	Organic cation/anion/zwitterion transport	10916	1650		0.16666666666666666	0.2857142857142857	15	10901	5	22	10	10879	10916	0.24708378165468528
M1	string	0	network_modules	86	TRUE	3.0652818010478935e-7	38	35	6	0.17142857142857143	0.15789473684210525	GO:0042908	GO:BP	xenobiotic transport	16175	10439		0.10526315789473684	0.15	38	16137	6	29	32	16108	16175	0.16263488418946134
M1	string	0	network_modules	86	TRUE	2.0210791705923526e-6	326	35	10	0.2857142857142857	0.03067484662576687	GO:0015711	GO:BP	organic anion transport	16175	4831		0.15789473684210525	0.2	326	15849	10	25	316	15824	16175	0.08799926115326663
M1	string	0	network_modules	86	TRUE	9.219857351037818e-6	188	35	8	0.22857142857142856	0.0425531914893617	GO:0003018	GO:BP	vascular process in circulatory system	16175	1469		0.21052631578947367	0.25	188	15987	8	27	180	15960	16175	0.09425858015495528
M1	string	0	network_modules	86	TRUE	3.232777136689114e-5	14	35	4	0.11428571428571428	0.2857142857142857	GO:0015697	GO:BP	quaternary ammonium group transport	16175	4817		0.2631578947368421	0.3	14	16161	4	31	10	16130	16175	0.17960513515413654
M1	string	0	network_modules	86	TRUE	5.523270852047353e-5	105	27	6	0.2222222222222222	0.05714285714285714	REAC:R-HSA-425393	REAC	Transport of inorganic cations/anions and amino acids/oligopeptides	10916	2596		0.3333333333333333	0.42857142857142855	105	10811	6	21	99	10790	10916	0.1084660581148816
M1	string	0	network_modules	86	TRUE	3.300013189308656e-4	6	35	3	0.08571428571428572	0.5	GO:0015747	GO:BP	urate transport	16175	4866		0.3157894736842105	0.35	6	16169	3	32	3	16137	16175	0.20638540920552684
M1	string	0	network_modules	86	TRUE	5.131149511002429e-4	10	27	3	0.1111111111111111	0.3	REAC:R-HSA-549127	REAC	Organic cation transport	10916	1649		0.5	0.5714285714285714	10	10906	3	24	7	10882	10916	0.18137634660329918
M1	string	0	network_modules	86	TRUE	5.419293176094425e-4	84	27	5	0.18518518518518517	0.05952380952380952	REAC:R-HSA-425366	REAC	Transport of bile salts and organic acids, metal ions and amine compounds	10916	2590		0.6666666666666666	0.7142857142857143	84	10832	5	22	79	10810	10916	0.10114198543799494
M1	string	0	network_modules	86	TRUE	5.766453956058552e-4	7	35	3	0.08571428571428572	0.42857142857142855	GO:0015879	GO:BP	carnitine transport	16175	4985		0.3684210526315789	0.4	7	16168	3	32	4	16136	16175	0.19094324713370853
M1	string	0	network_modules	86	TRUE	7.18251761761291e-4	135	35	6	0.17142857142857143	0.044444444444444446	GO:0015718	GO:BP	monocarboxylic acid transport	16175	4838		0.42105263157894735	0.45	135	16040	6	29	129	16011	16175	0.08347654440922228
M1	string	0	network_modules	86	TRUE	9.984041619091697e-4	95	27	5	0.18518518518518517	0.05263157894736842	REAC:R-HSA-5619102	REAC	SLC transporter disorders	10916	2145		0.8333333333333334	0.8571428571428571	95	10821	5	22	90	10799	10916	0.0946143958728376
M1	string	0	network_modules	86	TRUE	0.0011297083110129275	32	35	4	0.11428571428571428	0.125	GO:0072337	GO:BP	modified amino acid transport	16175	17357		0.47368421052631576	0.5	32	16143	4	31	28	16112	16175	0.11769760448162102
M1	string	0	network_modules	86	TRUE	0.0015236608419605196	248	35	7	0.2	0.028225806451612902	GO:0046942	GO:BP	carboxylic acid transport	16175	12438		0.5263157894736842	0.55	248	15927	7	28	241	15899	16175	0.06998817178857236
M1	string	0	network_modules	86	TRUE	0.0015653408855267653	249	35	7	0.2	0.028112449799196786	GO:0015849	GO:BP	organic acid transport	16175	4958		0.5789473684210527	0.6	249	15926	7	28	242	15898	16175	0.06982630018444808
M1	string	0	network_modules	86	TRUE	0.001888405475738017	2	27	2	0.07407407407407407	1	REAC:R-HSA-8942233	REAC	Intestinal infectious diseases	10916	1259		1	1	2	10914	2	25	0	10889	10916	0.271853632203404
M1	string	0	network_modules	86	TRUE	0.001968282975880127	10	35	3	0.08571428571428572	0.3	GO:0015838	GO:BP	amino-acid betaine transport	16175	4948		0.631578947368421	0.75	10	16165	3	32	7	16133	16175	0.15942193696978257
M1	string	0	network_modules	86	TRUE	0.001968282975880127	10	35	3	0.08571428571428572	0.3	GO:0046415	GO:BP	urate metabolic process	16175	12132		0.631578947368421	0.75	10	16165	3	32	7	16133	16175	0.15942193696978257
M1	string	0	network_modules	86	TRUE	0.001968282975880127	10	35	3	0.08571428571428572	0.3	GO:1990961	GO:BP	xenobiotic detoxification by transmembrane export across the plasma membrane	16175	25355		0.631578947368421	0.75	10	16165	3	32	7	16133	16175	0.15942193696978257
M1	string	0	network_modules	86	TRUE	0.004130115535621007	182	35	6	0.17142857142857143	0.03296703296703297	GO:0098739	GO:BP	import across plasma membrane	16175	18866		0.7894736842105263	0.8	182	15993	6	29	176	15964	16175	0.07071720076924046
M1	string	0	network_modules	86	TRUE	0.004670228387163061	13	35	3	0.08571428571428572	0.23076923076923078	GO:0046618	GO:BP	xenobiotic export from cell	16175	12258		0.8421052631578947	0.85	13	16162	3	32	10	16130	16175	0.13953048614874553
M1	string	0	network_modules	86	TRUE	0.005935110373289289	14	35	3	0.08571428571428572	0.21428571428571427	GO:0043252	GO:BP	sodium-independent organic anion transport	16175	10587		0.8947368421052632	0.9	14	16161	3	32	11	16129	16175	0.1343612002356167
M1	string	0	network_modules	86	TRUE	0.006097286281539506	439	35	8	0.22857142857142856	0.018223234624145785	GO:0003013	GO:BP	circulatory system process	16175	1464		0.9473684210526315	0.95	439	15736	8	27	431	15709	16175	0.057726196842906974
M1	string	0	network_modules	86	TRUE	0.00714665532978335	112	35	5	0.14285714285714285	0.044642857142857144	GO:0006820	GO:BP	monoatomic anion transport	16175	2497		1	1	112	16063	5	30	107	16033	16175	0.07633587958305751
M1	string	0	network_modules	87	TRUE	3.508990434266464e-11	92	23	9	0.391304347826087	0.09782608695652174	REAC:R-HSA-141444	REAC	Amplification  of signal from unattached  kinetochores via a MAD2  inhibitory signal	10916	143		0	0.046511627906976744	92	10824	9	14	83	10810	10916	0.19245288744148378
M1	string	0	network_modules	87	TRUE	3.508990434266464e-11	92	23	9	0.391304347826087	0.09782608695652174	REAC:R-HSA-141424	REAC	Amplification of signal from the kinetochores	10916	144		0	0.046511627906976744	92	10824	9	14	83	10810	10916	0.19245288744148378
M1	string	0	network_modules	87	TRUE	4.2041583423499245e-11	14	23	6	0.2608695652173913	0.42857142857142855	REAC:R-HSA-4839748	REAC	Signaling by AMER1 mutants	10916	2220		0.047619047619047616	0.18604651162790697	14	10902	6	17	8	10885	10916	0.33328794056439576
M1	string	0	network_modules	87	TRUE	4.2041583423499245e-11	14	23	6	0.2608695652173913	0.42857142857142855	REAC:R-HSA-5467337	REAC	APC truncation mutants have impaired AXIN binding	10916	22		0.047619047619047616	0.18604651162790697	14	10902	6	17	8	10885	10916	0.33328794056439576
M1	string	0	network_modules	87	TRUE	4.2041583423499245e-11	14	23	6	0.2608695652173913	0.42857142857142855	REAC:R-HSA-4839744	REAC	Signaling by APC mutants	10916	2221		0.047619047619047616	0.18604651162790697	14	10902	6	17	8	10885	10916	0.33328794056439576
M1	string	0	network_modules	87	TRUE	4.2041583423499245e-11	14	23	6	0.2608695652173913	0.42857142857142855	REAC:R-HSA-4839735	REAC	Signaling by AXIN mutants	10916	2222		0.047619047619047616	0.18604651162790697	14	10902	6	17	8	10885	10916	0.33328794056439576
M1	string	0	network_modules	87	TRUE	4.2041583423499245e-11	14	23	6	0.2608695652173913	0.42857142857142855	REAC:R-HSA-5467348	REAC	Truncations of AMER1 destabilize the destruction complex	10916	2609		0.047619047619047616	0.18604651162790697	14	10902	6	17	8	10885	10916	0.33328794056439576
M1	string	0	network_modules	87	TRUE	4.2041583423499245e-11	14	23	6	0.2608695652173913	0.42857142857142855	REAC:R-HSA-5467340	REAC	AXIN missense mutants destabilize the destruction complex	10916	42		0.047619047619047616	0.18604651162790697	14	10902	6	17	8	10885	10916	0.33328794056439576
M1	string	0	network_modules	87	TRUE	6.997568176962243e-11	15	23	6	0.2608695652173913	0.4	REAC:R-HSA-5358747	REAC	CTNNB1 S33 mutants aren't phosphorylated	10916	289		0.19047619047619047	0.32558139534883723	15	10901	6	17	9	10884	10916	0.3218878743151494
M1	string	0	network_modules	87	TRUE	6.997568176962243e-11	15	23	6	0.2608695652173913	0.4	REAC:R-HSA-5358749	REAC	CTNNB1 S37 mutants aren't phosphorylated	10916	290		0.19047619047619047	0.32558139534883723	15	10901	6	17	9	10884	10916	0.3218878743151494
M1	string	0	network_modules	87	TRUE	6.997568176962243e-11	15	23	6	0.2608695652173913	0.4	REAC:R-HSA-5358751	REAC	CTNNB1 S45 mutants aren't phosphorylated	10916	291		0.19047619047619047	0.32558139534883723	15	10901	6	17	9	10884	10916	0.3218878743151494
M1	string	0	network_modules	87	TRUE	6.997568176962243e-11	15	23	6	0.2608695652173913	0.4	REAC:R-HSA-5339716	REAC	Signaling by GSK3beta mutants	10916	2257		0.19047619047619047	0.32558139534883723	15	10901	6	17	9	10884	10916	0.3218878743151494
M1	string	0	network_modules	87	TRUE	6.997568176962243e-11	15	23	6	0.2608695652173913	0.4	REAC:R-HSA-5358752	REAC	CTNNB1 T41 mutants aren't phosphorylated	10916	292		0.19047619047619047	0.32558139534883723	15	10901	6	17	9	10884	10916	0.3218878743151494
M1	string	0	network_modules	87	TRUE	6.997568176962243e-11	15	23	6	0.2608695652173913	0.4	REAC:R-HSA-4839743	REAC	Signaling by CTNNB1 phospho-site mutants	10916	2228		0.19047619047619047	0.32558139534883723	15	10901	6	17	9	10884	10916	0.3218878743151494
M1	string	0	network_modules	87	TRUE	1.6883143465996092e-10	109	23	9	0.391304347826087	0.08256880733944955	REAC:R-HSA-69618	REAC	Mitotic Spindle Checkpoint	10916	1486		0.3333333333333333	0.3488372093023256	109	10807	9	14	100	10793	10916	0.17622857108434872
M1	string	0	network_modules	87	TRUE	1.725686551978204e-10	17	23	6	0.2608695652173913	0.35294117647058826	REAC:R-HSA-432142	REAC	Platelet sensitization by LDL	10916	1766		0.35714285714285715	0.3953488372093023	17	10899	6	17	11	10882	10916	0.30217524745751934
M1	string	0	network_modules	87	TRUE	1.725686551978204e-10	17	23	6	0.2608695652173913	0.35294117647058826	REAC:R-HSA-196299	REAC	Beta-catenin phosphorylation cascade	10916	217		0.35714285714285715	0.3953488372093023	17	10899	6	17	11	10882	10916	0.30217524745751934
M1	string	0	network_modules	87	TRUE	1.893605127241287e-10	131	19	9	0.47368421052631576	0.06870229007633588	KEGG:04114	KEGG	Oocyte meiosis	8484	268		0	0.1	131	8353	9	10	122	8343	8484	0.17607726791653583
M1	string	0	network_modules	87	TRUE	2.7653279286491585e-10	115	23	9	0.391304347826087	0.0782608695652174	REAC:R-HSA-9648025	REAC	EML4 and NUDC in mitotic spindle formation	10916	817		0.40476190476190477	0.4186046511627907	115	10801	9	14	106	10787	10916	0.1713699919707086
M1	string	0	network_modules	87	TRUE	5.12687046537052e-10	123	23	9	0.391304347826087	0.07317073170731707	REAC:R-HSA-2500257	REAC	Resolution of Sister Chromatid Cohesion	10916	2079		0.42857142857142855	0.4418604651162791	123	10793	9	14	114	10779	10916	0.1654456452959809
M1	string	0	network_modules	87	TRUE	5.382982783270656e-10	20	23	6	0.2608695652173913	0.3	REAC:R-HSA-389513	REAC	Co-inhibition by CTLA4	10916	376		0.4523809523809524	0.46511627906976744	20	10896	6	17	14	10879	10916	0.27833486292877846
M1	string	0	network_modules	87	TRUE	5.599967785588825e-10	188	23	10	0.43478260869565216	0.05319148936170213	REAC:R-HSA-2467813	REAC	Separation of Sister Chromatids	10916	2204		0.47619047619047616	0.4883720930232558	188	10728	10	13	178	10715	10916	0.14748045380367442
M1	string	0	network_modules	87	TRUE	1.2843550205347334e-9	136	23	9	0.391304347826087	0.0661764705882353	REAC:R-HSA-5663220	REAC	RHO GTPases Activate Formins	10916	1848		0.5	0.5116279069767442	136	10780	9	14	127	10766	10916	0.156941237871216
M1	string	0	network_modules	87	TRUE	3.851733594762928e-9	228	23	10	0.43478260869565216	0.043859649122807015	REAC:R-HSA-68882	REAC	Mitotic Anaphase	10916	1479		0.5238095238095238	0.5348837209302325	228	10688	10	13	218	10675	10916	0.13299309878854454
M1	string	0	network_modules	87	TRUE	4.02317509431043e-9	229	23	10	0.43478260869565216	0.043668122270742356	REAC:R-HSA-2555396	REAC	Mitotic Metaphase and Anaphase	10916	1482		0.5476190476190477	0.5581395348837209	229	10687	10	13	219	10674	10916	0.13267923884383515
M1	string	0	network_modules	87	TRUE	1.0076082399499035e-8	31	23	6	0.2608695652173913	0.1935483870967742	REAC:R-HSA-4641262	REAC	Disassembly of the destruction complex and recruitment of AXIN to the membrane	10916	746		0.5714285714285714	0.5813953488372093	31	10885	6	17	25	10868	10916	0.2228067389305462
M1	string	0	network_modules	87	TRUE	1.51166689779043e-8	33	23	6	0.2608695652173913	0.18181818181818182	REAC:R-HSA-5673000	REAC	RAF activation	10916	1839		0.5952380952380952	0.6046511627906976	33	10883	6	17	27	10866	10916	0.21581598830240634
M1	string	0	network_modules	87	TRUE	1.8331404330619733e-8	34	23	6	0.2608695652173913	0.17647058823529413	REAC:R-HSA-4791275	REAC	Signaling by WNT in cancer	10916	2315		0.6190476190476191	0.627906976744186	34	10882	6	17	28	10865	10916	0.2125527633230387
M1	string	0	network_modules	87	TRUE	4.0017488689063463e-08	199	23	9	0.391304347826087	0.04522613065326633	REAC:R-HSA-68877	REAC	Mitotic Prometaphase	10916	1484		0.6428571428571429	0.6511627906976745	199	10717	9	14	190	10703	10916	0.12814031502066292
M1	string	0	network_modules	87	TRUE	4.5165809876597955e-8	157	19	8	0.42105263157894735	0.050955414012738856	KEGG:04110	KEGG	Cell cycle	8484	264		0.1111111111111111	0.2	157	8327	8	11	149	8316	8484	0.14150985667314095
M1	string	0	network_modules	87	TRUE	7.07398139657998e-8	42	23	6	0.2608695652173913	0.14285714285714285	REAC:R-HSA-5675221	REAC	Negative regulation of MAPK pathway	10916	1573		0.6666666666666666	0.6744186046511628	42	10874	6	17	36	10857	10916	0.19076763064448068
M1	string	0	network_modules	87	TRUE	2.566987848603061e-7	120	19	7	0.3684210526315789	0.058333333333333334	KEGG:04071	KEGG	Sphingolipid signaling pathway	8484	260		0.2222222222222222	0.3	120	8364	7	12	113	8352	8484	0.14213761831648164
M1	string	0	network_modules	87	TRUE	1.0959147262832857e-6	289	23	9	0.391304347826087	0.031141868512110725	REAC:R-HSA-69620	REAC	Cell Cycle Checkpoints	10916	321		0.6904761904761905	0.6976744186046512	289	10627	9	14	280	10613	10916	0.1044213535306305
M1	string	0	network_modules	87	TRUE	1.1071471538990852e-6	406	23	10	0.43478260869565216	0.024630541871921183	REAC:R-HSA-68886	REAC	M Phase	10916	1343		0.7142857142857143	0.7209302325581395	406	10510	10	13	396	10497	10916	0.09654376299936081
M1	string	0	network_modules	87	TRUE	1.3014214600722312e-6	67	23	6	0.2608695652173913	0.08955223880597014	REAC:R-HSA-388841	REAC	Regulation of T cell activation by CD28 family	10916	2007		0.7380952380952381	0.7441860465116279	67	10849	6	17	61	10832	10916	0.14986650435991858
M1	string	0	network_modules	87	TRUE	2.53337348007921e-6	318	23	9	0.391304347826087	0.02830188679245283	REAC:R-HSA-195258	REAC	RHO GTPase Effectors	10916	1846		0.7619047619047619	0.7674418604651163	318	10598	9	14	309	10584	10916	0.09895642648984132
M1	string	0	network_modules	87	TRUE	2.66677307943929e-6	96	19	6	0.3157894736842105	0.0625	KEGG:03015	KEGG	mRNA surveillance pathway	8484	210		0.3333333333333333	0.4	96	8388	6	13	90	8375	8484	0.13637961024053905
M1	string	0	network_modules	87	TRUE	4.817727086003521e-6	83	23	6	0.2608695652173913	0.07228915662650602	REAC:R-HSA-195253	REAC	Degradation of beta-catenin by the destruction complex	10916	724		0.7857142857142857	0.7906976744186046	83	10833	6	17	77	10816	10916	0.1339729894045389
M1	string	0	network_modules	87	TRUE	5.567409375710748e-6	85	23	6	0.2608695652173913	0.07058823529411765	REAC:R-HSA-418346	REAC	Platelet homeostasis	10916	1765		0.8095238095238095	0.813953488372093	85	10831	6	17	79	10814	10916	0.13230389649212346
M1	string	0	network_modules	87	TRUE	8.99230980158559e-6	92	23	6	0.2608695652173913	0.06521739130434782	REAC:R-HSA-6811558	REAC	PI5P, PP2A and IER3 Regulate PI3K/AKT Signaling	10916	1677		0.8333333333333334	0.8372093023255814	92	10824	6	17	86	10807	10916	0.12688981364473662
M1	string	0	network_modules	87	TRUE	9.682533078717633e-6	119	19	6	0.3157894736842105	0.05042016806722689	KEGG:04660	KEGG	T cell receptor signaling pathway	8484	338		0.4444444444444444	0.5	119	8365	6	13	113	8352	8484	0.12156921619831003
M1	string	0	network_modules	87	TRUE	1.0178629620499522e-5	120	19	6	0.3157894736842105	0.05	KEGG:04152	KEGG	AMPK signaling pathway	8484	286		0.5555555555555556	0.6	120	8364	6	13	114	8351	8484	0.12102156533271351
M1	string	0	network_modules	87	TRUE	1.3998497639177737e-5	99	23	6	0.2608695652173913	0.06060606060606061	REAC:R-HSA-199418	REAC	Negative regulation of the PI3K/AKT network	10916	1580		0.8571428571428571	0.8604651162790697	99	10817	6	17	93	10800	10916	0.12205032491220938
M1	string	0	network_modules	87	TRUE	1.716272905988741e-5	131	19	6	0.3157894736842105	0.04580152671755725	KEGG:04728	KEGG	Dopaminergic synapse	8484	358		0.6666666666666666	0.7	131	8353	6	13	125	8340	8484	0.1154071632282221
M1	string	0	network_modules	87	TRUE	4.302827681806826e-5	153	19	6	0.3157894736842105	0.0392156862745098	KEGG:04261	KEGG	Adrenergic signaling in cardiomyocytes	8484	297		0.7777777777777778	0.8	153	8331	6	13	147	8318	8484	0.1060057758065289
M1	string	0	network_modules	87	TRUE	2.625389520915926e-4	330	19	7	0.3684210526315789	0.021212121212121213	KEGG:05165	KEGG	Human papillomavirus infection	8484	446		0.8888888888888888	0.9	330	8154	7	12	323	8142	8484	0.08074378603659499
M1	string	0	network_modules	87	TRUE	0.0020669193436080534	231	23	6	0.2608695652173913	0.025974025974025976	REAC:R-HSA-201681	REAC	TCF dependent signaling in response to WNT	10916	2421		0.8809523809523809	0.8837209302325582	231	10685	6	17	225	10668	10916	0.07653197299999427
M1	string	0	network_modules	87	TRUE	0.0034828936004010114	253	23	6	0.2608695652173913	0.023715415019762844	REAC:R-HSA-1257604	REAC	PIP3 activates AKT signaling	10916	1679		0.9047619047619048	0.9069767441860465	253	10663	6	17	247	10646	10916	0.07258875500683867
M1	string	0	network_modules	87	TRUE	0.004440800698674325	264	23	6	0.2608695652173913	0.022727272727272728	REAC:R-HSA-5673001	REAC	RAF/MAP kinase cascade	10916	1841		0.9285714285714286	0.9302325581395349	264	10652	6	17	258	10635	10916	0.07079566571341837
M1	string	0	network_modules	87	TRUE	0.004941689289294482	269	23	6	0.2608695652173913	0.022304832713754646	REAC:R-HSA-5684996	REAC	MAPK1/MAPK3 signaling	10916	1351		0.9523809523809523	0.9534883720930233	269	10647	6	17	263	10630	10916	0.07001533396099459
M1	string	0	network_modules	87	TRUE	0.005434722940473618	418	23	7	0.30434782608695654	0.01674641148325359	REAC:R-HSA-5663202	REAC	Diseases of signal transduction by growth factor receptors and second messengers	10916	773		0.9761904761904762	0.9767441860465116	418	10498	7	16	411	10482	10916	0.06370659075481347
M1	string	0	network_modules	87	TRUE	0.005506591474242113	356	19	6	0.3157894736842105	0.016853932584269662	KEGG:04151	KEGG	PI3K-Akt signaling pathway	8484	285		1	1	356	8128	6	13	350	8115	8484	0.06470311667950114
M1	string	0	network_modules	87	TRUE	0.008025097048014969	293	23	6	0.2608695652173913	0.020477815699658702	REAC:R-HSA-9006925	REAC	Intracellular signaling by second messengers	10916	1266		1	1	293	10623	6	17	287	10606	10916	0.06653720333814932
M1	string	0	network_modules	88	TRUE	1.0420614322855054e-12	126	33	11	0.3333333333333333	0.0873015873015873	GO:0006888	GO:BP	endoplasmic reticulum to Golgi vesicle-mediated transport	16175	2544		0	0.08333333333333333	126	16049	11	22	115	16027	16175	0.16742580694721132
M1	string	0	network_modules	88	TRUE	2.635560727995985e-10	284	33	12	0.36363636363636365	0.04225352112676056	GO:0048193	GO:BP	Golgi vesicle transport	16175	12570		0.09090909090909091	0.16666666666666666	284	15891	12	21	272	15870	16175	0.11914129134181359
M1	string	0	network_modules	88	TRUE	2.923593244661207e-10	186	22	10	0.45454545454545453	0.053763440860215055	REAC:R-HSA-948021	REAC	Transport to the Golgi and subsequent modification	10916	2604		0	0.1111111111111111	186	10730	10	12	176	10718	10916	0.15191795528157206
M1	string	0	network_modules	88	TRUE	4.0113016638567295e-8	305	22	10	0.45454545454545453	0.03278688524590164	REAC:R-HSA-446203	REAC	Asparagine N-linked glycosylation	10916	169		0.125	0.2222222222222222	305	10611	10	12	295	10599	10916	0.11632655318491006
M1	string	0	network_modules	88	TRUE	1.2416137908223893e-7	155	22	8	0.36363636363636365	0.05161290322580645	REAC:R-HSA-199977	REAC	ER to Golgi Anterograde Transport	10916	823		0.25	0.3333333333333333	155	10761	8	14	147	10747	10916	0.13272658924096423
M1	string	0	network_modules	88	TRUE	1.556728849557751e-6	33	22	5	0.22727272727272727	0.15151515151515152	REAC:R-HSA-5694530	REAC	Cargo concentration in the ER	10916	308		0.375	0.4444444444444444	33	10883	5	17	28	10866	10916	0.18356152437258302
M1	string	0	network_modules	88	TRUE	1.0406448407236907e-5	34	33	5	0.15151515151515152	0.14705882352941177	GO:0035459	GO:BP	vesicle cargo loading	16175	9047		0.18181818181818182	0.25	34	16141	5	28	29	16113	16175	0.1475049890987939
M1	string	0	network_modules	88	TRUE	1.1348076575050681e-5	74	33	6	0.18181818181818182	0.08108108108108109	GO:0006900	GO:BP	vesicle budding from membrane	16175	2553		0.2727272727272727	0.3333333333333333	74	16101	6	27	68	16074	16175	0.1187544616908958
M1	string	0	network_modules	88	TRUE	2.0417876792132575e-5	144	33	7	0.21212121212121213	0.04861111111111111	GO:0007030	GO:BP	Golgi organization	16175	2635		0.36363636363636365	0.4166666666666667	144	16031	7	26	137	16005	16175	0.09781927888646087
M1	string	0	network_modules	88	TRUE	2.439635667250665e-5	40	33	5	0.15151515151515152	0.125	GO:0090114	GO:BP	COPII-coated vesicle budding	16175	18031		0.45454545454545453	0.5	40	16135	5	28	35	16107	16175	0.13568047587199084
M1	string	0	network_modules	88	TRUE	3.0085332970445972e-5	202	22	7	0.3181818181818182	0.034653465346534656	REAC:R-HSA-6811442	REAC	Intra-Golgi and retrograde Golgi-to-ER traffic	10916	1262		0.5	0.5555555555555556	202	10714	7	15	195	10699	10916	0.09992701216719302
M1	string	0	network_modules	88	TRUE	6.190669146391088e-5	133	22	6	0.2727272727272727	0.045112781954887216	REAC:R-HSA-8856688	REAC	Golgi-to-ER retrograde transport	10916	1084		0.625	0.6666666666666666	133	10783	6	16	127	10767	10916	0.10672483843209463
M1	string	0	network_modules	88	TRUE	6.532867915202395e-5	68	22	5	0.22727272727272727	0.07352941176470588	REAC:R-HSA-204005	REAC	COPII-mediated vesicle transport	10916	280		0.75	0.7777777777777778	68	10848	5	17	63	10831	10916	0.12624939918458528
M1	string	0	network_modules	88	TRUE	8.377137451704943e-5	524	33	10	0.30303030303030304	0.019083969465648856	GO:0006886	GO:BP	intracellular protein transport	16175	2542		0.5454545454545454	0.5833333333333334	524	15651	10	23	514	15628	16175	0.06911451538326815
M1	string	0	network_modules	88	TRUE	2.334777399978559e-4	6	33	3	0.09090909090909091	0.5	GO:0035964	GO:BP	COPI-coated vesicle budding	16175	9367		0.6363636363636364	0.8333333333333334	6	16169	3	30	3	16139	16175	0.21258713991329356
M1	string	0	network_modules	88	TRUE	2.334777399978559e-4	6	33	3	0.09090909090909091	0.5	GO:0048205	GO:BP	COPI coating of Golgi vesicle	16175	12581		0.6363636363636364	0.8333333333333334	6	16169	3	30	3	16139	16175	0.21258713991329356
M1	string	0	network_modules	88	TRUE	2.334777399978559e-4	6	33	3	0.09090909090909091	0.5	GO:0048200	GO:BP	Golgi transport vesicle coating	16175	12576		0.6363636363636364	0.8333333333333334	6	16169	3	30	3	16139	16175	0.21258713991329356
M1	string	0	network_modules	88	TRUE	4.304901594182135e-4	99	22	5	0.22727272727272727	0.050505050505050504	REAC:R-HSA-6811434	REAC	COPI-dependent Golgi-to-ER retrograde traffic	10916	277		0.875	0.8888888888888888	99	10817	5	17	94	10800	10916	0.10343602555001469
M1	string	0	network_modules	88	TRUE	4.993659133523941e-4	102	22	5	0.22727272727272727	0.049019607843137254	REAC:R-HSA-6807878	REAC	COPI-mediated anterograde transport	10916	279		1	1	102	10814	5	17	97	10797	10916	0.10178932452705598
M1	string	0	network_modules	88	TRUE	9.765199754818417e-4	9	33	3	0.09090909090909091	0.3333333333333333	GO:0048194	GO:BP	Golgi vesicle budding	16175	12571		0.9090909090909091	0.9166666666666666	9	16166	3	30	6	16136	16175	0.17323716536333697
M1	string	0	network_modules	88	TRUE	0.00644701933546483	16	33	3	0.09090909090909091	0.1875	GO:0090110	GO:BP	COPII-coated vesicle cargo loading	16175	18028		1	1	16	16159	3	30	13	16129	16175	0.12933355639244704
M1	string	0	network_modules	89	TRUE	9.396934361855634e-20	196	26	16	0.6153846153846154	0.08163265306122448	REAC:R-HSA-112314	REAC	Neurotransmitter receptors and postsynaptic signal transmission	10916	1594		0	0.04	196	10720	16	10	180	10710	10916	0.21983526722832472
M1	string	0	network_modules	89	TRUE	2.185614422403247e-18	27	26	10	0.38461538461538464	0.37037037037037035	REAC:R-HSA-399719	REAC	Trafficking of AMPA receptors	10916	2532		0.041666666666666664	0.12	27	10889	10	16	17	10873	10916	0.3759110540695363
M1	string	0	network_modules	89	TRUE	2.185614422403247e-18	27	26	10	0.38461538461538464	0.37037037037037035	REAC:R-HSA-399721	REAC	Glutamate binding, activation of AMPA receptors and synaptic plasticity	10916	1057		0.041666666666666664	0.12	27	10889	10	16	17	10873	10916	0.3759110540695363
M1	string	0	network_modules	89	TRUE	5.539732872755278e-18	76	30	12	0.4	0.15789473684210525	GO:0035249	GO:BP	synaptic transmission, glutamatergic	16175	8924		0	0.08333333333333333	76	16099	12	18	64	16081	16175	0.2491770203736554
M1	string	0	network_modules	89	TRUE	8.98388434241685e-18	259	26	16	0.6153846153846154	0.06177606177606178	REAC:R-HSA-112315	REAC	Transmission across Chemical Synapses	10916	2580		0.125	0.16	259	10657	16	10	243	10647	10916	0.18995014061455454
M1	string	0	network_modules	89	TRUE	9.832414536168133e-15	400	26	16	0.6153846153846154	0.04	REAC:R-HSA-112316	REAC	Neuronal System	10916	1590		0.16666666666666666	0.2	400	10516	16	10	384	10506	10916	0.15050999604531584
M1	string	0	network_modules	89	TRUE	5.408394204752103e-13	262	30	13	0.43333333333333335	0.04961832061068702	GO:0050804	GO:BP	modulation of chemical synaptic transmission	16175	13270		0.09090909090909091	0.16666666666666666	262	15913	13	17	249	15896	16175	0.14244144270813677
M1	string	0	network_modules	89	TRUE	5.683999793734914e-13	263	30	13	0.43333333333333335	0.049429657794676805	GO:0099177	GO:BP	regulation of trans-synaptic signaling	16175	19085		0.18181818181818182	0.25	263	15912	13	17	250	15895	16175	0.1421537791192501
M1	string	0	network_modules	89	TRUE	4.496161991842142e-12	20	26	7	0.2692307692307692	0.35	REAC:R-HSA-438066	REAC	Unblocking of NMDA receptors, glutamate binding and activation	10916	2621		0.20833333333333334	0.24	20	10896	7	19	13	10877	10916	0.30552506070666574
M1	string	0	network_modules	89	TRUE	5.268363549677014e-12	115	22	10	0.45454545454545453	0.08695652173913043	KEGG:04724	KEGG	Glutamatergic synapse	8484	354		0	0.05263157894736842	115	8369	10	12	105	8357	8484	0.19445496958906638
M1	string	0	network_modules	89	TRUE	6.811574815192459e-12	41	30	8	0.26666666666666666	0.1951219512195122	GO:0007215	GO:BP	glutamate receptor signaling pathway	16175	2769		0.2727272727272727	0.3333333333333333	41	16134	8	22	33	16112	16175	0.22643511529119598
M1	string	0	network_modules	89	TRUE	3.256022040139875e-11	365	22	13	0.5909090909090909	0.03561643835616438	KEGG:04080	KEGG	Neuroactive ligand-receptor interaction	8484	263		0.05555555555555555	0.10526315789473684	365	8119	13	9	352	8110	8484	0.13767932509008035
M1	string	0	network_modules	89	TRUE	5.477375903285097e-11	13	26	6	0.23076923076923078	0.46153846153846156	REAC:R-HSA-416993	REAC	Trafficking of GluR2-containing AMPA receptors	10916	2533		0.25	0.28	13	10903	6	20	7	10883	10916	0.32525385247868493
M1	string	0	network_modules	89	TRUE	5.7528763209807645e-11	487	30	14	0.4666666666666667	0.028747433264887063	GO:0098916	GO:BP	anterograde trans-synaptic signaling	16175	18949		0.36363636363636365	0.5	487	15688	14	16	473	15672	16175	0.11012350985914213
M1	string	0	network_modules	89	TRUE	5.7528763209807645e-11	487	30	14	0.4666666666666667	0.028747433264887063	GO:0007268	GO:BP	chemical synaptic transmission	16175	2796		0.36363636363636365	0.5	487	15688	14	16	473	15672	16175	0.11012350985914213
M1	string	0	network_modules	89	TRUE	6.618677576637301e-11	492	30	14	0.4666666666666667	0.028455284552845527	GO:0099537	GO:BP	trans-synaptic signaling	16175	19116		0.5454545454545454	0.5833333333333334	492	15683	14	16	478	15667	16175	0.10950238245427285
M1	string	0	network_modules	89	TRUE	1.2713468310440831e-10	516	30	14	0.4666666666666667	0.027131782945736434	GO:0099536	GO:BP	synaptic signaling	16175	19115		0.6363636363636364	0.6666666666666666	516	15659	14	16	502	15643	16175	0.10664345038510384
M1	string	0	network_modules	89	TRUE	2.4425324815647773e-10	69	22	8	0.36363636363636365	0.11594202898550725	KEGG:05031	KEGG	Amphetamine addiction	8484	419		0.1111111111111111	0.15789473684210525	69	8415	8	14	61	8401	8484	0.20182160332881355
M1	string	0	network_modules	89	TRUE	1.0533500874845705e-9	131	22	9	0.4090909090909091	0.06870229007633588	KEGG:04728	KEGG	Dopaminergic synapse	8484	358		0.16666666666666666	0.21052631578947367	131	8353	9	13	122	8340	8484	0.16279045779657728
M1	string	0	network_modules	89	TRUE	4.050447850966573e-9	97	22	8	0.36363636363636365	0.08247422680412371	KEGG:04713	KEGG	Circadian entrainment	8484	348		0.2222222222222222	0.2631578947368421	97	8387	8	14	89	8373	8484	0.16891936785706177
M1	string	0	network_modules	89	TRUE	4.1917611248819696e-9	10	26	5	0.19230769230769232	0.5	REAC:R-HSA-451306	REAC	Ionotropic activity of kainate receptors	10916	1276		0.2916666666666667	0.36	10	10906	5	21	5	10885	10916	0.30911949890955726
M1	string	0	network_modules	89	TRUE	4.1917611248819696e-9	10	26	5	0.19230769230769232	0.5	REAC:R-HSA-451308	REAC	Activation of Ca-permeable Kainate Receptor	10916	81		0.2916666666666667	0.36	10	10906	5	21	5	10885	10916	0.30911949890955726
M1	string	0	network_modules	89	TRUE	8.316938289079543e-9	4	26	4	0.15384615384615385	1	REAC:R-HSA-399710	REAC	Activation of AMPA receptors	10916	72		0.375	0.4	4	10912	4	22	0	10890	10916	0.39183667534941563
M1	string	0	network_modules	89	TRUE	1.845265664514286e-8	30	26	6	0.23076923076923078	0.2	REAC:R-HSA-451326	REAC	Activation of kainate receptors upon glutamate binding	10916	102		0.4166666666666667	0.44	30	10886	6	20	24	10866	10916	0.21282187256702056
M1	string	0	network_modules	89	TRUE	3.3255865986497217e-7	21	26	5	0.19230769230769232	0.23809523809523808	REAC:R-HSA-9620244	REAC	Long-term potentiation	10916	1321		0.4583333333333333	0.48	21	10895	5	21	16	10874	10916	0.21229669829150838
M1	string	0	network_modules	89	TRUE	3.5961587991094637e-7	89	26	7	0.2692307692307692	0.07865168539325842	REAC:R-HSA-442755	REAC	Activation of NMDA receptors and postsynaptic events	10916	89		0.5	0.52	89	10827	7	19	82	10808	10916	0.14185896940205817
M1	string	0	network_modules	89	TRUE	8.650542451268804e-7	67	22	6	0.2727272727272727	0.08955223880597014	KEGG:04720	KEGG	Long-term potentiation	8484	350		0.2777777777777778	0.3157894736842105	67	8417	6	16	61	8401	8484	0.15255508724595226
M1	string	0	network_modules	89	TRUE	2.1830247897448035e-5	59	22	5	0.22727272727272727	0.0847457627118644	KEGG:04730	KEGG	Long-term depression	8484	359		0.3333333333333333	0.3684210526315789	59	8425	5	17	54	8408	8484	0.1351809260545961
M1	string	0	network_modules	89	TRUE	5.3742195576240114e-5	19	30	4	0.13333333333333333	0.21052631578947367	GO:0099637	GO:BP	neurotransmitter receptor transport	16175	19177		0.7272727272727273	0.75	19	16156	4	26	15	16130	16175	0.16631746816702525
M1	string	0	network_modules	89	TRUE	6.375690909224016e-5	223	22	7	0.3181818181818182	0.03139013452914798	KEGG:04024	KEGG	cAMP signaling pathway	8484	252		0.3888888888888889	0.42105263157894735	223	8261	7	15	216	8246	8484	0.09303287632184416
M1	string	0	network_modules	89	TRUE	1.215490487326115e-4	153	22	6	0.2727272727272727	0.0392156862745098	KEGG:04261	KEGG	Adrenergic signaling in cardiomyocytes	8484	297		0.4444444444444444	0.47368421052631576	153	8331	6	16	147	8315	8484	0.0975885292340694
M1	string	0	network_modules	89	TRUE	1.262700491035132e-4	154	22	6	0.2727272727272727	0.03896103896103896	KEGG:04921	KEGG	Oxytocin signaling pathway	8484	378		0.5	0.5263157894736842	154	8330	6	16	148	8314	8484	0.09723198715488987
M1	string	0	network_modules	89	TRUE	1.9330498142208034e-4	40	22	4	0.18181818181818182	0.1	KEGG:05033	KEGG	Nicotine addiction	8484	421		0.5555555555555556	0.5789473684210527	40	8444	4	18	36	8426	8484	0.13182517026854007
M1	string	0	network_modules	89	TRUE	2.7638302929503623e-4	76	26	5	0.19230769230769232	0.06578947368421052	REAC:R-HSA-438064	REAC	Post NMDA receptor activation events	10916	1772		0.5416666666666666	0.56	76	10840	5	21	71	10819	10916	0.10891726265959399
M1	string	0	network_modules	89	TRUE	2.858589016170931e-4	32	26	4	0.15384615384615385	0.125	REAC:R-HSA-5576892	REAC	Phase 0 - rapid depolarisation	10916	1732		0.5833333333333334	0.6	32	10884	4	22	28	10862	10916	0.13639501071663865
M1	string	0	network_modules	89	TRUE	4.68330384278211e-4	10	26	3	0.11538461538461539	0.3	REAC:R-HSA-111932	REAC	CaMK IV-mediated phosphorylation of CREB	10916	298		0.625	0.64	10	10906	3	23	7	10883	10916	0.18487986525356584
M1	string	0	network_modules	89	TRUE	6.307260728309001e-4	34	30	4	0.13333333333333333	0.11764705882352941	GO:0099072	GO:BP	regulation of postsynaptic membrane neurotransmitter receptor levels	16175	19029		0.8181818181818182	0.8333333333333334	34	16141	4	26	30	16115	16175	0.123514722053998
M1	string	0	network_modules	89	TRUE	7.990644282809254e-4	36	30	4	0.13333333333333333	0.1111111111111111	GO:0097120	GO:BP	receptor localization to synapse	16175	18510		0.9090909090909091	0.9166666666666666	36	16139	4	26	32	16113	16175	0.11992906603298022
M1	string	0	network_modules	89	TRUE	0.0016386738692258573	49	26	4	0.15384615384615385	0.08163265306122448	REAC:R-HSA-112043	REAC	PLC beta mediated events	10916	1693		0.6666666666666666	0.68	49	10867	4	22	45	10845	10916	0.10917166381540627
M1	string	0	network_modules	89	TRUE	0.0017945373672949001	2	26	2	0.07692307692307693	1	REAC:R-HSA-451307	REAC	Activation of Na-permeable kainate receptors	10916	91		0.7083333333333334	0.72	2	10914	2	24	0	10890	10916	0.2770449824007619
M1	string	0	network_modules	89	TRUE	0.002075157567086337	148	22	5	0.22727272727272727	0.033783783783783786	KEGG:04723	KEGG	Retrograde endocannabinoid signaling	8484	353		0.6111111111111112	0.631578947368421	148	8336	5	17	143	8319	8484	0.08172021118999472
M1	string	0	network_modules	89	TRUE	0.0024262532153276487	54	26	4	0.15384615384615385	0.07407407407407407	REAC:R-HSA-112040	REAC	G-protein mediated events	10916	998		0.75	0.76	54	10862	4	22	50	10840	10916	0.10369960442288996
M1	string	0	network_modules	89	TRUE	0.002552427339223072	76	22	4	0.18181818181818182	0.05263157894736842	KEGG:04971	KEGG	Gastric acid secretion	8484	402		0.6666666666666666	0.6842105263157895	76	8408	4	18	72	8390	8484	0.09354427436089456
M1	string	0	network_modules	89	TRUE	0.003144610988714724	18	26	3	0.11538461538461539	0.16666666666666666	REAC:R-HSA-442982	REAC	Ras activation upon Ca2+ influx through NMDA receptor	10916	1941		0.7916666666666666	0.8	18	10898	3	23	15	10875	10916	0.13696930681376612
M1	string	0	network_modules	89	TRUE	0.0034636116417279847	59	26	4	0.15384615384615385	0.06779661016949153	REAC:R-HSA-8986944	REAC	Transcriptional Regulation by MECP2	10916	2544		0.8333333333333334	0.84	59	10857	4	22	55	10835	10916	0.09892587960946497
M1	string	0	network_modules	89	TRUE	0.003966962738237625	85	22	4	0.18181818181818182	0.047058823529411764	KEGG:04911	KEGG	Insulin secretion	8484	368		0.7222222222222222	0.7368421052631579	85	8399	4	18	81	8381	8484	0.08795766341033437
M1	string	0	network_modules	89	TRUE	0.00437933600320193	20	26	3	0.11538461538461539	0.15	REAC:R-HSA-9617324	REAC	Negative regulation of NMDA receptor-mediated neuronal transmission	10916	1575		0.875	0.88	20	10896	3	23	17	10873	10916	0.12974307774804228
M1	string	0	network_modules	89	TRUE	0.0045147606463283784	55	30	4	0.13333333333333333	0.07272727272727272	GO:0051966	GO:BP	regulation of synaptic transmission, glutamatergic	16175	14035		1	1	55	16120	4	26	51	16094	16175	0.0962147321983194
M1	string	0	network_modules	89	TRUE	0.005101153770152939	21	26	3	0.11538461538461539	0.14285714285714285	REAC:R-HSA-8849932	REAC	Synaptic adhesion-like molecules	10916	2366		0.9166666666666666	0.92	21	10895	3	23	18	10872	10916	0.12651993704673264
M1	string	0	network_modules	89	TRUE	0.005642934484045833	93	22	4	0.18181818181818182	0.043010752688172046	KEGG:04912	KEGG	GnRH signaling pathway	8484	369		0.7777777777777778	0.7894736842105263	93	8391	4	18	89	8373	8484	0.08366779690150948
M1	string	0	network_modules	89	TRUE	0.006922195987537854	98	22	4	0.18181818181818182	0.04081632653061224	KEGG:04925	KEGG	Aldosterone synthesis and secretion	8484	382		0.8333333333333334	0.8947368421052632	98	8386	4	18	94	8368	8484	0.0812485417659704
M1	string	0	network_modules	89	TRUE	0.006922195987537854	98	22	4	0.18181818181818182	0.04081632653061224	KEGG:04750	KEGG	Inflammatory mediator regulation of TRP channels	8484	364		0.8333333333333334	0.8947368421052632	98	8386	4	18	94	8368	8484	0.0812485417659704
M1	string	0	network_modules	89	TRUE	0.007726227540900469	24	26	3	0.11538461538461539	0.125	REAC:R-HSA-3371571	REAC	HSF1-dependent transactivation	10916	1110		0.9583333333333334	0.96	24	10892	3	23	21	10869	10916	0.11807815706818106
M1	string	0	network_modules	89	TRUE	0.007784204338398303	101	22	4	0.18181818181818182	0.039603960396039604	KEGG:04916	KEGG	Melanogenesis	8484	373		0.9444444444444444	0.9473684210526315	101	8383	4	18	97	8365	8484	0.07988086351747734
M1	string	0	network_modules	89	TRUE	0.009738769466564842	107	22	4	0.18181818181818182	0.037383177570093455	KEGG:04922	KEGG	Glucagon signaling pathway	8484	379		1	1	107	8377	4	18	103	8359	8484	0.07731355294381194
M1	string	0	network_modules	89	TRUE	0.009893666278318003	26	26	3	0.11538461538461539	0.11538461538461539	REAC:R-HSA-442742	REAC	CREB1 phosphorylation through NMDA receptor-mediated activation of RAS signaling	10916	283		1	1	26	10890	3	23	23	10867	10916	0.11327258599985873
M1	string	0	network_modules	90	TRUE	4.0184778966562264e-49	329	35	34	0.9714285714285714	0.1033434650455927	REAC:R-HSA-73894	REAC	DNA Repair	10916	444		0	0.010309278350515464	329	10587	34	1	295	10586	10916	0.3122495869531966
M1	string	0	network_modules	90	TRUE	9.82728556409873e-41	528	36	32	0.8888888888888888	0.06060606060606061	GO:0006281	GO:BP	DNA repair	16175	2095		0	0.006944444444444444	528	15647	32	4	496	15643	16175	0.2275743139438218
M1	string	0	network_modules	90	TRUE	2.0909700136694915e-38	168	35	26	0.7428571428571429	0.15476190476190477	REAC:R-HSA-5693532	REAC	DNA Double-Strand Break Repair	10916	443		0.010416666666666666	0.020618556701030927	168	10748	26	9	142	10739	10916	0.33516441753484805
M1	string	0	network_modules	90	TRUE	4.226703568827521e-37	798	36	33	0.9166666666666666	0.041353383458646614	GO:0006974	GO:BP	DNA damage response	16175	2601		0.006993006993006993	0.013888888888888888	798	15377	33	3	765	15374	16175	0.1891494059579806
M1	string	0	network_modules	90	TRUE	3.0731472192970692e-33	152	36	22	0.6111111111111112	0.14473684210526316	GO:0000723	GO:BP	telomere maintenance	16175	202		0.013986013986013986	0.020833333333333332	152	16023	22	14	130	16009	16175	0.29454629061575444
M1	string	0	network_modules	90	TRUE	1.3131539131703653e-31	138	35	22	0.6285714285714286	0.15942028985507245	REAC:R-HSA-5693538	REAC	Homology Directed Repair	10916	1130		0.020833333333333332	0.030927835051546393	138	10778	22	13	116	10765	10916	0.31266946507895654
M1	string	0	network_modules	90	TRUE	2.074583938799759e-31	182	36	22	0.6111111111111112	0.12087912087912088	GO:0032200	GO:BP	telomere organization	16175	7392		0.02097902097902098	0.027777777777777776	182	15993	22	14	160	15979	16175	0.26859991764847285
M1	string	0	network_modules	90	TRUE	3.792675527094126e-31	281	36	24	0.6666666666666666	0.08540925266903915	GO:0006310	GO:BP	DNA recombination	16175	2115		0.027972027972027972	0.034722222222222224	281	15894	24	12	257	15882	16175	0.23470858409789574
M1	string	0	network_modules	90	TRUE	1.6276906989889164e-30	298	36	24	0.6666666666666666	0.08053691275167785	GO:0006302	GO:BP	double-strand break repair	16175	2109		0.03496503496503497	0.041666666666666664	298	15877	24	12	274	15865	16175	0.22766843730026548
M1	string	0	network_modules	90	TRUE	2.414110052378272e-29	68	35	18	0.5142857142857142	0.2647058823529412	REAC:R-HSA-5685942	REAC	HDR through Homologous Recombination (HRR)	10916	1097		0.03125	0.041237113402061855	68	10848	18	17	50	10831	10916	0.3662230817711402
M1	string	0	network_modules	90	TRUE	9.389629457147926e-28	132	35	20	0.5714285714285714	0.15151515151515152	REAC:R-HSA-5693567	REAC	HDR through Homologous Recombination (HRR) or Single Strand Annealing (SSA)	10916	1098		0.041666666666666664	0.05154639175257732	132	10784	20	15	112	10769	10916	0.29024128599045146
M1	string	0	network_modules	90	TRUE	3.301378122768743e-27	50	35	16	0.45714285714285713	0.32	REAC:R-HSA-9675135	REAC	Diseases of DNA repair	10916	758		0.052083333333333336	0.061855670103092786	50	10866	16	19	34	10847	10916	0.38012093086113563
M1	string	0	network_modules	90	TRUE	5.6185532312629415e-27	231	36	21	0.5833333333333334	0.09090909090909091	GO:0006260	GO:BP	DNA replication	16175	2077		0.04195804195804196	0.04861111111111111	231	15944	21	15	210	15929	16175	0.2265189693459597
M1	string	0	network_modules	90	TRUE	1.4890491292646025e-26	40	35	15	0.42857142857142855	0.375	REAC:R-HSA-5693616	REAC	Presynaptic phase of homologous DNA pairing and strand exchange	10916	1793		0.0625	0.07216494845360824	40	10876	15	20	25	10856	10916	0.39883431684303794
M1	string	0	network_modules	90	TRUE	5.580433167672594e-26	43	35	15	0.42857142857142855	0.3488372093023256	REAC:R-HSA-5693579	REAC	Homologous DNA Pairing and Strand Exchange	10916	1129		0.07291666666666667	0.08247422680412371	43	10873	15	20	28	10853	10916	0.38447420181531167
M1	string	0	network_modules	90	TRUE	6.59469640203896e-26	545	36	25	0.6944444444444444	0.045871559633027525	GO:0051276	GO:BP	chromosome organization	16175	13613		0.04895104895104895	0.05555555555555555	545	15630	25	11	520	15619	16175	0.172948568218924
M1	string	0	network_modules	90	TRUE	4.481890691093991e-25	35	35	14	0.4	0.4	REAC:R-HSA-9709570	REAC	Impaired BRCA2 binding to RAD51	10916	1173		0.08333333333333333	0.09278350515463918	35	10881	14	21	21	10860	10916	0.39807003032809485
M1	string	0	network_modules	90	TRUE	8.328531450787267e-25	147	36	18	0.5	0.12244897959183673	GO:0006261	GO:BP	DNA-templated DNA replication	16175	2078		0.055944055944055944	0.0625	147	16028	18	18	129	16010	16175	0.24432193282445386
M1	string	0	network_modules	90	TRUE	1.236410023390554e-24	435	36	23	0.6388888888888888	0.052873563218390804	GO:0051052	GO:BP	regulation of DNA metabolic process	16175	13462		0.06293706293706294	0.06944444444444445	435	15740	23	13	412	15727	16175	0.17867281921197267
M1	string	0	network_modules	90	TRUE	6.734744013414595e-24	41	35	14	0.4	0.34146341463414637	REAC:R-HSA-9701190	REAC	Defective homologous recombination repair (HRR) due to BRCA2 loss of function	10916	698		0.09375	0.1134020618556701	41	10875	14	21	27	10854	10916	0.3673832330836538
M1	string	0	network_modules	90	TRUE	6.734744013414595e-24	41	35	14	0.4	0.34146341463414637	REAC:R-HSA-9675136	REAC	Diseases of DNA Double-Strand Break Repair	10916	757		0.09375	0.1134020618556701	41	10875	14	21	27	10854	10916	0.3673832330836538
M1	string	0	network_modules	90	TRUE	7.441742318029137e-24	262	36	20	0.5555555555555556	0.07633587786259542	GO:0010948	GO:BP	negative regulation of cell cycle process	16175	4526		0.06993006993006994	0.0763888888888889	262	15913	20	16	242	15897	16175	0.20179362902940823
M1	string	0	network_modules	90	TRUE	1.0818022784014094e-22	116	35	17	0.4857142857142857	0.14655172413793102	REAC:R-HSA-1500620	REAC	Meiosis	10916	1410		0.11458333333333333	0.12371134020618557	116	10800	17	18	99	10782	10916	0.2627822594297009
M1	string	0	network_modules	90	TRUE	1.3912707128241212e-22	114	36	16	0.4444444444444444	0.14035087719298245	GO:0000077	GO:BP	DNA damage checkpoint signaling	16175	28		0.07692307692307693	0.08333333333333333	114	16061	16	20	98	16041	16175	0.24694136618980156
M1	string	0	network_modules	90	TRUE	2.8617584185218135e-22	94	35	16	0.45714285714285713	0.1702127659574468	REAC:R-HSA-69473	REAC	G2/M DNA damage checkpoint	10916	1006		0.125	0.13402061855670103	94	10822	16	19	78	10803	10916	0.2753204943566717
M1	string	0	network_modules	90	TRUE	3.38621467782103e-22	37	35	13	0.37142857142857144	0.35135135135135137	REAC:R-HSA-5685938	REAC	HDR through Single Strand Annealing (SSA)	10916	1100		0.13541666666666666	0.14432989690721648	37	10879	13	22	24	10857	10916	0.3591382783163844
M1	string	0	network_modules	90	TRUE	5.052733410479737e-22	123	36	16	0.4444444444444444	0.13008130081300814	GO:0031570	GO:BP	DNA integrity checkpoint signaling	16175	7220		0.08391608391608392	0.09027777777777778	123	16052	16	20	107	16032	16175	0.23749945217826787
M1	string	0	network_modules	90	TRUE	1.2934857663119213e-21	41	31	13	0.41935483870967744	0.3170731707317073	KEGG:03440	KEGG	Homologous recombination	8484	240		0	0.09090909090909091	41	8443	13	18	28	8425	8484	0.3619791508366569
M1	string	0	network_modules	90	TRUE	1.3379216150873768e-21	338	36	20	0.5555555555555556	0.05917159763313609	GO:0045786	GO:BP	negative regulation of cell cycle	16175	11618		0.09090909090909091	0.09722222222222222	338	15837	20	16	318	15821	16175	0.1765384836223904
M1	string	0	network_modules	90	TRUE	1.5782411368697676e-21	172	36	17	0.4722222222222222	0.09883720930232558	GO:0042770	GO:BP	signal transduction in response to DNA damage	16175	10355		0.0979020979020979	0.10416666666666667	172	16003	17	19	155	15984	16175	0.21254324639166114
M1	string	0	network_modules	90	TRUE	1.592946249529415e-21	19	35	11	0.3142857142857143	0.5789473684210527	REAC:R-HSA-174414	REAC	Processive synthesis on the C-strand of the telomere	10916	1801		0.14583333333333334	0.15463917525773196	19	10897	11	24	8	10873	10916	0.4252512825196396
M1	string	0	network_modules	90	TRUE	2.3675210113522084e-21	176	36	17	0.4722222222222222	0.09659090909090909	GO:0000075	GO:BP	cell cycle checkpoint signaling	16175	26		0.1048951048951049	0.11805555555555555	176	15999	17	19	159	15980	16175	0.21002778288800084
M1	string	0	network_modules	90	TRUE	2.3675210113522084e-21	176	36	17	0.4722222222222222	0.09659090909090909	GO:0000725	GO:BP	recombinational repair	16175	204		0.1048951048951049	0.11805555555555555	176	15999	17	19	159	15980	16175	0.21002778288800084
M1	string	0	network_modules	90	TRUE	1.1099410431303228e-20	57	36	13	0.3611111111111111	0.22807017543859648	GO:0045005	GO:BP	DNA-templated DNA replication maintenance of fidelity	16175	11223		0.11888111888111888	0.125	57	16118	13	23	44	16095	16175	0.2850008364394147
M1	string	0	network_modules	90	TRUE	1.2421806780875886e-20	246	36	18	0.5	0.07317073170731707	GO:0051054	GO:BP	positive regulation of DNA metabolic process	16175	13464		0.1258741258741259	0.13194444444444445	246	15929	18	18	228	15911	16175	0.18708987149838752
M1	string	0	network_modules	90	TRUE	1.7273470569040637e-20	154	35	17	0.4857142857142857	0.11038961038961038	REAC:R-HSA-1474165	REAC	Reproduction	10916	2064		0.15625	0.16494845360824742	154	10762	17	18	137	10744	10916	0.22679638173690475
M1	string	0	network_modules	90	TRUE	2.4763482424481734e-20	34	35	12	0.34285714285714286	0.35294117647058826	REAC:R-HSA-174417	REAC	Telomere C-strand (Lagging Strand) Synthesis	10916	2486		0.16666666666666666	0.17525773195876287	34	10882	12	23	22	10859	10916	0.34579534094198783
M1	string	0	network_modules	90	TRUE	5.190740643375887e-20	97	35	15	0.42857142857142855	0.15463917525773196	REAC:R-HSA-5693607	REAC	Processing of DNA double-strand break ends	10916	1798		0.17708333333333334	0.18556701030927836	97	10819	15	20	82	10799	10916	0.2536340561886996
M1	string	0	network_modules	90	TRUE	1.612843227067864e-19	224	36	17	0.4722222222222222	0.07589285714285714	GO:1901988	GO:BP	negative regulation of cell cycle phase transition	16175	21921		0.13286713286713286	0.1388888888888889	224	15951	17	19	207	15932	16175	0.18525031048433224
M1	string	0	network_modules	90	TRUE	1.7908454014501045e-19	17	35	10	0.2857142857142857	0.5882352941176471	REAC:R-HSA-174437	REAC	Removal of the Flap Intermediate from the C-strand	10916	2059		0.1875	0.1958762886597938	17	10899	10	25	7	10874	10916	0.40869904452051453
M1	string	0	network_modules	90	TRUE	2.1459340908690474e-19	48	36	12	0.3333333333333333	0.25	GO:0031297	GO:BP	replication fork processing	16175	7119		0.13986013986013987	0.14583333333333334	48	16127	12	24	36	16103	16175	0.28685002186421305
M1	string	0	network_modules	90	TRUE	2.6856231318126586e-19	630	36	22	0.6111111111111112	0.03492063492063492	GO:0010564	GO:BP	regulation of cell cycle process	16175	4217		0.14685314685314685	0.1527777777777778	630	15545	22	14	608	15531	16175	0.13967243023531528
M1	string	0	network_modules	90	TRUE	2.1958919474688988e-18	92	35	14	0.4	0.15217391304347827	REAC:R-HSA-6804756	REAC	Regulation of TP53 Activity through Phosphorylation	10916	2016		0.19791666666666666	0.20618556701030927	92	10824	14	21	78	10803	10916	0.24293325697148593
M1	string	0	network_modules	90	TRUE	4.6025121098916085e-18	167	35	16	0.45714285714285713	0.09580838323353294	REAC:R-HSA-69481	REAC	G2/M Checkpoints	10916	1005		0.20833333333333334	0.21649484536082475	167	10749	16	19	151	10730	10916	0.20416911590834366
M1	string	0	network_modules	90	TRUE	6.935099150263285e-18	51	35	12	0.34285714285714286	0.23529411764705882	REAC:R-HSA-180786	REAC	Extension of Telomeres	10916	887		0.21875	0.2268041237113402	51	10865	12	23	39	10842	10916	0.28126627541429206
M1	string	0	network_modules	90	TRUE	7.131259733719811e-18	90	36	13	0.3611111111111111	0.14444444444444443	GO:0010212	GO:BP	response to ionizing radiation	16175	3993		0.15384615384615385	0.1597222222222222	90	16085	13	23	77	16062	16175	0.22574722589216978
M1	string	0	network_modules	90	TRUE	1.0689982537238647e-17	172	36	15	0.4166666666666667	0.0872093023255814	GO:0000724	GO:BP	double-strand break repair via homologous recombination	16175	203		0.16083916083916083	0.16666666666666666	172	16003	15	21	157	15982	16175	0.18696211209086744
M1	string	0	network_modules	90	TRUE	1.7798005558639113e-17	24	35	10	0.2857142857142857	0.4166666666666667	REAC:R-HSA-9709603	REAC	Impaired BRCA2 binding to PALB2	10916	1172		0.22916666666666666	0.23711340206185566	24	10892	10	25	14	10867	10916	0.34330552026498307
M1	string	0	network_modules	90	TRUE	2.4949979543608866e-17	300	36	17	0.4722222222222222	0.056666666666666664	GO:0009314	GO:BP	response to radiation	16175	3460		0.16783216783216784	0.1736111111111111	300	15875	17	19	283	15856	16175	0.15881249202070002
M1	string	0	network_modules	90	TRUE	2.801236728374047e-17	376	36	18	0.5	0.047872340425531915	GO:1901987	GO:BP	regulation of cell cycle phase transition	16175	21920		0.17482517482517482	0.18055555555555555	376	15799	18	18	358	15781	16175	0.1494318181215783
M1	string	0	network_modules	90	TRUE	2.960146877529671e-17	25	35	10	0.2857142857142857	0.4	REAC:R-HSA-9704646	REAC	Defective HDR through Homologous Recombination Repair (HRR) due to PALB2 loss of BRCA2/RAD51/RAD51C binding function	10916	563		0.23958333333333334	0.27835051546391754	25	10891	10	25	15	10866	10916	0.3362760908565853
M1	string	0	network_modules	90	TRUE	2.960146877529671e-17	25	35	10	0.2857142857142857	0.4	REAC:R-HSA-9704331	REAC	Defective HDR through Homologous Recombination Repair (HRR) due to PALB2 loss of BRCA1 binding function	10916	562		0.23958333333333334	0.27835051546391754	25	10891	10	25	15	10866	10916	0.3362760908565853
M1	string	0	network_modules	90	TRUE	2.960146877529671e-17	25	35	10	0.2857142857142857	0.4	REAC:R-HSA-9701192	REAC	Defective homologous recombination repair (HRR) due to BRCA1 loss of function	10916	697		0.23958333333333334	0.27835051546391754	25	10891	10	25	15	10866	10916	0.3362760908565853
M1	string	0	network_modules	90	TRUE	2.960146877529671e-17	25	35	10	0.2857142857142857	0.4	REAC:R-HSA-9701193	REAC	Defective homologous recombination repair (HRR) due to PALB2 loss of function	10916	699		0.23958333333333334	0.27835051546391754	25	10891	10	25	15	10866	10916	0.3362760908565853
M1	string	0	network_modules	90	TRUE	3.540015553264223e-17	111	35	14	0.4	0.12612612612612611	REAC:R-HSA-157579	REAC	Telomere Maintenance	10916	2489		0.28125	0.28865979381443296	111	10805	14	21	97	10784	10916	0.22037693127496963
M1	string	0	network_modules	90	TRUE	7.544144989741591e-17	86	35	13	0.37142857142857144	0.1511627906976744	REAC:R-HSA-912446	REAC	Meiotic recombination	10916	1411		0.2916666666666667	0.29896907216494845	86	10830	13	22	73	10808	10916	0.23321909786857029
M1	string	0	network_modules	90	TRUE	7.607949707743799e-17	27	35	10	0.2857142857142857	0.37037037037037035	REAC:R-HSA-5693554	REAC	Resolution of D-loop Structures through Synthesis-Dependent Strand Annealing (SDSA)	10916	2078		0.3020833333333333	0.30927835051546393	27	10889	10	25	17	10864	10916	0.32340233815563907
M1	string	0	network_modules	90	TRUE	1.036766264843899e-16	88	35	13	0.37142857142857144	0.14772727272727273	REAC:R-HSA-73884	REAC	Base Excision Repair	10916	205		0.3125	0.31958762886597936	88	10828	13	22	75	10806	10916	0.23045873843931244
M1	string	0	network_modules	90	TRUE	8.447450560555169e-16	138	35	14	0.4	0.10144927536231885	REAC:R-HSA-73886	REAC	Chromosome Maintenance	10916	357		0.3229166666666667	0.32989690721649484	138	10778	14	21	124	10757	10916	0.19663781888176665
M1	string	0	network_modules	90	TRUE	1.1653649773783186e-15	34	35	10	0.2857142857142857	0.29411764705882354	REAC:R-HSA-5693568	REAC	Resolution of D-loop Structures through Holliday Junction Intermediates	10916	2077		0.3333333333333333	0.3402061855670103	34	10882	10	25	24	10857	10916	0.2876344198202372
M1	string	0	network_modules	90	TRUE	1.2159452949597756e-15	359	35	18	0.5142857142857142	0.05013927576601671	REAC:R-HSA-3700989	REAC	Transcriptional Regulation by TP53	10916	2546		0.34375	0.35051546391752575	359	10557	18	17	341	10540	10916	0.1530911656351784
M1	string	0	network_modules	90	TRUE	1.262331497818157e-15	465	36	18	0.5	0.03870967741935484	GO:0044770	GO:BP	cell cycle phase transition	16175	11146		0.18181818181818182	0.1875	465	15710	18	18	447	15692	16175	0.1331974172144222
M1	string	0	network_modules	90	TRUE	1.6281055851674706e-15	35	35	10	0.2857142857142857	0.2857142857142857	REAC:R-HSA-5693537	REAC	Resolution of D-Loop Structures	10916	2076		0.3541666666666667	0.36082474226804123	35	10881	10	25	25	10856	10916	0.28341670277154146
M1	string	0	network_modules	90	TRUE	2.9136911472538636e-15	140	36	13	0.3611111111111111	0.09285714285714286	GO:0071897	GO:BP	DNA biosynthetic process	16175	16970		0.1888111888111888	0.19444444444444445	140	16035	13	23	127	16012	16175	0.17970632566178843
M1	string	0	network_modules	90	TRUE	6.129796259933396e-15	148	36	13	0.3611111111111111	0.08783783783783784	GO:0071478	GO:BP	cellular response to radiation	16175	16711		0.1958041958041958	0.2013888888888889	148	16027	13	23	135	16004	16175	0.17458021668166515
M1	string	0	network_modules	90	TRUE	7.090372524856054e-15	160	35	14	0.4	0.0875	REAC:R-HSA-5633007	REAC	Regulation of TP53 Activity	10916	2012		0.3645833333333333	0.3711340206185567	160	10756	14	21	146	10735	10916	0.1818548121752173
M1	string	0	network_modules	90	TRUE	2.381862861033215e-14	53	36	10	0.2777777777777778	0.18867924528301888	GO:0071479	GO:BP	cellular response to ionizing radiation	16175	16712		0.20279720279720279	0.20833333333333334	53	16122	10	26	43	16096	16175	0.22685792247646125
M1	string	0	network_modules	90	TRUE	2.92596537825635e-14	68	35	11	0.3142857142857143	0.16176470588235295	REAC:R-HSA-5693571	REAC	Nonhomologous End-Joining (NHEJ)	10916	1605		0.375	0.38144329896907214	68	10848	11	24	57	10824	10916	0.2220567510465108
M1	string	0	network_modules	90	TRUE	3.3415002543692486e-14	289	35	16	0.45714285714285713	0.05536332179930796	REAC:R-HSA-69620	REAC	Cell Cycle Checkpoints	10916	321		0.3854166666666667	0.3917525773195876	289	10627	16	19	273	10608	10916	0.15214281358210152
M1	string	0	network_modules	90	TRUE	3.503519417728622e-14	84	36	11	0.3055555555555556	0.13095238095238096	GO:0010833	GO:BP	telomere maintenance via telomere lengthening	16175	4443		0.2097902097902098	0.2152777777777778	84	16091	11	25	73	16066	16175	0.19736565077539442
M1	string	0	network_modules	90	TRUE	1.1528471396632782e-13	134	36	12	0.3333333333333333	0.08955223880597014	GO:0007093	GO:BP	mitotic cell cycle checkpoint signaling	16175	2676		0.21678321678321677	0.2222222222222222	134	16041	12	24	122	16017	16175	0.16937053899119867
M1	string	0	network_modules	90	TRUE	1.281404723860721e-13	54	31	10	0.3225806451612903	0.18518518518518517	KEGG:03460	KEGG	Fanconi anemia pathway	8484	242		0.1	0.18181818181818182	54	8430	10	21	44	8409	8484	0.2407957765258614
M1	string	0	network_modules	90	TRUE	1.577474245562536e-13	251	36	14	0.3888888888888889	0.055776892430278883	GO:0071214	GO:BP	cellular response to abiotic stimulus	16175	16476		0.22377622377622378	0.2361111111111111	251	15924	14	22	237	15902	16175	0.14267076828050024
M1	string	0	network_modules	90	TRUE	1.577474245562536e-13	251	36	14	0.3888888888888889	0.055776892430278883	GO:0104004	GO:BP	cellular response to environmental stimulus	16175	19202		0.22377622377622378	0.2361111111111111	251	15924	14	22	237	15902	16175	0.14267076828050024
M1	string	0	network_modules	90	TRUE	2.0717076546657076e-13	98	36	11	0.3055555555555556	0.11224489795918367	GO:2001252	GO:BP	positive regulation of chromosome organization	16175	26441		0.23776223776223776	0.24305555555555555	98	16077	11	25	87	16052	16175	0.18227785319133571
M1	string	0	network_modules	90	TRUE	3.131430931349117e-13	21	35	8	0.22857142857142856	0.38095238095238093	REAC:R-HSA-5651801	REAC	PCNA-Dependent Long Patch Base Excision Repair	10916	1658		0.3958333333333333	0.4020618556701031	21	10895	8	27	13	10868	10916	0.29335337830074143
M1	string	0	network_modules	90	TRUE	3.4821171450404493e-13	36	35	9	0.2571428571428571	0.25	REAC:R-HSA-73933	REAC	Resolution of Abasic Sites (AP sites)	10916	2075		0.40625	0.41237113402061853	36	10880	9	26	27	10854	10916	0.25111113253722017
M1	string	0	network_modules	90	TRUE	3.9703286658927607e-13	23	31	8	0.25806451612903225	0.34782608695652173	KEGG:03430	KEGG	Mismatch repair	8484	239		0.2	0.2727272727272727	23	8461	8	23	15	8438	8484	0.29740151320106517
M1	string	0	network_modules	90	TRUE	4.0572511482090854e-13	69	36	10	0.2777777777777778	0.14492753623188406	GO:0032206	GO:BP	positive regulation of telomere maintenance	16175	7398		0.24475524475524477	0.25	69	16106	10	26	59	16080	16175	0.19820523407704604
M1	string	0	network_modules	90	TRUE	5.200700600958158e-13	207	36	13	0.3611111111111111	0.06280193236714976	GO:0006282	GO:BP	regulation of DNA repair	16175	2096		0.2517482517482518	0.2569444444444444	207	15968	13	23	194	15945	16175	0.14635824942399617
M1	string	0	network_modules	90	TRUE	5.49329411870307e-13	71	36	10	0.2777777777777778	0.14084507042253522	GO:0007004	GO:BP	telomere maintenance via telomerase	16175	2616		0.25874125874125875	0.2708333333333333	71	16104	10	26	61	16078	16175	0.19531746488047805
M1	string	0	network_modules	90	TRUE	5.49329411870307e-13	71	36	10	0.2777777777777778	0.14084507042253522	GO:0006278	GO:BP	RNA-templated DNA biosynthetic process	16175	2093		0.25874125874125875	0.2708333333333333	71	16104	10	26	61	16078	16175	0.19531746488047805
M1	string	0	network_modules	90	TRUE	1.2936520886701603e-12	77	36	10	0.2777777777777778	0.12987012987012986	GO:0044773	GO:BP	mitotic DNA damage checkpoint signaling	16175	11149		0.2727272727272727	0.2777777777777778	77	16098	10	26	67	16072	16175	0.18733380046946094
M1	string	0	network_modules	90	TRUE	1.6497835656985908e-12	25	35	8	0.22857142857142856	0.32	REAC:R-HSA-110373	REAC	Resolution of AP sites via the multiple-nucleotide patch replacement pathway	10916	2073		0.4166666666666667	0.422680412371134	25	10891	8	27	17	10864	10916	0.2684774149958385
M1	string	0	network_modules	90	TRUE	1.7673901896813245e-12	701	36	18	0.5	0.025677603423680456	GO:0009628	GO:BP	response to abiotic stimulus	16175	3549		0.27972027972027974	0.2847222222222222	701	15474	18	18	683	15456	16175	0.10592325949382055
M1	string	0	network_modules	90	TRUE	2.0798472632134973e-12	120	36	11	0.3055555555555556	0.09166666666666666	GO:0051053	GO:BP	negative regulation of DNA metabolic process	16175	13463		0.2867132867132867	0.2916666666666667	120	16055	11	25	109	16030	16175	0.16408802583412796
M1	string	0	network_modules	90	TRUE	2.084383665351415e-12	14	35	7	0.2	0.5	REAC:R-HSA-5358606	REAC	Mismatch repair (MMR) directed by MSH2:MSH3 (MutSbeta)	10916	1458		0.4270833333333333	0.44329896907216493	14	10902	7	28	7	10874	10916	0.3149068488319076
M1	string	0	network_modules	90	TRUE	2.084383665351415e-12	14	35	7	0.2	0.5	REAC:R-HSA-5358565	REAC	Mismatch repair (MMR) directed by MSH2:MSH6 (MutSalpha)	10916	1459		0.4270833333333333	0.44329896907216493	14	10902	7	28	7	10874	10916	0.3149068488319076
M1	string	0	network_modules	90	TRUE	2.2021662235235415e-12	81	36	10	0.2777777777777778	0.12345679012345678	GO:0044774	GO:BP	mitotic DNA integrity checkpoint signaling	16175	11150		0.2937062937062937	0.2986111111111111	81	16094	10	26	71	16068	16175	0.182506948581728
M1	string	0	network_modules	90	TRUE	3.899439283033758e-12	15	35	7	0.2	0.4666666666666667	REAC:R-HSA-5358508	REAC	Mismatch Repair	10916	1457		0.4479166666666667	0.4536082474226804	15	10901	7	28	8	10873	10916	0.30410261715057735
M1	string	0	network_modules	90	TRUE	1.0153572087854127e-11	35	36	8	0.2222222222222222	0.22857142857142856	GO:0033260	GO:BP	nuclear DNA replication	16175	8103		0.3006993006993007	0.3055555555555556	35	16140	8	28	27	16112	16175	0.22367084121334166
M1	string	0	network_modules	90	TRUE	1.129769108597481e-11	9	36	6	0.16666666666666666	0.6666666666666666	GO:0032201	GO:BP	telomere maintenance via semi-conservative replication	16175	7393		0.3076923076923077	0.3125	9	16166	6	30	3	16136	16175	0.3326833953576347
M1	string	0	network_modules	90	TRUE	1.3432506751542262e-11	437	36	15	0.4166666666666667	0.034324942791762014	GO:0080135	GO:BP	regulation of cellular response to stress	16175	17817		0.3146853146853147	0.3194444444444444	437	15738	15	21	422	15717	16175	0.11350527553637622
M1	string	0	network_modules	90	TRUE	1.6604564985137356e-11	37	36	8	0.2222222222222222	0.21621621621621623	GO:0016233	GO:BP	telomere capping	16175	5178		0.32167832167832167	0.3263888888888889	37	16138	8	28	29	16110	16175	0.21743294519655065
M1	string	0	network_modules	90	TRUE	1.7200632464272828e-11	202	36	12	0.3333333333333333	0.0594059405940594	GO:0045930	GO:BP	negative regulation of mitotic cell cycle	16175	11724		0.32867132867132864	0.3333333333333333	202	15973	12	24	190	15949	16175	0.13645312084694056
M1	string	0	network_modules	90	TRUE	2.637868308328259e-11	39	36	8	0.2222222222222222	0.20512820512820512	GO:0044786	GO:BP	cell cycle DNA replication	16175	11158		0.3356643356643357	0.3402777777777778	39	16136	8	28	31	16108	16175	0.2116784225455912
M1	string	0	network_modules	90	TRUE	2.9583605569772685e-11	104	36	10	0.2777777777777778	0.09615384615384616	GO:0032204	GO:BP	regulation of telomere maintenance	16175	7396		0.34265734265734266	0.3472222222222222	104	16071	10	26	94	16045	16175	0.16034148351227065
M1	string	0	network_modules	90	TRUE	4.644969356256444e-11	20	35	7	0.2	0.35	REAC:R-HSA-69186	REAC	Lagging Strand Synthesis	10916	1302		0.4583333333333333	0.4639175257731959	20	10896	7	28	13	10868	10916	0.26281354611700786
M1	string	0	network_modules	90	TRUE	4.894486164213568e-11	159	36	11	0.3055555555555556	0.06918238993710692	GO:1901991	GO:BP	negative regulation of mitotic cell cycle phase transition	16175	21924		0.34965034965034963	0.3541666666666667	159	16016	11	25	148	15991	16175	0.14156976649491532
M1	string	0	network_modules	90	TRUE	5.037252960415016e-11	42	36	8	0.2222222222222222	0.19047619047619047	GO:0006284	GO:BP	base-excision repair	16175	2098		0.35664335664335667	0.3611111111111111	42	16133	8	28	34	16105	16175	0.20382526814791127
M1	string	0	network_modules	90	TRUE	6.944827552693756e-11	113	36	10	0.2777777777777778	0.08849557522123894	GO:0000018	GO:BP	regulation of DNA recombination	16175	6		0.36363636363636365	0.3680555555555556	113	16062	10	26	103	16036	16175	0.15355131006070244
M1	string	0	network_modules	90	TRUE	1.0820857637882808e-10	118	36	10	0.2777777777777778	0.0847457627118644	GO:0034502	GO:BP	protein localization to chromosome	16175	8668		0.3706293706293706	0.375	118	16057	10	26	108	16031	16175	0.15011472825970684
M1	string	0	network_modules	90	TRUE	1.3317193708865775e-10	47	36	8	0.2222222222222222	0.1702127659574468	GO:0044818	GO:BP	mitotic G2/M transition checkpoint	16175	11174		0.3776223776223776	0.3819444444444444	47	16128	8	28	39	16100	16175	0.19243734482765706
M1	string	0	network_modules	90	TRUE	1.69550617589694e-10	13	31	6	0.1935483870967742	0.46153846153846156	KEGG:03450	KEGG	Non-homologous end-joining	8484	241		0.3	0.36363636363636365	13	8471	6	25	7	8446	8484	0.2972861519018535
M1	string	0	network_modules	90	TRUE	2.115539122907963e-10	12	35	6	0.17142857142857143	0.5	REAC:R-HSA-5685939	REAC	HDR through MMEJ (alt-NHEJ)	10916	1099		0.46875	0.4742268041237113	12	10904	6	29	6	10875	10916	0.2915203513509624
M1	string	0	network_modules	90	TRUE	2.848115362095861e-10	25	35	7	0.2	0.28	REAC:R-HSA-5696397	REAC	Gap-filling DNA repair synthesis and ligation in GG-NER	10916	1037		0.4791666666666667	0.4845360824742268	25	10891	7	28	18	10863	10916	0.23457807706546505
M1	string	0	network_modules	90	TRUE	3.7805245412770773e-10	29	36	7	0.19444444444444445	0.2413793103448276	GO:0006298	GO:BP	mismatch repair	16175	2107		0.38461538461538464	0.3888888888888889	29	16146	7	29	22	16117	16175	0.21507913088316352
M1	string	0	network_modules	90	TRUE	5.46255758718801e-10	77	35	9	0.2571428571428571	0.11688311688311688	REAC:R-HSA-5693565	REAC	Recruitment and ATM-mediated phosphorylation of repair and signaling proteins at DNA double strand breaks	10916	1949		0.4895833333333333	0.4948453608247423	77	10839	9	26	68	10813	10916	0.16947972401183226
M1	string	0	network_modules	90	TRUE	6.16176162693343e-10	78	35	9	0.2571428571428571	0.11538461538461539	REAC:R-HSA-5693606	REAC	DNA Double Strand Break Response	10916	442		0.5	0.5051546391752577	78	10838	9	26	69	10812	10916	0.1683358945158739
M1	string	0	network_modules	90	TRUE	6.349371349995594e-10	31	36	7	0.19444444444444445	0.22580645161290322	GO:0070198	GO:BP	protein localization to chromosome, telomeric region	16175	15981		0.3916083916083916	0.3958333333333333	31	16144	7	29	24	16115	16175	0.20790479041004392
M1	string	0	network_modules	90	TRUE	6.667555630173324e-10	15	36	6	0.16666666666666666	0.4	GO:0090737	GO:BP	telomere maintenance via telomere trimming	16175	18437		0.3986013986013986	0.4166666666666667	15	16160	6	30	9	16130	16175	0.25716771537225197
M1	string	0	network_modules	90	TRUE	6.667555630173324e-10	15	36	6	0.16666666666666666	0.4	GO:0001325	GO:BP	formation of extrachromosomal circular DNA	16175	311		0.3986013986013986	0.4166666666666667	15	16160	6	30	9	16130	16175	0.25716771537225197
M1	string	0	network_modules	90	TRUE	6.667555630173324e-10	15	36	6	0.16666666666666666	0.4	GO:0090656	GO:BP	t-circle formation	16175	18390		0.3986013986013986	0.4166666666666667	15	16160	6	30	9	16130	16175	0.25716771537225197
M1	string	0	network_modules	90	TRUE	6.844201196644111e-10	14	35	6	0.17142857142857143	0.42857142857142855	REAC:R-HSA-69166	REAC	Removal of the Flap Intermediate	10916	2058		0.5104166666666666	0.5154639175257731	14	10902	6	29	8	10873	10916	0.2696298123754246
M1	string	0	network_modules	90	TRUE	9.218633402865967e-10	59	36	8	0.2222222222222222	0.13559322033898305	GO:0010972	GO:BP	negative regulation of G2/M transition of mitotic cell cycle	16175	4548		0.4195804195804196	0.4236111111111111	59	16116	8	28	51	16088	16175	0.17123885750648588
M1	string	0	network_modules	90	TRUE	1.096949157222771e-9	286	36	12	0.3333333333333333	0.04195804195804196	GO:1901990	GO:BP	regulation of mitotic cell cycle phase transition	16175	21923		0.42657342657342656	0.4305555555555556	286	15889	12	24	274	15865	16175	0.11311861996549832
M1	string	0	network_modules	90	TRUE	1.138100573251997e-9	15	35	6	0.17142857142857143	0.4	REAC:R-HSA-69183	REAC	Processive synthesis on the lagging strand	10916	1802		0.5208333333333334	0.5257731958762887	15	10901	6	29	9	10872	10916	0.26035883799452025
M1	string	0	network_modules	90	TRUE	1.2204716701177206e-9	61	36	8	0.2222222222222222	0.13114754098360656	GO:0035825	GO:BP	homologous recombination	16175	9273		0.43356643356643354	0.4444444444444444	61	16114	8	28	53	16086	16175	0.1683234445132038
M1	string	0	network_modules	90	TRUE	1.2204716701177206e-9	61	36	8	0.2222222222222222	0.13114754098360656	GO:1902750	GO:BP	negative regulation of cell cycle G2/M phase transition	16175	22476		0.43356643356643354	0.4444444444444444	61	16114	8	28	53	16086	16175	0.1683234445132038
M1	string	0	network_modules	90	TRUE	1.963076530980686e-9	32	35	7	0.2	0.21875	REAC:R-HSA-69190	REAC	DNA strand elongation	10916	449		0.53125	0.5360824742268041	32	10884	7	28	25	10856	10916	0.2067336395792905
M1	string	0	network_modules	90	TRUE	2.3036773161182876e-9	36	31	7	0.22580645161290322	0.19444444444444445	KEGG:03030	KEGG	DNA replication	8484	214		0.4	0.45454545454545453	36	8448	7	24	29	8424	8484	0.20641698948194387
M1	string	0	network_modules	90	TRUE	2.7335988572586983e-9	229	36	11	0.3055555555555556	0.048034934497816595	GO:0033044	GO:BP	regulation of chromosome organization	16175	7999		0.44755244755244755	0.4513888888888889	229	15946	11	25	218	15921	16175	0.11649305448750458
M1	string	0	network_modules	90	TRUE	3.928595471921738e-9	8	36	5	0.1388888888888889	0.625	GO:0110025	GO:BP	DNA strand resection involved in replication fork processing	16175	19356		0.45454545454545453	0.4583333333333333	8	16167	5	31	3	16136	16175	0.2939785982905517
M1	string	0	network_modules	90	TRUE	4.309663257802378e-9	114	36	9	0.25	0.07894736842105263	GO:0000086	GO:BP	G2/M transition of mitotic cell cycle	16175	34		0.46153846153846156	0.4652777777777778	114	16061	9	27	105	16034	16175	0.13716368539842563
M1	string	0	network_modules	90	TRUE	4.9053796744918735e-9	656	36	15	0.4166666666666667	0.022865853658536585	GO:1903047	GO:BP	mitotic cell cycle process	16175	22727		0.46853146853146854	0.4722222222222222	656	15519	15	21	641	15498	16175	0.0900510155131722
M1	string	0	network_modules	90	TRUE	5.789212350661189e-9	427	36	13	0.3611111111111111	0.03044496487119438	GO:0007346	GO:BP	regulation of mitotic cell cycle	16175	2855		0.4755244755244755	0.4791666666666667	427	15748	13	23	414	15725	16175	0.09860576850218145
M1	string	0	network_modules	90	TRUE	1.2409261820219086e-8	128	36	9	0.25	0.0703125	GO:0044839	GO:BP	cell cycle G2/M phase transition	16175	11188		0.4825174825174825	0.4861111111111111	128	16047	9	27	119	16020	16175	0.12904048451702532
M1	string	0	network_modules	90	TRUE	1.3277757085825246e-8	23	36	6	0.16666666666666666	0.2608695652173913	GO:0010332	GO:BP	response to gamma radiation	16175	4062		0.48951048951048953	0.4930555555555556	23	16152	6	30	17	16122	16175	0.20711318504989826
M1	string	0	network_modules	90	TRUE	2.1157818975899377e-8	86	36	8	0.2222222222222222	0.09302325581395349	GO:0010389	GO:BP	regulation of G2/M transition of mitotic cell cycle	16175	4098		0.4965034965034965	0.5	86	16089	8	28	78	16061	16175	0.1408684681843222
M1	string	0	network_modules	90	TRUE	2.263090790130575e-8	370	36	12	0.3333333333333333	0.032432432432432434	GO:0044772	GO:BP	mitotic cell cycle phase transition	16175	11148		0.5034965034965035	0.5069444444444444	370	15805	12	24	358	15781	16175	0.09807599182267704
M1	string	0	network_modules	90	TRUE	3.532196584715245e-8	79	35	8	0.22857142857142856	0.10126582278481013	REAC:R-HSA-2559586	REAC	DNA Damage/Telomere Stress Induced Senescence	10916	441		0.5416666666666666	0.5463917525773195	79	10837	8	27	71	10810	10916	0.14809618535970914
M1	string	0	network_modules	90	TRUE	5.105481782737283e-8	26	35	6	0.17142857142857143	0.23076923076923078	REAC:R-HSA-174411	REAC	Polymerase switching on the C-strand of the telomere	10916	1770		0.5520833333333334	0.5567010309278351	26	10890	6	29	20	10861	10916	0.1966841426675762
M1	string	0	network_modules	90	TRUE	5.837502762796063e-8	84	35	8	0.22857142857142856	0.09523809523809523	REAC:R-HSA-5696399	REAC	Global Genome Nucleotide Excision Repair (GG-NER)	10916	1047		0.5625	0.5670103092783505	84	10832	8	27	76	10805	10916	0.14335680001376672
M1	string	0	network_modules	90	TRUE	6.159696285541879e-8	98	36	8	0.2222222222222222	0.08163265306122448	GO:1902749	GO:BP	regulation of cell cycle G2/M phase transition	16175	22475		0.5104895104895105	0.5138888888888888	98	16077	8	28	90	16049	16175	0.1315600494096791
M1	string	0	network_modules	90	TRUE	7.166034648129088e-8	792	36	15	0.4166666666666667	0.01893939393939394	GO:0000278	GO:BP	mitotic cell cycle	16175	76		0.5174825174825175	0.5208333333333334	792	15383	15	21	777	15362	16175	0.0804767379883082
M1	string	0	network_modules	90	TRUE	9.561867364117712e-8	31	36	6	0.16666666666666666	0.1935483870967742	GO:0007095	GO:BP	mitotic G2 DNA damage checkpoint signaling	16175	2678		0.5244755244755245	0.5277777777777778	31	16144	6	30	25	16114	16175	0.17790844769998085
M1	string	0	network_modules	90	TRUE	1.1313834895099917e-7	61	31	7	0.22580645161290322	0.11475409836065574	KEGG:03420	KEGG	Nucleotide excision repair	8484	238		0.5	0.5454545454545454	61	8423	7	24	54	8399	8484	0.15669696540540232
M1	string	0	network_modules	90	TRUE	1.3047625992906996e-7	30	35	6	0.17142857142857143	0.2	REAC:R-HSA-110314	REAC	Recognition of DNA damage by PCNA-containing replication complex	10916	1948		0.5729166666666666	0.5773195876288659	30	10886	6	29	24	10857	10916	0.18273963254484063
M1	string	0	network_modules	90	TRUE	1.982197897825886e-7	32	35	6	0.17142857142857143	0.1875	REAC:R-HSA-5656169	REAC	Termination of translesion DNA synthesis	10916	2492		0.5833333333333334	0.5876288659793815	32	10884	6	29	26	10855	10916	0.17676094115651603
M1	string	0	network_modules	90	TRUE	2.3835833154547927e-7	61	35	7	0.2	0.11475409836065574	REAC:R-HSA-6796648	REAC	TP53 Regulates Transcription of DNA Repair Genes	10916	2456		0.59375	0.5979381443298969	61	10855	7	28	54	10827	10916	0.14791291493024397
M1	string	0	network_modules	90	TRUE	2.990418671098264e-7	37	36	6	0.16666666666666666	0.16216216216216217	GO:0032205	GO:BP	negative regulation of telomere maintenance	16175	7397		0.5314685314685315	0.5347222222222222	37	16138	6	30	31	16108	16175	0.16250934385110594
M1	string	0	network_modules	90	TRUE	3.0092212280144997e-7	63	35	7	0.2	0.1111111111111111	REAC:R-HSA-6782210	REAC	Gap-filling DNA repair synthesis and ligation in TC-NER	10916	1038		0.6041666666666666	0.6082474226804123	63	10853	7	28	56	10825	10916	0.1454223876632596
M1	string	0	network_modules	90	TRUE	3.5955060618135054e-7	16	35	5	0.14285714285714285	0.3125	REAC:R-HSA-110312	REAC	Translesion synthesis by REV1	10916	2576		0.6145833333333334	0.6185567010309279	16	10900	5	30	11	10870	10916	0.20961044126044318
M1	string	0	network_modules	90	TRUE	4.2790739028072486e-7	17	36	5	0.1388888888888889	0.29411764705882354	GO:0071480	GO:BP	cellular response to gamma radiation	16175	16713		0.5384615384615384	0.5416666666666666	17	16158	5	31	12	16127	16175	0.20091278076238275
M1	string	0	network_modules	90	TRUE	4.4370488360182836e-7	6	35	4	0.11428571428571428	0.6666666666666666	REAC:R-HSA-5693548	REAC	Sensing of DNA Double Strand Breaks	10916	2195		0.625	0.6288659793814433	6	10910	4	31	2	10879	10916	0.27521578054986434
M1	string	0	network_modules	90	TRUE	4.813251448828991e-7	109	35	8	0.22857142857142856	0.07339449541284404	REAC:R-HSA-5696398	REAC	Nucleotide Excision Repair	10916	1622		0.6354166666666666	0.6391752577319587	109	10807	8	27	101	10780	10916	0.12468661444198031
M1	string	0	network_modules	90	TRUE	5.081961090537446e-7	17	35	5	0.14285714285714285	0.29411764705882354	REAC:R-HSA-5655862	REAC	Translesion synthesis by POLK	10916	2575		0.6458333333333334	0.6597938144329897	17	10899	5	30	12	10869	10916	0.20322956678892806
M1	string	0	network_modules	90	TRUE	5.081961090537446e-7	17	35	5	0.14285714285714285	0.29411764705882354	REAC:R-HSA-5656121	REAC	Translesion synthesis by POLI	10916	2574		0.6458333333333334	0.6597938144329897	17	10899	5	30	12	10869	10916	0.20322956678892806
M1	string	0	network_modules	90	TRUE	6.44791266125859e-7	44	31	6	0.1935483870967742	0.13636363636363635	KEGG:03410	KEGG	Base excision repair	8484	237		0.6	0.6363636363636364	44	8440	6	25	38	8415	8484	0.1588079206256297
M1	string	0	network_modules	90	TRUE	7.02348845696285e-7	39	35	6	0.17142857142857143	0.15384615384615385	REAC:R-HSA-110313	REAC	Translesion synthesis by Y family DNA polymerases bypasses lesions on DNA template	10916	2577		0.6666666666666666	0.6701030927835051	39	10877	6	29	33	10848	10916	0.15955584446714877
M1	string	0	network_modules	90	TRUE	8.01522292945338e-7	19	36	5	0.1388888888888889	0.2631578947368421	GO:2000001	GO:BP	regulation of DNA damage checkpoint	16175	25365		0.5454545454545454	0.5486111111111112	19	16156	5	31	14	16125	16175	0.1898857373553742
M1	string	0	network_modules	90	TRUE	8.979533331037592e-7	44	36	6	0.16666666666666666	0.13636363636363635	GO:0032508	GO:BP	DNA duplex unwinding	16175	7615		0.5524475524475524	0.5555555555555556	44	16131	6	30	38	16101	16175	0.1486627564609764
M1	string	0	network_modules	90	TRUE	9.505900989840367e-7	19	35	5	0.14285714285714285	0.2631578947368421	REAC:R-HSA-110320	REAC	Translesion Synthesis by POLH	10916	2573		0.6770833333333334	0.6804123711340206	19	10897	5	30	14	10867	10916	0.1920042784755707
M1	string	0	network_modules	90	TRUE	9.635325448685284e-7	41	35	6	0.17142857142857143	0.14634146341463414	REAC:R-HSA-5696400	REAC	Dual Incision in GG-NER	10916	807		0.6875	0.6907216494845361	41	10875	6	29	35	10846	10916	0.1554600221586241
M1	string	0	network_modules	90	TRUE	1.0669888613611438e-6	20	36	5	0.1388888888888889	0.25	GO:0006312	GO:BP	mitotic recombination	16175	2117		0.5594405594405595	0.5625	20	16155	5	31	15	16124	16175	0.18500036202228937
M1	string	0	network_modules	90	TRUE	1.2408612756041756e-6	7	36	4	0.1111111111111111	0.5714285714285714	GO:1904354	GO:BP	negative regulation of telomere capping	16175	23741		0.5664335664335665	0.5694444444444444	7	16168	4	32	3	16136	16175	0.2513290635694357
M1	string	0	network_modules	90	TRUE	1.267324529262153e-6	77	35	7	0.2	0.09090909090909091	REAC:R-HSA-6781827	REAC	Transcription-Coupled Nucleotide Excision Repair (TC-NER)	10916	2541		0.6979166666666666	0.7010309278350515	77	10839	7	28	70	10811	10916	0.13075528592638583
M1	string	0	network_modules	90	TRUE	1.6441284602299273e-6	90	36	7	0.19444444444444445	0.07777777777777778	GO:2001251	GO:BP	negative regulation of chromosome organization	16175	26440		0.5734265734265734	0.5763888888888888	90	16085	7	29	83	16056	16175	0.11992565817253263
M1	string	0	network_modules	90	TRUE	1.8341667331449081e-6	420	36	11	0.3055555555555556	0.02619047619047619	GO:0010638	GO:BP	positive regulation of organelle organization	16175	4284		0.5804195804195804	0.5833333333333334	420	15755	11	25	409	15730	16175	0.08303177622478189
M1	string	0	network_modules	90	TRUE	2.5569310970694314e-6	52	36	6	0.16666666666666666	0.11538461538461539	GO:0032392	GO:BP	DNA geometric change	16175	7543		0.5874125874125874	0.5902777777777778	52	16123	6	30	46	16093	16175	0.13637112229294657
M1	string	0	network_modules	90	TRUE	2.5879620121148563e-6	48	35	6	0.17142857142857143	0.125	REAC:R-HSA-73893	REAC	DNA Damage Bypass	10916	438		0.7083333333333334	0.711340206185567	48	10868	6	29	42	10839	10916	0.14317451418598653
M1	string	0	network_modules	90	TRUE	4.4529689461671876e-6	9	36	4	0.1111111111111111	0.4444444444444444	GO:0061820	GO:BP	telomeric D-loop disassembly	16175	15679		0.5944055944055944	0.5972222222222222	9	16166	4	32	5	16134	16175	0.22141747058229524
M1	string	0	network_modules	90	TRUE	6.20814269479609e-6	60	36	6	0.16666666666666666	0.1	GO:0071103	GO:BP	DNA conformation change	16175	16453		0.6013986013986014	0.6041666666666666	60	16115	6	30	54	16085	16175	0.1266018655607181
M1	string	0	network_modules	90	TRUE	7.598860872737447e-6	62	36	6	0.16666666666666666	0.0967741935483871	GO:0006303	GO:BP	double-strand break repair via nonhomologous end joining	16175	2110		0.6083916083916084	0.6111111111111112	62	16113	6	30	56	16083	16175	0.12445638466660794
M1	string	0	network_modules	90	TRUE	1.1625644430919912e-5	11	36	4	0.1111111111111111	0.36363636363636365	GO:0090657	GO:BP	telomeric loop disassembly	16175	18391		0.6153846153846154	0.6180555555555556	11	16164	4	32	7	16132	16175	0.20006801543837807
M1	string	0	network_modules	90	TRUE	1.524395583311955e-5	64	35	6	0.17142857142857143	0.09375	REAC:R-HSA-6782135	REAC	Dual incision in TC-NER	10916	808		0.71875	0.7216494845360825	64	10852	6	29	58	10823	10916	0.12299527247158983
M1	string	0	network_modules	90	TRUE	1.7410862976163055e-5	12	36	4	0.1111111111111111	0.3333333333333333	GO:0090399	GO:BP	replicative senescence	16175	18270		0.6223776223776224	0.625	12	16163	4	32	8	16131	16175	0.1914492257542533
M1	string	0	network_modules	90	TRUE	1.745698159094821e-5	3	36	3	0.08333333333333333	1	GO:0097695	GO:BP	establishment of protein-containing complex localization to telomere	16175	18726		0.6293706293706294	0.6388888888888888	3	16172	3	33	0	16139	16175	0.2883804541547979
M1	string	0	network_modules	90	TRUE	1.745698159094821e-5	3	36	3	0.08333333333333333	1	GO:0097694	GO:BP	establishment of RNA localization to telomere	16175	18725		0.6293706293706294	0.6388888888888888	3	16172	3	33	0	16139	16175	0.2883804541547979
M1	string	0	network_modules	90	TRUE	1.959233370582849e-5	128	36	7	0.19444444444444445	0.0546875	GO:2000779	GO:BP	regulation of double-strand break repair	16175	26035		0.6433566433566433	0.6458333333333334	128	16047	7	29	121	16018	16175	0.09942745682880207
M1	string	0	network_modules	90	TRUE	2.0683854205837535e-5	129	36	7	0.19444444444444445	0.05426356589147287	GO:0009411	GO:BP	response to UV	16175	3476		0.6503496503496503	0.6527777777777778	129	16046	7	29	122	16017	16175	0.09901158818069891
M1	string	0	network_modules	90	TRUE	2.0815773188846305e-5	13	35	4	0.11428571428571428	0.3076923076923077	REAC:R-HSA-3270619	REAC	IRF3-mediated induction of type I IFN	10916	1162		0.7291666666666666	0.7319587628865979	13	10903	4	31	9	10872	10916	0.18597779996168648
M1	string	0	network_modules	90	TRUE	2.7026761235101655e-5	304	36	9	0.25	0.029605263157894735	GO:0010639	GO:BP	negative regulation of organelle organization	16175	4285		0.6573426573426573	0.6597222222222222	304	15871	9	27	295	15844	16175	0.08041120546991436
M1	string	0	network_modules	90	TRUE	3.0128186963338837e-5	121	35	7	0.2	0.05785123966942149	REAC:R-HSA-69239	REAC	Synthesis of DNA	10916	2376		0.7395833333333334	0.7422680412371134	121	10795	7	28	114	10767	10916	0.10233551772747479
M1	string	0	network_modules	90	TRUE	3.3440561357692994e-5	79	36	6	0.16666666666666666	0.0759493670886076	GO:0006289	GO:BP	nucleotide-excision repair	16175	2102		0.6643356643356644	0.6666666666666666	79	16096	6	30	73	16066	16175	0.10960149433413484
M1	string	0	network_modules	90	TRUE	3.395283853918421e-5	187	35	8	0.22857142857142856	0.0427807486631016	REAC:R-HSA-69306	REAC	DNA Replication	10916	445		0.75	0.7525773195876289	187	10729	8	27	179	10702	10916	0.09241684200778455
M1	string	0	network_modules	90	TRUE	3.419283172330883e-5	37	35	5	0.14285714285714285	0.13513513513513514	REAC:R-HSA-176187	REAC	Activation of ATR in response to replication stress	10916	75		0.7604166666666666	0.7628865979381443	37	10879	5	30	32	10849	10916	0.13609469366337779
M1	string	0	network_modules	90	TRUE	4.32475259419224e-5	76	35	6	0.17142857142857143	0.07894736842105263	REAC:R-HSA-1221632	REAC	Meiotic synapsis	10916	1412		0.7708333333333334	0.7731958762886598	76	10840	6	29	70	10811	10916	0.1121808345282501
M1	string	0	network_modules	90	TRUE	4.4956984476603064e-5	39	35	5	0.14285714285714285	0.1282051282051282	REAC:R-HSA-6783310	REAC	Fanconi Anemia Pathway	10916	932		0.78125	0.7835051546391752	39	10877	5	30	34	10847	10916	0.13239719111380333
M1	string	0	network_modules	90	TRUE	4.5102929521963756e-5	194	35	8	0.22857142857142856	0.041237113402061855	REAC:R-HSA-2559583	REAC	Cellular Senescence	10916	331		0.7916666666666666	0.7938144329896907	194	10722	8	27	186	10695	10916	0.09048855369985902
M1	string	0	network_modules	90	TRUE	4.98705278573693e-5	41	36	5	0.1388888888888889	0.12195121951219512	GO:1901976	GO:BP	regulation of cell cycle checkpoint	16175	21911		0.6713286713286714	0.6736111111111112	41	16134	5	31	36	16103	16175	0.12807445510706664
M1	string	0	network_modules	90	TRUE	5.211538664899319e-5	85	36	6	0.16666666666666666	0.07058823529411765	GO:2000278	GO:BP	regulation of DNA biosynthetic process	16175	25603		0.6783216783216783	0.6805555555555556	85	16090	6	30	79	16060	16175	0.10543980729359816
M1	string	0	network_modules	90	TRUE	5.262522742260368e-5	16	35	4	0.11428571428571428	0.25	REAC:R-HSA-1834941	REAC	STING mediated induction of host immune responses	10916	2162		0.8020833333333334	0.8041237113402062	16	10900	4	31	12	10869	10916	0.16725376638448985
M1	string	0	network_modules	90	TRUE	5.6519325639099065e-5	42	36	5	0.1388888888888889	0.11904761904761904	GO:0045910	GO:BP	negative regulation of DNA recombination	16175	11704		0.6853146853146853	0.6875	42	16133	5	31	37	16102	16175	0.12648711963610879
M1	string	0	network_modules	90	TRUE	6.97210601025076e-5	4	36	3	0.08333333333333333	0.75	GO:0031860	GO:BP	telomeric 3' overhang formation	16175	7276		0.6923076923076923	0.6944444444444444	4	16171	3	33	1	16138	16175	0.24956682001728187
M1	string	0	network_modules	90	TRUE	7.623436122860794e-5	155	31	7	0.22580645161290322	0.04516129032258064	KEGG:04218	KEGG	Cellular senescence	8484	295		0.7	0.7272727272727273	155	8329	7	24	148	8305	8484	0.09384450334355379
M1	string	0	network_modules	90	TRUE	8.312325709297336e-5	157	31	7	0.22580645161290322	0.044585987261146494	KEGG:04110	KEGG	Cell cycle	8484	264		0.8	0.8181818181818182	157	8327	7	24	150	8303	8484	0.09315012090603805
M1	string	0	network_modules	90	TRUE	1.582793750817676e-4	808	36	12	0.3333333333333333	0.01485148514851485	GO:0033365	GO:BP	protein localization to organelle	16175	8175		0.6993006993006993	0.7013888888888888	808	15367	12	24	796	15343	16175	0.06143639739424679
M1	string	0	network_modules	90	TRUE	1.6826944781200544e-4	20	36	4	0.1111111111111111	0.2	GO:0000729	GO:BP	DNA double-strand break processing	16175	206		0.7062937062937062	0.7083333333333334	20	16155	4	32	16	16123	16175	0.147667932907318
M1	string	0	network_modules	90	TRUE	1.7403590754787806e-4	5	36	3	0.08333333333333333	0.6	GO:0000019	GO:BP	regulation of mitotic recombination	16175	7		0.7132867132867133	0.7152777777777778	5	16170	3	33	2	16137	16175	0.2230601506959967
M1	string	0	network_modules	90	TRUE	1.8734005748766435e-4	53	36	5	0.1388888888888889	0.09433962264150944	GO:0140527	GO:BP	reciprocal homologous recombination	16175	19808		0.7202797202797203	0.7291666666666666	53	16122	5	31	48	16091	16175	0.11207498382276695
M1	string	0	network_modules	90	TRUE	1.8734005748766435e-4	53	36	5	0.1388888888888889	0.09433962264150944	GO:0007131	GO:BP	reciprocal meiotic recombination	16175	2702		0.7202797202797203	0.7291666666666666	53	16122	5	31	48	16091	16175	0.11207498382276695
M1	string	0	network_modules	90	TRUE	2.061264462895287e-4	54	36	5	0.1388888888888889	0.09259259259259259	GO:0032210	GO:BP	regulation of telomere maintenance via telomerase	16175	7402		0.7342657342657343	0.7361111111111112	54	16121	5	31	49	16090	16175	0.11098522708070846
M1	string	0	network_modules	90	TRUE	2.2156480433863554e-4	162	35	7	0.2	0.043209876543209874	REAC:R-HSA-69242	REAC	S Phase	10916	2111		0.8125	0.8144329896907216	162	10754	7	28	155	10726	10916	0.08684931216644133
M1	string	0	network_modules	90	TRUE	2.730678065737382e-4	112	36	6	0.16666666666666666	0.05357142857142857	GO:0006275	GO:BP	regulation of DNA replication	16175	2090		0.7412587412587412	0.7430555555555556	112	16063	6	30	106	16033	16175	0.09098191951285886
M1	string	0	network_modules	90	TRUE	3.191984390784403e-4	171	35	7	0.2	0.04093567251461988	REAC:R-HSA-3108232	REAC	SUMO E3 ligases SUMOylate target proteins	10916	2163		0.8229166666666666	0.8247422680412371	171	10745	7	28	164	10717	10916	0.0841917422012721
M1	string	0	network_modules	90	TRUE	4.0258084760021905e-4	177	35	7	0.2	0.03954802259887006	REAC:R-HSA-2990846	REAC	SUMOylation	10916	2167		0.8333333333333334	0.8350515463917526	177	10739	7	28	170	10711	10916	0.0825287540853648
M1	string	0	network_modules	90	TRUE	4.3587563553662995e-4	25	36	4	0.1111111111111111	0.16	GO:1904353	GO:BP	regulation of telomere capping	16175	23740		0.7482517482517482	0.75	25	16150	4	32	21	16118	16175	0.1317270147774988
M1	string	0	network_modules	90	TRUE	4.5157946856668553e-4	63	36	5	0.1388888888888889	0.07936507936507936	GO:1904356	GO:BP	regulation of telomere maintenance via telomere lengthening	16175	23743		0.7552447552447552	0.7569444444444444	63	16112	5	31	58	16081	16175	0.1023591473187153
M1	string	0	network_modules	90	TRUE	5.852368572641143e-4	577	36	10	0.2777777777777778	0.01733102253032929	GO:0043085	GO:BP	positive regulation of catalytic activity	16175	10518		0.7622377622377622	0.7638888888888888	577	15598	10	26	567	15572	16175	0.06165089977255604
M1	string	0	network_modules	90	TRUE	6.437275113794164e-4	583	36	10	0.2777777777777778	0.017152658662092625	GO:0051129	GO:BP	negative regulation of cellular component organization	16175	13513		0.7692307692307693	0.7708333333333334	583	15592	10	26	573	15566	16175	0.06125064652527311
M1	string	0	network_modules	90	TRUE	6.558931872520943e-4	66	35	5	0.14285714285714285	0.07575757575757576	REAC:R-HSA-9670095	REAC	Inhibition of DNA recombination at telomere	10916	1189		0.84375	0.845360824742268	66	10850	5	30	61	10820	10916	0.10009150879209842
M1	string	0	network_modules	90	TRUE	7.071626337505836e-4	67	35	5	0.14285714285714285	0.07462686567164178	REAC:R-HSA-3371453	REAC	Regulation of HSF1-mediated heat shock response	10916	1977		0.8541666666666666	0.8556701030927835	67	10849	5	30	62	10819	10916	0.09927980506693666
M1	string	0	network_modules	90	TRUE	8.056209538369035e-4	220	36	7	0.19444444444444445	0.031818181818181815	GO:0009416	GO:BP	response to light stimulus	16175	3480		0.7762237762237763	0.7777777777777778	220	15955	7	29	213	15926	16175	0.07373941478497295
M1	string	0	network_modules	90	TRUE	8.258490744425357e-4	71	36	5	0.1388888888888889	0.07042253521126761	GO:0030330	GO:BP	DNA damage response, signal transduction by p53 class mediator	16175	6779		0.7832167832167832	0.7916666666666666	71	16104	5	31	66	16073	16175	0.09609073540443835
M1	string	0	network_modules	90	TRUE	8.258490744425357e-4	71	36	5	0.1388888888888889	0.07042253521126761	GO:0010569	GO:BP	regulation of double-strand break repair via homologous recombination	16175	4222		0.7832167832167832	0.7916666666666666	71	16104	5	31	66	16073	16175	0.09609073540443835
M1	string	0	network_modules	90	TRUE	0.0010128118688611356	72	35	5	0.14285714285714285	0.06944444444444445	REAC:R-HSA-3108214	REAC	SUMOylation of DNA damage response and repair proteins	10916	2168		0.8645833333333334	0.865979381443299	72	10844	5	30	67	10814	10916	0.09547171713726142
M1	string	0	network_modules	90	TRUE	0.0010739222658415811	31	36	4	0.1111111111111111	0.12903225806451613	GO:0044819	GO:BP	mitotic G1/S transition checkpoint signaling	16175	11175		0.7972027972027972	0.8055555555555556	31	16144	4	32	27	16112	16175	0.11791576227985472
M1	string	0	network_modules	90	TRUE	0.0010739222658415811	31	36	4	0.1111111111111111	0.12903225806451613	GO:0031571	GO:BP	mitotic G1 DNA damage checkpoint signaling	16175	7221		0.7972027972027972	0.8055555555555556	31	16144	4	32	27	16112	16175	0.11791576227985472
M1	string	0	network_modules	90	TRUE	0.001419565065467545	148	36	6	0.16666666666666666	0.04054054054054054	GO:0072331	GO:BP	signal transduction by p53 class mediator	16175	17354		0.8111888111888111	0.8125	148	16027	6	30	142	15997	16175	0.07813164688663747
M1	string	0	network_modules	90	TRUE	0.0017757983828634956	35	36	4	0.1111111111111111	0.11428571428571428	GO:0006301	GO:BP	postreplication repair	16175	2108		0.8181818181818182	0.8194444444444444	35	16140	4	32	31	16108	16175	0.11073574345695641
M1	string	0	network_modules	90	TRUE	0.0021857134918956563	12	35	3	0.08571428571428572	0.25	REAC:R-HSA-3371511	REAC	HSF1 activation	10916	1109		0.875	0.8762886597938144	12	10904	3	32	9	10872	10916	0.1448194406305537
M1	string	0	network_modules	90	TRUE	0.002232844510180945	37	36	4	0.1111111111111111	0.10810810810810811	GO:0022616	GO:BP	DNA strand elongation	16175	6623		0.8251748251748252	0.8263888888888888	37	16138	4	32	33	16106	16175	0.10758574250566122
M1	string	0	network_modules	90	TRUE	0.0025841639817163276	87	35	5	0.14285714285714285	0.05747126436781609	REAC:R-HSA-3371556	REAC	Cellular response to heat stress	10916	334		0.8854166666666666	0.8865979381443299	87	10829	5	30	82	10799	10916	0.08603596810449472
M1	string	0	network_modules	90	TRUE	0.0028351828075077012	13	35	3	0.08571428571428572	0.23076923076923078	REAC:R-HSA-174430	REAC	Telomere C-strand synthesis initiation	10916	2487		0.8958333333333334	0.8969072164948454	13	10903	3	32	10	10871	10916	0.1389937534810512
M1	string	0	network_modules	90	TRUE	0.0028453308736827525	11	36	3	0.08333333333333333	0.2727272727272727	GO:0000722	GO:BP	telomere maintenance via recombination	16175	201		0.8321678321678322	0.8333333333333334	11	16164	3	33	8	16131	16175	0.14974299444876987
M1	string	0	network_modules	90	TRUE	0.0033515324625327954	2	35	2	0.05714285714285714	1	REAC:R-HSA-9699150	REAC	Defective DNA double strand break response due to BARD1 loss of function	10916	531		0.90625	0.9175257731958762	2	10914	2	33	0	10881	10916	0.2386840542447829
M1	string	0	network_modules	90	TRUE	0.0033515324625327954	2	35	2	0.05714285714285714	1	REAC:R-HSA-9663199	REAC	Defective DNA double strand break response due to BRCA1 loss of function	10916	532		0.90625	0.9175257731958762	2	10914	2	33	0	10881	10916	0.2386840542447829
M1	string	0	network_modules	90	TRUE	0.00335587499801756	43	35	4	0.11428571428571428	0.09302325581395349	REAC:R-HSA-5696395	REAC	Formation of Incision Complex in GG-NER	10916	948		0.9270833333333334	0.9278350515463918	43	10873	4	31	39	10842	10916	0.0999109185707876
M1	string	0	network_modules	90	TRUE	0.003600484701817358	14	35	3	0.08571428571428572	0.21428571428571427	REAC:R-HSA-69109	REAC	Leading Strand Synthesis	10916	1308		0.9375	0.9587628865979382	14	10902	3	32	11	10870	10916	0.13379870300597554
M1	string	0	network_modules	90	TRUE	0.003600484701817358	14	35	3	0.08571428571428572	0.21428571428571427	REAC:R-HSA-162594	REAC	Early Phase of HIV Life Cycle	10916	831		0.9375	0.9587628865979382	14	10902	3	32	11	10870	10916	0.13379870300597554
M1	string	0	network_modules	90	TRUE	0.003600484701817358	14	35	3	0.08571428571428572	0.21428571428571427	REAC:R-HSA-69091	REAC	Polymerase switching	10916	1769		0.9375	0.9587628865979382	14	10902	3	32	11	10870	10916	0.13379870300597554
M1	string	0	network_modules	90	TRUE	0.004132783955023127	43	36	4	0.1111111111111111	0.09302325581395349	GO:0090329	GO:BP	regulation of DNA-templated DNA replication	16175	18209		0.8391608391608392	0.8402777777777778	43	16132	4	32	39	16100	16175	0.09947620609019797
M1	string	0	network_modules	90	TRUE	0.004337970349106521	99	36	5	0.1388888888888889	0.050505050505050504	GO:0007127	GO:BP	meiosis I	16175	2698		0.8461538461538461	0.8472222222222222	99	16076	5	31	94	16045	16175	0.08039797932154329
M1	string	0	network_modules	90	TRUE	0.004446701482554502	180	36	6	0.16666666666666666	0.03333333333333333	GO:0046777	GO:BP	protein autophosphorylation	16175	12365		0.8531468531468531	0.8541666666666666	180	15995	6	30	174	15965	16175	0.07002714681188613
M1	string	0	network_modules	90	TRUE	0.004916829375616961	13	36	3	0.08333333333333333	0.23076923076923078	GO:0006287	GO:BP	base-excision repair, gap-filling	16175	2100		0.8601398601398601	0.8680555555555556	13	16162	3	33	10	16129	16175	0.1375459691023551
M1	string	0	network_modules	90	TRUE	0.004916829375616961	13	36	3	0.08333333333333333	0.23076923076923078	GO:0010165	GO:BP	response to X-ray	16175	3964		0.8601398601398601	0.8680555555555556	13	16162	3	33	10	16129	16175	0.1375459691023551
M1	string	0	network_modules	90	TRUE	0.005935419460083595	47	36	4	0.1111111111111111	0.0851063829787234	GO:0016445	GO:BP	somatic diversification of immunoglobulins	16175	5224		0.8741258741258742	0.875	47	16128	4	32	43	16096	16175	0.09494387370329985
M1	string	0	network_modules	90	TRUE	0.00624821086171651	14	36	3	0.08333333333333333	0.21428571428571427	GO:0006266	GO:BP	DNA ligation	16175	2081		0.8811188811188811	0.8819444444444444	14	16161	3	33	11	16128	16175	0.13244742079327596
M1	string	0	network_modules	90	TRUE	0.006365752894807788	107	36	5	0.1388888888888889	0.04672897196261682	GO:0061982	GO:BP	meiosis I cell cycle process	16175	15766		0.8881118881118881	0.8888888888888888	107	16068	5	31	102	16037	16175	0.07706515718957292
M1	string	0	network_modules	90	TRUE	0.006673031669322927	51	35	4	0.11428571428571428	0.0784313725490196	REAC:R-HSA-171306	REAC	Packaging Of Telomere Ends	10916	1712		0.96875	0.9690721649484536	51	10865	4	31	47	10834	10916	0.0911649550571961
M1	string	0	network_modules	90	TRUE	0.007798317540910174	15	36	3	0.08333333333333333	0.2	GO:0031573	GO:BP	mitotic intra-S DNA damage checkpoint signaling	16175	7222		0.8951048951048951	0.8958333333333334	15	16160	3	33	12	16127	16175	0.12786439562882096
M1	string	0	network_modules	90	TRUE	0.008303875390306035	2	36	2	0.05555555555555555	1	GO:1905838	GO:BP	regulation of telomeric D-loop disassembly	16175	24948		0.9020979020979021	0.9791666666666666	2	16173	2	34	0	16139	16175	0.23545437524377763
M1	string	0	network_modules	90	TRUE	0.008303875390306035	2	36	2	0.05555555555555555	1	GO:0032214	GO:BP	negative regulation of telomere maintenance via semi-conservative replication	16175	7406		0.9020979020979021	0.9791666666666666	2	16173	2	34	0	16139	16175	0.23545437524377763
M1	string	0	network_modules	90	TRUE	0.008303875390306035	2	36	2	0.05555555555555555	1	GO:1905839	GO:BP	negative regulation of telomeric D-loop disassembly	16175	24949		0.9020979020979021	0.9791666666666666	2	16173	2	34	0	16139	16175	0.23545437524377763
M1	string	0	network_modules	90	TRUE	0.008303875390306035	2	36	2	0.05555555555555555	1	GO:0048239	GO:BP	negative regulation of DNA recombination at telomere	16175	12598		0.9020979020979021	0.9791666666666666	2	16173	2	34	0	16139	16175	0.23545437524377763
M1	string	0	network_modules	90	TRUE	0.008303875390306035	2	36	2	0.05555555555555555	1	GO:0072695	GO:BP	regulation of DNA recombination at telomere	16175	17506		0.9020979020979021	0.9791666666666666	2	16173	2	34	0	16139	16175	0.23545437524377763
M1	string	0	network_modules	90	TRUE	0.008303875390306035	2	36	2	0.05555555555555555	1	GO:1904534	GO:BP	negative regulation of telomeric loop disassembly	16175	23893		0.9020979020979021	0.9791666666666666	2	16173	2	34	0	16139	16175	0.23545437524377763
M1	string	0	network_modules	90	TRUE	0.008303875390306035	2	36	2	0.05555555555555555	1	GO:1904868	GO:BP	telomerase catalytic core complex assembly	16175	24176		0.9020979020979021	0.9791666666666666	2	16173	2	34	0	16139	16175	0.23545437524377763
M1	string	0	network_modules	90	TRUE	0.008303875390306035	2	36	2	0.05555555555555555	1	GO:1904882	GO:BP	regulation of telomerase catalytic core complex assembly	16175	24189		0.9020979020979021	0.9791666666666666	2	16173	2	34	0	16139	16175	0.23545437524377763
M1	string	0	network_modules	90	TRUE	0.008303875390306035	2	36	2	0.05555555555555555	1	GO:1904884	GO:BP	positive regulation of telomerase catalytic core complex assembly	16175	24191		0.9020979020979021	0.9791666666666666	2	16173	2	34	0	16139	16175	0.23545437524377763
M1	string	0	network_modules	90	TRUE	0.008303875390306035	2	36	2	0.05555555555555555	1	GO:1905777	GO:BP	regulation of exonuclease activity	16175	24888		0.9020979020979021	0.9791666666666666	2	16173	2	34	0	16139	16175	0.23545437524377763
M1	string	0	network_modules	90	TRUE	0.008303875390306035	2	36	2	0.05555555555555555	1	GO:1905778	GO:BP	negative regulation of exonuclease activity	16175	24889		0.9020979020979021	0.9791666666666666	2	16173	2	34	0	16139	16175	0.23545437524377763
M1	string	0	network_modules	90	TRUE	0.008303875390306035	2	36	2	0.05555555555555555	1	GO:0032213	GO:BP	regulation of telomere maintenance via semi-conservative replication	16175	7405		0.9020979020979021	0.9791666666666666	2	16173	2	34	0	16139	16175	0.23545437524377763
M1	string	0	network_modules	90	TRUE	0.008387398126822727	54	35	4	0.11428571428571428	0.07407407407407407	REAC:R-HSA-110330	REAC	Recognition and association of DNA glycosylase with site containing an affected purine	10916	1946		0.9791666666666666	1	54	10862	4	31	50	10831	10916	0.0883864835643812
M1	string	0	network_modules	90	TRUE	0.008387398126822727	54	35	4	0.11428571428571428	0.07407407407407407	REAC:R-HSA-73927	REAC	Depurination	10916	731		0.9791666666666666	1	54	10862	4	31	50	10831	10916	0.0883864835643812
M1	string	0	network_modules	90	TRUE	0.008387398126822727	54	35	4	0.11428571428571428	0.07407407407407407	REAC:R-HSA-110331	REAC	Cleavage of the damaged purine	10916	373		0.9791666666666666	1	54	10862	4	31	50	10831	10916	0.0883864835643812
M1	string	0	network_modules	90	TRUE	0.008904389896743815	203	36	6	0.16666666666666666	0.029556650246305417	GO:0051321	GO:BP	meiotic cell cycle	16175	13648		0.986013986013986	0.9861111111111112	203	15972	6	30	197	15942	16175	0.06538505797380838
M1	string	0	network_modules	90	TRUE	0.008910741284643668	72	31	4	0.12903225806451613	0.05555555555555555	KEGG:01524	KEGG	Platinum drug resistance	8484	198		0.9	0.9090909090909091	72	8412	4	27	68	8385	8484	0.07958145913076252
M1	string	0	network_modules	90	TRUE	0.008937831716048512	52	36	4	0.1111111111111111	0.07692307692307693	GO:0002200	GO:BP	somatic diversification of immune receptors	16175	738		0.993006993006993	1	52	16123	4	32	48	16091	16175	0.0900200137786174
M1	string	0	network_modules	90	TRUE	0.008937831716048512	52	36	4	0.1111111111111111	0.07692307692307693	GO:2000573	GO:BP	positive regulation of DNA biosynthetic process	16175	25874		0.993006993006993	1	52	16123	4	32	48	16091	16175	0.0900200137786174
M1	string	0	network_modules	90	TRUE	0.009915343040946928	74	31	4	0.12903225806451613	0.05405405405405406	KEGG:04115	KEGG	p53 signaling pathway	8484	269		1	1	74	8410	4	27	70	8383	8484	0.07835447174987112
M1	string	0	network_modules	91	TRUE	9.038094655239685e-18	144	33	15	0.45454545454545453	0.10416666666666667	REAC:R-HSA-8856828	REAC	Clathrin-mediated endocytosis	10916	372		0	0.1	144	10772	15	18	129	10754	10916	0.2130117906418077
M1	string	0	network_modules	91	TRUE	1.902778767312432e-9	533	34	14	0.4117647058823529	0.02626641651031895	GO:0006897	GO:BP	endocytosis	16175	2551		0	0.041666666666666664	533	15642	14	20	519	15622	16175	0.09739422855848252
M1	string	0	network_modules	91	TRUE	9.612538963454319e-9	740	34	15	0.4411764705882353	0.02027027027027027	GO:0098657	GO:BP	import into cell	16175	18813		0.043478260869565216	0.08333333333333333	740	15435	15	19	725	15416	16175	0.08685913801738152
M1	string	0	network_modules	91	TRUE	1.2618001534792019e-8	49	34	7	0.20588235294117646	0.14285714285714285	GO:0048488	GO:BP	synaptic vesicle endocytosis	16175	12781		0.08695652173913043	0.16666666666666666	49	16126	7	27	42	16099	16175	0.16940981477935588
M1	string	0	network_modules	91	TRUE	1.2618001534792019e-8	49	34	7	0.20588235294117646	0.14285714285714285	GO:0140238	GO:BP	presynaptic endocytosis	16175	19709		0.08695652173913043	0.16666666666666666	49	16126	7	27	42	16099	16175	0.16940981477935588
M1	string	0	network_modules	91	TRUE	4.938319187383803e-8	59	34	7	0.20588235294117646	0.11864406779661017	GO:0036465	GO:BP	synaptic vesicle recycling	16175	9613		0.17391304347826086	0.20833333333333334	59	16116	7	27	52	16089	16175	0.15396417295388737
M1	string	0	network_modules	91	TRUE	8.580852294918402e-8	248	26	10	0.38461538461538464	0.04032258064516129	KEGG:04144	KEGG	Endocytosis	8484	280		0	0.3333333333333333	248	8236	10	16	238	8220	8484	0.1169680422253814
M1	string	0	network_modules	91	TRUE	1.5215034653966984e-7	117	34	8	0.23529411764705882	0.06837606837606838	GO:0099504	GO:BP	synaptic vesicle cycle	16175	19100		0.21739130434782608	0.25	117	16058	8	26	109	16032	16175	0.12351803865750703
M1	string	0	network_modules	91	TRUE	1.9960019415645128e-7	121	34	8	0.23529411764705882	0.06611570247933884	GO:0099003	GO:BP	vesicle-mediated transport in synapse	16175	18999		0.2608695652173913	0.2916666666666667	121	16054	8	26	113	16028	16175	0.12134267144201953
M1	string	0	network_modules	91	TRUE	5.727067008502395e-7	19	34	5	0.14705882352941177	0.2631578947368421	GO:0097320	GO:BP	plasma membrane tubulation	16175	18595		0.30434782608695654	0.3333333333333333	19	16156	5	29	14	16127	16175	0.19547128998938765
M1	string	0	network_modules	91	TRUE	6.017710442269013e-7	44	34	6	0.17647058823529413	0.13636363636363635	GO:0006509	GO:BP	membrane protein ectodomain proteolysis	16175	2234		0.34782608695652173	0.375	44	16131	6	28	38	16103	16175	0.15310423742524498
M1	string	0	network_modules	91	TRUE	1.8652478832910722e-6	48	33	6	0.18181818181818182	0.125	REAC:R-HSA-177929	REAC	Signaling by EGFR	10916	2229		0.1111111111111111	0.2	48	10868	6	27	42	10841	10916	0.14765756085482598
M1	string	0	network_modules	91	TRUE	3.756341786505072e-6	59	34	6	0.17647058823529413	0.1016949152542373	GO:0033619	GO:BP	membrane protein proteolysis	16175	8321		0.391304347826087	0.4166666666666667	59	16116	6	28	53	16088	16175	0.1315725807121919
M1	string	0	network_modules	91	TRUE	4.529034627593597e-6	507	33	12	0.36363636363636365	0.023668639053254437	REAC:R-HSA-9006934	REAC	Signaling by Receptor Tyrosine Kinases	10916	2302		0.2222222222222222	0.3	507	10409	12	21	495	10388	10916	0.08299620833621349
M1	string	0	network_modules	91	TRUE	1.98574252640996e-5	137	34	7	0.20588235294117646	0.051094890510948905	GO:0007009	GO:BP	plasma membrane organization	16175	2621		0.43478260869565216	0.4583333333333333	137	16038	7	27	130	16011	16175	0.09886846052525218
M1	string	0	network_modules	91	TRUE	2.2044929671305502e-5	96	26	6	0.23076923076923078	0.0625	KEGG:04666	KEGG	Fc gamma R-mediated phagocytosis	8484	341		0.5	0.6666666666666666	96	8388	6	20	90	8368	8484	0.11503547712332823
M1	string	0	network_modules	91	TRUE	2.387835443219596e-5	14	33	4	0.12121212121212122	0.2857142857142857	REAC:R-HSA-177504	REAC	Retrograde neurotrophin signalling	10916	2095		0.3333333333333333	0.4	14	10902	4	29	10	10873	10916	0.1845251051021236
M1	string	0	network_modules	91	TRUE	3.6406162691816606e-5	15	34	4	0.11764705882352941	0.26666666666666666	GO:0051044	GO:BP	positive regulation of membrane protein ectodomain proteolysis	16175	13454		0.4782608695652174	0.5	15	16160	4	30	11	16130	16175	0.1759934037257069
M1	string	0	network_modules	91	TRUE	2.816403587986634e-4	6	34	3	0.08823529411764706	0.5	GO:0016191	GO:BP	synaptic vesicle uncoating	16175	5167		0.5217391304347826	0.5416666666666666	6	16169	3	31	3	16138	16175	0.2094180109807884
M1	string	0	network_modules	91	TRUE	3.324172301327896e-4	25	34	4	0.11764705882352941	0.16	GO:0051043	GO:BP	regulation of membrane protein ectodomain proteolysis	16175	13453		0.5652173913043478	0.5833333333333334	25	16150	4	30	21	16120	16175	0.13564380275206012
M1	string	0	network_modules	91	TRUE	7.863275307732894e-4	8	34	3	0.08823529411764706	0.375	GO:0072318	GO:BP	clathrin coat disassembly	16175	17346		0.6086956521739131	0.625	8	16167	3	31	5	16136	16175	0.18111729764309978
M1	string	0	network_modules	91	TRUE	0.0011777959722424531	9	34	3	0.08823529411764706	0.3333333333333333	GO:0072319	GO:BP	vesicle uncoating	16175	17347		0.6521739130434783	0.6666666666666666	9	16166	3	31	6	16135	16175	0.17064398330395733
M1	string	0	network_modules	91	TRUE	0.0015074975458769506	522	34	9	0.2647058823529412	0.017241379310344827	GO:0010256	GO:BP	endomembrane system organization	16175	4029		0.6956521739130435	0.7083333333333334	522	15653	9	25	513	15628	16175	0.06036481515269173
M1	string	0	network_modules	91	TRUE	0.0028244405028570083	97	34	5	0.14705882352941177	0.05154639175257732	GO:0007173	GO:BP	epidermal growth factor receptor signaling pathway	16175	2736		0.7391304347826086	0.75	97	16078	5	29	92	16049	16175	0.0838545097678454
M1	string	0	network_modules	91	TRUE	0.0031541398227264887	14	33	3	0.09090909090909091	0.21428571428571427	REAC:R-HSA-8875360	REAC	InlB-mediated entry of Listeria monocytogenes into host cell	10916	1203		0.4444444444444444	0.5	14	10902	3	30	11	10872	10916	0.13790050329445772
M1	string	0	network_modules	91	TRUE	0.004317697671708564	48	33	4	0.12121212121212122	0.08333333333333333	REAC:R-HSA-437239	REAC	Recycling pathway of L1	10916	1954		0.5555555555555556	0.6	48	10868	4	29	44	10839	10916	0.09721852172942605
M1	string	0	network_modules	91	TRUE	0.004586055830454497	147	26	5	0.19230769230769232	0.034013605442176874	KEGG:04072	KEGG	Phospholipase D signaling pathway	8484	261		1	1	147	8337	5	21	142	8316	8484	0.07434995658655663
M1	string	0	network_modules	91	TRUE	0.005748925971666418	112	34	5	0.14705882352941177	0.044642857142857144	GO:0038127	GO:BP	ERBB signaling pathway	16175	9716		0.782608695652174	0.7916666666666666	112	16063	5	29	107	16034	16175	0.07756064912942069
M1	string	0	network_modules	91	TRUE	0.006907858078900971	112	33	5	0.15151515151515152	0.044642857142857144	REAC:R-HSA-187037	REAC	Signaling by NTRK1 (TRKA)	10916	2284		0.6666666666666666	0.7	112	10804	5	28	107	10776	10916	0.07718779954603908
M1	string	0	network_modules	91	TRUE	0.006928568405827571	54	33	4	0.12121212121212122	0.07407407407407407	REAC:R-HSA-432722	REAC	Golgi Associated Vesicle Biogenesis	10916	1082		0.7777777777777778	0.8	54	10862	4	29	50	10833	10916	0.09125241119400944
M1	string	0	network_modules	91	TRUE	0.0071479232129570795	2	34	2	0.058823529411764705	1	GO:0060988	GO:BP	lipid tube assembly	16175	15114		0.8260869565217391	0.875	2	16173	2	32	0	16141	16175	0.24229556497128557
M1	string	0	network_modules	91	TRUE	0.0071479232129570795	2	34	2	0.058823529411764705	1	GO:0099050	GO:BP	vesicle scission	16175	19023		0.8260869565217391	0.875	2	16173	2	32	0	16141	16175	0.24229556497128557
M1	string	0	network_modules	91	TRUE	0.007773326277342256	16	34	3	0.08823529411764706	0.1875	GO:1903729	GO:BP	regulation of plasma membrane organization	16175	23241		0.9130434782608695	0.9166666666666666	16	16159	3	31	13	16128	16175	0.1273788682887789
M1	string	0	network_modules	91	TRUE	0.008310467440793466	19	33	3	0.09090909090909091	0.15789473684210525	REAC:R-HSA-8876384	REAC	Listeria monocytogenes entry into host cells	10916	1319		0.8888888888888888	0.9	19	10897	3	30	16	10867	10916	0.11779517370777758
M1	string	0	network_modules	91	TRUE	0.009756883679346877	20	33	3	0.09090909090909091	0.15	REAC:R-HSA-6807004	REAC	Negative regulation of MET activity	10916	1574		1	1	20	10896	3	30	17	10866	10916	0.11469984191412136
M1	string	0	network_modules	91	TRUE	0.00989637468388632	221	34	6	0.17647058823529413	0.027149321266968326	GO:0006898	GO:BP	receptor-mediated endocytosis	16175	2552		0.9565217391304348	0.9583333333333334	221	15954	6	28	215	15926	16175	0.06436682398232622
M1	string	0	network_modules	91	TRUE	0.009997451743617682	657	34	9	0.2647058823529412	0.0136986301369863	GO:0061024	GO:BP	membrane organization	16175	15141		1	1	657	15518	9	25	648	15493	16175	0.052099779082260496
M1	string	0	network_modules	92	TRUE	3.457335550730047e-33	774	36	31	0.8611111111111112	0.040051679586563305	GO:0007186	GO:BP	G protein-coupled receptor signaling pathway	16175	2744		0	0.03333333333333333	774	15401	31	5	743	15396	16175	0.17994568087847648
M1	string	0	network_modules	92	TRUE	1.449950720902093e-23	217	36	19	0.5277777777777778	0.08755760368663594	GO:0007188	GO:BP	adenylate cyclase-modulating G protein-coupled receptor signaling pathway	16175	2746		0.034482758620689655	0.06666666666666667	217	15958	19	17	198	15941	16175	0.2111577465860258
M1	string	0	network_modules	92	TRUE	1.0102868966536178e-19	460	35	22	0.6285714285714286	0.04782608695652174	REAC:R-HSA-500792	REAC	GPCR ligand binding	10916	1019		0	0.045454545454545456	460	10456	22	13	438	10443	10916	0.16554600112652992
M1	string	0	network_modules	92	TRUE	6.294017011794754e-18	328	35	19	0.5428571428571428	0.057926829268292686	REAC:R-HSA-373076	REAC	Class A/1 (Rhodopsin-like receptors)	10916	365		0.047619047619047616	0.09090909090909091	328	10588	19	16	309	10572	10916	0.17036301731620856
M1	string	0	network_modules	92	TRUE	3.5187842941505482e-15	312	35	17	0.4857142857142857	0.05448717948717949	REAC:R-HSA-418594	REAC	G alpha (i) signalling events	10916	987		0.09523809523809523	0.13636363636363635	312	10604	17	18	295	10586	10916	0.15559404787737097
M1	string	0	network_modules	92	TRUE	7.490569990231866e-15	365	33	18	0.5454545454545454	0.049315068493150684	KEGG:04080	KEGG	Neuroactive ligand-receptor interaction	8484	263		0	0.05555555555555555	365	8119	18	15	347	8104	8484	0.15473319803416935
M1	string	0	network_modules	92	TRUE	4.1019545992547836e-13	213	35	14	0.4	0.06572769953051644	REAC:R-HSA-416476	REAC	G alpha (q) signalling events	10916	988		0.14285714285714285	0.18181818181818182	213	10703	14	21	199	10682	10916	0.15601300830027798
M1	string	0	network_modules	92	TRUE	6.469489961949011e-12	8	35	6	0.17142857142857143	0.75	REAC:R-HSA-434316	REAC	Fatty Acids bound to GPR40 (FFAR1) regulate insulin secretion	10916	934		0.19047619047619047	0.22727272727272727	8	10908	6	29	2	10879	10916	0.3577405517988366
M1	string	0	network_modules	92	TRUE	1.0601854615737004e-10	11	35	6	0.17142857142857143	0.5454545454545454	REAC:R-HSA-400451	REAC	Free fatty acids regulate insulin secretion	10916	979		0.23809523809523808	0.2727272727272727	11	10905	6	29	5	10876	10916	0.3046328689724641
M1	string	0	network_modules	92	TRUE	8.858128336496232e-10	96	36	9	0.25	0.09375	GO:0007200	GO:BP	phospholipase C-activating G protein-coupled receptor signaling pathway	16175	2758		0.06896551724137931	0.1	96	16079	9	27	87	16052	16175	0.1500712319334399
M1	string	0	network_modules	92	TRUE	1.537109433892345e-9	31	35	7	0.2	0.22580645161290322	REAC:R-HSA-456926	REAC	Thrombin signalling through proteinase activated receptors (PARs)	10916	2506		0.2857142857142857	0.3181818181818182	31	10885	7	28	24	10857	10916	0.21012957420038617
M1	string	0	network_modules	92	TRUE	3.013939106982597e-9	38	36	7	0.19444444444444445	0.18421052631578946	GO:1903351	GO:BP	cellular response to dopamine	16175	22934		0.10344827586206896	0.16666666666666666	38	16137	7	29	31	16108	16175	0.18740035463151983
M1	string	0	network_modules	92	TRUE	3.013939106982597e-9	38	36	7	0.19444444444444445	0.18421052631578946	GO:1903350	GO:BP	response to dopamine	16175	22933		0.10344827586206896	0.16666666666666666	38	16137	7	29	31	16108	16175	0.18740035463151983
M1	string	0	network_modules	92	TRUE	3.262312909230093e-9	516	36	14	0.3888888888888889	0.027131782945736434	GO:0099536	GO:BP	synaptic signaling	16175	19115		0.1724137931034483	0.2	516	15659	14	22	502	15637	16175	0.09594089133942355
M1	string	0	network_modules	92	TRUE	3.928595471921738e-9	8	36	5	0.1388888888888889	0.625	GO:0060158	GO:BP	phospholipase C-activating dopamine receptor signaling pathway	16175	14396		0.20689655172413793	0.23333333333333334	8	16167	5	31	3	16136	16175	0.2939785982905517
M1	string	0	network_modules	92	TRUE	4.43843212866472e-9	40	36	7	0.19444444444444445	0.175	GO:0071868	GO:BP	cellular response to monoamine stimulus	16175	16950		0.2413793103448276	0.36666666666666664	40	16135	7	29	33	16106	16175	0.1825490131152581
M1	string	0	network_modules	92	TRUE	4.43843212866472e-9	40	36	7	0.19444444444444445	0.175	GO:0071867	GO:BP	response to monoamine	16175	16949		0.2413793103448276	0.36666666666666664	40	16135	7	29	33	16106	16175	0.1825490131152581
M1	string	0	network_modules	92	TRUE	4.43843212866472e-9	40	36	7	0.19444444444444445	0.175	GO:0071870	GO:BP	cellular response to catecholamine stimulus	16175	16952		0.2413793103448276	0.36666666666666664	40	16135	7	29	33	16106	16175	0.1825490131152581
M1	string	0	network_modules	92	TRUE	4.43843212866472e-9	40	36	7	0.19444444444444445	0.175	GO:0071869	GO:BP	response to catecholamine	16175	16951		0.2413793103448276	0.36666666666666664	40	16135	7	29	33	16106	16175	0.1825490131152581
M1	string	0	network_modules	92	TRUE	5.459638692639013e-9	251	33	12	0.36363636363636365	0.04780876494023904	KEGG:04020	KEGG	Calcium signaling pathway	8484	250		0.058823529411764705	0.1111111111111111	251	8233	12	21	239	8212	8484	0.1231971830492336
M1	string	0	network_modules	92	TRUE	1.5384345608220102e-8	42	35	7	0.2	0.16666666666666666	REAC:R-HSA-375280	REAC	Amine ligand-binding receptors	10916	139		0.3333333333333333	0.36363636363636365	42	10874	7	28	35	10846	10916	0.17969564097768187
M1	string	0	network_modules	92	TRUE	1.762223608909696e-8	10	36	5	0.1388888888888889	0.5	GO:0098664	GO:BP	G protein-coupled serotonin receptor signaling pathway	16175	18819		0.3793103448275862	0.4	10	16165	5	31	5	16134	16175	0.26272377855748485
M1	string	0	network_modules	92	TRUE	2.1030803413157626e-8	10	35	5	0.14285714285714285	0.5	REAC:R-HSA-399997	REAC	Acetylcholine regulates insulin secretion	10916	56		0.38095238095238093	0.4090909090909091	10	10906	5	30	5	10876	10916	0.2660960516037948
M1	string	0	network_modules	92	TRUE	2.99839878573045e-8	24	35	6	0.17142857142857143	0.25	REAC:R-HSA-428930	REAC	Thromboxane signalling through TP receptor	10916	2507		0.42857142857142855	0.45454545454545453	24	10892	6	29	18	10863	10916	0.20491840581843376
M1	string	0	network_modules	92	TRUE	5.384019013609786e-8	56	36	7	0.19444444444444445	0.125	GO:0007193	GO:BP	adenylate cyclase-inhibiting G protein-coupled receptor signaling pathway	16175	2751		0.41379310344827586	0.4666666666666667	56	16119	7	29	49	16090	16175	0.1535632564759332
M1	string	0	network_modules	92	TRUE	5.384019013609786e-8	56	36	7	0.19444444444444445	0.125	GO:0007187	GO:BP	G protein-coupled receptor signaling pathway, coupled to cyclic nucleotide second messenger	16175	2745		0.41379310344827586	0.4666666666666667	56	16119	7	29	49	16090	16175	0.1535632564759332
M1	string	0	network_modules	92	TRUE	6.579424572377721e-8	12	35	5	0.14285714285714285	0.4166666666666667	REAC:R-HSA-390666	REAC	Serotonin receptors	10916	2209		0.47619047619047616	0.5	12	10904	5	30	7	10874	10916	0.24262004777749283
M1	string	0	network_modules	92	TRUE	1.982197897825886e-7	32	35	6	0.17142857142857143	0.1875	REAC:R-HSA-392518	REAC	Signal amplification	10916	2213		0.5238095238095238	0.5454545454545454	32	10884	6	29	26	10855	10916	0.17676094115651603
M1	string	0	network_modules	92	TRUE	5.686907056708966e-7	129	36	8	0.2222222222222222	0.06201550387596899	GO:0007204	GO:BP	positive regulation of cytosolic calcium ion concentration	16175	2759		0.4827586206896552	0.5	129	16046	8	28	121	16018	16175	0.11376106036112464
M1	string	0	network_modules	92	TRUE	5.915405118278e-7	18	36	5	0.1388888888888889	0.2777777777777778	GO:0007213	GO:BP	G protein-coupled acetylcholine receptor signaling pathway	16175	2767		0.5172413793103449	0.5333333333333333	18	16157	5	31	13	16126	16175	0.1951705905967457
M1	string	0	network_modules	92	TRUE	1.0098741536885357e-6	120	33	8	0.24242424242424243	0.06666666666666667	KEGG:04071	KEGG	Sphingolipid signaling pathway	8484	260		0.11764705882352941	0.16666666666666666	120	8364	8	25	112	8339	8484	0.12080189645076823
M1	string	0	network_modules	92	TRUE	1.0951748825920882e-6	140	36	8	0.2222222222222222	0.05714285714285714	GO:0007189	GO:BP	adenylate cyclase-activating G protein-coupled receptor signaling pathway	16175	2747		0.5517241379310345	0.5666666666666667	140	16035	8	28	132	16007	16175	0.10889116700026802
M1	string	0	network_modules	92	TRUE	4.48376820003691e-6	26	36	5	0.1388888888888889	0.19230769230769232	GO:0095500	GO:BP	acetylcholine receptor signaling pathway	16175	18440		0.5862068965517241	0.6	26	16149	5	31	21	16118	16175	0.1618488651997726
M1	string	0	network_modules	92	TRUE	5.4940137925702364e-6	27	36	5	0.1388888888888889	0.18518518518518517	GO:0007212	GO:BP	G protein-coupled dopamine receptor signaling pathway	16175	2766		0.6206896551724138	0.6333333333333333	27	16148	5	31	22	16117	16175	0.15875677638169897
M1	string	0	network_modules	92	TRUE	6.677677570561882e-6	28	36	5	0.1388888888888889	0.17857142857142858	GO:1905145	GO:BP	cellular response to acetylcholine	16175	24393		0.6551724137931034	0.7333333333333333	28	16147	5	31	23	16116	16175	0.1558306463716443
M1	string	0	network_modules	92	TRUE	6.677677570561882e-6	28	36	5	0.1388888888888889	0.17857142857142858	GO:0098926	GO:BP	postsynaptic signal transduction	16175	18956		0.6551724137931034	0.7333333333333333	28	16147	5	31	23	16116	16175	0.1558306463716443
M1	string	0	network_modules	92	TRUE	6.677677570561882e-6	28	36	5	0.1388888888888889	0.17857142857142858	GO:1905144	GO:BP	response to acetylcholine	16175	24392		0.6551724137931034	0.7333333333333333	28	16147	5	31	23	16116	16175	0.1558306463716443
M1	string	0	network_modules	92	TRUE	1.4369403902500119e-5	112	33	7	0.21212121212121213	0.0625	KEGG:04726	KEGG	Serotonergic synapse	8484	356		0.17647058823529413	0.2222222222222222	112	8372	7	26	105	8346	8484	0.10890759621812789
M1	string	0	network_modules	92	TRUE	2.9075861705603436e-5	14	35	4	0.11428571428571428	0.2857142857142857	REAC:R-HSA-419408	REAC	Lysosphingolipid and LPA receptors	10916	1342		0.5714285714285714	0.5909090909090909	14	10902	4	31	10	10871	10916	0.17907573946245858
M1	string	0	network_modules	92	TRUE	3.8330186141274365e-5	431	36	10	0.2777777777777778	0.02320185614849188	GO:1901699	GO:BP	cellular response to nitrogen compound	16175	21652		0.7586206896551724	0.7666666666666667	431	15744	10	26	421	15718	16175	0.0736482823937291
M1	string	0	network_modules	92	TRUE	4.98705278573693e-5	41	36	5	0.1388888888888889	0.12195121951219512	GO:0007215	GO:BP	glutamate receptor signaling pathway	16175	2769		0.7931034482758621	0.8	41	16134	5	31	36	16103	16175	0.12807445510706664
M1	string	0	network_modules	92	TRUE	5.057898303824356e-5	78	35	6	0.17142857142857143	0.07692307692307693	REAC:R-HSA-422356	REAC	Regulation of insulin secretion	10916	2040		0.6190476190476191	0.6363636363636364	78	10838	6	29	72	10809	10916	0.11062012642317715
M1	string	0	network_modules	92	TRUE	9.184553039163461e-5	147	33	7	0.21212121212121213	0.047619047619047616	KEGG:04072	KEGG	Phospholipase D signaling pathway	8484	261		0.23529411764705882	0.2777777777777778	147	8337	7	26	140	8311	8484	0.09328603953131179
M1	string	0	network_modules	92	TRUE	1.2107315524733727e-4	487	36	10	0.2777777777777778	0.02053388090349076	GO:0007268	GO:BP	chemical synaptic transmission	16175	2796		0.8275862068965517	0.8666666666666667	487	15688	10	26	477	15662	16175	0.06845128989728742
M1	string	0	network_modules	92	TRUE	1.2107315524733727e-4	487	36	10	0.2777777777777778	0.02053388090349076	GO:0098916	GO:BP	anterograde trans-synaptic signaling	16175	18949		0.8275862068965517	0.8666666666666667	487	15688	10	26	477	15662	16175	0.06845128989728742
M1	string	0	network_modules	92	TRUE	1.3322241875494143e-4	492	36	10	0.2777777777777778	0.02032520325203252	GO:0099537	GO:BP	trans-synaptic signaling	16175	19116		0.896551724137931	0.9	492	15683	10	26	482	15657	16175	0.06802842224614825
M1	string	0	network_modules	92	TRUE	1.455175355926849e-4	49	35	5	0.14285714285714285	0.10204081632653061	REAC:R-HSA-112043	REAC	PLC beta mediated events	10916	1693		0.6666666666666666	0.6818181818181818	49	10867	5	30	44	10837	10916	0.11739427975953566
M1	string	0	network_modules	92	TRUE	2.0282688050596222e-4	105	33	6	0.18181818181818182	0.05714285714285714	KEGG:04928	KEGG	Parathyroid hormone synthesis, secretion and action	8484	385		0.29411764705882354	0.3333333333333333	105	8379	6	27	99	8352	8484	0.09577094221375587
M1	string	0	network_modules	92	TRUE	2.1592880222052232e-4	59	33	5	0.15151515151515152	0.0847457627118644	KEGG:04730	KEGG	Long-term depression	8484	359		0.35294117647058826	0.3888888888888889	59	8425	5	28	54	8397	8484	0.10870347197619716
M1	string	0	network_modules	92	TRUE	2.385827863428259e-4	54	35	5	0.14285714285714285	0.09259259259259259	REAC:R-HSA-112040	REAC	G-protein mediated events	10916	998		0.7142857142857143	0.7272727272727273	54	10862	5	30	49	10832	10916	0.1114828318812478
M1	string	0	network_modules	92	TRUE	3.017098605060386e-4	24	35	4	0.11428571428571428	0.16666666666666666	REAC:R-HSA-202040	REAC	G-protein activation	10916	996		0.7619047619047619	0.8181818181818182	24	10892	4	31	20	10861	10916	0.13572484859515913
M1	string	0	network_modules	92	TRUE	3.017098605060386e-4	24	35	4	0.11428571428571428	0.16666666666666666	REAC:R-HSA-418592	REAC	ADP signalling through P2Y purinoceptor 1	10916	12		0.7619047619047619	0.8181818181818182	24	10892	4	31	20	10861	10916	0.13572484859515913
M1	string	0	network_modules	92	TRUE	3.3304234704006094e-4	107	35	6	0.17142857142857143	0.056074766355140186	REAC:R-HSA-163685	REAC	Integration of energy metabolism	10916	1213		0.8571428571428571	0.8636363636363636	107	10809	6	29	101	10780	10916	0.09304454584109048
M1	string	0	network_modules	92	TRUE	4.08670779085884e-4	259	35	8	0.22857142857142856	0.03088803088803089	REAC:R-HSA-76002	REAC	Platelet activation, signaling and aggregation	10916	1762		0.9047619047619048	0.9090909090909091	259	10657	8	27	251	10630	10916	0.07633447080041791
M1	string	0	network_modules	92	TRUE	5.341723797532602e-4	124	33	6	0.18181818181818182	0.04838709677419355	KEGG:04611	KEGG	Platelet activation	8484	321		0.4117647058823529	0.4444444444444444	124	8360	6	27	118	8333	8484	0.08706271259725512
M1	string	0	network_modules	92	TRUE	6.072629089234312e-4	7	36	3	0.08333333333333333	0.42857142857142855	GO:0007198	GO:BP	adenylate cyclase-inhibiting serotonin receptor signaling pathway	16175	2756		0.9310344827586207	0.9333333333333333	7	16168	3	33	4	16135	16175	0.18825111540602296
M1	string	0	network_modules	92	TRUE	8.0016559732207e-4	133	33	6	0.18181818181818182	0.045112781954887216	KEGG:04270	KEGG	Vascular smooth muscle contraction	8484	298		0.47058823529411764	0.5	133	8351	6	27	127	8324	8484	0.08357703158130854
M1	string	0	network_modules	92	TRUE	0.0011153610073753432	619	36	10	0.2777777777777778	0.01615508885298869	GO:1901698	GO:BP	response to nitrogen compound	16175	21651		0.9655172413793104	0.9666666666666667	619	15556	10	26	609	15530	16175	0.058963668004699585
M1	string	0	network_modules	92	TRUE	0.0013168078674773928	85	33	5	0.15151515151515152	0.058823529411764705	KEGG:04742	KEGG	Taste transduction	8484	361		0.5294117647058824	0.5555555555555556	85	8399	5	28	80	8371	8484	0.08878209440368863
M1	string	0	network_modules	92	TRUE	0.0014521189109050216	223	33	7	0.21212121212121213	0.03139013452914798	KEGG:05163	KEGG	Human cytomegalovirus infection	8484	444		0.5882352941176471	0.6111111111111112	223	8261	7	26	216	8235	8484	0.07258814789611462
M1	string	0	network_modules	92	TRUE	0.0015597313146617291	88	33	5	0.15151515151515152	0.056818181818181816	KEGG:04540	KEGG	Gap junction	8484	318		0.6470588235294118	0.6666666666666666	88	8396	5	28	83	8368	8484	0.08705313283070182
M1	string	0	network_modules	92	TRUE	0.002030192851674482	38	35	4	0.11428571428571428	0.10526315789473684	REAC:R-HSA-6814122	REAC	Cooperation of PDCL (PhLP1) and TRiC/CCT in G-protein beta folding	10916	410		0.9523809523809523	0.9545454545454546	38	10878	4	31	34	10847	10916	0.10669757588672961
M1	string	0	network_modules	92	TRUE	0.0026301689310120665	98	33	5	0.15151515151515152	0.05102040816326531	KEGG:04750	KEGG	Inflammatory mediator regulation of TRP channels	8484	364		0.7058823529411765	0.7222222222222222	98	8386	5	28	93	8358	8484	0.08185202843916684
M1	string	0	network_modules	92	TRUE	0.0026399879601805643	164	33	6	0.18181818181818182	0.036585365853658534	KEGG:04022	KEGG	cGMP-PKG signaling pathway	8484	251		0.7647058823529411	0.7777777777777778	164	8320	6	27	158	8293	8484	0.073746331710281
M1	string	0	network_modules	92	TRUE	0.0028896224279957743	89	35	5	0.14285714285714285	0.056179775280898875	REAC:R-HSA-111885	REAC	Opioid Signalling	10916	1642		1	1	89	10827	5	30	84	10797	10916	0.08495608251738361
M1	string	0	network_modules	92	TRUE	0.003042430910392926	101	33	5	0.15151515151515152	0.04950495049504951	KEGG:05146	KEGG	Amoebiasis	8484	438		0.8235294117647058	0.8888888888888888	101	8383	5	28	96	8355	8484	0.08043793225232126
M1	string	0	network_modules	92	TRUE	0.003042430910392926	101	33	5	0.15151515151515152	0.04950495049504951	KEGG:05142	KEGG	Chagas disease	8484	434		0.8235294117647058	0.8888888888888888	101	8383	5	28	96	8355	8484	0.08043793225232126
M1	string	0	network_modules	92	TRUE	0.004916829375616961	13	36	3	0.08333333333333333	0.23076923076923078	GO:0007216	GO:BP	G protein-coupled glutamate receptor signaling pathway	16175	2770		1	1	13	16162	3	33	10	16129	16175	0.1375459691023551
M1	string	0	network_modules	92	TRUE	0.005671543081308597	115	33	5	0.15151515151515152	0.043478260869565216	KEGG:04724	KEGG	Glutamatergic synapse	8484	354		0.9411764705882353	0.9444444444444444	115	8369	5	28	110	8341	8484	0.07455414045557118
M1	string	0	network_modules	92	TRUE	0.007890925628834847	64	33	4	0.12121212121212122	0.0625	KEGG:04929	KEGG	GnRH secretion	8484	386		1	1	64	8420	4	29	60	8391	8484	0.08209140944914818
M1	string	0	network_modules	94	TRUE	7.086342540190688e-11	62	13	7	0.5384615384615384	0.11290322580645161	KEGG:03250	KEGG	Viral life cycle - HIV-1	8484	223		0	0.5	62	8422	7	6	55	8416	8484	0.24429901401513118
M1	string	0	network_modules	94	TRUE	3.868952795251928e-9	57	22	7	0.3181818181818182	0.12280701754385964	REAC:R-HSA-112382	REAC	Formation of RNA Pol II elongation complex 	10916	949		0	0.2222222222222222	57	10859	7	15	50	10844	10916	0.19513620044655824
M1	string	0	network_modules	94	TRUE	3.868952795251928e-9	57	22	7	0.3181818181818182	0.12280701754385964	REAC:R-HSA-75955	REAC	RNA Polymerase II Transcription Elongation	10916	1891		0	0.2222222222222222	57	10859	7	15	50	10844	10916	0.19513620044655824
M1	string	0	network_modules	94	TRUE	4.521294789684575e-8	80	22	7	0.3181818181818182	0.0875	REAC:R-HSA-674695	REAC	RNA Polymerase II Pre-transcription Events	10916	1888		0.25	0.3333333333333333	80	10836	7	15	73	10821	10916	0.16377851531690688
M1	string	0	network_modules	94	TRUE	1.2089579499997067e-5	81	31	6	0.1935483870967742	0.07407407407407407	GO:0034243	GO:BP	regulation of transcription elongation by RNA polymerase II	16175	8519		0	0.1111111111111111	81	16094	6	25	75	16069	16175	0.1170442477863593
M1	string	0	network_modules	94	TRUE	2.7453401424471503e-5	16	31	4	0.12903225806451613	0.25	GO:0042795	GO:BP	snRNA transcription by RNA polymerase II	16175	10372		0.125	0.2222222222222222	16	16159	4	27	12	16132	16175	0.17848775739942768
M1	string	0	network_modules	94	TRUE	3.385223439785426e-5	96	31	6	0.1935483870967742	0.0625	GO:0032784	GO:BP	regulation of DNA-templated transcription elongation	16175	7819		0.25	0.3333333333333333	96	16079	6	25	90	16054	16175	0.10703308790595574
M1	string	0	network_modules	94	TRUE	5.172864718795544e-5	103	31	6	0.1935483870967742	0.05825242718446602	GO:0006368	GO:BP	transcription elongation by RNA polymerase II	16175	2143		0.375	0.4444444444444444	103	16072	6	25	97	16047	16175	0.10311614604348397
M1	string	0	network_modules	94	TRUE	7.269369571802445e-5	20	31	4	0.12903225806451613	0.2	GO:0009301	GO:BP	snRNA transcription	16175	3448		0.5	0.5555555555555556	20	16155	4	27	16	16128	16175	0.15935570011765224
M1	string	0	network_modules	94	TRUE	9.352225560695507e-5	73	22	5	0.22727272727272727	0.0684931506849315	REAC:R-HSA-6807505	REAC	RNA polymerase II transcribes snRNA genes	10916	1904		0.375	0.4444444444444444	73	10843	5	17	68	10826	10916	0.12162464408251496
M1	string	0	network_modules	94	TRUE	1.1685720724341561e-4	118	31	6	0.1935483870967742	0.05084745762711865	GO:0006354	GO:BP	DNA-templated transcription elongation	16175	2131		0.625	0.6666666666666666	118	16057	6	25	112	16032	16175	0.09590694278693422
M1	string	0	network_modules	94	TRUE	1.2520684938188508e-4	31	22	4	0.18181818181818182	0.12903225806451613	REAC:R-HSA-73863	REAC	RNA Polymerase I Transcription Termination	10916	1886		0.5	0.5555555555555556	31	10885	4	18	27	10867	10916	0.15114247524712943
M1	string	0	network_modules	94	TRUE	3.404874571947924e-4	192	13	5	0.38461538461538464	0.026041666666666668	KEGG:05202	KEGG	Transcriptional misregulation in cancer	8484	454		1	1	192	8292	5	8	187	8284	8484	0.0953486983864076
M1	string	0	network_modules	94	TRUE	6.949082570239449e-4	47	22	4	0.18181818181818182	0.0851063829787234	REAC:R-HSA-73762	REAC	RNA Polymerase I Transcription Initiation	10916	1885		0.625	0.6666666666666666	47	10869	4	18	43	10851	10916	0.12183346149379237
M1	string	0	network_modules	94	TRUE	0.002812223153376912	48	31	4	0.12903225806451613	0.08333333333333333	GO:0032968	GO:BP	positive regulation of transcription elongation by RNA polymerase II	16175	7952		0.75	0.7777777777777778	48	16127	4	27	44	16100	16175	0.1015583645103453
M1	string	0	network_modules	94	TRUE	0.002908280859479586	67	22	4	0.18181818181818182	0.05970149253731343	REAC:R-HSA-427359	REAC	SIRT1 negatively regulates rRNA expression	10916	2142		0.75	0.7777777777777778	67	10849	4	18	63	10831	10916	0.10108163162862255
M1	string	0	network_modules	94	TRUE	0.00564074553738053	57	31	4	0.12903225806451613	0.07017543859649122	GO:0016073	GO:BP	snRNA metabolic process	16175	5100		0.875	1	57	16118	4	27	53	16091	16175	0.09281090554019938
M1	string	0	network_modules	94	TRUE	0.00564074553738053	57	31	4	0.12903225806451613	0.07017543859649122	GO:0032786	GO:BP	positive regulation of DNA-templated transcription, elongation	16175	7821		0.875	1	57	16118	4	27	53	16091	16175	0.09281090554019938
M1	string	0	network_modules	94	TRUE	0.008998681801634364	89	22	4	0.18181818181818182	0.0449438202247191	REAC:R-HSA-5250924	REAC	B-WICH complex positively regulates rRNA expression	10916	198		0.875	0.8888888888888888	89	10827	4	18	85	10809	10916	0.08678495473862688
M1	string	0	network_modules	94	TRUE	0.00940477636924578	90	22	4	0.18181818181818182	0.044444444444444446	REAC:R-HSA-73772	REAC	RNA Polymerase I Promoter Escape	10916	1882		1	1	90	10826	4	18	86	10808	10916	0.08625992878206512
M1	string	0	network_modules	95	TRUE	2.0352806556953395e-28	101	28	18	0.6428571428571429	0.1782178217821782	REAC:R-HSA-977606	REAC	Regulation of Complement cascade	10916	1971		0	0.2	101	10815	18	10	83	10805	10916	0.3355930104265934
M1	string	0	network_modules	95	TRUE	1.2870381479242064e-27	111	28	18	0.6428571428571429	0.16216216216216217	REAC:R-HSA-166658	REAC	Complement cascade	10916	390		0.25	0.4	111	10805	18	10	93	10795	10916	0.31980452847678487
M1	string	0	network_modules	95	TRUE	3.199678779702596e-25	86	20	15	0.75	0.1744186046511628	KEGG:04610	KEGG	Complement and coagulation cascades	8484	320		0	0.14285714285714285	86	8398	15	5	71	8393	8484	0.35903942387932175
M1	string	0	network_modules	95	TRUE	3.3608797802282895e-17	56	31	11	0.3548387096774194	0.19642857142857142	GO:0006956	GO:BP	complement activation	16175	2587		0	0.16666666666666666	56	16119	11	20	45	16099	16175	0.26213759347750043
M1	string	0	network_modules	95	TRUE	8.61835680084028e-16	8	28	7	0.25	0.875	REAC:R-HSA-166665	REAC	Terminal pathway of complement	10916	2490		0.5	0.6	8	10908	7	21	1	10887	10916	0.46710653494128757
M1	string	0	network_modules	95	TRUE	2.2711950828954012e-12	475	31	15	0.4838709677419355	0.031578947368421054	GO:0002253	GO:BP	activation of immune response	16175	785		0.2	0.3333333333333333	475	15700	15	16	460	15684	16175	0.11796720038538608
M1	string	0	network_modules	95	TRUE	5.233792494377487e-12	627	31	16	0.5161290322580645	0.025518341307814992	GO:0050778	GO:BP	positive regulation of immune response	16175	13252		0.4	0.5	627	15548	16	15	611	15533	16175	0.10836762654067135
M1	string	0	network_modules	95	TRUE	9.603302566418806e-11	756	31	16	0.5161290322580645	0.021164021164021163	GO:0050776	GO:BP	regulation of immune response	16175	13250		0.6	0.6666666666666666	756	15419	16	15	740	15404	16175	0.0974461337719225
M1	string	0	network_modules	95	TRUE	2.5909391562314183e-10	224	31	11	0.3548387096774194	0.049107142857142856	GO:0006959	GO:BP	humoral immune response	16175	2590		0.8	0.8333333333333334	224	15951	11	20	213	15931	16175	0.12786258040589657
M1	string	0	network_modules	95	TRUE	1.888725516442751e-8	132	20	8	0.4	0.06060606060606061	KEGG:05322	KEGG	Systemic lupus erythematosus	8484	484		0.16666666666666666	0.2857142857142857	132	8352	8	12	124	8340	8484	0.15099955259458106
M1	string	0	network_modules	95	TRUE	5.761348292644357e-8	231	20	9	0.45	0.03896103896103896	KEGG:05171	KEGG	Coronavirus disease - COVID-19	8484	452		0.3333333333333333	0.42857142857142855	231	8253	9	11	222	8242	8484	0.12627646598254347
M1	string	0	network_modules	95	TRUE	1.7124013604612656e-7	536	31	12	0.3870967741935484	0.022388059701492536	GO:0002252	GO:BP	immune effector process	16175	784		1	1	536	15639	12	19	524	15620	16175	0.08665345870528024
M1	string	0	network_modules	95	TRUE	3.2600126134255736e-5	227	20	7	0.35	0.030837004405286344	KEGG:04810	KEGG	Regulation of actin cytoskeleton	8484	365		0.5	0.5714285714285714	227	8257	7	13	220	8244	8484	0.09737195727093267
M1	string	0	network_modules	95	TRUE	8.275885976154796e-5	86	20	5	0.25	0.05813953488372093	KEGG:05150	KEGG	Staphylococcus aureus infection	8484	439		0.6666666666666666	0.7142857142857143	86	8398	5	15	81	8383	8484	0.11640038674437148
M1	string	0	network_modules	95	TRUE	1.0771666363873858e-4	271	20	7	0.35	0.025830258302583026	KEGG:05020	KEGG	Prion disease	8484	416		0.8333333333333334	0.8571428571428571	271	8213	7	13	264	8200	8484	0.08792207757873775
M1	string	0	network_modules	95	TRUE	0.005005351934184812	101	20	4	0.2	0.039603960396039604	KEGG:05146	KEGG	Amoebiasis	8484	438		1	1	101	8383	4	16	97	8367	8484	0.08430342347876404
M1	string	0	network_modules	95	TRUE	0.0063349653657779805	3	28	2	0.07142857142857142	0.6666666666666666	REAC:R-HSA-3359463	REAC	Defective CUBN causes MGA1	10916	513		0.75	1	3	10913	2	26	1	10887	10916	0.21768752796802934
M1	string	0	network_modules	95	TRUE	0.0063349653657779805	3	28	2	0.07142857142857142	0.6666666666666666	REAC:R-HSA-3359462	REAC	Defective AMN causes MGA1	10916	486		0.75	1	3	10913	2	26	1	10887	10916	0.21768752796802934
M1	string	0	network_modules	96	TRUE	2.1161419265850096e-25	31	33	13	0.3939393939393939	0.41935483870967744	GO:0099022	GO:BP	vesicle tethering	16175	19011		0	0.047619047619047616	31	16144	13	20	18	16124	16175	0.40527289135598066
M1	string	0	network_modules	96	TRUE	2.3572494433017294e-24	36	33	13	0.3939393939393939	0.3611111111111111	GO:0006901	GO:BP	vesicle coating	16175	2554		0.05	0.09523809523809523	36	16139	13	20	23	16119	16175	0.3758389868961707
M1	string	0	network_modules	96	TRUE	4.02081365730382e-21	59	33	13	0.3939393939393939	0.22033898305084745	GO:0006903	GO:BP	vesicle targeting	16175	2555		0.1	0.14285714285714285	59	16116	13	20	46	16096	16175	0.2927233508465051
M1	string	0	network_modules	96	TRUE	1.0218691586092254e-19	74	33	13	0.3939393939393939	0.17567567567567569	GO:0006900	GO:BP	vesicle budding from membrane	16175	2553		0.15	0.19047619047619047	74	16101	13	20	61	16081	16175	0.26087747375067594
M1	string	0	network_modules	96	TRUE	4.683326983675418e-19	23	33	10	0.30303030303030304	0.43478260869565216	GO:0048207	GO:BP	vesicle targeting, rough ER to cis-Golgi	16175	12583		0.2	0.2857142857142857	23	16152	10	23	13	16129	16175	0.3619002520848311
M1	string	0	network_modules	96	TRUE	4.683326983675418e-19	23	33	10	0.30303030303030304	0.43478260869565216	GO:0048208	GO:BP	COPII vesicle coating	16175	12584		0.2	0.2857142857142857	23	16152	10	23	13	16129	16175	0.3619002520848311
M1	string	0	network_modules	96	TRUE	1.5790280854154875e-18	126	33	14	0.42424242424242425	0.1111111111111111	GO:0006888	GO:BP	endoplasmic reticulum to Golgi vesicle-mediated transport	16175	2544		0.3	0.3333333333333333	126	16049	14	19	112	16030	16175	0.21418000815983182
M1	string	0	network_modules	96	TRUE	2.6841826565173094e-18	120	22	13	0.5909090909090909	0.10833333333333334	REAC:R-HSA-9007101	REAC	Rab regulation of trafficking	10916	1939		0	0.09090909090909091	120	10796	13	9	107	10787	10916	0.24993337396924536
M1	string	0	network_modules	96	TRUE	6.986345279038227e-18	88	22	12	0.5454545454545454	0.13636363636363635	REAC:R-HSA-8876198	REAC	RAB GEFs exchange GTP for GDP on RABs	10916	1834		0.1	0.18181818181818182	88	10828	12	10	76	10818	10916	0.27005841525615715
M1	string	0	network_modules	96	TRUE	1.2188159598818709e-17	30	33	10	0.30303030303030304	0.3333333333333333	GO:0048199	GO:BP	vesicle targeting, to, from or within Golgi	16175	12575		0.35	0.38095238095238093	30	16145	10	23	20	16122	16175	0.31649197614888835
M1	string	0	network_modules	96	TRUE	3.394377923367486e-16	40	33	10	0.30303030303030304	0.25	GO:0090114	GO:BP	COPII-coated vesicle budding	16175	18031		0.4	0.42857142857142855	40	16135	10	23	30	16112	16175	0.27361220217639987
M1	string	0	network_modules	96	TRUE	3.801102458148658e-15	284	33	15	0.45454545454545453	0.0528169014084507	GO:0048193	GO:BP	Golgi vesicle transport	16175	12570		0.45	0.47619047619047616	284	15891	15	18	269	15873	16175	0.15043774430163293
M1	string	0	network_modules	96	TRUE	1.5982639525431317e-14	178	33	13	0.3939393939393939	0.07303370786516854	GO:0051650	GO:BP	establishment of vesicle localization	16175	13863		0.5	0.5238095238095238	178	15997	13	20	165	15977	16175	0.16596560797323998
M1	string	0	network_modules	96	TRUE	2.8602744708855595e-14	186	33	13	0.3939393939393939	0.06989247311827956	GO:0051648	GO:BP	vesicle localization	16175	13861		0.55	0.5714285714285714	186	15989	13	20	173	15969	16175	0.16218809145829907
M1	string	0	network_modules	96	TRUE	1.2686392242724548e-12	68	22	9	0.4090909090909091	0.1323529411764706	REAC:R-HSA-204005	REAC	COPII-mediated vesicle transport	10916	280		0.2	0.2727272727272727	68	10848	9	13	59	10835	10916	0.23009526170428482
M1	string	0	network_modules	96	TRUE	2.7728046553807085e-11	315	33	13	0.3939393939393939	0.04126984126984127	GO:0016050	GO:BP	vesicle organization	16175	5082		0.6	0.6190476190476191	315	15860	13	20	302	15840	16175	0.1225255980413325
M1	string	0	network_modules	96	TRUE	8.09621853019396e-10	410	33	13	0.3939393939393939	0.03170731707317073	GO:0051656	GO:BP	establishment of organelle localization	16175	13869		0.65	0.6666666666666666	410	15765	13	20	397	15745	16175	0.10603009410446583
M1	string	0	network_modules	96	TRUE	2.6319078120296397e-9	155	22	9	0.4090909090909091	0.05806451612903226	REAC:R-HSA-199977	REAC	ER to Golgi Anterograde Transport	10916	823		0.3	0.36363636363636365	155	10761	9	13	146	10748	10916	0.14999157944752736
M1	string	0	network_modules	96	TRUE	1.366718133631471e-8	186	22	9	0.4090909090909091	0.04838709677419355	REAC:R-HSA-948021	REAC	Transport to the Golgi and subsequent modification	10916	2604		0.4	0.45454545454545453	186	10730	9	13	177	10717	10916	0.13613449695121801
M1	string	0	network_modules	96	TRUE	1.5893521629930974e-8	519	33	13	0.3939393939393939	0.025048169556840076	GO:0051640	GO:BP	organelle localization	16175	13853		0.7	0.7142857142857143	519	15656	13	20	506	15636	16175	0.09283900746899844
M1	string	0	network_modules	96	TRUE	1.7607347750499463e-8	657	33	14	0.42424242424242425	0.0213089802130898	GO:0061024	GO:BP	membrane organization	16175	15141		0.75	0.7619047619047619	657	15518	14	19	643	15499	16175	0.08786744726706235
M1	string	0	network_modules	96	TRUE	5.916759211566088e-7	20	33	5	0.15151515151515152	0.25	GO:0009301	GO:BP	snRNA transcription	16175	3448		0.8	0.8095238095238095	20	16155	5	28	15	16127	16175	0.19335324601262996
M1	string	0	network_modules	96	TRUE	6.488415469675954e-7	28	22	5	0.22727272727272727	0.17857142857142858	REAC:R-HSA-76071	REAC	RNA Polymerase III Transcription Initiation From Type 3 Promoter	10916	1902		0.5	0.5454545454545454	28	10888	5	17	23	10871	10916	0.19963929887258158
M1	string	0	network_modules	96	TRUE	1.1116171270802958e-6	305	22	9	0.4090909090909091	0.029508196721311476	REAC:R-HSA-446203	REAC	Asparagine N-linked glycosylation	10916	169		0.6	0.6363636363636364	305	10611	9	13	296	10598	10916	0.10393201287679411
M1	string	0	network_modules	96	TRUE	2.4631265334272877e-6	36	22	5	0.22727272727272727	0.1388888888888889	REAC:R-HSA-76046	REAC	RNA Polymerase III Transcription Initiation	10916	1899		0.7	0.7272727272727273	36	10880	5	17	31	10863	10916	0.17555559385425326
M1	string	0	network_modules	96	TRUE	2.720444715026106e-6	9	33	4	0.12121212121212122	0.4444444444444444	GO:0042796	GO:BP	snRNA transcription by RNA polymerase III	16175	10373		0.85	0.8571428571428571	9	16166	4	29	5	16137	16175	0.23133849964533032
M1	string	0	network_modules	96	TRUE	4.8645429601335565e-6	41	22	5	0.22727272727272727	0.12195121951219512	REAC:R-HSA-749476	REAC	RNA Polymerase III Abortive And Retractive Initiation	10916	1896		0.8	0.9090909090909091	41	10875	5	17	36	10858	10916	0.16420438060402512
M1	string	0	network_modules	96	TRUE	4.8645429601335565e-6	41	22	5	0.22727272727272727	0.12195121951219512	REAC:R-HSA-74158	REAC	RNA Polymerase III Transcription	10916	1898		0.8	0.9090909090909091	41	10875	5	17	36	10858	10916	0.16420438060402512
M1	string	0	network_modules	96	TRUE	3.8902403628716714e-5	16	33	4	0.12121212121212122	0.25	GO:0042795	GO:BP	snRNA transcription by RNA polymerase II	16175	10372		0.9	0.9047619047619048	16	16159	4	29	12	16130	16175	0.17291899453749424
M1	string	0	network_modules	96	TRUE	9.352225560695507e-5	73	22	5	0.22727272727272727	0.0684931506849315	REAC:R-HSA-6807505	REAC	RNA polymerase II transcribes snRNA genes	10916	1904		1	1	73	10843	5	17	68	10826	10916	0.12162464408251496
M1	string	0	network_modules	96	TRUE	1.3838759591121985e-4	56	33	5	0.15151515151515152	0.08928571428571429	GO:0006383	GO:BP	transcription by RNA polymerase III	16175	2148		0.95	0.9523809523809523	56	16119	5	28	51	16091	16175	0.11396639035183366
M1	string	0	network_modules	96	TRUE	1.5147507500476695e-4	57	33	5	0.15151515151515152	0.08771929824561403	GO:0016073	GO:BP	snRNA metabolic process	16175	5100		1	1	57	16118	5	28	52	16090	16175	0.1129185936759446
M1	string	0	network_modules	98	TRUE	0.0028977556575661098	245	23	6	0.2608695652173913	0.024489795918367346	REAC:R-HSA-425407	REAC	SLC-mediated transmembrane transport	10916	2146		0	0.3333333333333333	245	10671	6	17	239	10654	10916	0.07396405206805708
M1	string	0	network_modules	98	TRUE	0.0048904476213216894	2	30	2	0.06666666666666667	1	GO:0015819	GO:BP	lysine transport	16175	4931		0	0.5	2	16173	2	28	0	16145	16175	0.2579752855695965
M1	string	0	network_modules	98	TRUE	0.005285590282330415	24	23	3	0.13043478260869565	0.125	REAC:R-HSA-425410	REAC	Metal ion SLC transporters	10916	1442		0.5	0.6666666666666666	24	10892	3	20	21	10872	10916	0.1258070015753195
M1	string	0	network_modules	98	TRUE	0.008501434237349736	84	23	4	0.17391304347826086	0.047619047619047616	REAC:R-HSA-425366	REAC	Transport of bile salts and organic acids, metal ions and amine compounds	10916	2590		1	1	84	10832	4	19	80	10813	10916	0.08740525822126725
M1	string	0	network_modules	98	TRUE	0.008830981257422193	143	30	5	0.16666666666666666	0.03496503496503497	GO:0007043	GO:BP	cell-cell junction assembly	16175	2647		1	1	143	16032	5	25	138	16007	16175	0.0726778705110714
M1	string	0	network_modules	99	TRUE	1.0527252519825352e-10	244	22	11	0.5	0.045081967213114756	REAC:R-HSA-8951664	REAC	Neddylation	10916	1559		NA	1	244	10672	11	11	233	10661	10916	0.14520141891119673
M1	string	0	network_modules	99	TRUE	5.570775774215341e-7	84	9	5	0.5555555555555556	0.05952380952380952	KEGG:03083	KEGG	Polycomb repressive complex	8484	220		NA	1	84	8400	5	4	79	8396	8484	0.17959348100693995
M1	string	0	network_modules	99	TRUE	0.0023695478935030147	57	25	4	0.16	0.07017543859649122	GO:0006893	GO:BP	Golgi to plasma membrane transport	16175	2548		0	0.25	57	16118	4	21	53	16097	16175	0.10389218557707551
M1	string	0	network_modules	99	TRUE	0.002683062054683735	137	25	5	0.2	0.0364963503649635	GO:0098876	GO:BP	vesicle-mediated transport to the plasma membrane	16175	18924		0.3333333333333333	0.5	137	16038	5	20	132	16018	16175	0.08222990078852023
M1	string	0	network_modules	99	TRUE	0.007950797269081544	77	25	4	0.16	0.05194805194805195	GO:0032088	GO:BP	negative regulation of NF-kappaB transcription factor activity	16175	7355		0.6666666666666666	0.75	77	16098	4	21	73	16077	16175	0.08873585323622328
M1	string	0	network_modules	99	TRUE	0.008809191312596065	79	25	4	0.16	0.05063291139240506	GO:0032456	GO:BP	endocytic recycling	16175	7571		1	1	79	16096	4	21	75	16075	16175	0.08754107491124559
M1	string	0	network_modules	100	TRUE	0.0048037179122998935	745	28	9	0.32142857142857145	0.012080536912751677	GO:0098609	GO:BP	cell-cell adhesion	16175	18805		NA	1	745	15430	9	19	736	15411	16175	0.05470570929778325
M1	string	0	network_modules	101	TRUE	9.698381713926166e-10	168	18	9	0.5	0.05357142857142857	KEGG:04141	KEGG	Protein processing in endoplasmic reticulum	8484	278		NA	1	168	8316	9	9	159	8307	8484	0.15893013926680066
M1	string	0	network_modules	101	TRUE	1.317280899027221e-4	470	29	9	0.3103448275862069	0.019148936170212766	GO:0010498	GO:BP	proteasomal protein catabolic process	16175	4177		0	0.2	470	15705	9	20	461	15685	16175	0.07097306570111364
M1	string	0	network_modules	101	TRUE	1.7213636244706553e-4	66	29	5	0.1724137931034483	0.07575757575757576	GO:0036503	GO:BP	ERAD pathway	16175	9635		0.25	0.4	66	16109	5	24	61	16085	16175	0.11191154933045375
M1	string	0	network_modules	101	TRUE	2.292314910413891e-4	673	29	10	0.3448275862068966	0.014858841010401188	GO:0051603	GO:BP	proteolysis involved in protein catabolic process	16175	13820		0.5	0.6	673	15502	10	19	663	15483	16175	0.06435280756580648
M1	string	0	network_modules	101	TRUE	0.0050061356295680115	2	29	2	0.06896551724137931	1	GO:1904780	GO:BP	negative regulation of protein localization to centrosome	16175	24100		0.75	0.8	2	16173	2	27	0	16146	16175	0.26239356474948966
M1	string	0	network_modules	101	TRUE	0.008410890579028841	144	29	5	0.1724137931034483	0.034722222222222224	GO:0007030	GO:BP	Golgi organization	16175	2635		1	1	144	16031	5	24	139	16007	16175	0.07377286937263829
M1	string	0	network_modules	102	TRUE	6.495421804656472e-52	108	32	29	0.90625	0.26851851851851855	KEGG:03013	KEGG	Nucleocytoplasmic transport	8484	209		0	0.3333333333333333	108	8376	29	3	79	8373	8484	0.49042211538965513
M1	string	0	network_modules	102	TRUE	3.465738506692505e-45	38	31	21	0.6774193548387096	0.5526315789473685	REAC:R-HSA-168276	REAC	NS1 Mediated Effects on Host Pathways	10916	1550		0	0.013333333333333334	38	10878	21	10	17	10868	10916	0.6106381339549425
M1	string	0	network_modules	102	TRUE	1.6627143490163365e-43	34	31	20	0.6451612903225806	0.5882352941176471	REAC:R-HSA-177243	REAC	Interactions of Rev with host cellular proteins	10916	1221		0.013513513513513514	0.02666666666666667	34	10882	20	11	14	10871	10916	0.6148977245063054
M1	string	0	network_modules	102	TRUE	3.091107964389568e-42	261	34	28	0.8235294117647058	0.10727969348659004	GO:0051169	GO:BP	nuclear transport	16175	13552		0	0.05714285714285714	261	15914	28	6	233	15908	16175	0.2940991661852773
M1	string	0	network_modules	102	TRUE	3.091107964389568e-42	261	34	28	0.8235294117647058	0.10727969348659004	GO:0006913	GO:BP	nucleocytoplasmic transport	16175	2562		0	0.05714285714285714	261	15914	28	6	233	15908	16175	0.2940991661852773
M1	string	0	network_modules	102	TRUE	1.5321325127943264e-41	31	31	19	0.6129032258064516	0.6129032258064516	REAC:R-HSA-180746	REAC	Nuclear import of Rev protein	10916	1619		0.02702702702702703	0.04	31	10885	19	12	12	10873	10916	0.6118007912635025
M1	string	0	network_modules	102	TRUE	3.7674536018262944e-41	32	31	19	0.6129032258064516	0.59375	REAC:R-HSA-165054	REAC	Rev-mediated nuclear export of HIV RNA	10916	2098		0.04054054054054054	0.05333333333333334	32	10884	19	12	13	10872	10916	0.6021027663655207
M1	string	0	network_modules	102	TRUE	3.149235284622902e-39	29	31	18	0.5806451612903226	0.6206896551724138	REAC:R-HSA-168271	REAC	Transport of Ribonucleoproteins into the Host Nucleus	10916	2589		0.05405405405405406	0.06666666666666667	29	10887	18	13	11	10874	10916	0.5992337314460078
M1	string	0	network_modules	102	TRUE	6.40227919840165e-38	71	31	21	0.6774193548387096	0.29577464788732394	REAC:R-HSA-1169408	REAC	ISG15 antiviral mechanism	10916	1166		0.06756756756756757	0.08	71	10845	21	10	50	10835	10916	0.44540367658332836
M1	string	0	network_modules	102	TRUE	3.669694362481749e-36	29	31	17	0.5483870967741935	0.5862068965517241	REAC:R-HSA-168333	REAC	NEP/NS2 Interacts with the Cellular Export Machinery	10916	1514		0.08108108108108109	0.09333333333333334	29	10887	17	14	12	10873	10916	0.565789951824124
M1	string	0	network_modules	102	TRUE	8.458241520745847e-36	30	31	17	0.5483870967741935	0.5666666666666667	REAC:R-HSA-168274	REAC	Export of Viral Ribonucleoproteins from Nucleus	10916	883		0.0945945945945946	0.10666666666666667	30	10886	17	14	13	10872	10916	0.5562123655255258
M1	string	0	network_modules	102	TRUE	1.8706217565595953e-35	31	31	17	0.5483870967741935	0.5483870967741935	REAC:R-HSA-159227	REAC	Transport of the SLBP independent Mature mRNA	10916	2602		0.10810810810810811	0.13333333333333333	31	10885	17	14	14	10871	10916	0.547100923140753
M1	string	0	network_modules	102	TRUE	1.8706217565595953e-35	31	31	17	0.5483870967741935	0.5483870967741935	REAC:R-HSA-180910	REAC	Vpr-mediated nuclear import of PICs	10916	2665		0.10810810810810811	0.13333333333333333	31	10885	17	14	14	10871	10916	0.547100923140753
M1	string	0	network_modules	102	TRUE	3.985812799334408e-35	32	31	17	0.5483870967741935	0.53125	REAC:R-HSA-159230	REAC	Transport of the SLBP Dependant Mature mRNA	10916	2601		0.13513513513513514	0.14666666666666667	32	10884	17	14	15	10870	10916	0.538418932115128
M1	string	0	network_modules	102	TRUE	1.0144588764992847e-34	153	31	23	0.7419354838709677	0.1503267973856209	REAC:R-HSA-168255	REAC	Influenza Infection	10916	1185		0.14864864864864866	0.16	153	10763	23	8	130	10755	10916	0.33044641326595714
M1	string	0	network_modules	102	TRUE	1.6401558316732988e-34	34	31	17	0.5483870967741935	0.5	REAC:R-HSA-176033	REAC	Interactions of Vpr with host cellular proteins	10916	1223		0.16216216216216217	0.17333333333333334	34	10882	17	14	17	10868	10916	0.5222156174019611
M1	string	0	network_modules	102	TRUE	1.561664792882603e-33	28	31	16	0.5161290322580645	0.5714285714285714	REAC:R-HSA-170822	REAC	Regulation of Glucokinase by Glucokinase Regulatory Protein	10916	1975		0.17567567567567569	0.2	28	10888	16	15	12	10873	10916	0.5418407327284998
M1	string	0	network_modules	102	TRUE	1.561664792882603e-33	28	31	16	0.5161290322580645	0.5714285714285714	REAC:R-HSA-5619107	REAC	Defective TPR may confer susceptibility towards thyroid papillary carcinoma (TPC)	10916	684		0.17567567567567569	0.2	28	10888	16	15	12	10873	10916	0.5418407327284998
M1	string	0	network_modules	102	TRUE	2.0130454400843438e-33	38	31	17	0.5483870967741935	0.4473684210526316	REAC:R-HSA-159231	REAC	Transport of Mature mRNA Derived from an Intronless Transcript	10916	2585		0.20270270270270271	0.21333333333333335	38	10878	17	14	21	10864	10916	0.4937253158077667
M1	string	0	network_modules	102	TRUE	3.5642437240235505e-33	39	31	17	0.5483870967741935	0.4358974358974359	REAC:R-HSA-159234	REAC	Transport of Mature mRNAs Derived from Intronless Transcripts	10916	2587		0.21621621621621623	0.22666666666666666	39	10877	17	14	22	10863	10916	0.48729486517951054
M1	string	0	network_modules	102	TRUE	2.927950090276281e-32	43	31	17	0.5483870967741935	0.3953488372093023	REAC:R-HSA-4615885	REAC	SUMOylation of DNA replication proteins	10916	2170		0.22972972972972974	0.24	43	10873	17	14	26	10859	10916	0.4638500228386499
M1	string	0	network_modules	102	TRUE	3.069602697460953e-32	32	31	16	0.5161290322580645	0.5	REAC:R-HSA-4085377	REAC	SUMOylation of SUMOylation proteins	10916	2172		0.24324324324324326	0.25333333333333335	32	10884	16	15	16	10869	10916	0.5065770149899318
M1	string	0	network_modules	102	TRUE	4.088657063108831e-32	115	34	20	0.5882352941176471	0.17391304347826086	GO:0006606	GO:BP	protein import into nucleus	16175	2323		0.058823529411764705	0.08571428571428572	115	16060	20	14	95	16046	16175	0.31744377407683566
M1	string	0	network_modules	102	TRUE	4.5873988342939165e-32	24	31	15	0.4838709677419355	0.625	REAC:R-HSA-9615933	REAC	Postmitotic nuclear pore complex (NPC) reformation	10916	1778		0.25675675675675674	0.26666666666666666	24	10892	15	16	9	10876	10916	0.5488105431163236
M1	string	0	network_modules	102	TRUE	4.7844410427850517e-32	126	31	21	0.6774193548387096	0.16666666666666666	REAC:R-HSA-162909	REAC	Host Interactions of HIV factors	10916	1132		0.2702702702702703	0.28	126	10790	21	10	105	10780	10916	0.3326809693148571
M1	string	0	network_modules	102	TRUE	5.950912762479237e-32	33	31	16	0.5161290322580645	0.48484848484848486	REAC:R-HSA-3301854	REAC	Nuclear Pore Complex (NPC) Disassembly	10916	1615		0.28378378378378377	0.29333333333333333	33	10883	16	15	17	10868	10916	0.49877642818036566
M1	string	0	network_modules	102	TRUE	1.0306888290482337e-31	120	34	20	0.5882352941176471	0.16666666666666666	GO:0051170	GO:BP	import into nucleus	16175	13553		0.08823529411764706	0.11428571428571428	120	16055	20	14	100	16041	16175	0.31064305606695963
M1	string	0	network_modules	102	TRUE	2.0652712282225875e-31	35	31	16	0.5161290322580645	0.45714285714285713	REAC:R-HSA-3232142	REAC	SUMOylation of ubiquitinylation proteins	10916	2179		0.2972972972972973	0.30666666666666664	35	10881	16	15	19	10866	10916	0.4841876129878427
M1	string	0	network_modules	102	TRUE	1.5588481207968172e-30	147	31	21	0.6774193548387096	0.14285714285714285	REAC:R-HSA-1169410	REAC	Antiviral mechanism by IFN-stimulated genes	10916	157		0.3108108108108108	0.32	147	10769	21	10	126	10759	10916	0.30741217439046925
M1	string	0	network_modules	102	TRUE	3.176576312224346e-30	40	31	16	0.5161290322580645	0.4	REAC:R-HSA-168325	REAC	Viral Messenger RNA Synthesis	10916	2648		0.32432432432432434	0.3333333333333333	40	10876	16	15	24	10861	10916	0.4526155869286496
M1	string	0	network_modules	102	TRUE	4.675772646608601e-30	55	31	17	0.5483870967741935	0.3090909090909091	REAC:R-HSA-6784531	REAC	tRNA processing in the nucleus	10916	2745		0.33783783783783783	0.3466666666666667	55	10861	17	14	38	10847	10916	0.4095363684889567
M1	string	0	network_modules	102	TRUE	1.3350321188646197e-29	43	31	16	0.5161290322580645	0.37209302325581395	REAC:R-HSA-4570464	REAC	SUMOylation of RNA binding proteins	10916	2171		0.35135135135135137	0.36	43	10873	16	15	27	10858	10916	0.43636731369831205
M1	string	0	network_modules	102	TRUE	1.9038784289760277e-29	241	34	22	0.6470588235294118	0.0912863070539419	GO:0034504	GO:BP	protein localization to nucleus	16175	8670		0.11764705882352941	0.14285714285714285	241	15934	22	12	219	15922	16175	0.23948268796979766
M1	string	0	network_modules	102	TRUE	7.528646144689354e-29	47	31	16	0.5161290322580645	0.3404255319148936	REAC:R-HSA-2980766	REAC	Nuclear Envelope Breakdown	10916	1613		0.36486486486486486	0.37333333333333335	47	10869	16	15	31	10854	10916	0.4171637792520055
M1	string	0	network_modules	102	TRUE	1.8850485366750821e-28	145	31	20	0.6451612903225806	0.13793103448275862	REAC:R-HSA-162587	REAC	HIV Life Cycle	10916	1103		0.3783783783783784	0.38666666666666666	145	10771	20	11	125	10760	10916	0.2945448292203881
M1	string	0	network_modules	102	TRUE	3.57458829402556e-28	51	31	16	0.5161290322580645	0.3137254901960784	REAC:R-HSA-191859	REAC	snRNP Assembly	10916	2736		0.3918918918918919	0.41333333333333333	51	10865	16	15	35	10850	10916	0.4002573570097164
M1	string	0	network_modules	102	TRUE	3.57458829402556e-28	51	31	16	0.5161290322580645	0.3137254901960784	REAC:R-HSA-194441	REAC	Metabolism of non-coding RNA	10916	1431		0.3918918918918919	0.41333333333333333	51	10865	16	15	35	10850	10916	0.4002573570097164
M1	string	0	network_modules	102	TRUE	6.959394375093588e-28	71	31	17	0.5483870967741935	0.23943661971830985	REAC:R-HSA-159236	REAC	Transport of Mature mRNA derived from an Intron-Containing Transcript	10916	2586		0.4189189189189189	0.4266666666666667	71	10845	17	14	54	10831	10916	0.35974240790521944
M1	string	0	network_modules	102	TRUE	4.022142026031215e-27	132	31	19	0.6129032258064516	0.14393939393939395	REAC:R-HSA-162599	REAC	Late Phase of HIV Life Cycle	10916	1304		0.43243243243243246	0.44	132	10784	19	12	113	10772	10916	0.2933533443875549
M1	string	0	network_modules	102	TRUE	6.744491146558319e-27	80	31	17	0.5483870967741935	0.2125	REAC:R-HSA-72202	REAC	Transport of Mature Transcript to Cytoplasm	10916	2584		0.44594594594594594	0.4533333333333333	80	10836	17	14	63	10822	10916	0.3385281699065424
M1	string	0	network_modules	102	TRUE	1.8969938053496698e-26	225	31	21	0.6774193548387096	0.09333333333333334	REAC:R-HSA-162906	REAC	HIV Infection	10916	1102		0.4594594594594595	0.4666666666666667	225	10691	21	10	204	10681	10916	0.2466992201148419
M1	string	0	network_modules	102	TRUE	4.1796583684977743e-26	66	31	16	0.5161290322580645	0.24242424242424243	REAC:R-HSA-4551638	REAC	SUMOylation of chromatin organization proteins	10916	2173		0.47297297297297297	0.48	66	10850	16	15	50	10835	10916	0.3511430298060902
M1	string	0	network_modules	102	TRUE	5.483782594249479e-26	67	31	16	0.5161290322580645	0.23880597014925373	REAC:R-HSA-3371453	REAC	Regulation of HSF1-mediated heat shock response	10916	1977		0.4864864864864865	0.49333333333333335	67	10849	16	15	51	10834	10916	0.3484661752659915
M1	string	0	network_modules	102	TRUE	7.161773271767098e-26	68	31	16	0.5161290322580645	0.23529411764705882	REAC:R-HSA-70171	REAC	Glycolysis	10916	1074		0.5	0.5066666666666667	68	10848	16	15	52	10833	10916	0.3458482412867533
M1	string	0	network_modules	102	TRUE	1.995615241174077e-25	72	31	16	0.5161290322580645	0.2222222222222222	REAC:R-HSA-3108214	REAC	SUMOylation of DNA damage response and repair proteins	10916	2168		0.5135135135135135	0.52	72	10844	16	15	56	10829	10916	0.3359244769605163
M1	string	0	network_modules	102	TRUE	5.605934236499042e-25	263	31	21	0.6774193548387096	0.07984790874524715	REAC:R-HSA-913531	REAC	Interferon Signaling	10916	1227		0.527027027027027	0.5333333333333333	263	10653	21	10	242	10643	10916	0.22737695583725506
M1	string	0	network_modules	102	TRUE	6.207421152819112e-25	102	31	17	0.5483870967741935	0.16666666666666666	REAC:R-HSA-5578749	REAC	Transcriptional regulation by small RNAs	10916	2555		0.5405405405405406	0.5466666666666666	102	10814	17	14	85	10800	10916	0.2989925115139151
M1	string	0	network_modules	102	TRUE	7.425386152725482e-25	103	31	17	0.5483870967741935	0.1650485436893204	REAC:R-HSA-72306	REAC	tRNA processing	10916	2743		0.5540540540540541	0.56	103	10813	17	14	86	10799	10916	0.2975007415932285
M1	string	0	network_modules	102	TRUE	4.6017736402729084e-24	86	31	16	0.5161290322580645	0.18604651162790697	REAC:R-HSA-70326	REAC	Glucose metabolism	10916	1053		0.5675675675675675	0.5733333333333334	86	10830	16	15	70	10815	10916	0.3067924579848622
M1	string	0	network_modules	102	TRUE	5.6314474923054554e-24	87	31	16	0.5161290322580645	0.1839080459770115	REAC:R-HSA-3371556	REAC	Cellular response to heat stress	10916	334		0.581081081081081	0.5866666666666667	87	10829	16	15	71	10814	10916	0.30498328933814745
M1	string	0	network_modules	102	TRUE	1.2018674637928075e-23	120	31	17	0.5483870967741935	0.14166666666666666	REAC:R-HSA-9705671	REAC	SARS-CoV-2 activates/modulates innate and adaptive immune responses	10916	2123		0.5945945945945946	0.6	120	10796	17	14	103	10782	10916	0.27504322850467705
M1	string	0	network_modules	102	TRUE	2.3755784768252067e-23	70	31	15	0.4838709677419355	0.21428571428571427	REAC:R-HSA-2995410	REAC	Nuclear Envelope (NE) Reassembly	10916	1612		0.6081081081081081	0.6133333333333333	70	10846	15	16	55	10830	10916	0.31921393462113723
M1	string	0	network_modules	102	TRUE	2.596533228896054e-23	95	31	16	0.5161290322580645	0.16842105263157894	REAC:R-HSA-5619102	REAC	SLC transporter disorders	10916	2145		0.6216216216216216	0.6266666666666667	95	10821	16	15	79	10806	10916	0.29154631241568635
M1	string	0	network_modules	102	TRUE	7.675404560720475e-23	133	31	17	0.5483870967741935	0.12781954887218044	REAC:R-HSA-168273	REAC	Influenza Viral RNA Transcription and Replication	10916	1186		0.6351351351351351	0.64	133	10783	17	14	116	10769	10916	0.2608338143294997
M1	string	0	network_modules	102	TRUE	8.779866042737223e-23	134	31	17	0.5483870967741935	0.12686567164179105	REAC:R-HSA-211000	REAC	Gene Silencing by RNA	10916	1041		0.6486486486486487	0.6533333333333333	134	10782	17	14	117	10768	10916	0.2598263834197552
M1	string	0	network_modules	102	TRUE	1.4279475345033218e-22	177	31	18	0.5806451612903226	0.1016949152542373	REAC:R-HSA-2990846	REAC	SUMOylation	10916	2167		0.6621621621621622	0.6666666666666666	177	10739	18	13	159	10726	10916	0.23849101563047367
M1	string	0	network_modules	102	TRUE	5.094740382830397e-22	113	31	16	0.5161290322580645	0.1415929203539823	REAC:R-HSA-9610379	REAC	HCMV Late Events	10916	1090		0.6756756756756757	0.68	113	10803	16	15	97	10788	10916	0.2666723834424117
M1	string	0	network_modules	102	TRUE	1.8828697599945675e-21	373	34	20	0.5882352941176471	0.05361930294906166	GO:0072594	GO:BP	establishment of protein localization to organelle	16175	17458		0.14705882352941177	0.17142857142857143	373	15802	20	14	353	15788	16175	0.1728188216770675
M1	string	0	network_modules	102	TRUE	5.235133182332008e-21	152	34	16	0.47058823529411764	0.10526315789473684	GO:0051168	GO:BP	nuclear export	16175	13551		0.17647058823529413	0.2	152	16023	16	18	136	16005	16175	0.21938435768195078
M1	string	0	network_modules	102	TRUE	5.603630764845307e-21	114	34	15	0.4411764705882353	0.13157894736842105	GO:0050658	GO:BP	RNA transport	16175	13198		0.20588235294117646	0.2571428571428571	114	16061	15	19	99	16042	16175	0.23817609318250776
M1	string	0	network_modules	102	TRUE	5.603630764845307e-21	114	34	15	0.4411764705882353	0.13157894736842105	GO:0050657	GO:BP	nucleic acid transport	16175	13197		0.20588235294117646	0.2571428571428571	114	16061	15	19	99	16042	16175	0.23817609318250776
M1	string	0	network_modules	102	TRUE	6.030066810116085e-21	406	31	21	0.6774193548387096	0.05172413793103448	REAC:R-HSA-68886	REAC	M Phase	10916	1343		0.6891891891891891	0.6933333333333334	406	10510	21	10	385	10500	10916	0.18055073260359722
M1	string	0	network_modules	102	TRUE	6.7127629144867355e-21	171	31	17	0.5483870967741935	0.09941520467836257	REAC:R-HSA-3108232	REAC	SUMO E3 ligases SUMOylate target proteins	10916	2163		0.7027027027027027	0.7066666666666667	171	10745	17	14	154	10731	10916	0.22894414381502529
M1	string	0	network_modules	102	TRUE	8.461453345432254e-21	117	34	15	0.4411764705882353	0.1282051282051282	GO:0051236	GO:BP	establishment of RNA localization	16175	13586		0.2647058823529412	0.2857142857142857	117	16058	15	19	102	16039	16175	0.23502423316083368
M1	string	0	network_modules	102	TRUE	9.091418580991246e-21	134	31	16	0.5161290322580645	0.11940298507462686	REAC:R-HSA-68875	REAC	Mitotic Prophase	10916	1485		0.7162162162162162	0.72	134	10782	16	15	118	10767	10916	0.24419251687172772
M1	string	0	network_modules	102	TRUE	1.0300305171430138e-20	135	31	16	0.5161290322580645	0.11851851851851852	REAC:R-HSA-9609690	REAC	HCMV Early Events	10916	1088		0.7297297297297297	0.7333333333333333	135	10781	16	15	119	10766	10916	0.2432534664862926
M1	string	0	network_modules	102	TRUE	2.006287472318615e-20	90	34	14	0.4117647058823529	0.15555555555555556	GO:0006405	GO:BP	RNA export from nucleus	16175	2166		0.29411764705882354	0.3142857142857143	90	16085	14	20	76	16065	16175	0.2506266582865645
M1	string	0	network_modules	102	TRUE	3.702928581744814e-20	524	34	21	0.6176470588235294	0.04007633587786259	GO:0006886	GO:BP	intracellular protein transport	16175	2542		0.3235294117647059	0.34285714285714286	524	15651	21	13	503	15638	16175	0.1517135222082726
M1	string	0	network_modules	102	TRUE	8.063414515016251e-20	197	31	17	0.5483870967741935	0.08629441624365482	REAC:R-HSA-9705683	REAC	SARS-CoV-2-host interactions	10916	2128		0.7432432432432432	0.7466666666666667	197	10719	17	14	180	10705	10916	0.21260547837043553
M1	string	0	network_modules	102	TRUE	1.5811092523854845e-19	159	31	16	0.5161290322580645	0.10062893081761007	REAC:R-HSA-9609646	REAC	HCMV Infection	10916	1089		0.7567567567567568	0.76	159	10757	16	15	143	10742	10916	0.22341468966120598
M1	string	0	network_modules	102	TRUE	3.7798032413225856e-19	149	34	15	0.4411764705882353	0.10067114093959731	GO:0006403	GO:BP	RNA localization	16175	2164		0.35294117647058826	0.37142857142857144	149	16026	15	19	134	16007	16175	0.20752054904377998
M1	string	0	network_modules	102	TRUE	6.392514679431911e-19	173	31	16	0.5161290322580645	0.09248554913294797	REAC:R-HSA-5619115	REAC	Disorders of transmembrane transporters	10916	778		0.7702702702702703	0.7733333333333333	173	10743	16	15	157	10728	10916	0.21377558228663038
M1	string	0	network_modules	102	TRUE	2.4379892929261657e-18	168	34	15	0.4411764705882353	0.08928571428571429	GO:0015931	GO:BP	nucleobase-containing compound transport	16175	5016		0.38235294117647056	0.4	168	16007	15	19	153	15988	16175	0.19501795659536217
M1	string	0	network_modules	102	TRUE	9.161555124987813e-18	808	34	22	0.6470588235294118	0.027227722772277228	GO:0033365	GO:BP	protein localization to organelle	16175	8175		0.4117647058823529	0.42857142857142855	808	15367	22	12	786	15355	16175	0.12579667151132357
M1	string	0	network_modules	102	TRUE	2.77835449430707e-17	276	31	17	0.5483870967741935	0.06159420289855073	REAC:R-HSA-72203	REAC	Processing of Capped Intron-Containing Pre-mRNA	10916	1796		0.7837837837837838	0.7866666666666666	276	10640	17	14	259	10626	10916	0.1778247079991483
M1	string	0	network_modules	102	TRUE	5.877429315379862e-17	228	31	16	0.5161290322580645	0.07017543859649122	REAC:R-HSA-68882	REAC	Mitotic Anaphase	10916	1479		0.7972972972972973	0.8	228	10688	16	15	212	10673	10916	0.18481286876572173
M1	string	0	network_modules	102	TRUE	6.310597300011668e-17	229	31	16	0.5161290322580645	0.06986899563318777	REAC:R-HSA-2555396	REAC	Mitotic Metaphase and Anaphase	10916	1482		0.8108108108108109	0.8133333333333334	229	10687	16	15	213	10672	10916	0.18438342016300152
M1	string	0	network_modules	102	TRUE	7.301584329415946e-17	292	31	17	0.5483870967741935	0.05821917808219178	REAC:R-HSA-9694516	REAC	SARS-CoV-2 Infection	10916	2122		0.8243243243243243	0.8266666666666667	292	10624	17	14	275	10610	10916	0.17252951379435838
M1	string	0	network_modules	102	TRUE	9.57244067198174e-17	363	32	19	0.59375	0.05234159779614325	KEGG:05014	KEGG	Amyotrophic lateral sclerosis	8484	413		0.5	0.6666666666666666	363	8121	19	13	344	8108	8484	0.16751771011174899
M1	string	0	network_modules	102	TRUE	1.6618469710618637e-15	15	34	8	0.23529411764705882	0.5333333333333333	GO:0006999	GO:BP	nuclear pore organization	16175	2614		0.4411764705882353	0.45714285714285713	15	16160	8	26	7	16134	16175	0.35338510369537873
M1	string	0	network_modules	102	TRUE	2.556830361163959e-15	288	31	16	0.5161290322580645	0.05555555555555555	REAC:R-HSA-71387	REAC	Metabolism of carbohydrates	10916	1422		0.8378378378378378	0.84	288	10628	16	15	272	10613	10916	0.16307177896444291
M1	string	0	network_modules	102	TRUE	5.0530063142805016e-15	459	31	18	0.5806451612903226	0.0392156862745098	REAC:R-HSA-9679506	REAC	SARS-CoV Infections	10916	2112		0.8513513513513513	0.8533333333333334	459	10457	18	13	441	10444	10916	0.1432135211407873
M1	string	0	network_modules	102	TRUE	1.064876436038211e-12	121	34	11	0.3235294117647059	0.09090909090909091	GO:0006997	GO:BP	nucleus organization	16175	2612		0.47058823529411764	0.4857142857142857	121	16054	11	23	110	16031	16175	0.16834036577118638
M1	string	0	network_modules	102	TRUE	7.73373848679688e-12	19	34	7	0.20588235294117646	0.3684210526315789	GO:0006607	GO:BP	NLS-bearing protein import into nucleus	16175	2324		0.5	0.5142857142857142	19	16156	7	27	12	16129	16175	0.27428937610733367
M1	string	0	network_modules	102	TRUE	8.302734334214893e-10	92	31	9	0.2903225806451613	0.09782608695652174	REAC:R-HSA-141424	REAC	Amplification of signal from the kinetochores	10916	144		0.8648648648648649	0.88	92	10824	9	22	83	10802	10916	0.16456182129244287
M1	string	0	network_modules	102	TRUE	8.302734334214893e-10	92	31	9	0.2903225806451613	0.09782608695652174	REAC:R-HSA-141444	REAC	Amplification  of signal from unattached  kinetochores via a MAD2  inhibitory signal	10916	143		0.8648648648648649	0.88	92	10824	9	22	83	10802	10916	0.16456182129244287
M1	string	0	network_modules	102	TRUE	1.053032530002165e-9	7	34	5	0.14705882352941177	0.7142857142857143	GO:0000972	GO:BP	transcription-dependent tethering of RNA polymerase II gene DNA at nuclear periphery	16175	277		0.5294117647058824	0.5428571428571428	7	16168	5	29	2	16139	16175	0.32355827730659475
M1	string	0	network_modules	102	TRUE	1.9986319509995117e-9	69	34	8	0.23529411764705882	0.11594202898550725	GO:0006406	GO:BP	mRNA export from nucleus	16175	2167		0.5588235294117647	0.5714285714285714	69	16106	8	26	61	16080	16175	0.16269165321708423
M1	string	0	network_modules	102	TRUE	3.9499155365607405e-9	109	31	9	0.2903225806451613	0.08256880733944955	REAC:R-HSA-69618	REAC	Mitotic Spindle Checkpoint	10916	1486		0.8918918918918919	0.8933333333333333	109	10807	9	22	100	10785	10916	0.15046833756644673
M1	string	0	network_modules	102	TRUE	4.462091652871949e-9	76	34	8	0.23529411764705882	0.10526315789473684	GO:0051028	GO:BP	mRNA transport	16175	13445		0.5882352941176471	0.6	76	16099	8	26	68	16073	16175	0.15476157007616864
M1	string	0	network_modules	102	TRUE	6.44390479235535e-9	115	31	9	0.2903225806451613	0.0782608695652174	REAC:R-HSA-9648025	REAC	EML4 and NUDC in mitotic spindle formation	10916	817		0.9054054054054054	0.9066666666666666	115	10801	9	22	106	10779	10916	0.14624387818822623
M1	string	0	network_modules	102	TRUE	1.188350673872729e-8	123	31	9	0.2903225806451613	0.07317073170731707	REAC:R-HSA-2500257	REAC	Resolution of Sister Chromatid Cohesion	10916	2079		0.918918918918919	0.92	123	10793	9	22	114	10771	10916	0.14108988546844056
M1	string	0	network_modules	102	TRUE	1.2579816596468872e-8	10	34	5	0.14705882352941177	0.5	GO:0051292	GO:BP	nuclear pore complex assembly	16175	13624		0.6176470588235294	0.6285714285714286	10	16165	5	29	5	16136	16175	0.27039093730828334
M1	string	0	network_modules	102	TRUE	2.9513535424211854e-8	136	31	9	0.2903225806451613	0.0661764705882353	REAC:R-HSA-5663220	REAC	RHO GTPases Activate Formins	10916	1848		0.9324324324324325	0.9333333333333333	136	10780	9	22	127	10758	10916	0.13368519086256012
M1	string	0	network_modules	102	TRUE	5.33504964762458e-7	188	31	9	0.2903225806451613	0.047872340425531915	REAC:R-HSA-2467813	REAC	Separation of Sister Chromatids	10916	2204		0.9459459459459459	0.9466666666666667	188	10728	9	22	179	10706	10916	0.11202470180662204
M1	string	0	network_modules	102	TRUE	5.727067008502395e-7	19	34	5	0.14705882352941177	0.2631578947368421	GO:0046931	GO:BP	pore complex assembly	16175	12434		0.6470588235294118	0.6571428571428571	19	16156	5	29	14	16127	16175	0.19547128998938765
M1	string	0	network_modules	102	TRUE	8.81754400723983e-7	199	31	9	0.2903225806451613	0.04522613065326633	REAC:R-HSA-68877	REAC	Mitotic Prometaphase	10916	1484		0.9594594594594594	0.96	199	10717	9	22	190	10695	10916	0.10853842377885818
M1	string	0	network_modules	102	TRUE	8.818818691093011e-7	545	34	12	0.35294117647058826	0.022018348623853212	GO:0051276	GO:BP	chromosome organization	16175	13613		0.6764705882352942	0.6857142857142857	545	15630	12	22	533	15608	16175	0.08120221795499566
M1	string	0	network_modules	102	TRUE	2.2736249150568287e-5	289	31	9	0.2903225806451613	0.031141868512110725	REAC:R-HSA-69620	REAC	Cell Cycle Checkpoints	10916	321		0.972972972972973	0.9733333333333334	289	10627	9	22	280	10605	10916	0.08770597436394827
M1	string	0	network_modules	102	TRUE	2.4281540258962672e-5	80	34	6	0.17647058823529413	0.075	GO:0046822	GO:BP	regulation of nucleocytoplasmic transport	16175	12379		0.7058823529411765	0.7142857142857143	80	16095	6	28	74	16067	16175	0.11221597136366435
M1	string	0	network_modules	102	TRUE	5.154522246474414e-5	318	31	9	0.2903225806451613	0.02830188679245283	REAC:R-HSA-195258	REAC	RHO GTPase Effectors	10916	1846		0.9864864864864865	0.9866666666666667	318	10598	9	22	309	10576	10916	0.0828825107650186
M1	string	0	network_modules	102	TRUE	5.649037270794022e-5	4	34	3	0.08823529411764706	0.75	GO:0006404	GO:BP	RNA import into nucleus	16175	2165		0.7352941176470589	0.7428571428571429	4	16171	3	31	1	16140	16175	0.25682868944173903
M1	string	0	network_modules	102	TRUE	3.3795045507662173e-4	124	34	6	0.17647058823529413	0.04838709677419355	GO:0007052	GO:BP	mitotic spindle organization	16175	2651		0.7647058823529411	0.7714285714285715	124	16051	6	28	118	16023	16175	0.08882607995027053
M1	string	0	network_modules	102	TRUE	0.001169339324943148	153	34	6	0.17647058823529413	0.0392156862745098	GO:1902850	GO:BP	microtubule cytoskeleton organization involved in mitosis	16175	22560		0.7941176470588235	0.8	153	16022	6	28	147	15994	16175	0.07918828684226409
M1	string	0	network_modules	102	TRUE	0.0019464291113917467	90	34	5	0.14705882352941177	0.05555555555555555	GO:0072006	GO:BP	nephron development	16175	17042		0.8235294117647058	0.8285714285714286	90	16085	5	29	85	16056	16175	0.08730253554129108
M1	string	0	network_modules	102	TRUE	0.002652591232519723	176	34	6	0.17647058823529413	0.03409090909090909	GO:0007051	GO:BP	spindle organization	16175	2650		0.8529411764705882	0.8571428571428571	176	15999	6	28	170	15971	16175	0.07325694956274807
M1	string	0	network_modules	102	TRUE	0.004805510598403334	108	34	5	0.14705882352941177	0.046296296296296294	GO:0050000	GO:BP	chromosome localization	16175	13183		0.8823529411764706	0.8857142857142857	108	16067	5	29	103	16038	16175	0.07911343198742216
M1	string	0	network_modules	102	TRUE	0.004941521085513004	48	34	4	0.11764705882352941	0.08333333333333333	GO:0006611	GO:BP	protein export from nucleus	16175	2326		0.9117647058823529	0.9142857142857143	48	16127	4	30	44	16097	16175	0.09676247539037268
M1	string	0	network_modules	102	TRUE	0.006324915634638963	15	34	3	0.08823529411764706	0.2	GO:0046823	GO:BP	negative regulation of nucleocytoplasmic transport	16175	12380		0.9411764705882353	0.9428571428571428	15	16160	3	31	12	16129	16175	0.13164547873328894
M1	string	0	network_modules	102	TRUE	0.0071479232129570795	2	34	2	0.058823529411764705	1	GO:0046832	GO:BP	negative regulation of RNA export from nucleus	16175	12389		0.9705882352941176	0.9714285714285714	2	16173	2	32	0	16141	16175	0.24229556497128557
M1	string	0	network_modules	102	TRUE	0.00779158260191664	3	31	2	0.06451612903225806	0.6666666666666666	REAC:R-HSA-9636249	REAC	Inhibition of nitric oxide production	10916	1197		1	1	3	10913	2	29	1	10884	10916	0.20682917230121037
M1	string	0	network_modules	102	TRUE	0.008448996094654737	215	34	6	0.17647058823529413	0.027906976744186046	GO:0032386	GO:BP	regulation of intracellular transport	16175	7540		1	1	215	15960	6	28	209	15932	16175	0.06539517622737297
M1	string	0	network_modules	102	TRUE	0.008562522940719528	211	32	6	0.1875	0.02843601895734597	KEGG:05207	KEGG	Chemical carcinogenesis - receptor activation	8484	459		1	1	211	8273	6	26	205	8247	8484	0.0642573643217343
M1	string	0	network_modules	103	TRUE	1.7827469037065018e-13	112	32	11	0.34375	0.09821428571428571	GO:0006820	GO:BP	monoatomic anion transport	16175	2497		0	0.02564102564102564	112	16063	11	21	101	16042	16175	0.1808464879535799
M1	string	0	network_modules	103	TRUE	5.888930624233892e-12	65	32	9	0.28125	0.13846153846153847	GO:0098656	GO:BP	monoatomic anion transmembrane transport	16175	18812		0.02631578947368421	0.05128205128205128	65	16110	9	23	56	16087	16175	0.19510356611142327
M1	string	0	network_modules	103	TRUE	6.925015094957945e-10	245	25	11	0.44	0.044897959183673466	REAC:R-HSA-425407	REAC	SLC-mediated transmembrane transport	10916	2146		0	0.25	245	10671	11	14	234	10657	10916	0.13506059395426626
M1	string	0	network_modules	103	TRUE	8.499262232057989e-10	326	32	12	0.375	0.03680981595092025	GO:0015711	GO:BP	organic anion transport	16175	4831		0.05263157894736842	0.07692307692307693	326	15849	12	20	314	15829	16175	0.11242338347681868
M1	string	0	network_modules	103	TRUE	1.942981197619683e-9	182	32	10	0.3125	0.054945054945054944	GO:0098739	GO:BP	import across plasma membrane	16175	18866		0.07894736842105263	0.10256410256410256	182	15993	10	22	172	15971	16175	0.12716007132286597
M1	string	0	network_modules	103	TRUE	1.8603927962886172e-8	105	25	8	0.32	0.0761904761904762	REAC:R-HSA-425393	REAC	Transport of inorganic cations/anions and amino acids/oligopeptides	10916	2596		0.3333333333333333	0.5	105	10811	8	17	97	10794	10916	0.152358723657268
M1	string	0	network_modules	103	TRUE	3.0805096771546166e-8	30	32	6	0.1875	0.2	GO:0006884	GO:BP	cell volume homeostasis	16175	2540		0.10526315789473684	0.1282051282051282	30	16145	6	26	24	16119	16175	0.19210179759819276
M1	string	0	network_modules	103	TRUE	9.23485735258146e-7	26	25	5	0.2	0.19230769230769232	REAC:R-HSA-5223345	REAC	Miscellaneous transport and binding events	10916	1456		0.6666666666666666	0.75	26	10890	5	20	21	10870	10916	0.19423429923601793
M1	string	0	network_modules	103	TRUE	1.0544947914315596e-6	98	32	7	0.21875	0.07142857142857142	GO:0006865	GO:BP	amino acid transport	16175	2527		0.13157894736842105	0.15384615384615385	98	16077	7	25	91	16052	16175	0.122028499343964
M1	string	0	network_modules	103	TRUE	1.2285283217460921e-6	248	32	9	0.28125	0.036290322580645164	GO:0046942	GO:BP	carboxylic acid transport	16175	12438		0.15789473684210525	0.1794871794871795	248	15927	9	23	239	15904	16175	0.09635662183214318
M1	string	0	network_modules	103	TRUE	1.2729491856595275e-6	249	32	9	0.28125	0.03614457831325301	GO:0015849	GO:BP	organic acid transport	16175	4958		0.18421052631578946	0.20512820512820512	249	15926	9	23	240	15903	16175	0.09614360115238035
M1	string	0	network_modules	103	TRUE	3.646932464936403e-6	671	32	12	0.375	0.01788375558867362	GO:0034220	GO:BP	monoatomic ion transmembrane transport	16175	8508		0.21052631578947367	0.23076923076923078	671	15504	12	20	659	15484	16175	0.07446650762517949
M1	string	0	network_modules	103	TRUE	3.7113055387507417e-6	64	32	6	0.1875	0.09375	GO:1901264	GO:BP	carbohydrate derivative transport	16175	21340		0.23684210526315788	0.2564102564102564	64	16111	6	26	58	16085	16175	0.1301710475593262
M1	string	0	network_modules	103	TRUE	3.862898679712307e-6	10	32	4	0.125	0.4	GO:0055064	GO:BP	chloride ion homeostasis	16175	14227		0.2631578947368421	0.3076923076923077	10	16165	4	28	6	16137	16175	0.22279015997153992
M1	string	0	network_modules	103	TRUE	3.862898679712307e-6	10	32	4	0.125	0.4	GO:0055081	GO:BP	monoatomic anion homeostasis	16175	14234		0.2631578947368421	0.3076923076923077	10	16165	4	28	6	16137	16175	0.22279015997153992
M1	string	0	network_modules	103	TRUE	4.919557563769154e-6	67	32	6	0.1875	0.08955223880597014	GO:0098661	GO:BP	inorganic anion transmembrane transport	16175	18817		0.3157894736842105	0.3333333333333333	67	16108	6	26	61	16082	16175	0.12710667123123368
M1	string	0	network_modules	103	TRUE	7.648983047622973e-6	72	32	6	0.1875	0.08333333333333333	GO:0003333	GO:BP	amino acid transmembrane transport	16175	1753		0.34210526315789475	0.358974358974359	72	16103	6	26	66	16077	16175	0.12242613152965273
M1	string	0	network_modules	103	TRUE	4.131875314962112e-5	4	32	3	0.09375	0.75	GO:0140157	GO:BP	ammonium import across plasma membrane	16175	19684		0.3684210526315789	0.38461538461538464	4	16171	3	29	1	16142	16175	0.2647603185637826
M1	string	0	network_modules	103	TRUE	9.419656607678484e-5	109	32	6	0.1875	0.05504587155963303	GO:1903825	GO:BP	organic acid transmembrane transport	16175	23308		0.39473684210526316	0.41025641025641024	109	16066	6	26	103	16040	16175	0.09837058497111469
M1	string	0	network_modules	103	TRUE	9.486766688257635e-5	54	32	5	0.15625	0.09259259259259259	GO:1902476	GO:BP	chloride transmembrane transport	16175	22306		0.42105263157894735	0.4358974358974359	54	16121	5	27	49	16094	16175	0.11802512702158216
M1	string	0	network_modules	103	TRUE	1.0315796272895862e-4	5	32	3	0.09375	0.6	GO:0140361	GO:BP	cyclic-GMP-AMP transmembrane import across plasma membrane	16175	19752		0.4473684210526316	0.46153846153846156	5	16170	3	29	2	16141	16175	0.23665956801569427
M1	string	0	network_modules	103	TRUE	1.2980276176783744e-4	115	32	6	0.1875	0.05217391304347826	GO:0015698	GO:BP	inorganic anion transport	16175	4818		0.47368421052631576	0.48717948717948717	115	16060	6	26	109	16034	16175	0.09559134132578702
M1	string	0	network_modules	103	TRUE	1.2999575045662693e-4	7	25	3	0.12	0.42857142857142855	REAC:R-HSA-426117	REAC	Cation-coupled Chloride cotransporters	10916	318		1	1	7	10909	3	22	4	10887	10916	0.2258979995607186
M1	string	0	network_modules	103	TRUE	1.3409618603694485e-4	740	32	11	0.34375	0.014864864864864866	GO:0098657	GO:BP	import into cell	16175	18813		0.5	0.5128205128205128	740	15435	11	21	729	15414	16175	0.06350015794812962
M1	string	0	network_modules	103	TRUE	1.7583470554435922e-4	121	32	6	0.1875	0.049586776859504134	GO:0008361	GO:BP	regulation of cell size	16175	3180		0.5263157894736842	0.5384615384615384	121	16054	6	26	115	16028	16175	0.09301692051880181
M1	string	0	network_modules	103	TRUE	1.9170635755434704e-4	24	32	4	0.125	0.16666666666666666	GO:0015868	GO:BP	purine ribonucleotide transport	16175	4976		0.5526315789473685	0.5897435897435898	24	16151	4	28	20	16123	16175	0.1428715804112155
M1	string	0	network_modules	103	TRUE	1.9170635755434704e-4	24	32	4	0.125	0.16666666666666666	GO:0055075	GO:BP	potassium ion homeostasis	16175	14231		0.5526315789473685	0.5897435897435898	24	16151	4	28	20	16123	16175	0.1428715804112155
M1	string	0	network_modules	103	TRUE	2.060384700284936e-4	6	32	3	0.09375	0.5	GO:1903790	GO:BP	guanine nucleotide transmembrane transport	16175	23281		0.6052631578947368	0.6153846153846154	6	16169	3	29	3	16140	16175	0.21590337641264376
M1	string	0	network_modules	103	TRUE	2.689701334952113e-4	26	32	4	0.125	0.15384615384615385	GO:0051503	GO:BP	adenine nucleotide transport	16175	13755		0.631578947368421	0.6410256410256411	26	16149	4	28	22	16121	16175	0.1371376530721699
M1	string	0	network_modules	103	TRUE	2.944134300041692e-4	623	32	10	0.3125	0.016051364365971106	GO:0019725	GO:BP	cellular homeostasis	16175	6020		0.6578947368421053	0.6666666666666666	623	15552	10	22	613	15530	16175	0.06338913817295885
M1	string	0	network_modules	103	TRUE	3.153102390197551e-4	27	32	4	0.125	0.14814814814814814	GO:0015865	GO:BP	purine nucleotide transport	16175	4973		0.6842105263157895	0.717948717948718	27	16148	4	28	23	16120	16175	0.1345108450366454
M1	string	0	network_modules	103	TRUE	3.153102390197551e-4	27	32	4	0.125	0.14814814814814814	GO:0072530	GO:BP	purine-containing compound transmembrane transport	16175	17432		0.6842105263157895	0.717948717948718	27	16148	4	28	23	16120	16175	0.1345108450366454
M1	string	0	network_modules	103	TRUE	3.600824481175372e-4	7	32	3	0.09375	0.42857142857142855	GO:0001408	GO:BP	guanine nucleotide transport	16175	316		0.7368421052631579	0.7435897435897436	7	16168	3	29	4	16139	16175	0.19976152254110363
M1	string	0	network_modules	103	TRUE	5.753571925095902e-4	8	32	3	0.09375	0.375	GO:0070729	GO:BP	cyclic nucleotide transport	16175	16277		0.7631578947368421	0.7692307692307693	8	16167	3	29	5	16138	16175	0.18674177234759662
M1	string	0	network_modules	103	TRUE	7.290967932555497e-4	33	32	4	0.125	0.12121212121212122	GO:0006862	GO:BP	nucleotide transport	16175	2524		0.7894736842105263	0.7948717948717948	33	16142	4	28	29	16114	16175	0.12132623285808623
M1	string	0	network_modules	103	TRUE	8.618753117235394e-4	9	32	3	0.09375	0.3333333333333333	GO:0034214	GO:BP	protein hexamerization	16175	8506		0.8157894736842105	0.8205128205128205	9	16166	3	29	6	16137	16175	0.17595055271848542
M1	string	0	network_modules	103	TRUE	9.423636528615064e-4	85	32	5	0.15625	0.058823529411764705	GO:0006821	GO:BP	chloride transport	16175	2498		0.8421052631578947	0.8461538461538461	85	16090	5	27	80	16063	16175	0.09298270364966166
M1	string	0	network_modules	103	TRUE	0.001557319165393782	94	32	5	0.15625	0.05319148936170213	GO:0015695	GO:BP	organic cation transport	16175	4816		0.868421052631579	0.8717948717948718	94	16081	5	27	89	16054	16175	0.08811825282579382
M1	string	0	network_modules	103	TRUE	0.001688419813370325	11	32	3	0.09375	0.2727272727272727	GO:0072488	GO:BP	ammonium transmembrane transport	16175	17412		0.8947368421052632	0.8974358974358975	11	16164	3	29	8	16135	16175	0.15895193423622508
M1	string	0	network_modules	103	TRUE	0.002961923871362909	107	32	5	0.15625	0.04672897196261682	GO:1905039	GO:BP	carboxylic acid transmembrane transport	16175	24314		0.9210526315789473	0.9230769230769231	107	16068	5	27	102	16041	16175	0.08218396999762767
M1	string	0	network_modules	103	TRUE	0.0046983231258118496	52	32	4	0.125	0.07692307692307693	GO:0006970	GO:BP	response to osmotic stress	16175	2597		0.9473684210526315	0.9487179487179487	52	16123	4	28	48	16095	16175	0.09578487470907045
M1	string	0	network_modules	103	TRUE	0.007158526314070405	128	32	5	0.15625	0.0390625	GO:0015748	GO:BP	organophosphate ester transport	16175	4867		0.9736842105263158	0.9743589743589743	128	16047	5	27	123	16020	16175	0.07453726064107048
M1	string	0	network_modules	103	TRUE	0.008271744256650946	18	32	3	0.09375	0.16666666666666666	GO:1901679	GO:BP	nucleotide transmembrane transport	16175	21640		1	1	18	16157	3	29	15	16128	16175	0.1237074419608449
M1	string	0	network_modules	104	TRUE	1.5887919771560732e-16	23	32	9	0.28125	0.391304347826087	GO:1902455	GO:BP	negative regulation of stem cell population maintenance	16175	22293		0	0.037037037037037035	23	16152	9	23	14	16129	16175	0.33062929736460483
M1	string	0	network_modules	104	TRUE	6.655982700802491e-14	41	32	9	0.28125	0.21951219512195122	GO:1902459	GO:BP	positive regulation of stem cell population maintenance	16175	22297		0.038461538461538464	0.07407407407407407	41	16134	9	23	32	16111	16175	0.24678848507385975
M1	string	0	network_modules	104	TRUE	2.3327595229527934e-12	59	32	9	0.28125	0.15254237288135594	GO:2000036	GO:BP	regulation of stem cell population maintenance	16175	25399		0.07692307692307693	0.1111111111111111	59	16116	9	23	50	16093	16175	0.2050197641790468
M1	string	0	network_modules	104	TRUE	5.916773939378597e-11	83	32	9	0.28125	0.10843373493975904	GO:0030512	GO:BP	negative regulation of transforming growth factor beta receptor signaling pathway	16175	6828		0.11538461538461539	0.14814814814814814	83	16092	9	23	74	16069	16175	0.17205955609758997
M1	string	0	network_modules	104	TRUE	3.0525579040428215e-10	99	32	9	0.28125	0.09090909090909091	GO:0019827	GO:BP	stem cell population maintenance	16175	6046		0.15384615384615385	0.18518518518518517	99	16076	9	23	90	16053	16175	0.1570571198224567
M1	string	0	network_modules	104	TRUE	3.350147238863112e-10	100	32	9	0.28125	0.09	GO:0098727	GO:BP	maintenance of cell number	16175	18856		0.19230769230769232	0.2222222222222222	100	16075	9	23	91	16052	16175	0.1562396055159987
M1	string	0	network_modules	104	TRUE	2.250011015744775e-9	123	32	9	0.28125	0.07317073170731707	GO:0017015	GO:BP	regulation of transforming growth factor beta receptor signaling pathway	16175	5276		0.23076923076923078	0.25925925925925924	123	16052	9	23	114	16029	16175	0.14024862370117658
M1	string	0	network_modules	104	TRUE	2.607606680553425e-9	125	32	9	0.28125	0.072	GO:1903844	GO:BP	regulation of cellular response to transforming growth factor beta stimulus	16175	23323		0.2692307692307692	0.2962962962962963	125	16050	9	23	116	16027	16175	0.13906791161049734
M1	string	0	network_modules	104	TRUE	2.804577969734492e-9	126	32	9	0.28125	0.07142857142857142	GO:0090101	GO:BP	negative regulation of transmembrane receptor protein serine/threonine kinase signaling pathway	16175	18019		0.3076923076923077	0.3333333333333333	126	16049	9	23	117	16026	16175	0.13848796148922193
M1	string	0	network_modules	104	TRUE	7.331163912211092e-9	791	32	15	0.46875	0.018963337547408345	GO:0000122	GO:BP	negative regulation of transcription by RNA polymerase II	16175	48		0.34615384615384615	0.37037037037037035	791	15384	15	17	776	15367	16175	0.08667537261627142
M1	string	0	network_modules	104	TRUE	4.0605678817611605e-8	247	32	10	0.3125	0.04048582995951417	GO:0030336	GO:BP	negative regulation of cell migration	16175	6782		0.38461538461538464	0.4074074074074074	247	15928	10	22	237	15906	16175	0.10791703294012939
M1	string	0	network_modules	104	TRUE	5.7919802459567276e-8	176	32	9	0.28125	0.05113636363636364	GO:0007179	GO:BP	transforming growth factor beta receptor signaling pathway	16175	2741		0.4230769230769231	0.4444444444444444	176	15999	9	23	167	15976	16175	0.1160329447418242
M1	string	0	network_modules	104	TRUE	6.484111706169442e-8	259	32	10	0.3125	0.03861003861003861	GO:2000146	GO:BP	negative regulation of cell motility	16175	25494		0.46153846153846156	0.48148148148148145	259	15916	10	22	249	15894	16175	0.10516395097511605
M1	string	0	network_modules	104	TRUE	1.5495650903285103e-7	283	32	10	0.3125	0.0353356890459364	GO:0040013	GO:BP	negative regulation of locomotion	16175	9901		0.5	0.5185185185185185	283	15892	10	22	273	15870	16175	0.10017800152801928
M1	string	0	network_modules	104	TRUE	1.9887748164954095e-7	202	32	9	0.28125	0.04455445544554455	GO:0071560	GO:BP	cellular response to transforming growth factor beta stimulus	16175	16762		0.5384615384615384	0.5555555555555556	202	15973	9	23	193	15950	16175	0.10775202221792726
M1	string	0	network_modules	104	TRUE	2.581800548940513e-7	208	32	9	0.28125	0.04326923076923077	GO:0071559	GO:BP	response to transforming growth factor beta	16175	16761		0.5769230769230769	0.5925925925925926	208	15967	9	23	199	15944	16175	0.10605989815259896
M1	string	0	network_modules	104	TRUE	3.7639289448756827e-7	217	32	9	0.28125	0.041474654377880185	GO:0090092	GO:BP	regulation of transmembrane receptor protein serine/threonine kinase signaling pathway	16175	18013		0.6153846153846154	0.6296296296296297	217	15958	9	23	208	15935	16175	0.10365115506852474
M1	string	0	network_modules	104	TRUE	1.6255372293149262e-6	256	32	9	0.28125	0.03515625	GO:0090287	GO:BP	regulation of cellular response to growth factor stimulus	16175	18171		0.6538461538461539	0.6666666666666666	256	15919	9	23	247	15896	16175	0.09468648814180076
M1	string	0	network_modules	104	TRUE	1.8292444808709354e-6	94	18	6	0.3333333333333333	0.06382978723404255	REAC:R-HSA-3214815	REAC	HDACs deacetylate histones	10916	1092		0	0.14285714285714285	94	10822	6	12	88	10810	10916	0.14283036973649998
M1	string	0	network_modules	104	TRUE	3.051080493365197e-6	275	32	9	0.28125	0.03272727272727273	GO:0141091	GO:BP	transforming growth factor beta receptor superfamily signaling pathway	16175	20020		0.6923076923076923	0.7037037037037037	275	15900	9	23	266	15877	16175	0.09100697978395697
M1	string	0	network_modules	104	TRUE	3.5780731832605883e-6	105	18	6	0.3333333333333333	0.05714285714285714	REAC:R-HSA-427413	REAC	NoRC negatively regulates rRNA expression	10916	1602		0.16666666666666666	0.2857142857142857	105	10811	6	12	99	10799	10916	0.13479098511474588
M1	string	0	network_modules	104	TRUE	4.2423325808523185e-6	108	18	6	0.3333333333333333	0.05555555555555555	REAC:R-HSA-5250941	REAC	Negative epigenetic regulation of rRNA expression	10916	1566		0.3333333333333333	0.42857142857142855	108	10808	6	12	102	10796	10916	0.13281129836661362
M1	string	0	network_modules	104	TRUE	4.859561085997702e-6	290	32	9	0.28125	0.03103448275862069	GO:0007178	GO:BP	cell surface receptor protein serine/threonine kinase signaling pathway	16175	2740		0.7307692307692307	0.7407407407407407	290	15885	9	23	281	15862	16175	0.08835277671818781
M1	string	0	network_modules	104	TRUE	3.0456245356216868e-5	150	18	6	0.3333333333333333	0.04	REAC:R-HSA-9679191	REAC	Potential therapeutics for SARS	10916	1782		0.5	0.5714285714285714	150	10766	6	12	144	10754	10916	0.11157053335151514
M1	string	0	network_modules	104	TRUE	4.181691630351536e-5	271	18	7	0.3888888888888889	0.025830258302583026	REAC:R-HSA-3247509	REAC	Chromatin modifying enzymes	10916	355		0.6666666666666666	0.8571428571428571	271	10645	7	11	264	10634	10916	0.09509230566940391
M1	string	0	network_modules	104	TRUE	4.181691630351536e-5	271	18	7	0.3888888888888889	0.025830258302583026	REAC:R-HSA-4839726	REAC	Chromatin organization	10916	356		0.6666666666666666	0.8571428571428571	271	10645	7	11	264	10634	10916	0.09509230566940391
M1	string	0	network_modules	104	TRUE	1.0570237874109975e-4	185	18	6	0.3333333333333333	0.032432432432432434	REAC:R-HSA-212165	REAC	Epigenetic regulation of gene expression	10916	852		1	1	185	10731	6	12	179	10719	10916	0.09961788297740044
M1	string	0	network_modules	104	TRUE	2.770937214009096e-4	795	32	11	0.34375	0.013836477987421384	GO:0051241	GO:BP	negative regulation of multicellular organismal process	16175	13591		0.7692307692307693	0.7777777777777778	795	15380	11	21	784	15359	16175	0.060673392593101894
M1	string	0	network_modules	104	TRUE	3.600824481175372e-4	7	32	3	0.09375	0.42857142857142855	GO:0006776	GO:BP	vitamin A metabolic process	16175	2462		0.8076923076923077	0.8148148148148148	7	16168	3	29	4	16139	16175	0.19976152254110363
M1	string	0	network_modules	104	TRUE	5.426677625038356e-4	502	32	9	0.28125	0.017928286852589643	GO:0071363	GO:BP	cellular response to growth factor stimulus	16175	16615		0.8461538461538461	0.8518518518518519	502	15673	9	23	493	15650	16175	0.06424090031650846
M1	string	0	network_modules	104	TRUE	7.179165761612879e-4	519	32	9	0.28125	0.017341040462427744	GO:0070848	GO:BP	response to growth factor	16175	16340		0.8846153846153846	0.8888888888888888	519	15656	9	23	510	15633	16175	0.06294879191023067
M1	string	0	network_modules	104	TRUE	0.0023404164019965473	781	32	10	0.3125	0.012804097311139564	GO:0030334	GO:BP	regulation of cell migration	16175	6780		0.9230769230769231	0.9259259259259259	781	15394	10	22	771	15372	16175	0.05487624296730995
M1	string	0	network_modules	104	TRUE	0.002596130796321602	790	32	10	0.3125	0.012658227848101266	GO:0007167	GO:BP	enzyme-linked receptor protein signaling pathway	16175	2731		0.9615384615384616	0.9629629629629629	790	15385	10	22	780	15363	16175	0.054463780411188774
M1	string	0	network_modules	104	TRUE	0.0030277532224413485	617	32	9	0.28125	0.014586709886547812	GO:0051093	GO:BP	negative regulation of developmental process	16175	13488		1	1	617	15558	9	23	608	15535	16175	0.056506846338959624
M1	string	0	network_modules	104	TRUE	0.007751467575665787	24	7	2	0.2857142857142857	0.08333333333333333	KEGG:04977	KEGG	Vitamin digestion and absorption	8484	408		NA	1	24	8460	2	5	22	8455	8484	0.15305529817397903
M1	string	0	network_modules	105	TRUE	7.870121956945814e-36	55	24	18	0.75	0.32727272727272727	REAC:R-HSA-9639288	REAC	Amino acids regulate mTORC1	10916	142		0	0.07692307692307693	55	10861	18	6	37	10855	10916	0.4938930591262173
M1	string	0	network_modules	105	TRUE	9.367008901095449e-34	92	29	19	0.6551724137931034	0.20652173913043478	GO:1903432	GO:BP	regulation of TORC1 signaling	16175	23003		0	0.038461538461538464	92	16083	19	10	73	16073	16175	0.36601783138241206
M1	string	0	network_modules	105	TRUE	2.851042138910014e-33	97	29	19	0.6551724137931034	0.1958762886597938	GO:0038202	GO:BP	TORC1 signaling	16175	9766		0.04	0.07692307692307693	97	16078	19	10	78	16068	16175	0.3563453199402467
M1	string	0	network_modules	105	TRUE	6.285757152614343e-30	141	29	19	0.6551724137931034	0.1347517730496454	GO:0032006	GO:BP	regulation of TOR signaling	16175	7313		0.08	0.11538461538461539	141	16034	19	10	122	16024	16175	0.2947262309374538
M1	string	0	network_modules	105	TRUE	6.239494768478259e-29	158	29	19	0.6551724137931034	0.12025316455696203	GO:0031929	GO:BP	TOR signaling	16175	7288		0.12	0.15384615384615385	158	16017	19	10	139	16007	16175	0.2781144191453627
M1	string	0	network_modules	105	TRUE	9.86397048366281e-27	157	24	18	0.75	0.11464968152866242	REAC:R-HSA-9711097	REAC	Cellular response to starvation	10916	337		0.08333333333333333	0.15384615384615385	157	10759	18	6	139	10753	10916	0.29002241851854427
M1	string	0	network_modules	105	TRUE	7.91646822287713e-26	155	20	17	0.85	0.10967741935483871	KEGG:04150	KEGG	mTOR signaling pathway	8484	284		NA	1	155	8329	17	3	138	8326	8484	0.3018895511175864
M1	string	0	network_modules	105	TRUE	8.087917180219775e-23	52	29	13	0.4482758620689655	0.25	GO:1904263	GO:BP	positive regulation of TORC1 signaling	16175	23657		0.16	0.19230769230769232	52	16123	13	16	39	16107	16175	0.33320060291567494
M1	string	0	network_modules	105	TRUE	4.725334546843343e-21	46	29	12	0.41379310344827586	0.2608695652173913	GO:0034198	GO:BP	cellular response to amino acid starvation	16175	8499		0.2	0.23076923076923078	46	16129	12	17	34	16112	16175	0.32705163589533504
M1	string	0	network_modules	105	TRUE	5.94603141343523e-21	70	29	13	0.4482758620689655	0.18571428571428572	GO:0032008	GO:BP	positive regulation of TOR signaling	16175	7315		0.24	0.2692307692307692	70	16105	13	16	57	16089	16175	0.28662477387103147
M1	string	0	network_modules	105	TRUE	8.444149254556315e-21	48	29	12	0.41379310344827586	0.25	GO:1990928	GO:BP	response to amino acid starvation	16175	25341		0.28	0.3076923076923077	48	16127	12	17	36	16110	16175	0.32008908091611626
M1	string	0	network_modules	105	TRUE	2.529732486148631e-19	40	29	11	0.3793103448275862	0.275	GO:0071230	GO:BP	cellular response to amino acid stimulus	16175	16492		0.32	0.34615384615384615	40	16135	11	18	29	16117	16175	0.3215513401967948
M1	string	0	network_modules	105	TRUE	8.358052765727619e-19	44	29	11	0.3793103448275862	0.25	GO:0071229	GO:BP	cellular response to acid chemical	16175	16491		0.36	0.38461538461538464	44	16131	11	18	33	16113	16175	0.30642396396228805
M1	string	0	network_modules	105	TRUE	1.4509081108009345e-18	46	29	11	0.3793103448275862	0.2391304347826087	GO:0043200	GO:BP	response to amino acid	16175	10574		0.4	0.4230769230769231	46	16129	11	18	35	16111	16175	0.29960872474602945
M1	string	0	network_modules	105	TRUE	5.153247427597596e-18	51	29	11	0.3793103448275862	0.21568627450980393	GO:0001101	GO:BP	response to acid chemical	16175	287		0.44	0.46153846153846156	51	16124	11	18	40	16106	16175	0.28435368557322604
M1	string	0	network_modules	105	TRUE	5.007344794837175e-17	187	29	14	0.4827586206896552	0.0748663101604278	GO:0031669	GO:BP	cellular response to nutrient levels	16175	7272		0.48	0.5	187	15988	14	15	173	15973	16175	0.18680822028814956
M1	string	0	network_modules	105	TRUE	6.941700901653104e-17	138	29	13	0.4482758620689655	0.09420289855072464	GO:0009267	GO:BP	cellular response to starvation	16175	3432		0.52	0.5384615384615384	138	16037	13	16	125	16021	16175	0.20263282730238946
M1	string	0	network_modules	105	TRUE	2.9469342274527213e-16	45	29	10	0.3448275862068966	0.2222222222222222	GO:1904262	GO:BP	negative regulation of TORC1 signaling	16175	23656		0.56	0.5769230769230769	45	16130	10	19	35	16111	16175	0.2752144762320756
M1	string	0	network_modules	105	TRUE	4.646499385906036e-16	159	29	13	0.4482758620689655	0.08176100628930817	GO:0042594	GO:BP	response to starvation	16175	10254		0.6	0.6153846153846154	159	16016	13	16	146	16000	16175	0.1883437499268281
M1	string	0	network_modules	105	TRUE	6.089843445766617e-15	262	29	14	0.4827586206896552	0.05343511450381679	GO:0031667	GO:BP	response to nutrient levels	16175	7271		0.64	0.6538461538461539	262	15913	14	15	248	15898	16175	0.15663628336854407
M1	string	0	network_modules	105	TRUE	2.2374828274575715e-14	67	29	10	0.3448275862068966	0.14925373134328357	GO:0032007	GO:BP	negative regulation of TOR signaling	16175	7314		0.68	0.6923076923076923	67	16108	10	19	57	16089	16175	0.22480507636088762
M1	string	0	network_modules	105	TRUE	3.278251430360716e-14	24	24	8	0.3333333333333333	0.3333333333333333	REAC:R-HSA-166208	REAC	mTORC1-mediated signalling	10916	2711		0.16666666666666666	0.23076923076923078	24	10892	8	16	16	10876	10916	0.3318643652833884
M1	string	0	network_modules	105	TRUE	1.9007046007046952e-13	29	24	8	0.3333333333333333	0.27586206896551724	REAC:R-HSA-380972	REAC	Energy dependent regulation of mTOR by LKB1-AMPK	10916	843		0.25	0.3076923076923077	29	10887	8	16	21	10871	10916	0.30155448570683524
M1	string	0	network_modules	105	TRUE	4.16535102408888e-12	41	24	8	0.3333333333333333	0.1951219512195122	REAC:R-HSA-165159	REAC	MTOR signalling	10916	1387		0.3333333333333333	0.38461538461538464	41	10875	8	16	33	10859	10916	0.2529100955673886
M1	string	0	network_modules	105	TRUE	9.441907648840673e-11	59	24	8	0.3333333333333333	0.13559322033898305	REAC:R-HSA-8943724	REAC	Regulation of PTEN gene transcription	10916	1999		0.4166666666666667	0.46153846153846156	59	10857	8	16	51	10841	10916	0.2099488342034589
M1	string	0	network_modules	105	TRUE	1.7964504124771023e-9	84	24	8	0.3333333333333333	0.09523809523809523	REAC:R-HSA-5628897	REAC	TP53 Regulates Metabolic Genes	10916	2452		0.5	0.5384615384615384	84	10832	8	16	76	10816	10916	0.17492694741939163
M1	string	0	network_modules	105	TRUE	8.040538663106326e-8	134	24	8	0.3333333333333333	0.05970149253731343	REAC:R-HSA-1632852	REAC	Macroautophagy	10916	1388		0.5833333333333334	0.6153846153846154	134	10782	8	16	126	10766	10916	0.13686627879701702
M1	string	0	network_modules	105	TRUE	1.0184156440145579e-7	138	24	8	0.3333333333333333	0.057971014492753624	REAC:R-HSA-6807070	REAC	PTEN Regulation	10916	1703		0.6666666666666666	0.6923076923076923	138	10778	8	16	130	10762	10916	0.13473918959942924
M1	string	0	network_modules	105	TRUE	1.8829354776951768e-7	149	24	8	0.3333333333333333	0.053691275167785234	REAC:R-HSA-9612973	REAC	Autophagy	10916	193		0.75	0.7692307692307693	149	10767	8	16	141	10751	10916	0.12932880326367566
M1	string	0	network_modules	105	TRUE	4.988426893456544e-7	253	24	9	0.375	0.03557312252964427	REAC:R-HSA-1257604	REAC	PIP3 activates AKT signaling	10916	1679		0.8333333333333334	0.8461538461538461	253	10663	9	15	244	10648	10916	0.10975886534513703
M1	string	0	network_modules	105	TRUE	1.8129385330325807e-6	293	24	9	0.375	0.030716723549488054	REAC:R-HSA-9006925	REAC	Intracellular signaling by second messengers	10916	1266		0.9166666666666666	0.9230769230769231	293	10623	9	15	284	10608	10916	0.10111955284514239
M1	string	0	network_modules	105	TRUE	5.276714488589101e-6	324	29	9	0.3103448275862069	0.027777777777777776	GO:0010506	GO:BP	regulation of autophagy	16175	4181		0.72	0.7307692307692307	324	15851	9	20	315	15831	16175	0.08781684489225783
M1	string	0	network_modules	105	TRUE	3.494929938379328e-5	551	29	10	0.3448275862068966	0.018148820326678767	GO:1902532	GO:BP	negative regulation of intracellular signal transduction	16175	22341		0.76	0.7692307692307693	551	15624	10	19	541	15605	16175	0.07260520324641181
M1	string	0	network_modules	105	TRUE	5.617104738906909e-5	53	29	5	0.1724137931034483	0.09433962264150944	GO:0061462	GO:BP	protein localization to lysosome	16175	15493		0.8	0.8076923076923077	53	16122	5	24	48	16098	16175	0.12543027720836794
M1	string	0	network_modules	105	TRUE	1.811643081600574e-4	359	24	8	0.3333333333333333	0.022284122562674095	REAC:R-HSA-3700989	REAC	Transcriptional Regulation by TP53	10916	2546		1	1	359	10557	8	16	351	10541	10916	0.07907952013733663
M1	string	0	network_modules	105	TRUE	1.9124677443193265e-4	491	29	9	0.3103448275862069	0.018329938900203666	GO:0006914	GO:BP	autophagy	16175	2563		0.84	0.8846153846153846	491	15684	9	20	482	15664	16175	0.06916448527983249
M1	string	0	network_modules	105	TRUE	1.9124677443193265e-4	491	29	9	0.3103448275862069	0.018329938900203666	GO:0061919	GO:BP	process utilizing autophagic mechanism	16175	15723		0.84	0.8846153846153846	491	15684	9	20	482	15664	16175	0.06916448527983249
M1	string	0	network_modules	105	TRUE	4.0062470227005524e-4	78	29	5	0.1724137931034483	0.0641025641025641	GO:0072665	GO:BP	protein localization to vacuole	16175	17485		0.92	0.9230769230769231	78	16097	5	24	73	16073	16175	0.10252815058307206
M1	string	0	network_modules	105	TRUE	9.944649866122962e-4	10	29	3	0.10344827586206896	0.3	GO:1990253	GO:BP	cellular response to leucine starvation	16175	25122		0.96	0.9615384615384616	10	16165	3	26	7	16139	16175	0.1753246398155495
M1	string	0	network_modules	105	TRUE	0.00870047989554449	145	29	5	0.1724137931034483	0.034482758620689655	GO:0010508	GO:BP	positive regulation of autophagy	16175	4183		1	1	145	16030	5	24	140	16006	16175	0.0734925350086257
M1	string	0	network_modules	106	TRUE	0.005330412278352113	129	30	5	0.16666666666666666	0.03875968992248062	GO:1902904	GO:BP	negative regulation of supramolecular fiber organization	16175	22603		NA	1	129	16046	5	25	124	16021	16175	0.07690614174825926
M1	string	0	network_modules	107	TRUE	4.3856546791074024e-17	7	29	7	0.2413793103448276	1	GO:0035654	GO:BP	clathrin-coated vesicle cargo loading, AP-3-mediated	16175	9140		0	0.04878048780487805	7	16168	7	22	0	16146	16175	0.49096930911770975
M1	string	0	network_modules	107	TRUE	4.3856546791074024e-17	7	29	7	0.2413793103448276	1	GO:0035652	GO:BP	clathrin-coated vesicle cargo loading	16175	9138		0	0.04878048780487805	7	16168	7	22	0	16146	16175	0.49096930911770975
M1	string	0	network_modules	107	TRUE	1.3775167568625068e-12	18	29	7	0.2413793103448276	0.3888888888888889	GO:0048490	GO:BP	anterograde synaptic vesicle transport	16175	12783		0.05	0.12195121951219512	18	16157	7	22	11	16135	16175	0.3054129082045423
M1	string	0	network_modules	107	TRUE	1.3775167568625068e-12	18	29	7	0.2413793103448276	0.3888888888888889	GO:0099514	GO:BP	synaptic vesicle cytoskeletal transport	16175	19104		0.05	0.12195121951219512	18	16157	7	22	11	16135	16175	0.3054129082045423
M1	string	0	network_modules	107	TRUE	1.3775167568625068e-12	18	29	7	0.2413793103448276	0.3888888888888889	GO:0099517	GO:BP	synaptic vesicle transport along microtubule	16175	19106		0.05	0.12195121951219512	18	16157	7	22	11	16135	16175	0.3054129082045423
M1	string	0	network_modules	107	TRUE	2.0772488925541817e-11	5	29	5	0.1724137931034483	1	GO:0016183	GO:BP	synaptic vesicle coating	16175	5163		0.125	0.14634146341463414	5	16170	5	24	0	16146	16175	0.4149191383507322
M1	string	0	network_modules	107	TRUE	1.816403686355344e-10	33	29	7	0.2413793103448276	0.21212121212121213	GO:0048489	GO:BP	synaptic vesicle transport	16175	12782		0.15	0.17073170731707318	33	16142	7	22	26	16120	16175	0.2247961513249252
M1	string	0	network_modules	107	TRUE	2.2845972703427607e-10	34	29	7	0.2413793103448276	0.20588235294117646	GO:0035459	GO:BP	vesicle cargo loading	16175	9047		0.175	0.1951219512195122	34	16141	7	22	27	16119	16175	0.22141530542373622
M1	string	0	network_modules	107	TRUE	4.351438349507852e-10	7	29	5	0.1724137931034483	0.7142857142857143	GO:0070142	GO:BP	synaptic vesicle budding	16175	15937		0.2	0.24390243902439024	7	16168	5	24	2	16144	16175	0.3504404107620099
M1	string	0	network_modules	107	TRUE	4.351438349507852e-10	7	29	5	0.1724137931034483	0.7142857142857143	GO:0016185	GO:BP	synaptic vesicle budding from presynaptic endocytic zone membrane	16175	5164		0.2	0.24390243902439024	7	16168	5	24	2	16144	16175	0.3504404107620099
M1	string	0	network_modules	107	TRUE	7.861032415912633e-10	40	29	7	0.2413793103448276	0.175	GO:0097479	GO:BP	synaptic vesicle localization	16175	18670		0.25	0.2682926829268293	40	16135	7	22	33	16113	16175	0.20385625513621933
M1	string	0	network_modules	107	TRUE	8.233460840923026e-10	19	29	6	0.20689655172413793	0.3157894736842105	GO:1903232	GO:BP	melanosome assembly	16175	22844		0.275	0.2926829268292683	19	16156	6	23	13	16133	16175	0.2545350635250033
M1	string	0	network_modules	107	TRUE	1.1348272240615905e-9	42	29	7	0.2413793103448276	0.16666666666666666	GO:0047496	GO:BP	vesicle transport along microtubule	16175	12458		0.3	0.34146341463414637	42	16133	7	22	35	16111	16175	0.19885269447694745
M1	string	0	network_modules	107	TRUE	1.1348272240615905e-9	42	29	7	0.2413793103448276	0.16666666666666666	GO:0008089	GO:BP	anterograde axonal transport	16175	3120		0.3	0.34146341463414637	42	16133	7	22	35	16111	16175	0.19885269447694745
M1	string	0	network_modules	107	TRUE	4.059592269580748e-9	24	29	6	0.20689655172413793	0.25	GO:0060155	GO:BP	platelet dense granule organization	16175	14393		0.35	0.36585365853658536	24	16151	6	23	18	16128	16175	0.22616893137551392
M1	string	0	network_modules	107	TRUE	7.343733788176884e-9	54	29	7	0.2413793103448276	0.12962962962962962	GO:0098930	GO:BP	axonal transport	16175	18959		0.375	0.3902439024390244	54	16121	7	22	47	16099	16175	0.17489177767771888
M1	string	0	network_modules	107	TRUE	1.7940100649189403e-8	61	29	7	0.2413793103448276	0.11475409836065574	GO:0008088	GO:BP	axo-dendritic transport	16175	3119		0.4	0.4146341463414634	61	16114	7	22	54	16092	16175	0.16428782596541838
M1	string	0	network_modules	107	TRUE	3.550599679232275e-8	67	29	7	0.2413793103448276	0.1044776119402985	GO:0099518	GO:BP	vesicle cytoskeletal trafficking	16175	19107		0.425	0.43902439024390244	67	16108	7	22	60	16086	16175	0.1565435713553993
M1	string	0	network_modules	107	TRUE	6.604817230273339e-8	73	29	7	0.2413793103448276	0.0958904109589041	GO:0072384	GO:BP	organelle transport along microtubule	16175	17378		0.45	0.4634146341463415	73	16102	7	22	66	16080	16175	0.14976575351741783
M1	string	0	network_modules	107	TRUE	9.661928746425784e-8	39	29	6	0.20689655172413793	0.15384615384615385	GO:0048753	GO:BP	pigment granule organization	16175	13004		0.475	0.5121951219512195	39	16136	6	23	33	16113	16175	0.17670259328528315
M1	string	0	network_modules	107	TRUE	9.661928746425784e-8	39	29	6	0.20689655172413793	0.15384615384615385	GO:0032438	GO:BP	melanosome organization	16175	7566		0.475	0.5121951219512195	39	16136	6	23	33	16113	16175	0.17670259328528315
M1	string	0	network_modules	107	TRUE	1.396140342403946e-7	81	29	7	0.2413793103448276	0.08641975308641975	GO:0043473	GO:BP	pigmentation	16175	10719		0.525	0.5365853658536586	81	16094	7	22	74	16072	16175	0.14191606766385145
M1	string	0	network_modules	107	TRUE	5.705393732423582e-7	165	29	8	0.27586206896551724	0.048484848484848485	GO:0099111	GO:BP	microtubule-based transport	16175	19044		0.55	0.5609756097560976	165	16010	8	21	157	15989	16175	0.1120472522473772
M1	string	0	network_modules	107	TRUE	5.933999589478375e-7	52	29	6	0.20689655172413793	0.11538461538461539	GO:0033363	GO:BP	secretory granule organization	16175	8173		0.575	0.5853658536585366	52	16123	6	23	46	16100	16175	0.15248890870573134
M1	string	0	network_modules	107	TRUE	7.387415491030624e-7	131	20	7	0.35	0.05343511450381679	KEGG:04142	KEGG	Lysosome	8484	279		NA	1	131	8353	7	13	124	8340	8484	0.1318997219713899
M1	string	0	network_modules	107	TRUE	1.0441255950271805e-6	178	29	8	0.27586206896551724	0.0449438202247191	GO:0051650	GO:BP	establishment of vesicle localization	16175	13863		0.6	0.6097560975609756	178	15997	8	21	170	15976	16175	0.10759540010523112
M1	string	0	network_modules	107	TRUE	1.1044209158473283e-6	519	29	11	0.3793103448275862	0.02119460500963391	GO:0051640	GO:BP	organelle localization	16175	13853		0.625	0.6341463414634146	519	15656	11	18	508	15638	16175	0.08350187048477253
M1	string	0	network_modules	107	TRUE	1.1711392948074464e-6	58	29	6	0.20689655172413793	0.10344827586206896	GO:0033059	GO:BP	cellular pigmentation	16175	8013		0.65	0.6585365853658537	58	16117	6	23	52	16094	16175	0.14415015118319777
M1	string	0	network_modules	107	TRUE	1.4807284011985683e-6	186	29	8	0.27586206896551724	0.043010752688172046	GO:0051648	GO:BP	vesicle localization	16175	13861		0.675	0.6829268292682927	186	15989	8	21	178	15968	16175	0.10508581638710551
M1	string	0	network_modules	107	TRUE	4.123492884102998e-6	315	29	9	0.3103448275862069	0.02857142857142857	GO:0016050	GO:BP	vesicle organization	16175	5082		0.7	0.7073170731707317	315	15860	9	20	306	15840	16175	0.0892079109591939
M1	string	0	network_modules	107	TRUE	7.5362275954269844e-6	36	29	5	0.1724137931034483	0.1388888888888889	GO:0006901	GO:BP	vesicle coating	16175	2554		0.725	0.7317073170731707	36	16139	5	24	31	16115	16175	0.15305606205626468
M1	string	0	network_modules	107	TRUE	8.180434352425688e-6	144	29	7	0.2413793103448276	0.04861111111111111	GO:0010970	GO:BP	transport along microtubule	16175	4546		0.75	0.7560975609756098	144	16031	7	22	137	16009	16175	0.10488868997270932
M1	string	0	network_modules	107	TRUE	9.846315892445616e-6	348	29	9	0.3103448275862069	0.02586206896551724	GO:0007018	GO:BP	microtubule-based movement	16175	2626		0.775	0.7804878048780488	348	15827	9	20	339	15807	16175	0.08436540748255038
M1	string	0	network_modules	107	TRUE	3.751061961312121e-5	49	29	5	0.1724137931034483	0.10204081632653061	GO:0140238	GO:BP	presynaptic endocytosis	16175	19709		0.8	0.8292682926829268	49	16126	5	24	44	16102	16175	0.13062398392977734
M1	string	0	network_modules	107	TRUE	3.751061961312121e-5	49	29	5	0.1724137931034483	0.10204081632653061	GO:0048488	GO:BP	synaptic vesicle endocytosis	16175	12781		0.8	0.8292682926829268	49	16126	5	24	44	16102	16175	0.13062398392977734
M1	string	0	network_modules	107	TRUE	4.078636153870709e-5	410	29	9	0.3103448275862069	0.02195121951219512	GO:0051656	GO:BP	establishment of organelle localization	16175	13869		0.85	0.8536585365853658	410	15765	9	20	401	15745	16175	0.07684441194097254
M1	string	0	network_modules	107	TRUE	4.650851019662106e-5	185	29	7	0.2413793103448276	0.03783783783783784	GO:0030705	GO:BP	cytoskeleton-dependent intracellular transport	16175	6886		0.875	0.8780487804878049	185	15990	7	22	178	15968	16175	0.0916471252745445
M1	string	0	network_modules	107	TRUE	9.726908892916916e-5	59	29	5	0.1724137931034483	0.0847457627118644	GO:0036465	GO:BP	synaptic vesicle recycling	16175	9613		0.9	0.9024390243902439	59	16116	5	24	54	16092	16175	0.11864286401415046
M1	string	0	network_modules	107	TRUE	3.072146074410665e-4	74	29	5	0.1724137931034483	0.06756756756756757	GO:0006900	GO:BP	vesicle budding from membrane	16175	2553		0.925	0.926829268292683	74	16101	5	24	69	16077	16175	0.10540494288462235
M1	string	0	network_modules	107	TRUE	0.003029533416397141	117	29	5	0.1724137931034483	0.042735042735042736	GO:0099504	GO:BP	synaptic vesicle cycle	16175	19100		0.95	0.9512195121951219	117	16058	5	24	112	16034	16175	0.0826096327966114
M1	string	0	network_modules	107	TRUE	0.003576663762794121	121	29	5	0.1724137931034483	0.04132231404958678	GO:0099003	GO:BP	vesicle-mediated transport in synapse	16175	18999		0.975	0.975609756097561	121	16054	5	24	116	16030	16175	0.08112119803818693
M1	string	0	network_modules	107	TRUE	0.004953738310760011	533	29	8	0.27586206896551724	0.0150093808630394	GO:0006897	GO:BP	endocytosis	16175	2551		1	1	533	15642	8	21	525	15621	16175	0.05766953258973609
M1	string	0	network_modules	108	TRUE	4.4706904201726755e-11	59	22	8	0.36363636363636365	0.13559322033898305	REAC:R-HSA-6790901	REAC	rRNA modification in the nucleus and cytosol	10916	2731		0	0.125	59	10857	8	14	51	10843	10916	0.2195654348789983
M1	string	0	network_modules	108	TRUE	2.2812185313229628e-10	169	28	10	0.35714285714285715	0.05917159763313609	GO:0006364	GO:BP	rRNA processing	16175	2140		0	0.06666666666666667	169	16006	10	18	159	15988	16175	0.14198411028929447
M1	string	0	network_modules	108	TRUE	1.59183410019344e-9	205	28	10	0.35714285714285715	0.04878048780487805	GO:0016072	GO:BP	rRNA metabolic process	16175	5099		0.07142857142857142	0.13333333333333333	205	15970	10	18	195	15952	16175	0.12823250019524385
M1	string	0	network_modules	108	TRUE	1.198469859759597e-8	251	28	10	0.35714285714285715	0.0398406374501992	GO:0042254	GO:BP	ribosome biogenesis	16175	10060		0.14285714285714285	0.2	251	15924	10	18	241	15906	16175	0.11509704856082809
M1	string	0	network_modules	108	TRUE	2.3366408289854404e-7	46	28	6	0.21428571428571427	0.13043478260869565	GO:0030490	GO:BP	maturation of SSU-rRNA	16175	6815		0.21428571428571427	0.26666666666666666	46	16129	6	22	40	16107	16175	0.1653429312540259
M1	string	0	network_modules	108	TRUE	3.2969604352516375e-7	94	28	7	0.25	0.07446808510638298	GO:0042274	GO:BP	ribosomal small subunit biogenesis	16175	10071		0.2857142857142857	0.3333333333333333	94	16081	7	21	87	16060	16175	0.13377724504727628
M1	string	0	network_modules	108	TRUE	4.4706446389996485e-7	182	22	8	0.36363636363636365	0.04395604395604396	REAC:R-HSA-6791226	REAC	Major pathway of rRNA processing in the nucleolus and cytosol	10916	1389		0.14285714285714285	0.25	182	10734	8	14	174	10720	10916	0.12177232410117388
M1	string	0	network_modules	108	TRUE	6.835440802124334e-7	192	22	8	0.36363636363636365	0.041666666666666664	REAC:R-HSA-8868773	REAC	rRNA processing in the nucleus and cytosol	10916	2734		0.2857142857142857	0.375	192	10724	8	14	184	10710	10916	0.11830085544429166
M1	string	0	network_modules	108	TRUE	9.095226778697663e-7	390	28	10	0.35714285714285715	0.02564102564102564	GO:0022613	GO:BP	ribonucleoprotein complex biogenesis	16175	6620		0.35714285714285715	0.4	390	15785	10	18	380	15767	16175	0.09040827774286882
M1	string	0	network_modules	108	TRUE	1.0217938880687985e-6	202	22	8	0.36363636363636365	0.039603960396039604	REAC:R-HSA-72312	REAC	rRNA processing	10916	2732		0.42857142857142855	0.5	202	10714	8	14	194	10700	10916	0.11508379385929339
M1	string	0	network_modules	108	TRUE	2.4316063403413e-5	56	22	5	0.22727272727272727	0.08928571428571429	REAC:R-HSA-72187	REAC	mRNA 3'-end processing	10916	2701		0.5714285714285714	0.625	56	10860	5	17	51	10843	10916	0.13973467542579274
M1	string	0	network_modules	108	TRUE	5.1967913571202844e-5	65	22	5	0.22727272727272727	0.07692307692307693	REAC:R-HSA-73856	REAC	RNA Polymerase II Transcription Termination	10916	1895		0.7142857142857143	0.75	65	10851	5	17	60	10834	10916	0.1292726593112963
M1	string	0	network_modules	108	TRUE	8.127835475895418e-5	71	22	5	0.22727272727272727	0.07042253521126761	REAC:R-HSA-159236	REAC	Transport of Mature mRNA derived from an Intron-Containing Transcript	10916	2586		0.8571428571428571	0.875	71	10845	5	17	66	10828	10916	0.12341682293908147
M1	string	0	network_modules	108	TRUE	1.4832314008043535e-4	80	22	5	0.22727272727272727	0.0625	REAC:R-HSA-72202	REAC	Transport of Mature Transcript to Cytoplasm	10916	2584		1	1	80	10836	5	17	75	10819	10916	0.11588143893049109
M1	string	0	network_modules	108	TRUE	1.83439677528116e-4	139	15	5	0.3333333333333333	0.03597122302158273	KEGG:03008	KEGG	Ribosome biogenesis in eukaryotes	8484	207		0	0.5	139	8345	5	10	134	8335	8484	0.10507509581129683
M1	string	0	network_modules	108	TRUE	1.9142089556409468e-4	69	28	5	0.17857142857142858	0.07246376811594203	GO:0006406	GO:BP	mRNA export from nucleus	16175	2167		0.42857142857142855	0.4666666666666667	69	16106	5	23	64	16083	16175	0.11137053230689
M1	string	0	network_modules	108	TRUE	2.4639505525367945e-4	28	28	4	0.14285714285714285	0.14285714285714285	GO:0000462	GO:BP	maturation of SSU-rRNA from tricistronic rRNA transcript (SSU-rRNA, 5.8S rRNA, LSU-rRNA)	16175	152		0.5	0.5333333333333333	28	16147	4	24	24	16123	16175	0.14137079864459562
M1	string	0	network_modules	108	TRUE	3.1206931430545536e-4	76	28	5	0.17857142857142858	0.06578947368421052	GO:0051028	GO:BP	mRNA transport	16175	13445		0.5714285714285714	0.6	76	16099	5	23	71	16076	16175	0.10587729395932728
M1	string	0	network_modules	108	TRUE	7.301303892142018e-4	90	28	5	0.17857142857142858	0.05555555555555555	GO:0006405	GO:BP	RNA export from nucleus	16175	2166		0.6428571428571429	0.6666666666666666	90	16085	5	23	85	16062	16175	0.09685231130986062
M1	string	0	network_modules	108	TRUE	0.0019308852676345658	108	15	4	0.26666666666666666	0.037037037037037035	KEGG:03013	KEGG	Nucleocytoplasmic transport	8484	209		1	1	108	8376	4	11	104	8365	8484	0.09532914358077148
M1	string	0	network_modules	108	TRUE	0.0023702840048648146	114	28	5	0.17857142857142858	0.043859649122807015	GO:0050658	GO:BP	RNA transport	16175	13198		0.7142857142857143	0.8	114	16061	5	23	109	16038	16175	0.08538121565712763
M1	string	0	network_modules	108	TRUE	0.0023702840048648146	114	28	5	0.17857142857142858	0.043859649122807015	GO:0050657	GO:BP	nucleic acid transport	16175	13197		0.7142857142857143	0.8	114	16061	5	23	109	16038	16175	0.08538121565712763
M1	string	0	network_modules	108	TRUE	0.0026956282650344703	117	28	5	0.17857142857142858	0.042735042735042736	GO:0051236	GO:BP	establishment of RNA localization	16175	13586		0.8571428571428571	0.8666666666666667	117	16058	5	23	112	16035	16175	0.08419620729007256
M1	string	0	network_modules	108	TRUE	0.008857271491895536	149	28	5	0.17857142857142858	0.03355704697986577	GO:0006403	GO:BP	RNA localization	16175	2164		0.9285714285714286	0.9333333333333333	149	16026	5	23	144	16003	16175	0.07382130335745869
M1	string	0	network_modules	108	TRUE	0.009763920173586491	152	28	5	0.17857142857142858	0.03289473684210526	GO:0051168	GO:BP	nuclear export	16175	13551		1	1	152	16023	5	23	147	16000	16175	0.07301596524869543
M1	string	0	network_modules	109	TRUE	5.2346329240934616e-20	301	28	19	0.6785714285714286	0.06312292358803986	KEGG:04010	KEGG	MAPK signaling pathway	8484	243		0	0.043478260869565216	301	8183	19	9	282	8174	8484	0.20004668857507663
M1	string	0	network_modules	109	TRUE	1.6450444301610116e-13	595	32	17	0.53125	0.02857142857142857	GO:0000165	GO:BP	MAPK cascade	16175	55		0	0.05	595	15580	17	15	578	15565	16175	0.1169554216891121
M1	string	0	network_modules	109	TRUE	1.6404502010365e-10	63	24	8	0.3333333333333333	0.12698412698412698	REAC:R-HSA-450294	REAC	MAP kinase activation	10916	1345		0	0.02857142857142857	63	10853	8	16	55	10837	10916	0.20298486361113183
M1	string	0	network_modules	109	TRUE	4.4594651705618657e-10	71	24	8	0.3333333333333333	0.11267605633802817	REAC:R-HSA-448424	REAC	Interleukin-17 signaling	10916	1238		0.029411764705882353	0.05714285714285714	71	10845	8	16	63	10829	10916	0.19084998172290077
M1	string	0	network_modules	109	TRUE	3.716845112939401e-9	45	32	7	0.21875	0.15555555555555556	GO:0051403	GO:BP	stress-activated MAPK cascade	16175	13696		0.05263157894736842	0.1	45	16130	7	25	38	16105	16175	0.18255468292420118
M1	string	0	network_modules	109	TRUE	4.655902417206788e-9	11	24	5	0.20833333333333334	0.45454545454545453	REAC:R-HSA-171007	REAC	p38MAPK events	10916	2716		0.058823529411764705	0.08571428571428572	11	10905	5	19	6	10886	10916	0.306732055472572
M1	string	0	network_modules	109	TRUE	4.937067987259018e-9	95	24	8	0.3333333333333333	0.08421052631578947	REAC:R-HSA-975871	REAC	MyD88 cascade initiated on plasma membrane	10916	1497		0.08823529411764706	0.17142857142857143	95	10821	8	16	87	10805	10916	0.16406244020049993
M1	string	0	network_modules	109	TRUE	4.937067987259018e-9	95	24	8	0.3333333333333333	0.08421052631578947	REAC:R-HSA-168176	REAC	Toll Like Receptor 5 (TLR5) Cascade	10916	2517		0.08823529411764706	0.17142857142857143	95	10821	8	16	87	10805	10916	0.16406244020049993
M1	string	0	network_modules	109	TRUE	4.937067987259018e-9	95	24	8	0.3333333333333333	0.08421052631578947	REAC:R-HSA-168142	REAC	Toll Like Receptor 10 (TLR10) Cascade	10916	2513		0.08823529411764706	0.17142857142857143	95	10821	8	16	87	10805	10916	0.16406244020049993
M1	string	0	network_modules	109	TRUE	8.125823735073478e-9	50	32	7	0.21875	0.14	GO:0031098	GO:BP	stress-activated protein kinase signaling cascade	16175	7024		0.10526315789473684	0.15	50	16125	7	25	43	16100	16175	0.17296550354423484
M1	string	0	network_modules	109	TRUE	8.144181956605301e-9	101	24	8	0.3333333333333333	0.07920792079207921	REAC:R-HSA-975138	REAC	TRAF6 mediated induction of NFkB and MAP kinases upon TLR7/8 or 9 activation	10916	2468		0.17647058823529413	0.2	101	10815	8	16	93	10799	10916	0.15888934153554565
M1	string	0	network_modules	109	TRUE	8.825710383582653e-9	102	24	8	0.3333333333333333	0.0784313725490196	REAC:R-HSA-975155	REAC	MyD88 dependent cascade initiated on endosome	10916	1500		0.20588235294117646	0.22857142857142856	102	10814	8	16	94	10798	10916	0.1580711690421144
M1	string	0	network_modules	109	TRUE	9.556374029498824e-9	103	24	8	0.3333333333333333	0.07766990291262135	REAC:R-HSA-168181	REAC	Toll Like Receptor 7/8 (TLR7/8) Cascade	10916	2518		0.23529411764705882	0.2857142857142857	103	10813	8	16	95	10797	10916	0.15726475576302806
M1	string	0	network_modules	109	TRUE	9.556374029498824e-9	103	24	8	0.3333333333333333	0.07766990291262135	REAC:R-HSA-168164	REAC	Toll Like Receptor 3 (TLR3) Cascade	10916	2515		0.23529411764705882	0.2857142857142857	103	10813	8	16	95	10797	10916	0.15726475576302806
M1	string	0	network_modules	109	TRUE	1.2073742742691822e-8	106	24	8	0.3333333333333333	0.07547169811320754	REAC:R-HSA-168138	REAC	Toll Like Receptor 9 (TLR9) Cascade	10916	2519		0.29411764705882354	0.3142857142857143	106	10810	8	16	98	10794	10916	0.1549132928256498
M1	string	0	network_modules	109	TRUE	1.3032273883209835e-8	107	24	8	0.3333333333333333	0.07476635514018691	REAC:R-HSA-166166	REAC	MyD88-independent TLR4 cascade 	10916	1501		0.3235294117647059	0.37142857142857144	107	10809	8	16	99	10793	10916	0.1541511835716906
M1	string	0	network_modules	109	TRUE	1.3032273883209835e-8	107	24	8	0.3333333333333333	0.07476635514018691	REAC:R-HSA-937061	REAC	TRIF (TICAM1)-mediated TLR4 signaling 	10916	2471		0.3235294117647059	0.37142857142857144	107	10809	8	16	99	10793	10916	0.1541511835716906
M1	string	0	network_modules	109	TRUE	1.8886868223834796e-8	112	24	8	0.3333333333333333	0.07142857142857142	REAC:R-HSA-166058	REAC	MyD88:MAL(TIRAP) cascade initiated on plasma membrane	10916	1502		0.38235294117647056	0.42857142857142855	112	10804	8	16	104	10788	10916	0.15049252134578656
M1	string	0	network_modules	109	TRUE	1.8886868223834796e-8	112	24	8	0.3333333333333333	0.07142857142857142	REAC:R-HSA-168188	REAC	Toll Like Receptor TLR6:TLR2 Cascade	10916	2521		0.38235294117647056	0.42857142857142855	112	10804	8	16	104	10788	10916	0.15049252134578656
M1	string	0	network_modules	109	TRUE	2.3401863608405948e-8	115	24	8	0.3333333333333333	0.06956521739130435	REAC:R-HSA-181438	REAC	Toll Like Receptor 2 (TLR2) Cascade	10916	2514		0.4411764705882353	0.4857142857142857	115	10801	8	16	107	10785	10916	0.14841087288507196
M1	string	0	network_modules	109	TRUE	2.3401863608405948e-8	115	24	8	0.3333333333333333	0.06956521739130435	REAC:R-HSA-168179	REAC	Toll Like Receptor TLR1:TLR2 Cascade	10916	2520		0.4411764705882353	0.4857142857142857	115	10801	8	16	107	10785	10916	0.14841087288507196
M1	string	0	network_modules	109	TRUE	2.5116010247099798e-8	93	28	8	0.2857142857142857	0.08602150537634409	KEGG:04912	KEGG	GnRH signaling pathway	8484	369		0.045454545454545456	0.08695652173913043	93	8391	8	20	85	8371	8484	0.1518414936509245
M1	string	0	network_modules	109	TRUE	6.18197071903518e-8	17	24	5	0.20833333333333334	0.29411764705882354	REAC:R-HSA-167044	REAC	Signalling to RAS	10916	2332		0.5	0.5142857142857142	17	10899	5	19	12	10880	10916	0.24614875620956228
M1	string	0	network_modules	109	TRUE	1.3549336665057733e-7	143	24	8	0.3333333333333333	0.055944055944055944	REAC:R-HSA-166016	REAC	Toll Like Receptor 4 (TLR4) Cascade	10916	2516		0.5294117647058824	0.5428571428571428	143	10773	8	16	135	10757	10916	0.1322042659553983
M1	string	0	network_modules	109	TRUE	3.5392150927044105e-7	141	32	8	0.25	0.05673758865248227	GO:0007254	GO:BP	JNK cascade	16175	2787		0.15789473684210525	0.2	141	16034	8	24	133	16010	16175	0.11556414279064203
M1	string	0	network_modules	109	TRUE	4.047862459365247e-7	164	24	8	0.3333333333333333	0.04878048780487805	REAC:R-HSA-168898	REAC	Toll-like Receptor Cascades	10916	2522		0.5588235294117647	0.5714285714285714	164	10752	8	16	156	10736	10916	0.12282828856641788
M1	string	0	network_modules	109	TRUE	4.139071464312491e-7	45	32	6	0.1875	0.13333333333333333	GO:0038066	GO:BP	p38MAPK cascade	16175	9683		0.21052631578947367	0.25	45	16130	6	26	39	16104	16175	0.15613949308389208
M1	string	0	network_modules	109	TRUE	1.663269491657043e-6	31	24	5	0.20833333333333334	0.16129032258064516	REAC:R-HSA-187687	REAC	Signalling to ERKs	10916	2331		0.5882352941176471	0.6	31	10885	5	19	26	10866	10916	0.18126680654255561
M1	string	0	network_modules	109	TRUE	2.3391314686691276e-6	106	28	7	0.25	0.0660377358490566	KEGG:04620	KEGG	Toll-like receptor signaling pathway	8484	325		0.09090909090909091	0.13043478260869565	106	8378	7	21	99	8357	8484	0.12304060795550759
M1	string	0	network_modules	109	TRUE	3.65064510345304e-6	113	28	7	0.25	0.061946902654867256	KEGG:04668	KEGG	TNF signaling pathway	8484	342		0.13636363636363635	0.17391304347826086	113	8371	7	21	106	8350	8484	0.11880435047525519
M1	string	0	network_modules	109	TRUE	3.9967747099645554e-6	67	28	6	0.21428571428571427	0.08955223880597014	KEGG:04664	KEGG	Fc epsilon RI signaling pathway	8484	340		0.18181818181818182	0.21739130434782608	67	8417	6	22	61	8395	8484	0.13417345702540612
M1	string	0	network_modules	109	TRUE	1.4500128597022701e-5	138	28	7	0.25	0.050724637681159424	KEGG:05418	KEGG	Fluid shear stress and atherosclerosis	8484	495		0.22727272727272727	0.2608695652173913	138	8346	7	21	131	8325	8484	0.10632625299651978
M1	string	0	network_modules	109	TRUE	2.012742312216549e-5	40	32	5	0.15625	0.125	GO:0043506	GO:BP	regulation of JUN kinase activity	16175	10743		0.2631578947368421	0.3	40	16135	5	27	35	16108	16175	0.13784918221046308
M1	string	0	network_modules	109	TRUE	3.643765276630458e-5	112	24	6	0.25	0.05357142857142857	REAC:R-HSA-187037	REAC	Signaling by NTRK1 (TRKA)	10916	2284		0.6176470588235294	0.6285714285714286	112	10804	6	18	106	10786	10916	0.11167455435593292
M1	string	0	network_modules	109	TRUE	4.776388132713417e-5	23	24	4	0.16666666666666666	0.17391304347826086	REAC:R-HSA-450302	REAC	activated TAK1 mediates p38 MAPK activation	10916	2685		0.6470588235294118	0.6571428571428571	23	10893	4	20	19	10873	10916	0.1684616552340407
M1	string	0	network_modules	109	TRUE	6.069372482848458e-5	122	24	6	0.25	0.04918032786885246	REAC:R-HSA-2559580	REAC	Oxidative Stress Induced Senescence	10916	1654		0.6764705882352942	0.6857142857142857	122	10794	6	18	116	10776	10916	0.10664038724961716
M1	string	0	network_modules	109	TRUE	7.493869275051085e-5	59	28	5	0.17857142857142858	0.0847457627118644	KEGG:04370	KEGG	VEGF signaling pathway	8484	307		0.2727272727272727	0.30434782608695654	59	8425	5	23	54	8402	8484	0.1188357038801927
M1	string	0	network_modules	109	TRUE	7.724064875969255e-5	701	32	11	0.34375	0.015691868758915834	GO:0009628	GO:BP	response to abiotic stimulus	16175	3549		0.3157894736842105	0.35	701	15474	11	21	690	15453	16175	0.06568760459464067
M1	string	0	network_modules	109	TRUE	9.264592992893597e-5	131	24	6	0.25	0.04580152671755725	REAC:R-HSA-166520	REAC	Signaling by NTRKs	10916	2287		0.7058823529411765	0.7142857142857143	131	10785	6	18	125	10767	10916	0.10259949631125849
M1	string	0	network_modules	109	TRUE	1.1059810596403583e-4	472	24	9	0.375	0.019067796610169493	REAC:R-HSA-449147	REAC	Signaling by Interleukins	10916	2261		0.7352941176470589	0.7428571428571429	472	10444	9	15	463	10429	10916	0.0765659830951849
M1	string	0	network_modules	109	TRUE	1.4557252028889474e-4	194	28	7	0.25	0.03608247422680412	KEGG:05167	KEGG	Kaposi sarcoma-associated herpesvirus infection	8484	448		0.3181818181818182	0.34782608695652173	194	8290	7	21	187	8269	8484	0.08743797939376173
M1	string	0	network_modules	109	TRUE	2.034525779843701e-4	124	32	6	0.1875	0.04838709677419355	GO:0043405	GO:BP	regulation of MAP kinase activity	16175	10673		0.3684210526315789	0.4	124	16051	6	26	118	16025	16175	0.09179873649151757
M1	string	0	network_modules	109	TRUE	2.696873303685883e-4	136	28	6	0.21428571428571427	0.04411764705882353	KEGG:05135	KEGG	Yersinia infection	8484	432		0.36363636363636365	0.391304347826087	136	8348	6	22	130	8326	8484	0.09083680399831723
M1	string	0	network_modules	109	TRUE	3.117279382917259e-4	36	24	4	0.16666666666666666	0.1111111111111111	REAC:R-HSA-168638	REAC	NOD1/2 Signaling Pathway	10916	1529		0.7647058823529411	0.7714285714285715	36	10880	4	20	32	10860	10916	0.1337576511564755
M1	string	0	network_modules	109	TRUE	3.153102390197551e-4	27	32	4	0.125	0.14814814814814814	GO:0043507	GO:BP	positive regulation of JUN kinase activity	16175	10744		0.42105263157894735	0.45	27	16148	4	28	23	16120	16175	0.1345108450366454
M1	string	0	network_modules	109	TRUE	3.464107868418661e-4	142	28	6	0.21428571428571427	0.04225352112676056	KEGG:04936	KEGG	Alcoholic liver disease	8484	393		0.4090909090909091	0.43478260869565216	142	8342	6	22	136	8320	8484	0.08861174271873017
M1	string	0	network_modules	109	TRUE	4.7012349617342377e-4	11	24	3	0.125	0.2727272727272727	REAC:R-HSA-376172	REAC	DSCAM interactions	10916	450		0.7941176470588235	0.8	11	10905	3	21	8	10884	10916	0.1834428914126782
M1	string	0	network_modules	109	TRUE	4.90260614230069e-4	94	24	5	0.20833333333333334	0.05319148936170213	REAC:R-HSA-4420097	REAC	VEGFA-VEGFR2 Pathway	10916	2634		0.8235294117647058	0.8285714285714286	94	10822	5	19	89	10803	10916	0.10146676358398905
M1	string	0	network_modules	109	TRUE	5.742845532409331e-4	155	28	6	0.21428571428571427	0.03870967741935484	KEGG:04218	KEGG	Cellular senescence	8484	295		0.45454545454545453	0.4782608695652174	155	8329	6	22	149	8307	8484	0.08422218371197229
M1	string	0	network_modules	109	TRUE	5.871439124958263e-4	42	24	4	0.16666666666666666	0.09523809523809523	REAC:R-HSA-5675221	REAC	Negative regulation of MAPK pathway	10916	1573		0.8529411764705882	0.8571428571428571	42	10874	4	20	38	10854	10916	0.12345292408416489
M1	string	0	network_modules	109	TRUE	5.95916625273818e-4	156	28	6	0.21428571428571427	0.038461538461538464	KEGG:04148	KEGG	Efferocytosis	8484	283		0.5	0.5217391304347826	156	8328	6	22	150	8306	8484	0.08390636182987866
M1	string	0	network_modules	109	TRUE	7.083662947858179e-4	251	32	7	0.21875	0.027888446215139442	GO:0104004	GO:BP	cellular response to environmental stimulus	16175	19202		0.47368421052631576	0.55	251	15924	7	25	244	15899	16175	0.07320770346517984
M1	string	0	network_modules	109	TRUE	7.083662947858179e-4	251	32	7	0.21875	0.027888446215139442	GO:0071214	GO:BP	cellular response to abiotic stimulus	16175	16476		0.47368421052631576	0.55	251	15924	7	25	244	15899	16175	0.07320770346517984
M1	string	0	network_modules	109	TRUE	7.400487776438873e-4	162	28	6	0.21428571428571427	0.037037037037037035	KEGG:05161	KEGG	Hepatitis B	8484	442		0.5454545454545454	0.5652173913043478	162	8322	6	22	156	8300	8484	0.08207020117110474
M1	string	0	network_modules	109	TRUE	8.094842960443141e-4	104	24	5	0.20833333333333334	0.04807692307692308	REAC:R-HSA-194138	REAC	Signaling by VEGF	10916	2313		0.8823529411764706	0.8857142857142857	104	10812	5	19	99	10793	10916	0.09606721593841373
M1	string	0	network_modules	109	TRUE	8.559049034402013e-4	530	32	9	0.28125	0.016981132075471698	GO:0043408	GO:BP	regulation of MAPK cascade	16175	10676		0.5789473684210527	0.6	530	15645	9	23	521	15622	16175	0.06214394091601283
M1	string	0	network_modules	109	TRUE	9.279494991350989e-4	194	24	6	0.25	0.030927835051546393	REAC:R-HSA-2559583	REAC	Cellular Senescence	10916	331		0.9117647058823529	0.9142857142857143	194	10722	6	18	188	10704	10916	0.08250703905330399
M1	string	0	network_modules	109	TRUE	0.001242936342316251	104	28	5	0.17857142857142858	0.04807692307692308	KEGG:04625	KEGG	C-type lectin receptor signaling pathway	8484	330		0.5909090909090909	0.6086956521739131	104	8380	5	23	99	8357	8484	0.08697308263993045
M1	string	0	network_modules	109	TRUE	0.0014977079240950553	412	32	8	0.25	0.019417475728155338	GO:0045859	GO:BP	regulation of protein kinase activity	16175	11671		0.631578947368421	0.65	412	15763	8	24	404	15739	16175	0.06344987417292451
M1	string	0	network_modules	109	TRUE	0.0017552249461254815	55	24	4	0.16666666666666666	0.07272727272727272	REAC:R-HSA-168643	REAC	Nucleotide-binding domain, leucine rich repeat containing receptor (NLR) signaling pathways	10916	1628		0.9411764705882353	0.9428571428571428	55	10861	4	20	51	10841	10916	0.10715592564170635
M1	string	0	network_modules	109	TRUE	0.002148097234568393	185	32	6	0.1875	0.032432432432432434	GO:0018105	GO:BP	peptidyl-serine phosphorylation	16175	5324		0.6842105263157895	0.7	185	15990	6	26	179	15964	16175	0.07371980226397666
M1	string	0	network_modules	109	TRUE	0.002290742842727022	118	28	5	0.17857142857142858	0.0423728813559322	KEGG:04722	KEGG	Neurotrophin signaling pathway	8484	352		0.6363636363636364	0.6521739130434783	118	8366	5	23	113	8343	8484	0.0809082859800995
M1	string	0	network_modules	109	TRUE	0.0023146370889970246	198	28	6	0.21428571428571427	0.030303030303030304	KEGG:05169	KEGG	Epstein-Barr virus infection	8484	450		0.6818181818181818	0.6956521739130435	198	8286	6	22	192	8264	8484	0.07277906694244933
M1	string	0	network_modules	109	TRUE	0.0023857880570679235	119	28	5	0.17857142857142858	0.04201680672268908	KEGG:04660	KEGG	T cell receptor signaling pathway	8484	338		0.7272727272727273	0.7391304347826086	119	8365	5	23	114	8342	8484	0.08051475828473817
M1	string	0	network_modules	109	TRUE	0.0024838687703772912	120	28	5	0.17857142857142858	0.041666666666666664	KEGG:04935	KEGG	Growth hormone synthesis, secretion and action	8484	392		0.7727272727272727	0.782608695652174	120	8364	5	23	115	8341	8484	0.08012593327291463
M1	string	0	network_modules	109	TRUE	0.0025793151351004425	443	32	8	0.25	0.01805869074492099	GO:0043549	GO:BP	regulation of kinase activity	16175	10763		0.7368421052631579	0.75	443	15732	8	24	435	15708	16175	0.060727024647500266
M1	string	0	network_modules	109	TRUE	0.0030959047296475217	197	32	6	0.1875	0.030456852791878174	GO:0018209	GO:BP	peptidyl-serine modification	16175	5368		0.7894736842105263	0.8	197	15978	6	26	191	15952	16175	0.07116493496316302
M1	string	0	network_modules	109	TRUE	0.0035146137190228527	129	28	5	0.17857142857142858	0.03875968992248062	KEGG:04926	KEGG	Relaxin signaling pathway	8484	383		0.8181818181818182	0.8260869565217391	129	8355	5	23	124	8332	8484	0.0768230732018759
M1	string	0	network_modules	109	TRUE	0.003579634378139606	214	28	6	0.21428571428571427	0.028037383177570093	KEGG:05417	KEGG	Lipid and atherosclerosis	8484	494		0.8636363636363636	0.8695652173913043	214	8270	6	22	208	8248	8484	0.0693811111753725
M1	string	0	network_modules	109	TRUE	0.003923024692750985	132	28	5	0.17857142857142858	0.03787878787878788	KEGG:04380	KEGG	Osteoclast differentiation	8484	309		0.9090909090909091	0.9130434782608695	132	8352	5	23	127	8329	8484	0.07579429194105204
M1	string	0	network_modules	109	TRUE	0.00431868161691075	22	24	3	0.125	0.13636363636363635	REAC:R-HSA-112409	REAC	RAF-independent MAPK1/3 activation	10916	1840		0.9705882352941176	0.9714285714285714	22	10894	3	21	19	10873	10916	0.12872445833395138
M1	string	0	network_modules	109	TRUE	0.0046983231258118496	52	32	4	0.125	0.07692307692307693	GO:0006970	GO:BP	response to osmotic stress	16175	2597		0.8421052631578947	0.85	52	16123	4	28	48	16095	16175	0.09578487470907045
M1	string	0	network_modules	109	TRUE	0.0047188100591004515	70	28	4	0.14285714285714285	0.05714285714285714	KEGG:05120	KEGG	Epithelial cell signaling in Helicobacter pylori infection	8484	426		0.9545454545454546	0.9565217391304348	70	8414	4	24	66	8390	8484	0.08562732139614529
M1	string	0	network_modules	109	TRUE	0.007436798583425856	129	32	5	0.15625	0.03875968992248062	GO:0009411	GO:BP	response to UV	16175	3476		0.8947368421052632	0.9	129	16046	5	27	124	16019	16175	0.07421916200682648
M1	string	0	network_modules	109	TRUE	0.00754900301878683	512	32	8	0.25	0.015625	GO:0051338	GO:BP	regulation of transferase activity	16175	13665		0.9473684210526315	0.95	512	15663	8	24	504	15639	16175	0.05552650839905874
M1	string	0	network_modules	109	TRUE	0.008291689424351186	249	28	6	0.21428571428571427	0.024096385542168676	KEGG:05132	KEGG	Salmonella infection	8484	429		1	1	249	8235	6	22	243	8213	8484	0.06305042187391599
M1	string	0	network_modules	109	TRUE	0.008569588050578962	235	32	6	0.1875	0.02553191489361702	GO:0071900	GO:BP	regulation of protein serine/threonine kinase activity	16175	16971		1	1	235	15940	6	26	229	15914	16175	0.06436108877209817
M1	string	0	network_modules	109	TRUE	0.009107786262651926	28	24	3	0.125	0.10714285714285714	REAC:R-HSA-525793	REAC	Myogenesis	10916	1504		1	1	28	10888	3	21	25	10867	10916	0.11362337779738162
M1	string	0	network_modules	110	TRUE	2.0156431055795924e-7	44	13	5	0.38461538461538464	0.11363636363636363	KEGG:03410	KEGG	Base excision repair	8484	237		0	0.5	44	8440	5	8	39	8432	8484	0.2069369903186234
M1	string	0	network_modules	110	TRUE	1.770069790950569e-6	62	29	6	0.20689655172413793	0.0967741935483871	GO:0006303	GO:BP	double-strand break repair via nonhomologous end joining	16175	2110		0	0.14285714285714285	62	16113	6	23	56	16090	16175	0.13927032272808798
M1	string	0	network_modules	110	TRUE	2.5343530100018176e-6	298	29	9	0.3103448275862069	0.030201342281879196	GO:0006302	GO:BP	double-strand break repair	16175	2109		0.16666666666666666	0.2857142857142857	298	15877	9	20	289	15857	16175	0.091999251837128
M1	string	0	network_modules	110	TRUE	4.3957919143580125e-6	11	29	4	0.13793103448275862	0.36363636363636365	GO:0000012	GO:BP	single strand break repair	16175	4		0.3333333333333333	0.42857142857142855	11	16164	4	25	7	16139	16175	0.22312872387251997
M1	string	0	network_modules	110	TRUE	1.3284489977474957e-5	14	29	4	0.13793103448275862	0.2857142857142857	GO:0006266	GO:BP	DNA ligation	16175	2081		0.5	0.5714285714285714	14	16161	4	25	10	16136	16175	0.19753353685849726
M1	string	0	network_modules	110	TRUE	1.5487537983215965e-5	329	9	6	0.6666666666666666	0.0182370820668693	REAC:R-HSA-73894	REAC	DNA Repair	10916	444		0	0.16666666666666666	329	10587	6	3	323	10584	10916	0.10694607182536472
M1	string	0	network_modules	110	TRUE	2.331581855823161e-5	528	29	10	0.3448275862068966	0.01893939393939394	GO:0006281	GO:BP	DNA repair	16175	2095		0.6666666666666666	0.7142857142857143	528	15647	10	19	518	15628	16175	0.07445430486421604
M1	string	0	network_modules	110	TRUE	4.33557307677188e-5	13	13	3	0.23076923076923078	0.23076923076923078	KEGG:03450	KEGG	Non-homologous end-joining	8484	241		1	1	13	8471	3	10	10	8461	8484	0.22958873259900292
M1	string	0	network_modules	110	TRUE	8.337346278552082e-5	5	29	3	0.10344827586206896	0.6	GO:0051103	GO:BP	DNA ligation involved in DNA repair	16175	13498		0.8333333333333334	0.8571428571428571	5	16170	3	26	2	16144	16175	0.24865338676338936
M1	string	0	network_modules	110	TRUE	9.699741336137247e-5	798	29	11	0.3793103448275862	0.013784461152882205	GO:0006974	GO:BP	DNA damage response	16175	2601		1	1	798	15377	11	18	787	15359	16175	0.06457353084070032
M1	string	0	network_modules	110	TRUE	7.582977458089813e-4	36	9	3	0.3333333333333333	0.08333333333333333	REAC:R-HSA-73933	REAC	Resolution of Abasic Sites (AP sites)	10916	2075		0.2	0.3333333333333333	36	10880	3	6	33	10874	10916	0.16535867412424085
M1	string	0	network_modules	110	TRUE	0.0017841299060024822	168	9	4	0.4444444444444444	0.023809523809523808	REAC:R-HSA-5693532	REAC	DNA Double-Strand Break Repair	10916	443		0.4	0.5	168	10748	4	5	164	10743	10916	0.10012114428862018
M1	string	0	network_modules	110	TRUE	0.003517493525200745	7	9	2	0.2222222222222222	0.2857142857142857	REAC:R-HSA-5649702	REAC	APEX1-Independent Resolution of AP Sites via the Single Nucleotide Replacement Pathway	10916	30		0.6	0.6666666666666666	7	10909	2	7	5	10902	10916	0.25143346313144566
M1	string	0	network_modules	110	TRUE	0.0046879858427047475	8	9	2	0.2222222222222222	0.25	REAC:R-HSA-110362	REAC	POLB-Dependent Long Patch Base Excision Repair	10916	1696		0.8	0.8333333333333334	8	10908	2	7	6	10901	10916	0.23510800786592262
M1	string	0	network_modules	110	TRUE	0.00525258891560795	68	9	3	0.3333333333333333	0.04411764705882353	REAC:R-HSA-5693571	REAC	Nonhomologous End-Joining (NHEJ)	10916	1605		1	1	68	10848	3	6	65	10842	10916	0.11942317489357408
M1	string	0	network_modules	111	TRUE	1.853679107055197e-40	183	32	25	0.78125	0.1366120218579235	GO:0071805	GO:BP	potassium ion transmembrane transport	16175	16918		0	0.011904761904761904	183	15992	25	7	158	15985	16175	0.32411936837871724
M1	string	0	network_modules	111	TRUE	1.5125574147245785e-39	198	32	25	0.78125	0.12626262626262627	GO:0006813	GO:BP	potassium ion transport	16175	2493		0.012048192771084338	0.023809523809523808	198	15977	25	7	173	15970	16175	0.31137110020067804
M1	string	0	network_modules	111	TRUE	2.2457692451423204e-35	43	30	18	0.6	0.4186046511627907	REAC:R-HSA-1296072	REAC	Voltage gated Potassium channels	10916	2663		0	0.14285714285714285	43	10873	18	12	25	10861	10916	0.4995415872173798
M1	string	0	network_modules	111	TRUE	1.0271550923946942e-31	575	32	27	0.84375	0.04695652173913043	GO:0098662	GO:BP	inorganic cation transmembrane transport	16175	18818		0.024096385542168676	0.03571428571428571	575	15600	27	5	548	15595	16175	0.19433475880590062
M1	string	0	network_modules	111	TRUE	1.1298770046028482e-31	577	32	27	0.84375	0.04679376083188908	GO:0098655	GO:BP	monoatomic cation transmembrane transport	16175	18811		0.03614457831325301	0.047619047619047616	577	15598	27	5	550	15593	16175	0.19398041956015336
M1	string	0	network_modules	111	TRUE	1.2567867526419696e-30	630	32	27	0.84375	0.04285714285714286	GO:0098660	GO:BP	inorganic ion transmembrane transport	16175	18816		0.04819277108433735	0.05952380952380952	630	15545	27	5	603	15540	16175	0.1852038570505044
M1	string	0	network_modules	111	TRUE	7.051028794990277e-30	671	32	27	0.84375	0.040238450074515646	GO:0034220	GO:BP	monoatomic ion transmembrane transport	16175	8508		0.060240963855421686	0.07142857142857142	671	15504	27	5	644	15499	16175	0.17912760786708218
M1	string	0	network_modules	111	TRUE	8.992844195472011e-30	677	32	27	0.84375	0.03988183161004431	GO:0030001	GO:BP	metal ion transport	16175	6646		0.07228915662650602	0.08333333333333333	677	15498	27	5	650	15493	16175	0.17828411638475664
M1	string	0	network_modules	111	TRUE	1.366680078058778e-28	748	32	27	0.84375	0.03609625668449198	GO:0006812	GO:BP	monoatomic cation transport	16175	2492		0.08433734939759036	0.09523809523809523	748	15427	27	5	721	15422	16175	0.16907113356219616
M1	string	0	network_modules	111	TRUE	1.9032745282683717e-27	103	30	18	0.6	0.17475728155339806	REAC:R-HSA-1296071	REAC	Potassium Channels	10916	1780		0.16666666666666666	0.2857142857142857	103	10813	18	12	85	10801	10916	0.32067527243492105
M1	string	0	network_modules	111	TRUE	4.2117536202422434e-18	400	30	19	0.6333333333333333	0.0475	REAC:R-HSA-112316	REAC	Neuronal System	10916	1590		0.3333333333333333	0.42857142857142855	400	10516	19	11	381	10505	10916	0.1667183382801103
M1	string	0	network_modules	111	TRUE	4.709122424765778e-14	65	32	10	0.3125	0.15384615384615385	GO:1901379	GO:BP	regulation of potassium ion transmembrane transport	16175	21429		0.0963855421686747	0.10714285714285714	65	16110	10	22	55	16088	16175	0.2170959712952434
M1	string	0	network_modules	111	TRUE	6.409510308730566e-14	23	32	8	0.25	0.34782608695652173	GO:0099623	GO:BP	regulation of cardiac muscle cell membrane repolarization	16175	19168		0.10843373493975904	0.11904761904761904	23	16152	8	24	15	16128	16175	0.29370603163595105
M1	string	0	network_modules	111	TRUE	1.8688386344202903e-13	74	32	10	0.3125	0.13513513513513514	GO:0043266	GO:BP	regulation of potassium ion transport	16175	10590		0.12048192771084337	0.13095238095238096	74	16101	10	22	64	16079	16175	0.20315610364083425
M1	string	0	network_modules	111	TRUE	1.0203904854531464e-12	31	32	8	0.25	0.25806451612903225	GO:0060306	GO:BP	regulation of membrane repolarization	16175	14519		0.13253012048192772	0.14285714285714285	31	16144	8	24	23	16120	16175	0.2525448681460392
M1	string	0	network_modules	111	TRUE	1.497410514739214e-12	8	32	6	0.1875	0.75	GO:0098915	GO:BP	membrane repolarization during ventricular cardiac muscle cell action potential	16175	18948		0.14457831325301204	0.15476190476190477	8	16167	6	26	2	16141	16175	0.37447395041565534
M1	string	0	network_modules	111	TRUE	1.7911464663905726e-12	33	32	8	0.25	0.24242424242424243	GO:0099622	GO:BP	cardiac muscle cell membrane repolarization	16175	19167		0.1566265060240964	0.16666666666666666	33	16142	8	24	25	16118	16175	0.24466554631918516
M1	string	0	network_modules	111	TRUE	4.275047951339571e-12	19	32	7	0.21875	0.3684210526315789	GO:0060307	GO:BP	regulation of ventricular cardiac muscle cell membrane repolarization	16175	14520		0.1686746987951807	0.17857142857142858	19	16156	7	25	12	16131	16175	0.28280893004800944
M1	string	0	network_modules	111	TRUE	6.906673068155734e-12	9	30	6	0.2	0.6666666666666666	REAC:R-HSA-5576890	REAC	Phase 3 - rapid repolarisation	10916	1735		0.5	0.5714285714285714	9	10907	6	24	3	10883	10916	0.3642940202245211
M1	string	0	network_modules	111	TRUE	9.65649315017269e-12	108	32	10	0.3125	0.09259259259259259	GO:0001508	GO:BP	action potential	16175	323		0.18072289156626506	0.19047619047619047	108	16067	10	22	98	16045	16175	0.16719299073895616
M1	string	0	network_modules	111	TRUE	1.3614282028330584e-11	71	32	9	0.28125	0.1267605633802817	GO:0086001	GO:BP	cardiac muscle cell action potential	16175	17878		0.1927710843373494	0.20238095238095238	71	16104	9	23	62	16081	16175	0.18646276264031753
M1	string	0	network_modules	111	TRUE	2.0687363480913332e-11	23	32	7	0.21875	0.30434782608695654	GO:0099625	GO:BP	ventricular cardiac muscle cell membrane repolarization	16175	19170		0.20481927710843373	0.21428571428571427	23	16152	7	25	16	16127	16175	0.25678276590729726
M1	string	0	network_modules	111	TRUE	3.308844358535713e-11	46	32	8	0.25	0.17391304347826086	GO:0086009	GO:BP	membrane repolarization	16175	17883		0.21686746987951808	0.2261904761904762	46	16129	8	24	38	16105	16175	0.2066406983724825
M1	string	0	network_modules	111	TRUE	4.7724588883399306e-11	48	32	8	0.25	0.16666666666666666	GO:0086002	GO:BP	cardiac muscle cell action potential involved in contraction	16175	17879		0.2289156626506024	0.25	48	16127	8	24	40	16103	16175	0.20220121563438617
M1	string	0	network_modules	111	TRUE	4.7724588883399306e-11	48	32	8	0.25	0.16666666666666666	GO:1901016	GO:BP	regulation of potassium ion transmembrane transporter activity	16175	21138		0.2289156626506024	0.25	48	16127	8	24	40	16103	16175	0.20220121563438617
M1	string	0	network_modules	111	TRUE	7.453069095630666e-11	27	32	7	0.21875	0.25925925925925924	GO:0086011	GO:BP	membrane repolarization during action potential	16175	17885		0.25301204819277107	0.2619047619047619	27	16148	7	25	20	16123	16175	0.23675940001194487
M1	string	0	network_modules	111	TRUE	1.2599277029918332e-10	90	32	9	0.28125	0.1	GO:0061337	GO:BP	cardiac conduction	16175	15419		0.26506024096385544	0.27380952380952384	90	16085	9	23	81	16062	16175	0.1650098448388213
M1	string	0	network_modules	111	TRUE	1.3063886989407788e-10	29	32	7	0.21875	0.2413793103448276	GO:0086005	GO:BP	ventricular cardiac muscle cell action potential	16175	17882		0.27710843373493976	0.2857142857142857	29	16146	7	25	22	16121	16175	0.22833346580092703
M1	string	0	network_modules	111	TRUE	2.0827079199095557e-10	95	32	9	0.28125	0.09473684210526316	GO:2001257	GO:BP	regulation of cation channel activity	16175	26443		0.2891566265060241	0.2976190476190476	95	16080	9	23	86	16057	16175	0.16045364327500108
M1	string	0	network_modules	111	TRUE	4.1977235741498206e-10	62	32	8	0.25	0.12903225806451613	GO:0086003	GO:BP	cardiac muscle cell contraction	16175	17880		0.30120481927710846	0.30952380952380953	62	16113	8	24	54	16089	16175	0.17736699420849936
M1	string	0	network_modules	111	TRUE	4.2355931735317864e-10	16	32	6	0.1875	0.375	GO:0097623	GO:BP	potassium ion export across plasma membrane	16175	18713		0.3132530120481928	0.32142857142857145	16	16159	6	26	10	16133	16175	0.2641581125635299
M1	string	0	network_modules	111	TRUE	5.262435549680436e-10	229	32	11	0.34375	0.048034934497816595	GO:1904062	GO:BP	regulation of monoatomic cation transmembrane transport	16175	23501		0.3253012048192771	0.3333333333333333	229	15946	11	21	218	15925	16175	0.12421117099902436
M1	string	0	network_modules	111	TRUE	6.410998007435226e-10	163	32	10	0.3125	0.06134969325153374	GO:0008016	GO:BP	regulation of heart contraction	16175	3097		0.3373493975903614	0.34523809523809523	163	16012	10	22	153	15990	16175	0.13481089057176115
M1	string	0	network_modules	111	TRUE	6.536892209744912e-10	17	32	6	0.1875	0.35294117647058826	GO:1902259	GO:BP	regulation of delayed rectifier potassium channel activity	16175	22156		0.3493975903614458	0.35714285714285715	17	16158	6	26	11	16132	16175	0.25619399155352574
M1	string	0	network_modules	111	TRUE	8.774177052216177e-10	111	32	9	0.28125	0.08108108108108109	GO:0060048	GO:BP	cardiac muscle contraction	16175	14311		0.3614457831325301	0.36904761904761907	111	16064	9	23	102	16041	16175	0.14798007138594987
M1	string	0	network_modules	111	TRUE	1.4291390352447568e-9	19	32	6	0.1875	0.3157894736842105	GO:1901380	GO:BP	negative regulation of potassium ion transmembrane transport	16175	21430		0.37349397590361444	0.39285714285714285	19	16156	6	26	13	16130	16175	0.2421895347211356
M1	string	0	network_modules	111	TRUE	1.4291390352447568e-9	19	32	6	0.1875	0.3157894736842105	GO:0086013	GO:BP	membrane repolarization during cardiac muscle cell action potential	16175	17887		0.37349397590361444	0.39285714285714285	19	16156	6	26	13	16130	16175	0.2421895347211356
M1	string	0	network_modules	111	TRUE	1.5373963329435808e-9	40	32	7	0.21875	0.175	GO:0086091	GO:BP	regulation of heart rate by cardiac conduction	16175	17929		0.39759036144578314	0.40476190476190477	40	16135	7	25	33	16110	16175	0.19387557890006019
M1	string	0	network_modules	111	TRUE	1.939582690165596e-9	258	32	11	0.34375	0.04263565891472868	GO:0006936	GO:BP	muscle contraction	16175	2575		0.40963855421686746	0.4166666666666667	258	15917	11	21	247	15896	16175	0.11649168482358023
M1	string	0	network_modules	111	TRUE	1.942981197619683e-9	182	32	10	0.3125	0.054945054945054944	GO:0032412	GO:BP	regulation of monoatomic ion transmembrane transporter activity	16175	7550		0.42168674698795183	0.42857142857142855	182	15993	10	22	172	15971	16175	0.12716007132286597
M1	string	0	network_modules	111	TRUE	2.2890215254456672e-9	185	32	10	0.3125	0.05405405405405406	GO:0060047	GO:BP	heart contraction	16175	14310		0.43373493975903615	0.44047619047619047	185	15990	10	22	175	15968	16175	0.12605900128163594
M1	string	0	network_modules	111	TRUE	2.293839986361616e-9	262	32	11	0.34375	0.04198473282442748	GO:0034765	GO:BP	regulation of monoatomic ion transmembrane transport	16175	8734		0.4457831325301205	0.4523809523809524	262	15913	11	21	251	15892	16175	0.11552632302524768
M1	string	0	network_modules	111	TRUE	2.9897561685197672e-9	190	32	10	0.3125	0.05263157894736842	GO:1903522	GO:BP	regulation of blood circulation	16175	23072		0.4578313253012048	0.47619047619047616	190	15985	10	22	180	15963	16175	0.12428098656109311
M1	string	0	network_modules	111	TRUE	2.9897561685197672e-9	190	32	10	0.3125	0.05263157894736842	GO:0022898	GO:BP	regulation of transmembrane transporter activity	16175	6629		0.4578313253012048	0.47619047619047616	190	15985	10	22	180	15963	16175	0.12428098656109311
M1	string	0	network_modules	111	TRUE	3.1509999770160166e-9	191	32	10	0.3125	0.05235602094240838	GO:0003015	GO:BP	heart process	16175	1466		0.4819277108433735	0.4880952380952381	191	15984	10	22	181	15962	16175	0.12393361271230649
M1	string	0	network_modules	111	TRUE	3.913898306464842e-9	22	32	6	0.1875	0.2727272727272727	GO:0043267	GO:BP	negative regulation of potassium ion transport	16175	10591		0.4939759036144578	0.5	22	16153	6	26	16	16127	16175	0.22486850846262976
M1	string	0	network_modules	111	TRUE	4.309372300546749e-9	82	32	8	0.25	0.0975609756097561	GO:0002027	GO:BP	regulation of heart rate	16175	629		0.5060240963855421	0.5119047619047619	82	16093	8	24	74	16069	16175	0.15354811897764148
M1	string	0	network_modules	111	TRUE	5.106740226337834e-9	282	32	11	0.34375	0.03900709219858156	GO:0042391	GO:BP	regulation of membrane potential	16175	10141		0.5180722891566265	0.5238095238095238	282	15893	11	21	271	15872	16175	0.11100374024299975
M1	string	0	network_modules	111	TRUE	5.334213440434458e-9	381	32	12	0.375	0.031496062992125984	GO:0044057	GO:BP	regulation of system process	16175	10893		0.5301204819277109	0.5357142857142857	381	15794	12	20	369	15774	16175	0.10317539299646626
M1	string	0	network_modules	111	TRUE	5.514017589661203e-9	284	32	11	0.34375	0.03873239436619718	GO:0010959	GO:BP	regulation of metal ion transport	16175	4536		0.54216867469879515	0.5476190476190477	284	15891	11	21	273	15870	16175	0.11057723607019512
M1	string	0	network_modules	111	TRUE	5.791854618853393e-9	203	32	10	0.3125	0.04926108374384237	GO:0032409	GO:BP	regulation of transporter activity	16175	7547		0.5542168674698795	0.5595238095238095	203	15972	10	22	193	15950	16175	0.11996319282220178
M1	string	0	network_modules	111	TRUE	6.381576701816354e-9	86	32	8	0.25	0.09302325581395349	GO:0070252	GO:BP	actin-mediated cell contraction	16175	16020		0.5662650602409639	0.5714285714285714	86	16089	8	24	78	16065	16175	0.1498019517901306
M1	string	0	network_modules	111	TRUE	9.460661682283615e-9	144	32	9	0.28125	0.0625	GO:0006941	GO:BP	striated muscle contraction	16175	2579		0.5783132530120482	0.5833333333333334	144	16031	9	23	135	16008	16175	0.12908886779103385
M1	string	0	network_modules	111	TRUE	1.1124220309748376e-8	303	32	11	0.34375	0.036303630363036306	GO:0003012	GO:BP	muscle system process	16175	1463		0.5903614457831325	0.5952380952380952	303	15872	11	21	292	15851	16175	0.10673248208978083
M1	string	0	network_modules	111	TRUE	2.306189970991022e-8	113	15	7	0.4666666666666667	0.061946902654867256	KEGG:04725	KEGG	Cholinergic synapse	8484	355		0	0.5	113	8371	7	8	106	8363	8484	0.16643073606565645
M1	string	0	network_modules	111	TRUE	2.4678110979334828e-8	29	32	6	0.1875	0.20689655172413793	GO:1901381	GO:BP	positive regulation of potassium ion transmembrane transport	16175	21431		0.6024096385542169	0.6071428571428571	29	16146	6	26	23	16120	16175	0.19544484180090926
M1	string	0	network_modules	111	TRUE	3.978451996935692e-8	341	32	11	0.34375	0.03225806451612903	GO:0043269	GO:BP	regulation of monoatomic ion transport	16175	10593		0.6144578313253012	0.6190476190476191	341	15834	11	21	330	15813	16175	0.10000245339894814
M1	string	0	network_modules	111	TRUE	4.773299208873647e-8	110	32	8	0.25	0.07272727272727272	GO:0030048	GO:BP	actin filament-based movement	16175	6667		0.6265060240963856	0.6309523809523809	110	16065	8	24	102	16041	16175	0.13175069479720822
M1	string	0	network_modules	111	TRUE	5.54962068712058e-8	65	32	7	0.21875	0.1076923076923077	GO:1904063	GO:BP	negative regulation of cation transmembrane transport	16175	23502		0.6385542168674698	0.6428571428571429	65	16110	7	25	58	16085	16175	0.15111875574378297
M1	string	0	network_modules	111	TRUE	5.946182733601446e-8	354	32	11	0.34375	0.031073446327683617	GO:0034762	GO:BP	regulation of transmembrane transport	16175	8731		0.6506024096385542	0.6547619047619048	354	15821	11	21	343	15800	16175	0.09794481894164499
M1	string	0	network_modules	111	TRUE	6.938960410555698e-8	34	32	6	0.1875	0.17647058823529413	GO:0043268	GO:BP	positive regulation of potassium ion transport	16175	10592		0.6626506024096386	0.6666666666666666	34	16141	6	26	28	16115	16175	0.1802301735720307
M1	string	0	network_modules	111	TRUE	9.49132656037408e-8	70	32	7	0.21875	0.1	GO:0034766	GO:BP	negative regulation of monoatomic ion transmembrane transport	16175	8735		0.6746987951807228	0.6785714285714286	70	16105	7	25	63	16080	16175	0.145434616230056
M1	string	0	network_modules	111	TRUE	1.0632304094858283e-7	15	30	5	0.16666666666666666	0.3333333333333333	REAC:R-HSA-5576893	REAC	Phase 2 - plateau phase	10916	1734		0.6666666666666666	0.7142857142857143	15	10901	5	25	10	10876	10916	0.23424182088501733
M1	string	0	network_modules	111	TRUE	4.905014729963391e-7	88	32	7	0.21875	0.07954545454545454	GO:0043271	GO:BP	negative regulation of monoatomic ion transport	16175	10595		0.6867469879518072	0.6904761904761905	88	16087	7	25	81	16062	16175	0.12910958847856252
M1	string	0	network_modules	111	TRUE	5.316513186111155e-7	89	32	7	0.21875	0.07865168539325842	GO:0034763	GO:BP	negative regulation of transmembrane transport	16175	8732		0.6987951807228916	0.7023809523809523	89	16086	7	25	82	16061	16175	0.12834898480373316
M1	string	0	network_modules	111	TRUE	6.464992431026859e-7	7	32	4	0.125	0.5714285714285714	GO:1902260	GO:BP	negative regulation of delayed rectifier potassium channel activity	16175	22157		0.7108433734939759	0.7142857142857143	7	16168	4	28	3	16140	16175	0.2666575004111757
M1	string	0	network_modules	111	TRUE	1.1272186671786069e-6	163	32	8	0.25	0.049079754601226995	GO:0043270	GO:BP	positive regulation of monoatomic ion transport	16175	10594		0.7228915662650602	0.7261904761904762	163	16012	8	24	155	15988	16175	0.1069502832276923
M1	string	0	network_modules	111	TRUE	1.5312019171467433e-6	358	32	10	0.3125	0.027932960893854747	GO:0008015	GO:BP	blood circulation	16175	3096		0.7349397590361446	0.7380952380952381	358	15817	10	22	348	15795	16175	0.08787613754705317
M1	string	0	network_modules	111	TRUE	3.0688931404692063e-6	114	32	7	0.21875	0.06140350877192982	GO:1904064	GO:BP	positive regulation of cation transmembrane transport	16175	23503		0.7469879518072289	0.75	114	16061	7	25	107	16036	16175	0.11267137047638741
M1	string	0	network_modules	111	TRUE	3.368019417291021e-6	63	32	6	0.1875	0.09523809523809523	GO:0140115	GO:BP	export across plasma membrane	16175	19670		0.7590361445783133	0.7619047619047619	63	16112	6	26	57	16086	16175	0.1312402035568292
M1	string	0	network_modules	111	TRUE	3.862898679712307e-6	10	32	4	0.125	0.4	GO:1903817	GO:BP	negative regulation of voltage-gated potassium channel activity	16175	23304		0.7710843373493976	0.7738095238095238	10	16165	4	28	6	16137	16175	0.22279015997153992
M1	string	0	network_modules	111	TRUE	5.2628761950251046e-6	31	32	5	0.15625	0.16129032258064516	GO:2001258	GO:BP	negative regulation of cation channel activity	16175	26444		0.7831325301204819	0.7857142857142857	31	16144	5	27	26	16117	16175	0.1571089161275781
M1	string	0	network_modules	111	TRUE	6.917235210499521e-6	128	32	7	0.21875	0.0546875	GO:0034767	GO:BP	positive regulation of monoatomic ion transmembrane transport	16175	8736		0.7951807228915663	0.7976190476190477	128	16047	7	25	121	16022	16175	0.10594272804411858
M1	string	0	network_modules	111	TRUE	1.034359957176631e-5	3	32	3	0.09375	1	GO:1903765	GO:BP	negative regulation of potassium ion export across plasma membrane	16175	23259		0.8072289156626506	0.8095238095238095	3	16172	3	29	0	16143	16175	0.3059115646022684
M1	string	0	network_modules	111	TRUE	1.0882927475178366e-5	439	32	10	0.3125	0.022779043280182234	GO:0003013	GO:BP	circulatory system process	16175	1464		0.8192771084337349	0.8214285714285714	439	15736	10	22	429	15714	16175	0.07818795060317518
M1	string	0	network_modules	111	TRUE	1.5300463662882817e-5	130	30	7	0.23333333333333334	0.05384615384615385	REAC:R-HSA-5576891	REAC	Cardiac conduction	10916	306		0.8333333333333334	0.8571428571428571	130	10786	7	23	123	10763	10916	0.10715518918003156
M1	string	0	network_modules	111	TRUE	3.320118672570944e-5	16	32	4	0.125	0.25	GO:1901017	GO:BP	negative regulation of potassium ion transmembrane transporter activity	16175	21139		0.8313253012048193	0.8333333333333334	16	16159	4	28	12	16131	16175	0.17563841108400688
M1	string	0	network_modules	111	TRUE	5.382104294732087e-5	172	32	7	0.21875	0.040697674418604654	GO:0034764	GO:BP	positive regulation of transmembrane transport	16175	8733		0.8433734939759037	0.8452380952380952	172	16003	7	25	165	15978	16175	0.09033755617858504
M1	string	0	network_modules	111	TRUE	6.391288562918268e-5	50	32	5	0.15625	0.1	GO:0032413	GO:BP	negative regulation of ion transmembrane transporter activity	16175	7551		0.8554216867469879	0.8571428571428571	50	16125	5	27	45	16098	16175	0.1228384348799034
M1	string	0	network_modules	111	TRUE	1.0420913698053716e-4	55	32	5	0.15625	0.09090909090909091	GO:0086065	GO:BP	cell communication involved in cardiac conduction	16175	17919		0.8674698795180723	0.8690476190476191	55	16120	5	27	50	16093	16175	0.11690359222058526
M1	string	0	network_modules	111	TRUE	1.250791519654451e-4	57	32	5	0.15625	0.08771929824561403	GO:0032410	GO:BP	negative regulation of transporter activity	16175	7548		0.8795180722891566	0.8809523809523809	57	16118	5	27	52	16091	16175	0.11474856207473226
M1	string	0	network_modules	111	TRUE	1.6000989639751307e-4	307	32	8	0.25	0.026058631921824105	GO:0051051	GO:BP	negative regulation of transport	16175	13461		0.891566265060241	0.8928571428571429	307	15868	8	24	299	15844	16175	0.07537834976288094
M1	string	0	network_modules	111	TRUE	2.942765826887972e-4	153	15	5	0.3333333333333333	0.032679738562091505	KEGG:04261	KEGG	Adrenergic signaling in cardiomyocytes	8484	297		1	1	153	8331	5	10	148	8321	8484	0.09971467240821394
M1	string	0	network_modules	111	TRUE	3.2099193806045664e-4	203	30	7	0.23333333333333334	0.034482758620689655	REAC:R-HSA-397014	REAC	Muscle contraction	10916	1496		1	1	203	10713	7	23	196	10690	10916	0.08344356493956177
M1	string	0	network_modules	111	TRUE	3.600824481175372e-4	7	32	3	0.09375	0.42857142857142855	GO:0060372	GO:BP	regulation of atrial cardiac muscle cell membrane repolarization	16175	14580		0.9036144578313253	0.9166666666666666	7	16168	3	29	4	16139	16175	0.19976152254110363
M1	string	0	network_modules	111	TRUE	3.600824481175372e-4	7	32	3	0.09375	0.42857142857142855	GO:1903764	GO:BP	regulation of potassium ion export across plasma membrane	16175	23258		0.9036144578313253	0.9166666666666666	7	16168	3	29	4	16139	16175	0.19976152254110363
M1	string	0	network_modules	111	TRUE	5.621873627357967e-4	31	32	4	0.125	0.12903225806451613	GO:0086019	GO:BP	cell-cell signaling involved in cardiac conduction	16175	17893		0.927710843373494	0.9285714285714286	31	16144	4	28	27	16116	16175	0.12529693212142443
M1	string	0	network_modules	111	TRUE	0.00122959491731375	10	32	3	0.09375	0.3	GO:0099624	GO:BP	atrial cardiac muscle cell membrane repolarization	16175	19169		0.9397590361445783	0.9404761904761905	10	16165	3	29	7	16136	16175	0.16681577603957878
M1	string	0	network_modules	111	TRUE	0.002225417748366917	101	32	5	0.15625	0.04950495049504951	GO:0007605	GO:BP	sensory perception of sound	16175	3064		0.9518072289156626	0.9523809523809523	101	16074	5	27	96	16047	16175	0.08478373135036193
M1	string	0	network_modules	111	TRUE	0.00285565441826092	46	32	4	0.125	0.08695652173913043	GO:0098900	GO:BP	regulation of action potential	16175	18933		0.963855421686747	0.9642857142857143	46	16129	4	28	42	16101	16175	0.10213149644093024
M1	string	0	network_modules	111	TRUE	0.002961923871362909	107	32	5	0.15625	0.04672897196261682	GO:0050954	GO:BP	sensory perception of mechanical stimulus	16175	13396		0.9759036144578314	0.9761904761904762	107	16068	5	27	102	16041	16175	0.08218396999762767
M1	string	0	network_modules	111	TRUE	0.0044129793006306975	116	32	5	0.15625	0.04310344827586207	GO:0006937	GO:BP	regulation of muscle contraction	16175	2576		0.9879518072289156	0.9880952380952381	116	16059	5	27	111	16032	16175	0.0786599648333715
M1	string	0	network_modules	111	TRUE	0.004826245727160992	653	32	9	0.28125	0.013782542113323124	GO:0051050	GO:BP	positive regulation of transport	16175	13460		1	1	653	15522	9	23	644	15499	16175	0.054487360180366096
M1	string	0	network_modules	112	TRUE	6.888402439097062e-31	25	24	14	0.5833333333333334	0.56	REAC:R-HSA-8982491	REAC	Glycogen metabolism	10916	1064		0	0.07692307692307693	25	10891	14	10	11	10881	10916	0.570584288968977
M1	string	0	network_modules	112	TRUE	6.557489328513336e-25	52	31	14	0.45161290322580644	0.2692307692307692	GO:0005977	GO:BP	glycogen metabolic process	16175	1852		0	0.05	52	16123	14	17	38	16106	16175	0.3471032605563034
M1	string	0	network_modules	112	TRUE	8.902692839894537e-25	53	31	14	0.45161290322580644	0.2641509433962264	GO:0044042	GO:BP	glucan metabolic process	16175	10891		0.05263157894736842	0.1	53	16122	14	17	39	16105	16175	0.3437763652855053
M1	string	0	network_modules	112	TRUE	1.0673861611518308e-23	62	31	14	0.45161290322580644	0.22580645161290322	GO:0006112	GO:BP	energy reserve metabolic process	16175	1971		0.10526315789473684	0.15	62	16113	14	17	48	16096	16175	0.31754116822389905
M1	string	0	network_modules	112	TRUE	8.757974740558942e-23	71	31	14	0.45161290322580644	0.19718309859154928	GO:0005976	GO:BP	polysaccharide metabolic process	16175	1851		0.15789473684210525	0.2	71	16104	14	17	57	16087	16175	0.29644766804789074
M1	string	0	network_modules	112	TRUE	9.147728653349101e-23	14	24	10	0.4166666666666667	0.7142857142857143	REAC:R-HSA-70221	REAC	Glycogen breakdown (glycogenolysis)	10916	1063		0.08333333333333333	0.15384615384615385	14	10902	10	14	4	10888	10916	0.5448138521353562
M1	string	0	network_modules	112	TRUE	1.0923183485142825e-15	367	31	16	0.5161290322580645	0.043596730245231606	GO:0005975	GO:BP	carbohydrate metabolic process	16175	1850		0.21052631578947367	0.25	367	15808	16	15	351	15793	16175	0.14520519397032733
M1	string	0	network_modules	112	TRUE	3.226054048721514e-15	137	21	12	0.5714285714285714	0.08759124087591241	KEGG:04910	KEGG	Insulin signaling pathway	8484	367		0	0.2	137	8347	12	9	125	8338	8484	0.21944975020792368
M1	string	0	network_modules	112	TRUE	1.0059072490995008e-14	252	31	14	0.45161290322580644	0.05555555555555555	GO:0015980	GO:BP	energy derivation by oxidation of organic compounds	16175	5060		0.2631578947368421	0.3	252	15923	14	17	238	15906	16175	0.15428599536354523
M1	string	0	network_modules	112	TRUE	2.7651453101316787e-14	288	24	14	0.5833333333333334	0.04861111111111111	REAC:R-HSA-71387	REAC	Metabolism of carbohydrates	10916	1422		0.16666666666666666	0.23076923076923078	288	10628	14	10	274	10618	10916	0.16312088026006796
M1	string	0	network_modules	112	TRUE	6.015416361957728e-14	372	31	15	0.4838709677419355	0.04032258064516129	GO:0006091	GO:BP	generation of precursor metabolites and energy	16175	1954		0.3157894736842105	0.35	372	15803	15	16	357	15787	16175	0.13472839284504637
M1	string	0	network_modules	112	TRUE	5.747846450880002e-13	36	21	8	0.38095238095238093	0.2222222222222222	KEGG:00500	KEGG	Starch and sucrose metabolism	8484	62		0.25	0.4	36	8448	8	13	28	8435	8484	0.28868621375659265
M1	string	0	network_modules	112	TRUE	1.3422272794965882e-12	107	21	10	0.47619047619047616	0.09345794392523364	KEGG:04922	KEGG	Glucagon signaling pathway	8484	379		0.5	0.6	107	8377	10	11	97	8366	8484	0.2069356315335922
M1	string	0	network_modules	112	TRUE	5.2562137097993744e-11	14	24	6	0.25	0.42857142857142855	REAC:R-HSA-3322077	REAC	Glycogen synthesis	10916	1073		0.25	0.3076923076923077	14	10902	6	18	8	10884	10916	0.3262154543587794
M1	string	0	network_modules	112	TRUE	8.747962547836654e-11	15	24	6	0.25	0.4	REAC:R-HSA-3229121	REAC	Glycogen storage diseases	10916	1072		0.3333333333333333	0.38461538461538464	15	10901	6	18	9	10883	10916	0.31505244074929833
M1	string	0	network_modules	112	TRUE	6.300016371624916e-10	37	31	7	0.22580645161290322	0.1891891891891892	GO:0009250	GO:BP	glucan biosynthetic process	16175	3415		0.3684210526315789	0.45	37	16138	7	24	30	16114	16175	0.20502566703944006
M1	string	0	network_modules	112	TRUE	6.300016371624916e-10	37	31	7	0.22580645161290322	0.1891891891891892	GO:0005978	GO:BP	glycogen biosynthetic process	16175	1853		0.3684210526315789	0.45	37	16138	7	24	30	16114	16175	0.20502566703944006
M1	string	0	network_modules	112	TRUE	6.406284249699502e-9	10	31	5	0.16129032258064516	0.5	GO:0005980	GO:BP	glycogen catabolic process	16175	1855		0.47368421052631576	0.5	10	16165	5	26	5	16139	16175	0.2832514459852064
M1	string	0	network_modules	112	TRUE	9.237970284873054e-9	53	31	7	0.22580645161290322	0.1320754716981132	GO:0000271	GO:BP	polysaccharide biosynthetic process	16175	74		0.5263157894736842	0.55	53	16122	7	24	46	16098	16175	0.17063193935814835
M1	string	0	network_modules	112	TRUE	1.172911602467262e-8	11	31	5	0.16129032258064516	0.45454545454545453	GO:0000272	GO:BP	polysaccharide catabolic process	16175	75		0.5789473684210527	0.65	11	16164	5	26	6	16138	16175	0.26997408973001197
M1	string	0	network_modules	112	TRUE	1.172911602467262e-8	11	31	5	0.16129032258064516	0.45454545454545453	GO:0009251	GO:BP	glucan catabolic process	16175	3416		0.5789473684210527	0.65	11	16164	5	26	6	16138	16175	0.26997408973001197
M1	string	0	network_modules	112	TRUE	1.8871248183847737e-8	33	24	6	0.25	0.18181818181818182	REAC:R-HSA-5663084	REAC	Diseases of carbohydrate metabolism	10916	763		0.4166666666666667	0.46153846153846156	33	10883	6	18	27	10865	10916	0.21117398131466733
M1	string	0	network_modules	112	TRUE	2.8774322034316115e-7	108	21	7	0.3333333333333333	0.06481481481481481	KEGG:04931	KEGG	Insulin resistance	8484	388		0.75	0.8	108	8376	7	14	101	8362	8484	0.14245777891082337
M1	string	0	network_modules	112	TRUE	2.882342144377365e-6	3	24	3	0.125	1	REAC:R-HSA-3878781	REAC	Glycogen storage disease type IV (GBE1)	10916	1068		0.5	0.5384615384615384	3	10913	3	21	0	10892	10916	0.3532130535428617
M1	string	0	network_modules	112	TRUE	8.85311560569583e-6	3	31	3	0.0967741935483871	1	GO:1902267	GO:BP	regulation of polyamine transmembrane transport	16175	22163		0.6842105263157895	0.7	3	16172	3	28	0	16144	16175	0.3108160869570241
M1	string	0	network_modules	112	TRUE	1.34970841765262e-5	147	31	7	0.22580645161290322	0.047619047619047616	GO:0016051	GO:BP	carbohydrate biosynthetic process	16175	5083		0.7368421052631579	0.75	147	16028	7	24	140	16004	16175	0.10007299980504786
M1	string	0	network_modules	112	TRUE	2.4002782571709713e-4	9	24	3	0.125	0.3333333333333333	REAC:R-HSA-3785653	REAC	Myoclonic epilepsy of Lafora	10916	1503		0.5833333333333334	0.6153846153846154	9	10907	3	21	6	10886	10916	0.20308479792044035
M1	string	0	network_modules	112	TRUE	4.925641449442667e-4	8	31	3	0.0967741935483871	0.375	GO:1902047	GO:BP	polyamine transmembrane transport	16175	21970		0.7894736842105263	0.8	8	16167	3	28	5	16139	16175	0.18975539861157925
M1	string	0	network_modules	112	TRUE	0.0014299037347152072	2	24	2	0.08333333333333333	1	REAC:R-HSA-3858516	REAC	Glycogen storage disease type 0 (liver GYS2)	10916	1065		0.6666666666666666	0.8461538461538461	2	10914	2	22	0	10892	10916	0.2883840379923303
M1	string	0	network_modules	112	TRUE	0.0014299037347152072	2	24	2	0.08333333333333333	1	REAC:R-HSA-3814836	REAC	Glycogen storage disease type XV (GYG1)	10916	1071		0.6666666666666666	0.8461538461538461	2	10914	2	22	0	10892	10916	0.2883840379923303
M1	string	0	network_modules	112	TRUE	0.0014299037347152072	2	24	2	0.08333333333333333	1	REAC:R-HSA-3828062	REAC	Glycogen storage disease type 0 (muscle GYS1)	10916	1066		0.6666666666666666	0.8461538461538461	2	10914	2	22	0	10892	10916	0.2883840379923303
M1	string	0	network_modules	112	TRUE	0.00217388952341212	58	24	4	0.16666666666666666	0.06896551724137931	REAC:R-HSA-351202	REAC	Metabolism of polyamines	10916	1433		0.9166666666666666	0.9230769230769231	58	10858	4	20	54	10838	10916	0.10418481941685023
M1	string	0	network_modules	112	TRUE	0.003176809760522477	14	31	3	0.0967741935483871	0.21428571428571427	GO:0015846	GO:BP	polyamine transport	16175	4955		0.8421052631578947	0.85	14	16161	3	28	11	16133	16175	0.14291547382459283
M1	string	0	network_modules	112	TRUE	0.0035574894487904254	245	24	6	0.25	0.024489795918367346	REAC:R-HSA-5668914	REAC	Diseases of metabolism	10916	767		1	1	245	10671	6	18	239	10653	10916	0.07211370249670818
M1	string	0	network_modules	112	TRUE	0.004720031868106026	123	31	5	0.16129032258064516	0.04065040650406504	GO:0016052	GO:BP	carbohydrate catabolic process	16175	5084		0.8947368421052632	0.9	123	16052	5	26	118	16026	16175	0.07752409829044268
M1	string	0	network_modules	112	TRUE	0.004937290989342017	2	31	2	0.06451612903225806	1	GO:1902269	GO:BP	positive regulation of polyamine transmembrane transport	16175	22165		0.9473684210526315	0.95	2	16173	2	29	0	16144	16175	0.2537724263756736
M1	string	0	network_modules	112	TRUE	0.005599427479046993	6	21	2	0.09523809523809523	0.3333333333333333	KEGG:00440	KEGG	Phosphonate and phosphinate metabolism	8484	57		1	1	6	8478	2	19	4	8459	8484	0.1771330146082941
M1	string	0	network_modules	112	TRUE	0.005911620580495352	17	31	3	0.0967741935483871	0.17647058823529413	GO:0006595	GO:BP	polyamine metabolic process	16175	2312		1	1	17	16158	3	28	14	16130	16175	0.129454889231472
M1	string	0	network_modules	113	TRUE	6.466622900906119e-5	5	27	3	0.1111111111111111	0.6	GO:0046391	GO:BP	5-phosphoribose 1-diphosphate metabolic process	16175	12118		0	1	5	16170	3	24	2	16146	16175	0.25773556882201987
M1	string	0	network_modules	113	TRUE	6.466622900906119e-5	5	27	3	0.1111111111111111	0.6	GO:0006015	GO:BP	5-phosphoribose 1-diphosphate biosynthetic process	16175	1888		0	1	5	16170	3	24	2	16146	16175	0.25773556882201987
M1	string	0	network_modules	114	TRUE	3.7070832858844075e-5	35	15	4	0.26666666666666666	0.11428571428571428	REAC:R-HSA-432720	REAC	Lysosome Vesicle Biogenesis	10916	1341		0	0.5	35	10881	4	11	31	10870	10916	0.17287127968240615
M1	string	0	network_modules	114	TRUE	7.069169316876647e-4	72	15	4	0.26666666666666666	0.05555555555555555	REAC:R-HSA-199992	REAC	trans-Golgi Network Vesicle Budding	10916	2749		1	1	72	10844	4	11	68	10833	10916	0.11918089737911702
M1	string	0	network_modules	114	TRUE	9.645992934152215e-4	131	11	4	0.36363636363636365	0.030534351145038167	KEGG:04142	KEGG	Lysosome	8484	279		NA	1	131	8353	4	7	127	8346	8484	0.10175241063979346
M1	string	0	network_modules	115	TRUE	3.918904575572291e-43	244	32	29	0.90625	0.11885245901639344	REAC:R-HSA-8951664	REAC	Neddylation	10916	1559		0	0.043478260869565216	244	10672	29	3	215	10669	10916	0.3242114352345173
M1	string	0	network_modules	115	TRUE	8.799476732696855e-31	798	31	28	0.9032258064516129	0.03508771929824561	GO:0043687	GO:BP	post-translational protein modification	16175	10838		0	0.03125	798	15377	28	3	770	15374	16175	0.17277641012700093
M1	string	0	network_modules	115	TRUE	9.187601645605628e-31	667	31	27	0.8709677419354839	0.04047976011994003	GO:0032446	GO:BP	protein modification by small protein conjugation	16175	7568		0.03225806451612903	0.0625	667	15508	27	4	640	15504	16175	0.18285894262532149
M1	string	0	network_modules	115	TRUE	2.1858111874531302e-29	749	31	27	0.8709677419354839	0.036048064085447265	GO:0070647	GO:BP	protein modification by small protein conjugation or removal	16175	16231		0.06451612903225806	0.09375	749	15426	27	4	722	15422	16175	0.17196015260217454
M1	string	0	network_modules	115	TRUE	1.2910703534453953e-26	140	17	16	0.9411764705882353	0.11428571428571428	KEGG:04120	KEGG	Ubiquitin mediated proteolysis	8484	270		0	0.2	140	8344	16	1	124	8343	8484	0.32523569714371053
M1	string	0	network_modules	115	TRUE	2.3062878387350914e-26	29	31	13	0.41935483870967744	0.4482758620689655	GO:0045116	GO:BP	protein neddylation	16175	11286		0.0967741935483871	0.125	29	16146	13	18	16	16128	16175	0.43252279844125563
M1	string	0	network_modules	115	TRUE	3.8246264585790157e-25	38	32	14	0.4375	0.3684210526315789	REAC:R-HSA-5696394	REAC	DNA Damage Recognition in GG-NER	10916	439		0.045454545454545456	0.08695652173913043	38	10878	14	18	24	10860	10916	0.3995641703728285
M1	string	0	network_modules	115	TRUE	6.847038311146397e-23	52	32	14	0.4375	0.2692307692307692	REAC:R-HSA-6781823	REAC	Formation of TC-NER Pre-Incision Complex	10916	951		0.09090909090909091	0.13043478260869565	52	10864	14	18	38	10846	10916	0.3407776292416868
M1	string	0	network_modules	115	TRUE	7.37206249710407e-21	11	31	9	0.2903225806451613	0.8181818181818182	GO:0000338	GO:BP	protein deneddylation	16175	95		0.12903225806451613	0.15625	11	16164	9	22	2	16142	16175	0.48686786882370875
M1	string	0	network_modules	115	TRUE	3.127831459475695e-20	77	32	14	0.4375	0.18181818181818182	REAC:R-HSA-6781827	REAC	Transcription-Coupled Nucleotide Excision Repair (TC-NER)	10916	2541		0.13636363636363635	0.17391304347826086	77	10839	14	18	63	10821	10916	0.27888367362743877
M1	string	0	network_modules	115	TRUE	3.3386919476219684e-20	20	31	10	0.3225806451612903	0.5	GO:2000434	GO:BP	regulation of protein neddylation	16175	25749		0.16129032258064516	0.1875	20	16155	10	21	10	16134	16175	0.4007019968782351
M1	string	0	network_modules	115	TRUE	5.994233824727803e-20	109	32	15	0.46875	0.13761467889908258	REAC:R-HSA-5696398	REAC	Nucleotide Excision Repair	10916	1622		0.18181818181818182	0.21739130434782608	109	10807	15	17	94	10790	10916	0.250189096030216
M1	string	0	network_modules	115	TRUE	1.1690422550700618e-19	84	32	14	0.4375	0.16666666666666666	REAC:R-HSA-5696399	REAC	Global Genome Nucleotide Excision Repair (GG-NER)	10916	1047		0.22727272727272727	0.2608695652173913	84	10832	14	18	70	10814	10916	0.2666991408049739
M1	string	0	network_modules	115	TRUE	1.840496287125244e-14	547	31	17	0.5483870967741935	0.031078610603290677	GO:0006511	GO:BP	ubiquitin-dependent protein catabolic process	16175	2235		0.1935483870967742	0.21875	547	15628	17	14	530	15614	16175	0.12474358432546667
M1	string	0	network_modules	115	TRUE	1.9302654181317715e-14	673	31	18	0.5806451612903226	0.02674591381872214	GO:0051603	GO:BP	proteolysis involved in protein catabolic process	16175	13820		0.22580645161290322	0.25	673	15502	18	13	655	15489	16175	0.11828708738597954
M1	string	0	network_modules	115	TRUE	2.348483447328597e-14	555	31	17	0.5483870967741935	0.03063063063063063	GO:0019941	GO:BP	modification-dependent protein catabolic process	16175	6072		0.25806451612903225	0.28125	555	15620	17	14	538	15606	16175	0.123753914133485
M1	string	0	network_modules	115	TRUE	2.6492198162813937e-14	559	31	17	0.5483870967741935	0.03041144901610018	GO:0043632	GO:BP	modification-dependent macromolecule catabolic process	16175	10812		0.2903225806451613	0.3125	559	15616	17	14	542	15602	16175	0.12326681618341752
M1	string	0	network_modules	115	TRUE	3.7104069402884145e-14	206	31	13	0.41935483870967744	0.06310679611650485	GO:1903320	GO:BP	regulation of protein modification by small protein conjugation or removal	16175	22904		0.3225806451612903	0.34375	206	15969	13	18	193	15951	16175	0.15890402716155172
M1	string	0	network_modules	115	TRUE	4.238528799745598e-14	329	32	16	0.5	0.0486322188449848	REAC:R-HSA-73894	REAC	DNA Repair	10916	444		0.2727272727272727	0.30434782608695654	329	10587	16	16	313	10571	10916	0.14901466683947895
M1	string	0	network_modules	115	TRUE	4.488974760876509e-14	209	31	13	0.41935483870967744	0.06220095693779904	GO:1901873	GO:BP	regulation of post-translational protein modification	16175	21817		0.3548387096774194	0.375	209	15966	13	18	196	15948	16175	0.15770230052567163
M1	string	0	network_modules	115	TRUE	1.671072382429872e-12	363	31	14	0.45161290322580644	0.03856749311294766	GO:0043161	GO:BP	proteasome-mediated ubiquitin-dependent protein catabolic process	16175	10561		0.3870967741935484	0.40625	363	15812	14	17	349	15795	16175	0.12697057195956898
M1	string	0	network_modules	115	TRUE	1.942421493038671e-12	470	31	15	0.4838709677419355	0.031914893617021274	GO:0010498	GO:BP	proteasomal protein catabolic process	16175	4177		0.41935483870967744	0.4375	470	15705	15	16	455	15689	16175	0.11865479072556107
M1	string	0	network_modules	115	TRUE	2.0201575336909192e-12	590	31	16	0.5161290322580645	0.02711864406779661	GO:0016567	GO:BP	protein ubiquitination	16175	5254		0.45161290322580644	0.46875	590	15585	16	15	574	15570	16175	0.11211592589118656
M1	string	0	network_modules	115	TRUE	7.256923405156586e-11	104	32	10	0.3125	0.09615384615384616	REAC:R-HSA-8856825	REAC	Cargo recognition for clathrin-mediated endocytosis	10916	309		0.3181818181818182	0.34782608695652173	104	10812	10	22	94	10790	10916	0.1691134149982702
M1	string	0	network_modules	115	TRUE	5.066509114974563e-10	109	31	9	0.2903225806451613	0.08256880733944955	GO:0070646	GO:BP	protein modification by small protein removal	16175	16230		0.4838709677419355	0.5	109	16066	9	22	100	16044	16175	0.15189162490845612
M1	string	0	network_modules	115	TRUE	1.9816073112771155e-9	144	32	10	0.3125	0.06944444444444445	REAC:R-HSA-8856828	REAC	Clathrin-mediated endocytosis	10916	372		0.36363636363636365	0.391304347826087	144	10772	10	22	134	10750	10916	0.1422439064459848
M1	string	0	network_modules	115	TRUE	3.6858300067802596e-9	210	17	9	0.5294117647058824	0.04285714285714286	KEGG:05170	KEGG	Human immunodeficiency virus 1 infection	8484	451		0.25	0.4	210	8274	9	8	201	8266	8484	0.14554296123695976
M1	string	0	network_modules	115	TRUE	7.650320463162727e-8	61	17	6	0.35294117647058826	0.09836065573770492	KEGG:03420	KEGG	Nucleotide excision repair	8484	238		0.5	0.6	61	8423	6	11	55	8412	8484	0.18336890155308952
M1	string	0	network_modules	115	TRUE	1.9414613054750719e-7	308	32	11	0.34375	0.03571428571428571	REAC:R-HSA-983168	REAC	Antigen processing: Ubiquitination & Proteasome degradation	10916	154		0.4090909090909091	0.43478260869565216	308	10608	11	21	297	10587	10916	0.10332348288711757
M1	string	0	network_modules	115	TRUE	1.7786971766805928e-6	380	32	11	0.34375	0.02894736842105263	REAC:R-HSA-983169	REAC	Class I MHC mediated antigen processing & presentation	10916	368		0.45454545454545453	0.4782608695652174	380	10536	11	21	369	10515	10916	0.09138752263138722
M1	string	0	network_modules	115	TRUE	4.509569602041783e-6	300	31	9	0.2903225806451613	0.03	GO:0009314	GO:BP	response to radiation	16175	3460		0.5161290322580645	0.53125	300	15875	9	22	291	15853	16175	0.08826982691458635
M1	string	0	network_modules	115	TRUE	5.425151346922253e-6	129	31	7	0.22580645161290322	0.05426356589147287	GO:0009411	GO:BP	response to UV	16175	3476		0.5483870967741935	0.5625	129	16046	7	24	122	16022	16175	0.10731522959666037
M1	string	0	network_modules	115	TRUE	7.134983701051816e-6	30	32	5	0.15625	0.16666666666666666	REAC:R-HSA-110314	REAC	Recognition of DNA damage by PCNA-containing replication complex	10916	1948		0.5	0.5217391304347826	30	10886	5	27	25	10859	10916	0.1589874199203857
M1	string	0	network_modules	115	TRUE	8.632731253494853e-6	220	31	8	0.25806451612903225	0.03636363636363636	GO:0009416	GO:BP	response to light stimulus	16175	3480		0.5806451612903226	0.59375	220	15955	8	23	212	15932	16175	0.09248545787066695
M1	string	0	network_modules	115	TRUE	1.0015506927166473e-5	68	17	5	0.29411764705882354	0.07352941176470588	KEGG:05211	KEGG	Renal cell carcinoma	8484	462		0.75	0.8	68	8416	5	12	63	8404	8484	0.14377214905303204
M1	string	0	network_modules	115	TRUE	2.3411454621283192e-5	43	31	5	0.16129032258064516	0.11627906976744186	GO:0031146	GO:BP	SCF-dependent proteasomal ubiquitin-dependent protein catabolic process	16175	7064		0.6129032258064516	0.625	43	16132	5	26	38	16106	16175	0.13499937281682792
M1	string	0	network_modules	115	TRUE	3.6677966321561934e-5	41	32	5	0.15625	0.12195121951219512	REAC:R-HSA-5696400	REAC	Dual Incision in GG-NER	10916	807		0.5454545454545454	0.5652173913043478	41	10875	5	27	36	10848	10916	0.13517319348661117
M1	string	0	network_modules	115	TRUE	4.691842637140233e-5	43	32	5	0.15625	0.11627906976744186	REAC:R-HSA-5696395	REAC	Formation of Incision Complex in GG-NER	10916	948		0.5909090909090909	0.6086956521739131	43	10873	5	27	38	10846	10916	0.1318457415720561
M1	string	0	network_modules	115	TRUE	5.914471109243797e-5	182	31	7	0.22580645161290322	0.038461538461538464	GO:0045732	GO:BP	positive regulation of protein catabolic process	16175	11573		0.6451612903225806	0.65625	182	15993	7	24	175	15969	16175	0.08913670306682353
M1	string	0	network_modules	115	TRUE	8.260255520759601e-5	48	32	5	0.15625	0.10416666666666667	REAC:R-HSA-73893	REAC	DNA Damage Bypass	10916	438		0.6363636363636364	0.6521739130434783	48	10868	5	27	43	10841	10916	0.12444331657822158
M1	string	0	network_modules	115	TRUE	1.0691814787517739e-4	109	17	5	0.29411764705882354	0.045871559633027525	KEGG:04066	KEGG	HIF-1 signaling pathway	8484	257		1	1	109	8375	5	12	104	8363	8484	0.11191234465571287
M1	string	0	network_modules	115	TRUE	1.7496763552749957e-4	23	32	4	0.125	0.17391304347826086	REAC:R-HSA-9013422	REAC	RHOBTB1 GTPase cycle	10916	1862		0.6818181818181818	0.6956521739130435	23	10893	4	28	19	10865	10916	0.14532279088828948
M1	string	0	network_modules	115	TRUE	3.2872799154108243e-4	63	32	5	0.15625	0.07936507936507936	REAC:R-HSA-6782210	REAC	Gap-filling DNA repair synthesis and ligation in TC-NER	10916	1038		0.7272727272727273	0.7391304347826086	63	10853	5	27	58	10826	10916	0.10771445159687121
M1	string	0	network_modules	115	TRUE	3.558501787559035e-4	64	32	5	0.15625	0.078125	REAC:R-HSA-6782135	REAC	Dual incision in TC-NER	10916	808		0.7727272727272727	0.782608695652174	64	10852	5	27	59	10825	10916	0.1068094799075847
M1	string	0	network_modules	115	TRUE	4.1538272190999825e-4	66	32	5	0.15625	0.07575757575757576	REAC:R-HSA-1234176	REAC	Oxygen-dependent proline hydroxylation of Hypoxia-inducible Factor Alpha	10916	1655		0.8181818181818182	0.8260869565217391	66	10850	5	27	61	10823	10916	0.10506024694827588
M1	string	0	network_modules	115	TRUE	4.806590274462611e-4	370	31	8	0.25806451612903225	0.021621621621621623	GO:0044772	GO:BP	mitotic cell cycle phase transition	16175	11148		0.6774193548387096	0.6875	370	15805	8	23	362	15782	16175	0.06893499763961725
M1	string	0	network_modules	115	TRUE	4.882926207473156e-4	248	31	7	0.22580645161290322	0.028225806451612902	GO:0000209	GO:BP	protein polyubiquitination	16175	59		0.7096774193548387	0.71875	248	15927	7	24	241	15903	16175	0.07506292659703706
M1	string	0	network_modules	115	TRUE	5.903611915039014e-4	701	31	10	0.3225806451612903	0.014265335235378032	GO:0009628	GO:BP	response to abiotic stimulus	16175	3549		0.7419354838709677	0.75	701	15474	10	21	691	15453	16175	0.06009526367549938
M1	string	0	network_modules	115	TRUE	5.921665725084866e-4	81	31	5	0.16129032258064516	0.06172839506172839	GO:0034644	GO:BP	cellular response to UV	16175	8706		0.7741935483870968	0.78125	81	16094	5	26	76	16068	16175	0.09701874817303187
M1	string	0	network_modules	115	TRUE	7.874219111659035e-4	75	32	5	0.15625	0.06666666666666667	REAC:R-HSA-1234174	REAC	Cellular response to hypoxia	10916	335		0.8636363636363636	0.8695652173913043	75	10841	5	27	70	10814	10916	0.09805494832403053
M1	string	0	network_modules	115	TRUE	0.0010093976436382228	35	32	4	0.125	0.11428571428571428	REAC:R-HSA-9706574	REAC	RHOBTB GTPase Cycle	10916	1861		0.9090909090909091	0.9130434782608695	35	10881	4	28	31	10853	10916	0.1168155443109671
M1	string	0	network_modules	115	TRUE	0.0012555209874463358	11	32	3	0.09375	0.2727272727272727	REAC:R-HSA-9708530	REAC	Regulation of BACH1 activity	10916	1965		0.9545454545454546	0.9565217391304348	11	10905	3	29	8	10876	10916	0.15849404779724957
M1	string	0	network_modules	115	TRUE	0.0017718422962343073	187	31	6	0.1935483870967742	0.03208556149732621	GO:0000082	GO:BP	G1/S transition of mitotic cell cycle	16175	31		0.8064516129032258	0.8125	187	15988	6	25	181	15963	16175	0.07460069210522469
M1	string	0	network_modules	115	TRUE	0.0019250443315875537	12	31	3	0.0967741935483871	0.25	GO:0140627	GO:BP	ubiquitin-dependent protein catabolic process via the C-end degron rule pathway	16175	19838		0.8387096774193549	0.875	12	16163	3	28	9	16135	16175	0.15455580397878332
M1	string	0	network_modules	115	TRUE	0.0019250443315875537	12	31	3	0.0967741935483871	0.25	GO:0070914	GO:BP	UV-damage excision repair	16175	16369		0.8387096774193549	0.875	12	16163	3	28	9	16135	16175	0.15455580397878332
M1	string	0	network_modules	115	TRUE	0.002137263110161525	309	31	7	0.22580645161290322	0.022653721682847898	GO:0042176	GO:BP	regulation of protein catabolic process	16175	10004		0.9032258064516129	0.90625	309	15866	7	24	302	15842	16175	0.0661687849807354
M1	string	0	network_modules	115	TRUE	0.002160952447153148	105	31	5	0.16129032258064516	0.047619047619047616	GO:0071482	GO:BP	cellular response to light stimulus	16175	16715		0.9354838709677419	0.9375	105	16070	5	26	100	16044	16175	0.08446652532890556
M1	string	0	network_modules	115	TRUE	0.0026890279745527355	465	31	8	0.25806451612903225	0.017204301075268817	GO:0044770	GO:BP	cell cycle phase transition	16175	11146		0.967741935483871	0.96875	465	15710	8	23	457	15687	16175	0.060136784010447183
M1	string	0	network_modules	115	TRUE	0.0038788949535713013	214	31	6	0.1935483870967742	0.028037383177570093	GO:0044843	GO:BP	cell cycle G1/S phase transition	16175	11189		1	1	214	15961	6	25	208	15936	16175	0.0691547368576772
M1	string	0	network_modules	115	TRUE	0.005440186182088337	53	32	4	0.125	0.07547169811320754	REAC:R-HSA-180585	REAC	Vif-mediated degradation of APOBEC3G	10916	2646		1	1	53	10863	4	28	49	10835	10916	0.09372084443082877
M1	string	0	network_modules	116	TRUE	1.3469458402566031e-26	140	26	18	0.6923076923076923	0.12857142857142856	REAC:R-HSA-1474228	REAC	Degradation of the extracellular matrix	10916	726		0	0.1111111111111111	140	10776	18	8	122	10768	10916	0.2950677303772727
M1	string	0	network_modules	116	TRUE	1.83087111518505e-24	298	26	20	0.7692307692307693	0.06711409395973154	REAC:R-HSA-1474244	REAC	Extracellular matrix organization	10916	889		0.125	0.2222222222222222	298	10618	20	6	278	10612	10916	0.22246951891025085
M1	string	0	network_modules	116	TRUE	1.8508980438725e-22	33	26	12	0.46153846153846156	0.36363636363636365	REAC:R-HSA-1592389	REAC	Activation of Matrix Metalloproteinases	10916	86		0.25	0.3333333333333333	33	10883	12	14	21	10869	10916	0.40809275131281086
M1	string	0	network_modules	116	TRUE	3.1769271865336814e-19	37	32	11	0.34375	0.2972972972972973	GO:0030574	GO:BP	collagen catabolic process	16175	6846		0	0.03125	37	16138	11	21	26	16117	16175	0.31823246128800675
M1	string	0	network_modules	116	TRUE	1.816681777545075e-18	236	32	16	0.5	0.06779661016949153	GO:0030198	GO:BP	extracellular matrix organization	16175	6707		0.03225806451612903	0.0625	236	15939	16	16	220	15923	16175	0.18023908085619353
M1	string	0	network_modules	116	TRUE	1.9463683932755334e-18	237	32	16	0.5	0.06751054852320675	GO:0043062	GO:BP	extracellular structure organization	16175	10509		0.06451612903225806	0.09375	237	15938	16	16	221	15922	16175	0.17984116178221507
M1	string	0	network_modules	116	TRUE	2.0846786303743025e-18	238	32	16	0.5	0.06722689075630252	GO:0045229	GO:BP	external encapsulating structure organization	16175	11340		0.0967741935483871	0.125	238	15937	16	16	222	15921	16175	0.17944571602772627
M1	string	0	network_modules	116	TRUE	1.0129745769610471e-16	59	32	11	0.34375	0.1864406779661017	GO:0022617	GO:BP	extracellular matrix disassembly	16175	6624		0.12903225806451613	0.15625	59	16116	11	21	48	16095	16175	0.25117835452606613
M1	string	0	network_modules	116	TRUE	9.135784077038168e-16	71	32	11	0.34375	0.15492957746478872	GO:0032963	GO:BP	collagen metabolic process	16175	7947		0.16129032258064516	0.1875	71	16104	11	21	60	16083	16175	0.22855588261278337
M1	string	0	network_modules	116	TRUE	3.734717099094412e-14	64	26	10	0.38461538461538464	0.15625	REAC:R-HSA-1442490	REAC	Collagen degradation	10916	386		0.375	0.4444444444444444	64	10852	10	16	54	10836	10916	0.24240792316709947
M1	string	0	network_modules	116	TRUE	1.4714334170874257e-8	11	32	5	0.15625	0.45454545454545453	GO:0071492	GO:BP	cellular response to UV-A	16175	16725		0.1935483870967742	0.21875	11	16164	5	27	6	16137	16175	0.26569419800518035
M1	string	0	network_modules	116	TRUE	6.349629214557654e-8	14	32	5	0.15625	0.35714285714285715	GO:0070141	GO:BP	response to UV-A	16175	15936		0.22580645161290322	0.25	14	16161	5	27	9	16134	16175	0.23525378737750455
M1	string	0	network_modules	116	TRUE	1.0713694789505297e-7	374	32	11	0.34375	0.029411764705882353	GO:0022411	GO:BP	cellular component disassembly	16175	6602		0.25806451612903225	0.28125	374	15801	11	21	363	15780	16175	0.09498398261749717
M1	string	0	network_modules	116	TRUE	2.6768120788367354e-7	42	32	6	0.1875	0.14285714285714285	GO:0010466	GO:BP	negative regulation of peptidase activity	16175	4159		0.2903225806451613	0.3125	42	16133	6	26	36	16107	16175	0.16176696620804754
M1	string	0	network_modules	116	TRUE	6.464992431026859e-7	7	32	4	0.125	0.5714285714285714	GO:0051045	GO:BP	negative regulation of membrane protein ectodomain proteolysis	16175	13455		0.3225806451612903	0.34375	7	16168	4	28	3	16140	16175	0.2666575004111757
M1	string	0	network_modules	116	TRUE	4.420177718311843e-6	30	32	5	0.15625	0.16666666666666666	GO:0010951	GO:BP	negative regulation of endopeptidase activity	16175	4529		0.3548387096774194	0.375	30	16145	5	27	25	16118	16175	0.15976496154708683
M1	string	0	network_modules	116	TRUE	7.709388751036382e-6	130	32	7	0.21875	0.05384615384615385	GO:0045861	GO:BP	negative regulation of proteolysis	16175	11673		0.3870967741935484	0.40625	130	16045	7	25	123	16020	16175	0.10506952146558744
M1	string	0	network_modules	116	TRUE	2.932155071479204e-5	43	32	5	0.15625	0.11627906976744186	GO:0035987	GO:BP	endodermal cell differentiation	16175	9378		0.41935483870967744	0.4375	43	16132	5	27	38	16105	16175	0.1328055481764893
M1	string	0	network_modules	116	TRUE	3.178732197519353e-5	91	32	6	0.1875	0.06593406593406594	GO:0051346	GO:BP	negative regulation of hydrolase activity	16175	13673		0.45161290322580644	0.46875	91	16084	6	26	85	16058	16175	0.10826301720957389
M1	string	0	network_modules	116	TRUE	3.355825478272021e-5	92	16	5	0.3125	0.05434782608695652	KEGG:04657	KEGG	IL-17 signaling pathway	8484	335		0	0.25	92	8392	5	11	87	8381	8484	0.12660639048641975
M1	string	0	network_modules	116	TRUE	6.391288562918268e-5	50	32	5	0.15625	0.1	GO:0001706	GO:BP	endoderm formation	16175	398		0.4838709677419355	0.5	50	16125	5	27	45	16098	16175	0.1228384348799034
M1	string	0	network_modules	116	TRUE	6.70649301952362e-5	103	32	6	0.1875	0.05825242718446602	GO:0052547	GO:BP	regulation of peptidase activity	16175	14133		0.5161290322580645	0.53125	103	16072	6	26	97	16046	16175	0.10138392933037542
M1	string	0	network_modules	116	TRUE	1.0315796272895862e-4	5	32	3	0.09375	0.6	GO:1905049	GO:BP	negative regulation of metallopeptidase activity	16175	24324		0.5483870967741935	0.5625	5	16170	3	29	2	16141	16175	0.23665956801569427
M1	string	0	network_modules	116	TRUE	1.250791519654451e-4	57	32	5	0.15625	0.08771929824561403	GO:0007492	GO:BP	endoderm development	16175	2978		0.5806451612903226	0.59375	57	16118	5	27	52	16091	16175	0.11474856207473226
M1	string	0	network_modules	116	TRUE	2.2790576362250752e-4	25	32	4	0.125	0.16	GO:0051043	GO:BP	regulation of membrane protein ectodomain proteolysis	16175	13453		0.6129032258064516	0.625	25	16150	4	28	21	16122	16175	0.13991925302498212
M1	string	0	network_modules	116	TRUE	2.4508636177531266e-4	140	26	6	0.23076923076923078	0.04285714285714286	REAC:R-HSA-3781865	REAC	Diseases of glycosylation	10916	765		0.5	0.5555555555555556	140	10776	6	20	134	10756	10916	0.09464298063872364
M1	string	0	network_modules	116	TRUE	5.739921031399737e-4	77	32	5	0.15625	0.06493506493506493	GO:0052548	GO:BP	regulation of endopeptidase activity	16175	14134		0.6451612903225806	0.65625	77	16098	5	27	72	16071	16175	0.0979892775930501
M1	string	0	network_modules	116	TRUE	6.954820208915196e-4	80	32	5	0.15625	0.0625	GO:0001704	GO:BP	formation of primary germ layer	16175	396		0.6774193548387096	0.6875	80	16095	5	27	75	16068	16175	0.09602567213710904
M1	string	0	network_modules	116	TRUE	7.402050384186505e-4	81	32	5	0.15625	0.06172839506172839	GO:0034644	GO:BP	cellular response to UV	16175	8706		0.7096774193548387	0.71875	81	16094	5	27	76	16067	16175	0.09539505002285187
M1	string	0	network_modules	116	TRUE	0.001585798669984273	283	32	7	0.21875	0.024734982332155476	GO:0001501	GO:BP	skeletal system development	16175	318		0.7419354838709677	0.75	283	15892	7	25	276	15867	16175	0.06834218922270843
M1	string	0	network_modules	116	TRUE	0.001688419813370325	11	32	3	0.09375	0.2727272727272727	GO:1905048	GO:BP	regulation of metallopeptidase activity	16175	24323		0.7741935483870968	0.78125	11	16164	3	29	8	16135	16175	0.15895193423622508
M1	string	0	network_modules	116	TRUE	0.0017844953667270136	41	32	4	0.125	0.0975609756097561	GO:1904645	GO:BP	response to amyloid-beta	16175	23985		0.8064516129032258	0.8125	41	16134	4	28	37	16106	16175	0.10843687218387127
M1	string	0	network_modules	116	TRUE	0.0018123076261785409	111	26	5	0.19230769230769232	0.04504504504504504	REAC:R-HSA-6785807	REAC	Interleukin-4 and Interleukin-13 signaling	10916	1252		0.625	0.6666666666666666	111	10805	5	21	106	10784	10916	0.08870858455026072
M1	string	0	network_modules	116	TRUE	0.0022588228160006028	105	16	4	0.25	0.0380952380952381	KEGG:04928	KEGG	Parathyroid hormone synthesis, secretion and action	8484	385		0.3333333333333333	0.5	105	8379	4	12	101	8367	8484	0.09342634303223506
M1	string	0	network_modules	116	TRUE	0.002382166529198762	44	32	4	0.125	0.09090909090909091	GO:0006509	GO:BP	membrane protein ectodomain proteolysis	16175	2234		0.8387096774193549	0.84375	44	16131	4	28	40	16103	16175	0.10452609431994424
M1	string	0	network_modules	116	TRUE	0.0026978434822544453	105	32	5	0.15625	0.047619047619047616	GO:0071482	GO:BP	cellular response to light stimulus	16175	16715		0.8709677419354839	0.875	105	16070	5	27	100	16043	16175	0.08302637007296873
M1	string	0	network_modules	116	TRUE	0.0035278942093314837	41	16	3	0.1875	0.07317073170731707	KEGG:05219	KEGG	Bladder cancer	8484	470		0.6666666666666666	0.75	41	8443	3	13	38	8430	8484	0.11449615136192523
M1	string	0	network_modules	116	TRUE	0.0037050243361023607	60	26	4	0.15384615384615385	0.06666666666666667	REAC:R-HSA-2022090	REAC	Assembly of collagen fibrils and other multimeric structures	10916	177		0.75	0.7777777777777778	60	10856	4	22	56	10834	10916	0.09804200871441116
M1	string	0	network_modules	116	TRUE	0.004228656647006275	115	32	5	0.15625	0.043478260869565216	GO:0007369	GO:BP	gastrulation	16175	2871		0.9032258064516129	0.90625	115	16060	5	27	110	16033	16175	0.07903152611806928
M1	string	0	network_modules	116	TRUE	0.0050620109123938216	129	16	4	0.25	0.031007751937984496	KEGG:04926	KEGG	Relaxin signaling pathway	8484	383		1	1	129	8355	4	12	125	8343	8484	0.08340475644254185
M1	string	0	network_modules	116	TRUE	0.0062457205292647125	245	26	6	0.23076923076923078	0.024489795918367346	REAC:R-HSA-5668914	REAC	Diseases of metabolism	10916	767		0.875	0.8888888888888888	245	10671	6	20	239	10651	10916	0.06872144504022754
M1	string	0	network_modules	116	TRUE	0.007436798583425856	129	32	5	0.15625	0.03875968992248062	GO:0009411	GO:BP	response to UV	16175	3476		0.9354838709677419	0.9375	129	16046	5	27	124	16019	16175	0.07421916200682648
M1	string	0	network_modules	116	TRUE	0.007822285512758627	59	32	4	0.125	0.06779661016949153	GO:0033619	GO:BP	membrane protein proteolysis	16175	8321		0.967741935483871	0.96875	59	16116	4	28	55	16088	16175	0.08962328831149852
M1	string	0	network_modules	116	TRUE	0.009499312222751357	76	26	4	0.15384615384615385	0.05263157894736842	REAC:R-HSA-3000178	REAC	ECM proteoglycans	10916	812		1	1	76	10840	4	22	72	10818	10916	0.08631554341405889
M1	string	0	network_modules	116	TRUE	0.009809493645624893	19	32	3	0.09375	0.15789473684210525	GO:0002052	GO:BP	positive regulation of neuroblast proliferation	16175	651		1	1	19	16156	3	29	16	16127	16175	0.12033134874051403
M1	string	0	network_modules	117	TRUE	2.3532119737531315e-7	193	13	7	0.5384615384615384	0.03626943005181347	KEGG:04814	KEGG	Motor proteins	8484	366		0	0.16666666666666666	193	8291	7	6	186	8285	8484	0.13549735678064906
M1	string	0	network_modules	117	TRUE	4.649883605893815e-5	5	25	3	0.12	0.6	GO:0008655	GO:BP	pyrimidine-containing compound salvage	16175	3226		0	0.1111111111111111	5	16170	3	22	2	16148	16175	0.26788542285229483
M1	string	0	network_modules	117	TRUE	4.727727532629818e-5	249	13	6	0.46153846153846156	0.024096385542168676	KEGG:05132	KEGG	Salmonella infection	8484	429		0.2	0.3333333333333333	249	8235	6	7	243	8228	8484	0.10031071532905488
M1	string	0	network_modules	117	TRUE	1.901628062032523e-4	11	18	3	0.16666666666666666	0.2727272727272727	REAC:R-HSA-73614	REAC	Pyrimidine salvage	10916	1829		0	0.16666666666666666	11	10905	3	15	8	10890	10916	0.21219354140982122
M1	string	0	network_modules	117	TRUE	3.936743651875599e-4	123	18	5	0.2777777777777778	0.04065040650406504	REAC:R-HSA-2132295	REAC	MHC class II antigen presentation	10916	1371		0.2	0.3333333333333333	123	10793	5	13	118	10780	10916	0.10261624126239476
M1	string	0	network_modules	117	TRUE	4.4474354491634755e-4	53	18	4	0.2222222222222222	0.07547169811320754	REAC:R-HSA-6811436	REAC	COPI-independent Golgi-to-ER retrograde traffic	10916	278		0.4	0.5	53	10863	4	14	49	10849	10916	0.1270887454259628
M1	string	0	network_modules	117	TRUE	5.974790164732384e-4	57	18	4	0.2222222222222222	0.07017543859649122	REAC:R-HSA-3371497	REAC	HSP90 chaperone cycle for steroid hormone receptors (SHR) in the presence of ligand	10916	1111		0.6	0.6666666666666666	57	10859	4	14	53	10845	10916	0.1223643271639881
M1	string	0	network_modules	117	TRUE	0.0019533411790221347	44	13	3	0.23076923076923078	0.06818181818181818	KEGG:04962	KEGG	Vasopressin-regulated water reabsorption	8484	398		0.4	0.5	44	8440	3	10	41	8430	8484	0.123030785679778
M1	string	0	network_modules	117	TRUE	0.0020159726818593984	23	18	3	0.16666666666666666	0.13043478260869565	REAC:R-HSA-8956321	REAC	Nucleotide salvage	10916	1626		0.8	0.8333333333333334	23	10893	3	15	20	10878	10916	0.1458519063163776
M1	string	0	network_modules	117	TRUE	0.0031234301241226206	17	25	3	0.12	0.17647058823529413	GO:0051014	GO:BP	actin filament severing	16175	13440		0.125	0.2222222222222222	17	16158	3	22	14	16136	16175	0.14443436822943198
M1	string	0	network_modules	117	TRUE	0.003208029768024045	305	13	5	0.38461538461538464	0.01639344262295082	KEGG:05016	KEGG	Huntington disease	8484	414		0.6	0.6666666666666666	305	8179	5	8	300	8171	8484	0.07336919852001018
M1	string	0	network_modules	117	TRUE	0.003276358997535711	2	25	2	0.08	1	GO:0010138	GO:BP	pyrimidine ribonucleotide salvage	16175	3943		0.25	0.6666666666666666	2	16173	2	23	0	16150	16175	0.282641522315189
M1	string	0	network_modules	117	TRUE	0.003276358997535711	2	25	2	0.08	1	GO:0032262	GO:BP	pyrimidine nucleotide salvage	16175	7448		0.25	0.6666666666666666	2	16173	2	23	0	16150	16175	0.282641522315189
M1	string	0	network_modules	117	TRUE	0.003276358997535711	2	25	2	0.08	1	GO:0044206	GO:BP	UMP salvage	16175	10931		0.25	0.6666666666666666	2	16173	2	23	0	16150	16175	0.282641522315189
M1	string	0	network_modules	117	TRUE	0.003276358997535711	2	25	2	0.08	1	GO:0044211	GO:BP	CTP salvage	16175	10935		0.25	0.6666666666666666	2	16173	2	23	0	16150	16175	0.282641522315189
M1	string	0	network_modules	117	TRUE	0.004266090814270048	57	13	3	0.23076923076923078	0.05263157894736842	KEGG:00240	KEGG	Pyrimidine metabolism	8484	24		0.8	0.8333333333333334	57	8427	3	10	54	8417	8484	0.10744281513963352
M1	string	0	network_modules	117	TRUE	0.006084175383553334	21	25	3	0.12	0.14285714285714285	GO:0072528	GO:BP	pyrimidine-containing compound biosynthetic process	16175	17430		0.75	0.7777777777777778	21	16154	3	22	18	16132	16175	0.1296985984599606
M1	string	0	network_modules	117	TRUE	0.006136786649401866	102	18	4	0.2222222222222222	0.0392156862745098	REAC:R-HSA-6807878	REAC	COPI-mediated anterograde transport	10916	279		1	1	102	10814	4	14	98	10800	10916	0.08992163120158835
M1	string	0	network_modules	117	TRUE	0.007349170066817167	363	13	5	0.38461538461538464	0.013774104683195593	KEGG:05014	KEGG	Amyotrophic lateral sclerosis	8484	413		1	1	363	8121	5	8	358	8113	8484	0.06616918492436606
M1	string	0	network_modules	117	TRUE	0.00923062445209091	24	25	3	0.12	0.125	GO:0051016	GO:BP	barbed-end actin filament capping	16175	13441		0.875	1	24	16151	3	22	21	16129	16175	0.12114361369528363
M1	string	0	network_modules	117	TRUE	0.00923062445209091	24	25	3	0.12	0.125	GO:0051693	GO:BP	actin filament capping	16175	13896		0.875	1	24	16151	3	22	21	16129	16175	0.12114361369528363
M1	string	0	network_modules	118	TRUE	4.690881276835474e-15	100	22	11	0.5	0.11	REAC:R-HSA-5668541	REAC	TNFR2 non-canonical NF-kB pathway	10916	2450		0	0.3333333333333333	100	10816	11	11	89	10805	10916	0.23151920629881198
M1	string	0	network_modules	118	TRUE	8.955700015083169e-14	29	22	8	0.36363636363636365	0.27586206896551724	REAC:R-HSA-5669034	REAC	TNFs bind their physiological receptors	10916	2451		0.5	0.6666666666666666	29	10887	8	14	21	10873	10916	0.315145323303532
M1	string	0	network_modules	118	TRUE	1.5118283059017184e-11	291	16	11	0.6875	0.037800687285223365	KEGG:04060	KEGG	Cytokine-cytokine receptor interaction	8484	253		0	0.5	291	8193	11	5	280	8188	8484	0.15600859465197867
M1	string	0	network_modules	118	TRUE	7.807590763591178e-7	44	16	5	0.3125	0.11363636363636363	KEGG:04672	KEGG	Intestinal immune network for IgA production	8484	344		1	1	44	8440	5	11	39	8429	8484	0.18597504875231768
M1	string	0	network_modules	118	TRUE	7.3871615716042824e-6	16	22	4	0.18181818181818182	0.25	REAC:R-HSA-5676594	REAC	TNF receptor superfamily (TNFSF) members mediating non-canonical NF-kB pathway	10916	2445		1	1	16	10900	4	18	12	10882	10916	0.21185073361328274
M1	string	0	network_modules	118	TRUE	3.5027584102540816e-4	91	25	5	0.2	0.054945054945054944	GO:0050864	GO:BP	regulation of B cell activation	16175	13312		0	0.2	91	16084	5	20	86	16064	16175	0.10224652340061922
M1	string	0	network_modules	118	TRUE	0.0023695478935030147	57	25	4	0.16	0.07017543859649122	GO:0050871	GO:BP	positive regulation of B cell activation	16175	13319		0.25	0.4	57	16118	4	21	53	16097	16175	0.10389218557707551
M1	string	0	network_modules	118	TRUE	0.003783788757470958	64	25	4	0.16	0.0625	GO:0019731	GO:BP	antibacterial humoral response	16175	6022		0.5	0.6	64	16111	4	21	60	16090	16175	0.09779617201527248
M1	string	0	network_modules	118	TRUE	0.009819758219721055	3	25	2	0.08	0.6666666666666666	GO:1900005	GO:BP	positive regulation of serine-type endopeptidase activity	16175	20322		0.75	1	3	16172	2	23	1	16149	16175	0.23060434694047444
M1	string	0	network_modules	118	TRUE	0.009819758219721055	3	25	2	0.08	0.6666666666666666	GO:1902573	GO:BP	positive regulation of serine-type peptidase activity	16175	22363		0.75	1	3	16172	2	23	1	16149	16175	0.23060434694047444
M1	string	0	network_modules	119	TRUE	1.1955005757853723e-15	365	23	16	0.6956521739130435	0.043835616438356165	KEGG:04080	KEGG	Neuroactive ligand-receptor interaction	8484	263		NA	1	365	8119	16	7	349	8112	8484	0.167696141687492
M1	string	0	network_modules	119	TRUE	8.106471980495757e-15	460	20	15	0.75	0.03260869565217391	REAC:R-HSA-500792	REAC	GPCR ligand binding	10916	1019		0	0.1	460	10456	15	5	445	10451	10916	0.15094914576906449
M1	string	0	network_modules	119	TRUE	1.4860819712377976e-12	774	29	17	0.5862068965517241	0.021963824289405683	GO:0007186	GO:BP	G protein-coupled receptor signaling pathway	16175	2744		0	0.05555555555555555	774	15401	17	12	757	15389	16175	0.10688945067651814
M1	string	0	network_modules	119	TRUE	5.999243516028088e-9	33	20	6	0.3	0.18181818181818182	REAC:R-HSA-420092	REAC	Glucagon-type ligand receptors	10916	1050		0.1111111111111111	0.2	33	10883	6	14	27	10869	10916	0.23175888027748606
M1	string	0	network_modules	119	TRUE	5.347333998482997e-8	156	20	8	0.4	0.05128205128205128	REAC:R-HSA-418555	REAC	G alpha (s) signalling events	10916	989		0.2222222222222222	0.3	156	10760	8	12	148	10748	10916	0.13923113795931488
M1	string	0	network_modules	119	TRUE	6.199930756443241e-8	93	20	7	0.35	0.07526881720430108	REAC:R-HSA-373080	REAC	Class B/2 (Secretin family receptors)	10916	366		0.3333333333333333	0.4	93	10823	7	13	86	10810	10916	0.1591825472782875
M1	string	0	network_modules	119	TRUE	1.0378469927479262e-5	149	29	7	0.2413793103448276	0.04697986577181208	GO:0030072	GO:BP	peptide hormone secretion	16175	6672		0.058823529411764705	0.1111111111111111	149	16026	7	22	142	16004	16175	0.10299275017089032
M1	string	0	network_modules	119	TRUE	1.0873479291355965e-5	150	29	7	0.2413793103448276	0.04666666666666667	GO:0002790	GO:BP	peptide secretion	16175	1301		0.11764705882352941	0.16666666666666666	150	16025	7	22	143	16003	16175	0.10262473445313441
M1	string	0	network_modules	119	TRUE	1.3548206154705438e-5	361	29	9	0.3103448275862069	0.024930747922437674	GO:0010817	GO:BP	regulation of hormone levels	16175	4429		0.17647058823529413	0.2222222222222222	361	15814	9	20	352	15794	16175	0.08263588737624
M1	string	0	network_modules	119	TRUE	1.8954283686233747e-5	328	20	8	0.4	0.024390243902439025	REAC:R-HSA-373076	REAC	Class A/1 (Rhodopsin-like receptors)	10916	365		0.4444444444444444	0.5	328	10588	8	12	320	10576	10916	0.09284251480966295
M1	string	0	network_modules	119	TRUE	2.0604018190640832e-5	213	20	7	0.35	0.03286384976525822	REAC:R-HSA-416476	REAC	G alpha (q) signalling events	10916	988		0.5555555555555556	0.6	213	10703	7	13	206	10690	10916	0.10236636087029934
M1	string	0	network_modules	119	TRUE	2.489319556933972e-5	169	29	7	0.2413793103448276	0.04142011834319527	GO:0015833	GO:BP	peptide transport	16175	4943		0.23529411764705882	0.2777777777777778	169	16006	7	22	162	15984	16175	0.09625171066689923
M1	string	0	network_modules	119	TRUE	2.873230042985767e-5	24	20	4	0.2	0.16666666666666666	REAC:R-HSA-400508	REAC	Incretin synthesis, secretion, and inactivation	10916	1180		0.6666666666666666	0.7	24	10892	4	16	20	10876	10916	0.18093179213255337
M1	string	0	network_modules	119	TRUE	4.314966761088564e-5	183	29	7	0.2413793103448276	0.03825136612021858	GO:0046879	GO:BP	hormone secretion	16175	12414		0.29411764705882354	0.3333333333333333	183	15992	7	22	176	15970	16175	0.0921903533791347
M1	string	0	network_modules	119	TRUE	6.0066666286056835e-5	192	29	7	0.2413793103448276	0.036458333333333336	GO:0009914	GO:BP	hormone transport	16175	3770		0.35294117647058826	0.3888888888888889	192	15983	7	22	185	15961	16175	0.08981131108779052
M1	string	0	network_modules	119	TRUE	8.514912458331844e-5	202	29	7	0.2413793103448276	0.034653465346534656	GO:0042886	GO:BP	amide transport	16175	10431		0.4117647058823529	0.4444444444444444	202	15973	7	22	195	15951	16175	0.08735150960518069
M1	string	0	network_modules	119	TRUE	1.3909419928322033e-4	217	29	7	0.2413793103448276	0.03225806451612903	GO:0007188	GO:BP	adenylate cyclase-modulating G protein-coupled receptor signaling pathway	16175	2746		0.47058823529411764	0.5	217	15958	7	22	210	15936	16175	0.08397637419573153
M1	string	0	network_modules	119	TRUE	2.1566467357206096e-4	69	29	5	0.1724137931034483	0.07246376811594203	GO:0007218	GO:BP	neuropeptide signaling pathway	16175	2772		0.5294117647058824	0.5555555555555556	69	16106	5	24	64	16082	16175	0.10934124140342835
M1	string	0	network_modules	119	TRUE	4.6520466850329475e-4	8	29	3	0.10344827586206896	0.375	GO:0007217	GO:BP	tachykinin receptor signaling pathway	16175	2771		0.5882352941176471	0.6111111111111112	8	16167	3	26	5	16141	16175	0.196242469013387
M1	string	0	network_modules	119	TRUE	0.0015894894904353344	311	29	7	0.2413793103448276	0.022508038585209004	GO:0023061	GO:BP	signal release	16175	6645		0.6470588235294118	0.6666666666666666	311	15864	7	22	304	15842	16175	0.06856061544874285
M1	string	0	network_modules	119	TRUE	0.002314230743942589	21	20	3	0.15	0.14285714285714285	REAC:R-HSA-381771	REAC	Synthesis, secretion, and inactivation of Glucagon-like Peptide-1 (GLP-1)	10916	2415		0.7777777777777778	0.8	21	10895	3	17	18	10878	10916	0.14477948506952504
M1	string	0	network_modules	119	TRUE	0.004540214217589968	127	29	5	0.1724137931034483	0.03937007874015748	GO:0090276	GO:BP	regulation of peptide hormone secretion	16175	18165		0.7058823529411765	0.7222222222222222	127	16048	5	24	122	16024	16175	0.07901844920016672
M1	string	0	network_modules	119	TRUE	0.004718919902853241	128	29	5	0.1724137931034483	0.0390625	GO:0002791	GO:BP	regulation of peptide secretion	16175	1302		0.7647058823529411	0.7777777777777778	128	16047	5	24	123	16023	16175	0.07868205966823291
M1	string	0	network_modules	119	TRUE	0.0050061356295680115	2	29	2	0.06896551724137931	1	GO:0038192	GO:BP	gastric inhibitory peptide signaling pathway	16175	9761		0.8235294117647058	0.8333333333333334	2	16173	2	27	0	16146	16175	0.26239356474948966
M1	string	0	network_modules	119	TRUE	0.005092918790165008	130	29	5	0.1724137931034483	0.038461538461538464	GO:0090087	GO:BP	regulation of peptide transport	16175	18008		0.8823529411764706	0.8888888888888888	130	16045	5	24	125	16021	16175	0.07802064415332553
M1	string	0	network_modules	119	TRUE	0.005848445437810162	88	20	4	0.2	0.045454545454545456	REAC:R-HSA-2980736	REAC	Peptide hormone metabolism	10916	1725		0.8888888888888888	0.9	88	10828	4	16	84	10812	10916	0.09195841483079846
M1	string	0	network_modules	119	TRUE	0.007277277981161174	195	20	5	0.25	0.02564102564102564	REAC:R-HSA-375276	REAC	Peptide ligand-binding receptors	10916	1726		1	1	195	10721	5	15	190	10706	10916	0.07508498656754495
M1	string	0	network_modules	119	TRUE	0.0073273045214080875	140	29	5	0.1724137931034483	0.03571428571428571	GO:0007189	GO:BP	adenylate cyclase-activating G protein-coupled receptor signaling pathway	16175	2747		0.9411764705882353	0.9444444444444444	140	16035	5	24	135	16011	16175	0.07492315581913403
M1	string	0	network_modules	119	TRUE	0.00818042290488247	255	29	6	0.20689655172413793	0.023529411764705882	GO:0007610	GO:BP	behavior	16175	3067		1	1	255	15920	6	23	249	15897	16175	0.06502815315981633
M1	string	0	network_modules	120	TRUE	4.105220282655152e-7	39	15	5	0.3333333333333333	0.1282051282051282	REAC:R-HSA-6783310	REAC	Fanconi Anemia Pathway	10916	932		0	0.16666666666666666	39	10877	5	10	34	10867	10916	0.20501605782450774
M1	string	0	network_modules	120	TRUE	1.3742412742862238e-6	30	26	5	0.19230769230769232	0.16666666666666666	GO:1904357	GO:BP	negative regulation of telomere maintenance via telomere lengthening	16175	23744		0	0.058823529411764705	30	16145	5	21	25	16124	16175	0.17760952894088647
M1	string	0	network_modules	120	TRUE	4.17176470799388e-6	37	26	5	0.19230769230769232	0.13513513513513514	GO:0032205	GO:BP	negative regulation of telomere maintenance	16175	7397		0.0625	0.11764705882352941	37	16138	5	21	32	16117	16175	0.15959975704328297
M1	string	0	network_modules	120	TRUE	4.814612854185025e-6	84	26	6	0.23076923076923078	0.07142857142857142	GO:0010833	GO:BP	telomere maintenance via telomere lengthening	16175	4443		0.125	0.17647058823529413	84	16091	6	20	78	16071	16175	0.12592731321465214
M1	string	0	network_modules	120	TRUE	2.740338660244256e-5	54	11	4	0.36363636363636365	0.07407407407407407	KEGG:03460	KEGG	Fanconi anemia pathway	8484	242		NA	1	54	8430	4	7	50	8423	8484	0.16186987605064265
M1	string	0	network_modules	120	TRUE	6.540050582733513e-5	63	26	5	0.19230769230769232	0.07936507936507936	GO:1904356	GO:BP	regulation of telomere maintenance via telomere lengthening	16175	23743		0.1875	0.23529411764705882	63	16112	5	21	58	16091	16175	0.12137340386848376
M1	string	0	network_modules	120	TRUE	1.7077605021612697e-4	152	26	6	0.23076923076923078	0.039473684210526314	GO:0000723	GO:BP	telomere maintenance	16175	202		0.25	0.29411764705882354	152	16023	6	20	146	16003	16175	0.09206342964852525
M1	string	0	network_modules	120	TRUE	3.9712917596910547e-4	90	26	5	0.19230769230769232	0.05555555555555555	GO:2001251	GO:BP	negative regulation of chromosome organization	16175	26440		0.3125	0.35294117647058826	90	16085	5	21	85	16064	16175	0.10073304669319011
M1	string	0	network_modules	120	TRUE	4.6401890099829443e-4	37	26	4	0.15384615384615385	0.10810810810810811	GO:0016233	GO:BP	telomere capping	16175	5178		0.375	0.4117647058823529	37	16138	4	22	33	16116	16175	0.1272955503413058
M1	string	0	network_modules	120	TRUE	4.95595781575246e-4	182	26	6	0.23076923076923078	0.03296703296703297	GO:0032200	GO:BP	telomere organization	16175	7392		0.4375	0.47058823529411764	182	15993	6	20	176	15973	16175	0.08350764443633747
M1	string	0	network_modules	120	TRUE	5.542489865897746e-4	2	15	2	0.13333333333333333	1	REAC:R-HSA-5545619	REAC	XAV939 stabilizes AXIN	10916	2675		0.2	0.3333333333333333	2	10914	2	13	0	10901	10916	0.36493083716272035
M1	string	0	network_modules	120	TRUE	8.184538744298828e-4	104	26	5	0.19230769230769232	0.04807692307692308	GO:0032204	GO:BP	regulation of telomere maintenance	16175	7396		0.5	0.5294117647058824	104	16071	5	21	99	16050	16175	0.09331426856635397
M1	string	0	network_modules	120	TRUE	0.0016669193276441132	120	26	5	0.19230769230769232	0.041666666666666664	GO:0051053	GO:BP	negative regulation of DNA metabolic process	16175	13463		0.5625	0.5882352941176471	120	16055	5	21	115	16034	16175	0.08645160420098219
M1	string	0	network_modules	120	TRUE	0.0020217862218025844	53	26	4	0.15384615384615385	0.07547169811320754	GO:0140527	GO:BP	reciprocal homologous recombination	16175	19808		0.625	0.7058823529411765	53	16122	4	22	49	16100	16175	0.10571770801694112
M1	string	0	network_modules	120	TRUE	0.0020217862218025844	53	26	4	0.15384615384615385	0.07547169811320754	GO:0007131	GO:BP	reciprocal meiotic recombination	16175	2702		0.625	0.7058823529411765	53	16122	4	22	49	16100	16175	0.10571770801694112
M1	string	0	network_modules	120	TRUE	0.002300329022634316	15	26	3	0.11538461538461539	0.2	GO:0000712	GO:BP	resolution of meiotic recombination intermediates	16175	192		0.75	0.7647058823529411	15	16160	3	23	12	16137	16175	0.15088121656469844
M1	string	0	network_modules	120	TRUE	0.003450794777497106	2	26	2	0.07692307692307693	1	GO:1904743	GO:BP	negative regulation of telomeric DNA binding	16175	24070		0.8125	0.8235294117647058	2	16173	2	24	0	16149	16175	0.27714423421480233
M1	string	0	network_modules	120	TRUE	0.003571843023105698	61	26	4	0.15384615384615385	0.06557377049180328	GO:0035825	GO:BP	homologous recombination	16175	9273		0.875	0.8823529411764706	61	16114	4	22	57	16092	16175	0.09824254785503261
M1	string	0	network_modules	120	TRUE	0.003850748878833555	34	15	3	0.2	0.08823529411764706	REAC:R-HSA-5693568	REAC	Resolution of D-loop Structures through Holliday Junction Intermediates	10916	2077		0.4	0.5	34	10882	3	12	31	10870	10916	0.1310676377940269
M1	string	0	network_modules	120	TRUE	0.004208281195643667	35	15	3	0.2	0.08571428571428572	REAC:R-HSA-5693537	REAC	Resolution of D-Loop Structures	10916	2076		0.6	0.6666666666666666	35	10881	3	12	32	10869	10916	0.12912750052634908
M1	string	0	network_modules	120	TRUE	0.005865746549805984	69	26	4	0.15384615384615385	0.057971014492753624	GO:0032206	GO:BP	positive regulation of telomere maintenance	16175	7398		0.9375	0.9411764705882353	69	16106	4	22	65	16084	16175	0.0920903633688503
M1	string	0	network_modules	120	TRUE	0.007908590544271926	132	15	4	0.26666666666666666	0.030303030303030304	REAC:R-HSA-5693567	REAC	HDR through Homologous Recombination (HRR) or Single Strand Annealing (SSA)	10916	1098		0.8	0.8333333333333334	132	10784	4	11	128	10773	10916	0.08639998810271489
M1	string	0	network_modules	120	TRUE	0.008716206850131171	298	26	6	0.23076923076923078	0.020134228187919462	GO:0006302	GO:BP	double-strand break repair	16175	2109		1	1	298	15877	6	20	292	15857	16175	0.06335914962514382
M1	string	0	network_modules	120	TRUE	0.009420615141387239	138	15	4	0.26666666666666666	0.028985507246376812	REAC:R-HSA-5693538	REAC	Homology Directed Repair	10916	1130		1	1	138	10778	4	11	134	10767	10916	0.08434187572567262
M1	string	0	network_modules	121	TRUE	1.4226851933013638e-4	44	19	4	0.21052631578947367	0.09090909090909091	KEGG:00970	KEGG	Aminoacyl-tRNA biosynthesis	8484	153		0	0.3333333333333333	44	8440	4	15	40	8425	8484	0.13543788104442692
M1	string	0	network_modules	121	TRUE	9.987491174849013e-4	38	30	4	0.13333333333333333	0.10526315789473684	GO:0006418	GO:BP	tRNA aminoacylation for protein translation	16175	2175		0	0.16666666666666666	38	16137	4	26	34	16111	16175	0.11662751944258445
M1	string	0	network_modules	121	TRUE	0.0013649471227356635	41	30	4	0.13333333333333333	0.0975609756097561	GO:0043038	GO:BP	amino acid activation	16175	10488		0.2	0.5	41	16134	4	26	37	16108	16175	0.11213105069464156
M1	string	0	network_modules	121	TRUE	0.0013649471227356635	41	30	4	0.13333333333333333	0.0975609756097561	GO:0043039	GO:BP	tRNA aminoacylation	16175	10489		0.2	0.5	41	16134	4	26	37	16108	16175	0.11213105069464156
M1	string	0	network_modules	121	TRUE	0.001383080098492013	11	30	3	0.1	0.2727272727272727	GO:0006614	GO:BP	SRP-dependent cotranslational protein targeting to membrane	16175	2329		0.6	0.6666666666666666	11	16164	3	27	8	16137	16175	0.16422965067086123
M1	string	0	network_modules	121	TRUE	0.0015206162267034002	292	18	6	0.3333333333333333	0.02054794520547945	REAC:R-HSA-72766	REAC	Translation	10916	2565		NA	1	292	10624	6	12	286	10612	10916	0.07722178782647329
M1	string	0	network_modules	121	TRUE	0.0025399397581994465	31	19	3	0.15789473684210525	0.0967741935483871	KEGG:03060	KEGG	Protein export	8484	217		0.5	0.6666666666666666	31	8453	3	16	28	8437	8484	0.1211091530133535
M1	string	0	network_modules	121	TRUE	0.004353366884517676	37	19	3	0.15789473684210525	0.08108108108108109	KEGG:01250	KEGG	Biosynthesis of nucleotide sugars	8484	191		1	1	37	8447	3	16	34	8431	8484	0.11038632242275283
M1	string	0	network_modules	121	TRUE	0.006780253706363283	18	30	3	0.1	0.16666666666666666	GO:0006613	GO:BP	cotranslational protein targeting to membrane	16175	2328		0.8	0.8333333333333334	18	16157	3	27	15	16130	16175	0.1278525022130053
M1	string	0	network_modules	121	TRUE	0.007318324051961092	62	30	4	0.13333333333333333	0.06451612903225806	GO:0006112	GO:BP	energy reserve metabolic process	16175	1971		1	1	62	16113	4	26	58	16087	16175	0.09033841697598959
M1	string	0	network_modules	122	TRUE	7.609654139578941e-16	16	29	8	0.27586206896551724	0.5	GO:0006744	GO:BP	ubiquinone biosynthetic process	16175	2443		0	0.05405405405405406	16	16159	8	21	8	16138	16175	0.37057446311430675
M1	string	0	network_modules	122	TRUE	7.609654139578941e-16	16	29	8	0.27586206896551724	0.5	GO:1901663	GO:BP	quinone biosynthetic process	16175	21630		0	0.05405405405405406	16	16159	8	21	8	16138	16175	0.37057446311430675
M1	string	0	network_modules	122	TRUE	2.5813091340877734e-15	18	29	8	0.27586206896551724	0.4444444444444444	GO:0006743	GO:BP	ubiquinone metabolic process	16175	2442		0.05555555555555555	0.08108108108108109	18	16157	8	21	10	16136	16175	0.34924540414705024
M1	string	0	network_modules	122	TRUE	1.8776402580780433e-14	22	29	8	0.27586206896551724	0.36363636363636365	GO:1901661	GO:BP	quinone metabolic process	16175	21628		0.08333333333333333	0.10810810810810811	22	16153	8	21	14	16132	16175	0.3156590926274413
M1	string	0	network_modules	122	TRUE	6.772100287452214e-12	42	29	8	0.27586206896551724	0.19047619047619047	GO:0042181	GO:BP	ketone biosynthetic process	16175	10009		0.1111111111111111	0.13513513513513514	42	16133	8	21	34	16112	16175	0.2275691348169675
M1	string	0	network_modules	122	TRUE	1.3393600402900772e-10	18	21	6	0.2857142857142857	0.3333333333333333	REAC:R-HSA-163210	REAC	Formation of ATP by chemiosmotic coupling	10916	944		0	0.1	18	10898	6	15	12	10883	10916	0.30737471169750025
M1	string	0	network_modules	122	TRUE	2.784276460342519e-10	8	21	5	0.23809523809523808	0.625	REAC:R-HSA-2142789	REAC	Ubiquinol biosynthesis	10916	2618		0.1111111111111111	0.2	8	10908	5	16	3	10892	10916	0.3850825744424474
M1	string	0	network_modules	122	TRUE	2.01845791703092e-9	232	15	9	0.6	0.03879310344827586	KEGG:04714	KEGG	Thermogenesis	8484	349		0	0.09090909090909091	232	8252	9	6	223	8246	8484	0.14777440831254482
M1	string	0	network_modules	122	TRUE	5.231248192858434e-9	31	21	6	0.2857142857142857	0.1935483870967742	REAC:R-HSA-8949613	REAC	Cristae formation	10916	414		0.2222222222222222	0.3	31	10885	6	15	25	10870	10916	0.23337706100489872
M1	string	0	network_modules	122	TRUE	5.704084090434231e-8	19	21	5	0.23809523809523808	0.2631578947368421	REAC:R-HSA-8978934	REAC	Metabolism of cofactors	10916	1423		0.3333333333333333	0.4	19	10897	5	16	14	10881	10916	0.24893930676543213
M1	string	0	network_modules	122	TRUE	6.968935693029356e-8	127	29	8	0.27586206896551724	0.06299212598425197	GO:0006119	GO:BP	oxidative phosphorylation	16175	1977		0.1388888888888889	0.16216216216216217	127	16048	8	21	119	16027	16175	0.12869160506396207
M1	string	0	network_modules	122	TRUE	7.701556743165456e-8	134	15	7	0.4666666666666667	0.05223880597014925	KEGG:00190	KEGG	Oxidative phosphorylation	8484	18		0.1	0.18181818181818182	134	8350	7	8	127	8342	8484	0.1521906855266693
M1	string	0	network_modules	122	TRUE	1.31537390623359e-7	11	15	4	0.26666666666666666	0.36363636363636365	KEGG:00130	KEGG	Ubiquinone and other terpenoid-quinone biosynthesis	8484	16		0.2	0.2727272727272727	11	8473	4	11	7	8462	8484	0.3103610975804535
M1	string	0	network_modules	122	TRUE	2.1943501749393733e-7	177	21	8	0.38095238095238093	0.04519774011299435	REAC:R-HSA-1428517	REAC	Aerobic respiration and respiratory electron transport	10916	127		0.4444444444444444	0.5	177	10739	8	13	169	10726	10916	0.12678608707242112
M1	string	0	network_modules	122	TRUE	4.927662742049203e-7	162	29	8	0.27586206896551724	0.04938271604938271	GO:0009060	GO:BP	aerobic respiration	16175	3236		0.16666666666666666	0.1891891891891892	162	16013	8	21	154	15992	16175	0.11314831392892141
M1	string	0	network_modules	122	TRUE	6.906946147453793e-7	169	29	8	0.27586206896551724	0.047337278106508875	GO:0042180	GO:BP	ketone metabolic process	16175	10008		0.19444444444444445	0.21621621621621623	169	16006	8	21	161	15985	16175	0.11062406970125077
M1	string	0	network_modules	122	TRUE	1.3586004542315595e-6	202	15	7	0.4666666666666667	0.034653465346534656	KEGG:05415	KEGG	Diabetic cardiomyopathy	8484	492		0.3	0.36363636363636365	202	8282	7	8	195	8274	8484	0.1222504816762745
M1	string	0	network_modules	122	TRUE	1.6119014601485499e-6	188	29	8	0.27586206896551724	0.0425531914893617	GO:0045333	GO:BP	cellular respiration	16175	11360		0.2222222222222222	0.24324324324324326	188	15987	8	21	180	15966	16175	0.10448300106189601
M1	string	0	network_modules	122	TRUE	2.369612321943359e-6	65	29	6	0.20689655172413793	0.09230769230769231	GO:0042776	GO:BP	proton motive force-driven mitochondrial ATP synthesis	16175	10361		0.25	0.2702702702702703	65	16110	6	23	59	16087	16175	0.13590684490401062
M1	string	0	network_modules	122	TRUE	4.444029044310794e-6	72	29	6	0.20689655172413793	0.08333333333333333	GO:0015986	GO:BP	proton motive force-driven ATP synthesis	16175	5062		0.2777777777777778	0.2972972972972973	72	16103	6	23	66	16080	16175	0.12888391951782155
M1	string	0	network_modules	122	TRUE	4.713667695809422e-6	92	21	6	0.2857142857142857	0.06521739130434782	REAC:R-HSA-1592230	REAC	Mitochondrial biogenesis	10916	1464		0.5555555555555556	0.6	92	10824	6	15	86	10809	10916	0.1331680832713109
M1	string	0	network_modules	122	TRUE	1.0300269012537935e-5	271	15	7	0.4666666666666667	0.025830258302583026	KEGG:05020	KEGG	Prion disease	8484	416		0.4	0.45454545454545453	271	8213	7	8	264	8205	8484	0.1040419467442646
M1	string	0	network_modules	122	TRUE	1.6207224446846003e-5	252	29	8	0.27586206896551724	0.031746031746031744	GO:0015980	GO:BP	energy derivation by oxidation of organic compounds	16175	5060		0.3055555555555556	0.32432432432432434	252	15923	8	21	244	15902	16175	0.08907237185616451
M1	string	0	network_modules	122	TRUE	1.732405873326377e-5	90	29	6	0.20689655172413793	0.06666666666666667	GO:0006754	GO:BP	ATP biosynthetic process	16175	2451		0.3333333333333333	0.35135135135135137	90	16085	6	23	84	16062	16175	0.11470773861971456
M1	string	0	network_modules	122	TRUE	1.9792436596984405e-5	92	29	6	0.20689655172413793	0.06521739130434782	GO:0009206	GO:BP	purine ribonucleoside triphosphate biosynthetic process	16175	3372		0.3611111111111111	0.40540540540540543	92	16083	6	23	86	16060	16175	0.11339143680117252
M1	string	0	network_modules	122	TRUE	1.9792436596984405e-5	92	29	6	0.20689655172413793	0.06521739130434782	GO:0009145	GO:BP	purine nucleoside triphosphate biosynthetic process	16175	3312		0.3611111111111111	0.40540540540540543	92	16083	6	23	86	16060	16175	0.11339143680117252
M1	string	0	network_modules	122	TRUE	2.726120034375591e-5	97	29	6	0.20689655172413793	0.061855670103092786	GO:0009201	GO:BP	ribonucleoside triphosphate biosynthetic process	16175	3367		0.4166666666666667	0.43243243243243246	97	16078	6	23	91	16055	16175	0.11027780158157652
M1	string	0	network_modules	122	TRUE	3.915726294384877e-5	103	29	6	0.20689655172413793	0.05825242718446602	GO:0009142	GO:BP	nucleoside triphosphate biosynthetic process	16175	3309		0.4444444444444444	0.4594594594594595	103	16072	6	23	97	16049	16175	0.10683997520599435
M1	string	0	network_modules	122	TRUE	4.480240893451504e-5	184	29	7	0.2413793103448276	0.03804347826086957	GO:0046034	GO:BP	ATP metabolic process	16175	11811		0.4722222222222222	0.4864864864864865	184	15991	7	22	177	15969	16175	0.0919176625031595
M1	string	0	network_modules	122	TRUE	7.422126601712098e-5	198	29	7	0.2413793103448276	0.03535353535353535	GO:0009205	GO:BP	purine ribonucleoside triphosphate metabolic process	16175	3371		0.5	0.5135135135135135	198	15977	7	22	191	15955	16175	0.08831370275513405
M1	string	0	network_modules	122	TRUE	7.618486789821156e-5	221	15	6	0.4	0.027149321266968326	KEGG:05208	KEGG	Chemical carcinogenesis - reactive oxygen species	8484	460		0.5	0.5454545454545454	221	8263	6	9	215	8254	8484	0.09880521551138532
M1	string	0	network_modules	122	TRUE	8.22970758603205e-5	201	29	7	0.2413793103448276	0.03482587064676617	GO:0009144	GO:BP	purine nucleoside triphosphate metabolic process	16175	3311		0.5277777777777778	0.5405405405405406	201	15974	7	22	194	15952	16175	0.08758944297173735
M1	string	0	network_modules	122	TRUE	9.110497433948747e-5	204	29	7	0.2413793103448276	0.03431372549019608	GO:0009199	GO:BP	ribonucleoside triphosphate metabolic process	16175	3365		0.5555555555555556	0.5675675675675675	204	15971	7	22	197	15949	16175	0.08688074496941778
M1	string	0	network_modules	122	TRUE	1.3055803192307168e-4	215	29	7	0.2413793103448276	0.03255813953488372	GO:0009141	GO:BP	nucleoside triphosphate metabolic process	16175	3308		0.5833333333333334	0.5945945945945946	215	15960	7	22	208	15938	16175	0.08440652892812665
M1	string	0	network_modules	122	TRUE	1.4405436011360762e-4	128	29	6	0.20689655172413793	0.046875	GO:0009152	GO:BP	purine ribonucleotide biosynthetic process	16175	3319		0.6111111111111112	0.6216216216216216	128	16047	6	23	122	16024	16175	0.0951754867658531
M1	string	0	network_modules	122	TRUE	2.1589541934526028e-4	137	29	6	0.20689655172413793	0.043795620437956206	GO:0009260	GO:BP	ribonucleotide biosynthetic process	16175	3425		0.6388888888888888	0.6486486486486487	137	16038	6	23	131	16015	16175	0.0917646718178166
M1	string	0	network_modules	122	TRUE	2.198945176268193e-4	265	15	6	0.4	0.022641509433962263	KEGG:05012	KEGG	Parkinson disease	8484	412		0.6	0.6363636363636364	265	8219	6	9	259	8210	8484	0.08921690986819403
M1	string	0	network_modules	122	TRUE	2.784801237645103e-4	143	29	6	0.20689655172413793	0.04195804195804196	GO:0046390	GO:BP	ribose phosphate biosynthetic process	16175	12117		0.6666666666666666	0.6756756756756757	143	16032	6	23	137	16009	16175	0.08966777522914689
M1	string	0	network_modules	122	TRUE	2.78953408370411e-4	364	29	8	0.27586206896551724	0.02197802197802198	GO:0007005	GO:BP	mitochondrion organization	16175	2617		0.6944444444444444	0.7027027027027027	364	15811	8	21	356	15790	16175	0.07239614254802568
M1	string	0	network_modules	122	TRUE	3.29396803809379e-4	372	29	8	0.27586206896551724	0.021505376344086023	GO:0006091	GO:BP	generation of precursor metabolites and energy	16175	1954		0.7222222222222222	0.7297297297297297	372	15803	8	21	364	15782	16175	0.07149174800601286
M1	string	0	network_modules	122	TRUE	4.961517024020437e-4	305	15	6	0.4	0.019672131147540985	KEGG:05016	KEGG	Huntington disease	8484	414		0.7	0.7272727272727273	305	8179	6	9	299	8170	8484	0.08229836483928063
M1	string	0	network_modules	122	TRUE	5.553722550244236e-4	266	29	7	0.2413793103448276	0.02631578947368421	GO:0009150	GO:BP	purine ribonucleotide metabolic process	16175	3317		0.75	0.7567567567567568	266	15909	7	22	259	15887	16175	0.07495558653412808
M1	string	0	network_modules	122	TRUE	6.261025773155262e-4	164	29	6	0.20689655172413793	0.036585365853658534	GO:0006164	GO:BP	purine nucleotide biosynthetic process	16175	1999		0.7777777777777778	0.7837837837837838	164	16011	6	23	158	15988	16175	0.08323593124781171
M1	string	0	network_modules	122	TRUE	7.12551701759631e-4	276	29	7	0.2413793103448276	0.025362318840579712	GO:0009259	GO:BP	ribonucleotide metabolic process	16175	3424		0.8055555555555556	0.8108108108108109	276	15899	7	22	269	15877	16175	0.07340599101260246
M1	string	0	network_modules	122	TRUE	8.435898276750122e-4	283	29	7	0.2413793103448276	0.024734982332155476	GO:0019693	GO:BP	ribose phosphate metabolic process	16175	6010		0.8333333333333334	0.8378378378378378	283	15892	7	22	276	15870	16175	0.07236853386113641
M1	string	0	network_modules	122	TRUE	0.0010701495720102417	16	21	3	0.14285714285714285	0.1875	REAC:R-HSA-8949664	REAC	Processing of SMDT1	10916	1800		0.6666666666666666	0.7	16	10900	3	18	13	10882	10916	0.16225919808324704
M1	string	0	network_modules	122	TRUE	0.0013114384643245543	186	29	6	0.20689655172413793	0.03225806451612903	GO:0009165	GO:BP	nucleotide biosynthetic process	16175	3331		0.8611111111111112	0.8648648648648649	186	15989	6	23	180	15966	16175	0.07767160933161736
M1	string	0	network_modules	122	TRUE	0.0013462738450124691	363	15	6	0.4	0.01652892561983471	KEGG:05014	KEGG	Amyotrophic lateral sclerosis	8484	413		0.8	0.8181818181818182	363	8121	6	9	357	8112	8484	0.0742848266495848
M1	string	0	network_modules	122	TRUE	0.0017998160728272448	382	15	6	0.4	0.015706806282722512	KEGG:05010	KEGG	Alzheimer disease	8484	411		0.9	0.9090909090909091	382	8102	6	9	376	8093	8484	0.07204420456123103
M1	string	0	network_modules	122	TRUE	0.0023397243394241525	482	29	8	0.27586206896551724	0.016597510373443983	GO:0044283	GO:BP	small molecule biosynthetic process	16175	10950		0.8888888888888888	0.8918918918918919	482	15693	8	21	474	15672	16175	0.061331080488529824
M1	string	0	network_modules	122	TRUE	0.0033551546175614867	23	21	3	0.14285714285714285	0.13043478260869565	REAC:R-HSA-8949215	REAC	Mitochondrial calcium ion transport	10916	1465		0.7777777777777778	0.8	23	10893	3	18	20	10875	10916	0.1347630200400537
M1	string	0	network_modules	122	TRUE	0.003428174933696807	349	29	7	0.2413793103448276	0.02005730659025788	GO:0006163	GO:BP	purine nucleotide metabolic process	16175	1998		0.9166666666666666	0.918918918918919	349	15826	7	22	342	15804	16175	0.06411294806118979
M1	string	0	network_modules	122	TRUE	0.0034882369596701086	220	29	6	0.20689655172413793	0.02727272727272727	GO:0072522	GO:BP	purine-containing compound biosynthetic process	16175	17424		0.9444444444444444	0.9459459459459459	220	15955	6	23	214	15932	16175	0.07072490911359142
M1	string	0	network_modules	122	TRUE	0.0042586239263753	292	21	6	0.2857142857142857	0.02054794520547945	REAC:R-HSA-1852241	REAC	Organelle biogenesis and maintenance	10916	1646		0.8888888888888888	0.9	292	10624	6	15	286	10609	10916	0.0704635363029079
M1	string	0	network_modules	122	TRUE	0.006907632533258837	388	29	7	0.2413793103448276	0.01804123711340206	GO:0009117	GO:BP	nucleotide metabolic process	16175	3286		0.9722222222222222	0.972972972972973	388	15787	7	22	381	15765	16175	0.06021269363292425
M1	string	0	network_modules	122	TRUE	0.0075444415689372235	153	15	4	0.26666666666666666	0.026143790849673203	KEGG:01240	KEGG	Biosynthesis of cofactors	8484	190		1	1	153	8331	4	11	149	8320	8484	0.07863107662724728
M1	string	0	network_modules	122	TRUE	0.007585557978961981	189	21	5	0.23809523809523808	0.026455026455026454	REAC:R-HSA-196854	REAC	Metabolism of vitamins and cofactors	10916	1440		1	1	189	10727	5	16	184	10711	10916	0.074310744321445
M1	string	0	network_modules	122	TRUE	0.009145458691755518	260	29	6	0.20689655172413793	0.023076923076923078	GO:1901293	GO:BP	nucleoside phosphate biosynthetic process	16175	21368		1	1	260	15915	6	23	254	15892	16175	0.06430579158607844
M1	string	0	network_modules	123	TRUE	3.499016376992143e-15	24	19	8	0.42105263157894735	0.3333333333333333	REAC:R-HSA-6783589	REAC	Interleukin-6 family signaling	10916	1253		0	0.3333333333333333	24	10892	8	11	16	10881	10916	0.3734135791726963
M1	string	0	network_modules	123	TRUE	8.451047464999375e-14	17	19	7	0.3684210526315789	0.4117647058823529	REAC:R-HSA-6788467	REAC	IL-6-type cytokine receptor ligand interactions	10916	1146		0.5	0.6666666666666666	17	10899	7	12	10	10887	10916	0.38848460536422513
M1	string	0	network_modules	123	TRUE	3.6374829413857004e-8	5	26	4	0.15384615384615385	0.8	GO:0070120	GO:BP	ciliary neurotrophic factor-mediated signaling pathway	16175	15922		0	0.07692307692307693	5	16170	4	22	1	16148	16175	0.3504542112176851
M1	string	0	network_modules	123	TRUE	2.9200930725354434e-7	162	15	7	0.4666666666666667	0.043209876543209874	KEGG:04630	KEGG	JAK-STAT signaling pathway	8484	332		0	0.5	162	8322	7	8	155	8314	8484	0.13763271349867912
M1	string	0	network_modules	123	TRUE	3.158244054489871e-7	54	26	6	0.23076923076923078	0.1111111111111111	GO:0042531	GO:BP	positive regulation of tyrosine phosphorylation of STAT protein	16175	10227		0.08333333333333333	0.15384615384615385	54	16121	6	20	48	16101	16175	0.15820290428834174
M1	string	0	network_modules	123	TRUE	8.229560475976222e-7	63	26	6	0.23076923076923078	0.09523809523809523	GO:0042509	GO:BP	regulation of tyrosine phosphorylation of STAT protein	16175	10226		0.16666666666666666	0.23076923076923078	63	16112	6	20	57	16092	16175	0.1461498947448764
M1	string	0	network_modules	123	TRUE	9.983133644550706e-7	65	26	6	0.23076923076923078	0.09230769230769231	GO:0007260	GO:BP	tyrosine phosphorylation of STAT protein	16175	2790		0.25	0.3076923076923077	65	16110	6	20	59	16090	16175	0.14381437645288034
M1	string	0	network_modules	123	TRUE	1.6761184795965928e-5	291	15	7	0.4666666666666667	0.024054982817869417	KEGG:04060	KEGG	Cytokine-cytokine receptor interaction	8484	253		1	1	291	8193	7	8	284	8185	8484	0.0999803373278198
M1	string	0	network_modules	123	TRUE	7.041325909558889e-5	131	26	6	0.23076923076923078	0.04580152671755725	GO:0050731	GO:BP	positive regulation of peptidyl-tyrosine phosphorylation	16175	13230		0.3333333333333333	0.38461538461538464	131	16044	6	20	125	16024	16175	0.09968469640946918
M1	string	0	network_modules	123	TRUE	1.1392715682599357e-4	142	26	6	0.23076923076923078	0.04225352112676056	GO:0007259	GO:BP	cell surface receptor signaling pathway via JAK-STAT	16175	2789		0.4166666666666667	0.46153846153846156	142	16033	6	20	136	16013	16175	0.09548617124096305
M1	string	0	network_modules	123	TRUE	1.5170046438645757e-4	149	26	6	0.23076923076923078	0.040268456375838924	GO:0097696	GO:BP	cell surface receptor signaling pathway via STAT	16175	18727		0.5	0.5384615384615384	149	16026	6	20	143	16006	16175	0.09305481880363731
M1	string	0	network_modules	123	TRUE	1.819644733211536e-4	472	19	8	0.42105263157894735	0.01694915254237288	REAC:R-HSA-449147	REAC	Signaling by Interleukins	10916	2261		1	1	472	10444	8	11	464	10433	10916	0.0775639147763142
M1	string	0	network_modules	123	TRUE	2.195966476640015e-4	80	26	5	0.19230769230769232	0.0625	GO:0043524	GO:BP	negative regulation of neuron apoptotic process	16175	10753		0.5833333333333334	0.6153846153846154	80	16095	5	21	75	16074	16175	0.10716394297472057
M1	string	0	network_modules	123	TRUE	3.932856554074613e-4	175	26	6	0.23076923076923078	0.03428571428571429	GO:0050730	GO:BP	regulation of peptidyl-tyrosine phosphorylation	16175	13229		0.6666666666666666	0.6923076923076923	175	16000	6	20	169	15980	16175	0.08531064506240671
M1	string	0	network_modules	123	TRUE	0.0012817543571766498	214	26	6	0.23076923076923078	0.028037383177570093	GO:0018108	GO:BP	peptidyl-tyrosine phosphorylation	16175	5327		0.75	0.7692307692307693	214	15961	6	20	208	15941	16175	0.07639381749801971
M1	string	0	network_modules	123	TRUE	0.0013171440136340081	215	26	6	0.23076923076923078	0.027906976744186046	GO:0018212	GO:BP	peptidyl-tyrosine modification	16175	5371		0.8333333333333334	0.8461538461538461	215	15960	6	20	209	15940	16175	0.07619667709032035
M1	string	0	network_modules	123	TRUE	0.0016669193276441132	120	26	5	0.19230769230769232	0.041666666666666664	GO:0043523	GO:BP	regulation of neuron apoptotic process	16175	10752		0.9166666666666666	0.9230769230769231	120	16055	5	21	115	16034	16175	0.08645160420098219
M1	string	0	network_modules	123	TRUE	0.00320770564458381	137	26	5	0.19230769230769232	0.0364963503649635	GO:0051402	GO:BP	neuron apoptotic process	16175	13695		1	1	137	16038	5	21	132	16017	16175	0.08049291330996321
M1	string	0	network_modules	124	TRUE	7.978041754042789e-9	5	18	4	0.2222222222222222	0.8	REAC:R-HSA-5624138	REAC	Trafficking of myristoylated proteins to the cilium	10916	2534		0	0.5	5	10911	4	14	1	10897	10916	0.4212117665314081
M1	string	0	network_modules	124	TRUE	3.803304845922365e-4	51	18	4	0.2222222222222222	0.0784313725490196	REAC:R-HSA-5620920	REAC	Cargo trafficking to the periciliary membrane	10916	310		1	1	51	10865	4	14	47	10851	10916	0.129653986216156
M1	string	0	network_modules	124	TRUE	0.009476989773658911	126	8	3	0.375	0.023809523809523808	KEGG:00230	KEGG	Purine metabolism	8484	22		NA	1	126	8358	3	5	123	8353	8484	0.09147351158378104
M1	string	0	network_modules	125	TRUE	1.7529624412916073e-20	20	29	10	0.3448275862068966	0.5	GO:0033141	GO:BP	positive regulation of peptidyl-serine phosphorylation of STAT protein	16175	8056		0	0.017857142857142856	20	16155	10	19	10	16136	16175	0.41436613440984643
M1	string	0	network_modules	125	TRUE	3.3429870590570687e-20	21	29	10	0.3448275862068966	0.47619047619047616	GO:0033139	GO:BP	regulation of peptidyl-serine phosphorylation of STAT protein	16175	8054		0.01818181818181818	0.03571428571428571	21	16154	10	19	11	16135	16175	0.40431969296129766
M1	string	0	network_modules	125	TRUE	6.122257370644259e-20	22	29	10	0.3448275862068966	0.45454545454545453	GO:0042501	GO:BP	serine phosphorylation of STAT protein	16175	10225		0.03636363636363636	0.05357142857142857	22	16153	10	19	12	16134	16175	0.3949648788570566
M1	string	0	network_modules	125	TRUE	6.322813214396849e-20	24	22	10	0.45454545454545453	0.4166666666666667	REAC:R-HSA-912694	REAC	Regulation of IFNA/IFNB signaling	10916	1979		0	0.1	24	10892	10	12	14	10880	10916	0.4340035803145191
M1	string	0	network_modules	125	TRUE	9.628029671902381e-19	30	22	10	0.45454545454545453	0.3333333333333333	REAC:R-HSA-933541	REAC	TRAF6 mediated IRF7 activation	10916	2465		0.1111111111111111	0.2	30	10886	10	12	20	10874	10916	0.3878197481153347
M1	string	0	network_modules	125	TRUE	1.882234369106998e-18	29	29	10	0.3448275862068966	0.3448275862068966	GO:0002323	GO:BP	natural killer cell activation involved in immune response	16175	855		0.05454545454545454	0.07142857142857142	29	16146	10	19	19	16127	16175	0.3436508241605693
M1	string	0	network_modules	125	TRUE	1.7934597268309735e-17	49	17	10	0.5882352941176471	0.20408163265306123	KEGG:05320	KEGG	Autoimmune thyroid disease	8484	482		0	0.043478260869565216	49	8435	10	7	39	8428	8484	0.34441785027399097
M1	string	0	network_modules	125	TRUE	3.2453770358537153e-17	37	29	10	0.3448275862068966	0.2702702702702703	GO:0043330	GO:BP	response to exogenous dsRNA	16175	10636		0.07272727272727272	0.08928571428571429	37	16138	10	19	27	16119	16175	0.3038760858986374
M1	string	0	network_modules	125	TRUE	7.93951988661355e-17	64	29	11	0.3793103448275862	0.171875	GO:0098586	GO:BP	cellular response to virus	16175	18801		0.09090909090909091	0.10714285714285714	64	16111	11	18	53	16093	16175	0.25339625308910896
M1	string	0	network_modules	125	TRUE	1.0400602235243445e-16	41	29	10	0.3448275862068966	0.24390243902439024	GO:0043331	GO:BP	response to dsRNA	16175	10637		0.10909090909090909	0.125	41	16134	10	19	31	16115	16175	0.28849987987288667
M1	string	0	network_modules	125	TRUE	4.417401606629161e-16	74	29	11	0.3793103448275862	0.14864864864864866	GO:0060337	GO:BP	type I interferon-mediated signaling pathway	16175	14549		0.12727272727272726	0.14285714285714285	74	16101	11	18	63	16083	16175	0.2353386357672018
M1	string	0	network_modules	125	TRUE	4.850725285125428e-16	106	17	11	0.6470588235294118	0.10377358490566038	KEGG:04620	KEGG	Toll-like receptor signaling pathway	8484	325		0.045454545454545456	0.08695652173913043	106	8378	11	6	95	8372	8484	0.255984194373515
M1	string	0	network_modules	125	TRUE	5.171341592449764e-16	75	29	11	0.3793103448275862	0.14666666666666667	GO:0071357	GO:BP	cellular response to type I interferon	16175	16609		0.14545454545454545	0.17857142857142858	75	16100	11	18	64	16082	16175	0.2337331386454515
M1	string	0	network_modules	125	TRUE	5.171341592449764e-16	75	29	11	0.3793103448275862	0.14666666666666667	GO:0030101	GO:BP	natural killer cell activation	16175	6679		0.14545454545454545	0.17857142857142858	75	16100	11	18	64	16082	16175	0.2337331386454515
M1	string	0	network_modules	125	TRUE	9.910975818626459e-16	71	17	10	0.5882352941176471	0.14084507042253522	KEGG:04622	KEGG	RIG-I-like receptor signaling pathway	8484	327		0.09090909090909091	0.13043478260869565	71	8413	10	7	61	8406	8484	0.28522252236991386
M1	string	0	network_modules	125	TRUE	1.2721723381615947e-15	81	29	11	0.3793103448275862	0.13580246913580246	GO:0034340	GO:BP	response to type I interferon	16175	8578		0.18181818181818182	0.19642857142857142	81	16094	11	18	70	16076	16175	0.22472902608453033
M1	string	0	network_modules	125	TRUE	2.9161675147877797e-15	124	17	11	0.6470588235294118	0.08870967741935484	KEGG:04650	KEGG	Natural killer cell mediated cytotoxicity	8484	334		0.13636363636363635	0.17391304347826086	124	8360	11	6	113	8354	8484	0.23613904459918625
M1	string	0	network_modules	125	TRUE	4.553813782688304e-15	82	17	10	0.5882352941176471	0.12195121951219512	KEGG:04623	KEGG	Cytosolic DNA-sensing pathway	8484	328		0.18181818181818182	0.21739130434782608	82	8402	10	7	72	8395	8484	0.26498300336482006
M1	string	0	network_modules	125	TRUE	6.402409866383298e-15	198	17	12	0.7058823529411765	0.06060606060606061	KEGG:05169	KEGG	Epstein-Barr virus infection	8484	450		0.22727272727272727	0.2608695652173913	198	8286	12	5	186	8281	8484	0.2025751309370468
M1	string	0	network_modules	125	TRUE	9.112280793270658e-15	96	29	11	0.3793103448275862	0.11458333333333333	GO:0140888	GO:BP	interferon-mediated signaling pathway	16175	19923		0.2	0.21428571428571427	96	16079	11	18	85	16061	16175	0.20601138313156786
M1	string	0	network_modules	125	TRUE	9.828853568869309e-15	138	17	11	0.6470588235294118	0.07971014492753623	KEGG:05162	KEGG	Measles	8484	443		0.2727272727272727	0.30434782608695654	138	8346	11	6	127	8340	8484	0.22344385289194788
M1	string	0	network_modules	125	TRUE	2.920756419914835e-14	76	22	10	0.45454545454545453	0.13157894736842105	REAC:R-HSA-909733	REAC	Interferon alpha/beta signaling	10916	1228		0.2222222222222222	0.3	76	10840	10	12	66	10828	10916	0.24189869144239856
M1	string	0	network_modules	125	TRUE	4.532619639506159e-14	158	17	11	0.6470588235294118	0.06962025316455696	KEGG:05160	KEGG	Hepatitis C	8484	441		0.3181818181818182	0.391304347826087	158	8326	11	6	147	8320	8484	0.20829283285778033
M1	string	0	network_modules	125	TRUE	4.532619639506159e-14	158	17	11	0.6470588235294118	0.06962025316455696	KEGG:04217	KEGG	Necroptosis	8484	294		0.3181818181818182	0.391304347826087	158	8326	11	6	147	8320	8484	0.20829283285778033
M1	string	0	network_modules	125	TRUE	6.005446805812873e-14	162	17	11	0.6470588235294118	0.06790123456790123	KEGG:04630	KEGG	JAK-STAT signaling pathway	8484	332		0.4090909090909091	0.43478260869565216	162	8322	11	6	151	8316	8484	0.20560030953786698
M1	string	0	network_modules	125	TRUE	6.50659132703211e-14	82	22	10	0.45454545454545453	0.12195121951219512	REAC:R-HSA-168928	REAC	DDX58/IFIH1-mediated induction of interferon-alpha/beta	10916	436		0.3333333333333333	0.4	82	10834	10	12	72	10822	10916	0.23265905188655442
M1	string	0	network_modules	125	TRUE	8.45162778935098e-14	167	17	11	0.6470588235294118	0.0658682634730539	KEGG:05164	KEGG	Influenza A	8484	445		0.45454545454545453	0.4782608695652174	167	8317	11	6	156	8311	8484	0.20236982859286526
M1	string	0	network_modules	125	TRUE	8.529321883958625e-14	76	29	10	0.3448275862068966	0.13157894736842105	GO:0042100	GO:BP	B cell proliferation	16175	9966		0.21818181818181817	0.23214285714285715	76	16099	10	19	66	16080	16175	0.21078912499494856
M1	string	0	network_modules	125	TRUE	1.6694893689821013e-13	81	29	10	0.3448275862068966	0.12345679012345678	GO:0033138	GO:BP	positive regulation of peptidyl-serine phosphorylation	16175	8053		0.23636363636363636	0.25	81	16094	10	19	71	16075	16175	0.2040257864793606
M1	string	0	network_modules	125	TRUE	2.1571903037036315e-13	83	29	10	0.3448275862068966	0.12048192771084337	GO:0046425	GO:BP	regulation of receptor signaling pathway via JAK-STAT	16175	12135		0.2545454545454545	0.26785714285714285	83	16092	10	19	73	16073	16175	0.2014918379267878
M1	string	0	network_modules	125	TRUE	2.217306584687423e-13	182	17	11	0.6470588235294118	0.06043956043956044	KEGG:04621	KEGG	NOD-like receptor signaling pathway	8484	326		0.5	0.5217391304347826	182	8302	11	6	171	8296	8484	0.19347936719020986
M1	string	0	network_modules	125	TRUE	4.527369659699992e-13	194	17	11	0.6470588235294118	0.05670103092783505	KEGG:05167	KEGG	Kaposi sarcoma-associated herpesvirus infection	8484	448		0.5454545454545454	0.5652173913043478	194	8290	11	6	183	8284	8484	0.18711154437701438
M1	string	0	network_modules	125	TRUE	5.035569877962023e-13	90	29	10	0.3448275862068966	0.1111111111111111	GO:1904892	GO:BP	regulation of receptor signaling pathway via STAT	16175	24199		0.2727272727272727	0.2857142857142857	90	16085	10	19	80	16066	16175	0.19329298521750715
M1	string	0	network_modules	125	TRUE	7.855956547342033e-13	142	29	11	0.3793103448275862	0.07746478873239436	GO:0007259	GO:BP	cell surface receptor signaling pathway via JAK-STAT	16175	2789		0.2909090909090909	0.30357142857142855	142	16033	11	18	131	16015	16175	0.16833879805918614
M1	string	0	network_modules	125	TRUE	1.349756257757046e-12	149	29	11	0.3793103448275862	0.0738255033557047	GO:0097696	GO:BP	cell surface receptor signaling pathway via STAT	16175	18727		0.3090909090909091	0.32142857142857145	149	16026	11	18	138	16008	16175	0.164180869395681
M1	string	0	network_modules	125	TRUE	1.350962926120746e-12	142	17	10	0.5882352941176471	0.07042253521126761	KEGG:04936	KEGG	Alcoholic liver disease	8484	393		0.5909090909090909	0.6086956521739131	142	8342	10	7	132	8335	8484	0.19961617028774037
M1	string	0	network_modules	125	TRUE	1.5074627669812553e-12	100	29	10	0.3448275862068966	0.1	GO:0002286	GO:BP	T cell activation involved in immune response	16175	818		0.32727272727272727	0.3392857142857143	100	16075	10	19	90	16056	16175	0.18309658969935155
M1	string	0	network_modules	125	TRUE	1.8509994367866845e-12	102	29	10	0.3448275862068966	0.09803921568627451	GO:0033135	GO:BP	regulation of peptidyl-serine phosphorylation	16175	8051		0.34545454545454546	0.35714285714285715	102	16073	10	19	92	16054	16175	0.18123771892376198
M1	string	0	network_modules	125	TRUE	2.5189897856666667e-12	224	29	12	0.41379310344827586	0.05357142857142857	GO:0006959	GO:BP	humoral immune response	16175	2590		0.36363636363636365	0.375	224	15951	12	17	212	15934	16175	0.14504162414375657
M1	string	0	network_modules	125	TRUE	3.1347048479363576e-12	330	17	12	0.7058823529411765	0.03636363636363636	KEGG:05165	KEGG	Human papillomavirus infection	8484	446		0.6363636363636364	0.6521739130434783	330	8154	12	5	318	8149	8484	0.15457330002213893
M1	string	0	network_modules	125	TRUE	3.1586574317366768e-12	231	17	11	0.6470588235294118	0.047619047619047616	KEGG:05171	KEGG	Coronavirus disease - COVID-19	8484	452		0.6818181818181818	0.6956521739130435	231	8253	11	6	220	8247	8484	0.170656090312721
M1	string	0	network_modules	125	TRUE	3.3975749680178853e-12	120	22	10	0.45454545454545453	0.08333333333333333	REAC:R-HSA-9705671	REAC	SARS-CoV-2 activates/modulates innate and adaptive immune responses	10916	2123		0.4444444444444444	0.5	120	10796	10	12	110	10784	10916	0.19116310276017473
M1	string	0	network_modules	125	TRUE	3.677074941698887e-12	109	29	10	0.3448275862068966	0.09174311926605505	GO:0030183	GO:BP	B cell differentiation	16175	6700		0.38181818181818183	0.39285714285714285	109	16066	10	19	99	16047	16175	0.1751356091797954
M1	string	0	network_modules	125	TRUE	5.176389522874281e-12	162	17	10	0.5882352941176471	0.06172839506172839	KEGG:05161	KEGG	Hepatitis B	8484	442		0.7272727272727273	0.7391304347826086	162	8322	10	7	152	8315	8484	0.1863410291346511
M1	string	0	network_modules	125	TRUE	1.1330796975728932e-11	175	17	10	0.5882352941176471	0.05714285714285714	KEGG:05152	KEGG	Tuberculosis	8484	440		0.7727272727272727	0.782608695652174	175	8309	10	7	165	8302	8484	0.17894337399789978
M1	string	0	network_modules	125	TRUE	4.047059433991638e-11	291	17	11	0.6470588235294118	0.037800687285223365	KEGG:04060	KEGG	Cytokine-cytokine receptor interaction	8484	253		0.8181818181818182	0.8260869565217391	291	8193	11	6	280	8187	8484	0.1508627578709298
M1	string	0	network_modules	125	TRUE	7.139903366561798e-11	210	17	10	0.5882352941176471	0.047619047619047616	KEGG:05170	KEGG	Human immunodeficiency virus 1 infection	8484	451		0.8636363636363636	0.8695652173913043	210	8274	10	7	200	8267	8484	0.1625075764532701
M1	string	0	network_modules	125	TRUE	8.631733611218759e-11	214	17	10	0.5882352941176471	0.04672897196261682	KEGG:05417	KEGG	Lipid and atherosclerosis	8484	494		0.9090909090909091	0.9130434782608695	214	8270	10	7	204	8263	8484	0.16088584801980058
M1	string	0	network_modules	125	TRUE	1.1121788098326127e-10	169	22	10	0.45454545454545453	0.05917159763313609	REAC:R-HSA-983231	REAC	Factors involved in megakaryocyte development and platelet production	10916	931		0.5555555555555556	0.6	169	10747	10	12	159	10735	10916	0.15981650624396818
M1	string	0	network_modules	125	TRUE	1.3055853430904903e-10	223	17	10	0.5882352941176471	0.04484304932735426	KEGG:05163	KEGG	Human cytomegalovirus infection	8484	444		0.9545454545454546	0.9565217391304348	223	8261	10	7	213	8254	8484	0.15739454542317977
M1	string	0	network_modules	125	TRUE	1.6346296154493345e-10	158	29	10	0.3448275862068966	0.06329113924050633	GO:0002285	GO:BP	lymphocyte activation involved in immune response	16175	817		0.4	0.4107142857142857	158	16017	10	19	148	15998	16175	0.14438215591520984
M1	string	0	network_modules	125	TRUE	3.6867460014330754e-10	356	17	11	0.6470588235294118	0.03089887640449438	KEGG:04151	KEGG	PI3K-Akt signaling pathway	8484	285		1	1	356	8128	11	6	345	8122	8484	0.1352286902483576
M1	string	0	network_modules	125	TRUE	5.208002028826466e-10	197	22	10	0.45454545454545453	0.050761421319796954	REAC:R-HSA-9705683	REAC	SARS-CoV-2-host interactions	10916	2128		0.6666666666666666	0.7	197	10719	10	12	187	10707	10916	0.14735122126178432
M1	string	0	network_modules	125	TRUE	7.535103127503556e-10	292	22	11	0.5	0.03767123287671233	REAC:R-HSA-9694516	REAC	SARS-CoV-2 Infection	10916	2122		0.7777777777777778	0.8	292	10624	11	11	281	10613	10916	0.13180643084819574
M1	string	0	network_modules	125	TRUE	8.029437479903399e-10	185	29	10	0.3448275862068966	0.05405405405405406	GO:0018105	GO:BP	peptidyl-serine phosphorylation	16175	5324		0.41818181818181815	0.42857142857142855	185	15990	10	19	175	15971	16175	0.1328781354168333
M1	string	0	network_modules	125	TRUE	1.5089224090394973e-9	197	29	10	0.3448275862068966	0.050761421319796954	GO:0042113	GO:BP	B cell activation	16175	9971		0.43636363636363634	0.4642857142857143	197	15978	10	19	187	15959	16175	0.12852919792332987
M1	string	0	network_modules	125	TRUE	1.5089224090394973e-9	197	29	10	0.3448275862068966	0.050761421319796954	GO:0018209	GO:BP	peptidyl-serine modification	16175	5368		0.43636363636363634	0.4642857142857143	197	15978	10	19	187	15959	16175	0.12852919792332987
M1	string	0	network_modules	125	TRUE	2.5995617409911017e-9	208	29	10	0.3448275862068966	0.04807692307692308	GO:0046651	GO:BP	lymphocyte proliferation	16175	12287		0.4727272727272727	0.48214285714285715	208	15967	10	19	198	15948	16175	0.12487169704982395
M1	string	0	network_modules	125	TRUE	2.9995963499653907e-9	211	29	10	0.3448275862068966	0.04739336492890995	GO:0032943	GO:BP	mononuclear cell proliferation	16175	7928		0.4909090909090909	0.5	211	15964	10	19	201	15945	16175	0.12392317954981959
M1	string	0	network_modules	125	TRUE	3.790019543332666e-9	216	29	10	0.3448275862068966	0.046296296296296294	GO:0002366	GO:BP	leukocyte activation involved in immune response	16175	898		0.509090909090909	0.5178571428571429	216	15959	10	19	206	15940	16175	0.1223855390844488
M1	string	0	network_modules	125	TRUE	4.76201007179695e-9	221	29	10	0.3448275862068966	0.04524886877828054	GO:0002263	GO:BP	cell activation involved in immune response	16175	795		0.5272727272727272	0.5357142857142857	221	15954	10	19	211	15935	16175	0.12089927397847253
M1	string	0	network_modules	125	TRUE	9.156545778321052e-9	236	29	10	0.3448275862068966	0.0423728813559322	GO:0070661	GO:BP	leukocyte proliferation	16175	16242		0.5454545454545454	0.5535714285714286	236	15939	10	19	226	15920	16175	0.11672133062105611
M1	string	0	network_modules	125	TRUE	9.28999446818565e-9	263	22	10	0.45454545454545453	0.03802281368821293	REAC:R-HSA-913531	REAC	Interferon Signaling	10916	1227		0.8888888888888888	0.9	263	10653	10	12	253	10641	10916	0.12615151129993968
M1	string	0	network_modules	125	TRUE	9.893435719367769e-9	334	29	11	0.3793103448275862	0.03293413173652695	GO:0009615	GO:BP	response to virus	16175	3541		0.5636363636363636	0.5714285714285714	334	15841	11	18	323	15823	16175	0.1068884242779312
M1	string	0	network_modules	125	TRUE	3.4654782068541276e-8	500	29	12	0.41379310344827586	0.024	GO:0001934	GO:BP	positive regulation of protein phosphorylation	16175	548		0.5818181818181818	0.5892857142857143	500	15675	12	17	488	15658	16175	0.09375319618412059
M1	string	0	network_modules	125	TRUE	5.7160698715911825e-8	522	29	12	0.41379310344827586	0.022988505747126436	GO:0042327	GO:BP	positive regulation of phosphorylation	16175	10095		0.6	0.6071428571428571	522	15653	12	17	510	15636	16175	0.09149456726898128
M1	string	0	network_modules	125	TRUE	7.769937445378597e-8	536	29	12	0.41379310344827586	0.022388059701492536	GO:0002252	GO:BP	immune effector process	16175	784		0.6181818181818182	0.625	536	15639	12	17	524	15622	16175	0.09012724392803415
M1	string	0	network_modules	125	TRUE	8.097257578553266e-8	406	29	11	0.3793103448275862	0.027093596059113302	GO:0042110	GO:BP	T cell activation	16175	9970		0.6363636363636364	0.6428571428571429	406	15769	11	18	395	15751	16175	0.09596356934260133
M1	string	0	network_modules	125	TRUE	8.890660477659056e-8	297	29	10	0.3448275862068966	0.03367003367003367	GO:0030098	GO:BP	lymphocyte differentiation	16175	6676		0.6545454545454545	0.6607142857142857	297	15878	10	19	287	15859	16175	0.10305582359100415
M1	string	0	network_modules	125	TRUE	9.979866143609632e-8	459	22	11	0.5	0.023965141612200435	REAC:R-HSA-9679506	REAC	SARS-CoV Infections	10916	2112		1	1	459	10457	11	11	448	10446	10916	0.10253942905045449
M1	string	0	network_modules	125	TRUE	1.1346960955076506e-7	419	29	11	0.3793103448275862	0.026252983293556086	GO:0019221	GO:BP	cytokine-mediated signaling pathway	16175	5598		0.6727272727272727	0.6785714285714286	419	15756	11	18	408	15738	16175	0.09428767921915547
M1	string	0	network_modules	125	TRUE	1.3933726683302494e-7	721	29	13	0.4482758620689655	0.018030513176144243	GO:0045087	GO:BP	innate immune response	16175	11270		0.6909090909090909	0.6964285714285714	721	15454	13	16	708	15438	16175	0.08290532884605423
M1	string	0	network_modules	125	TRUE	1.4006666469912184e-7	564	29	12	0.41379310344827586	0.02127659574468085	GO:0045937	GO:BP	positive regulation of phosphate metabolic process	16175	11731		0.7090909090909091	0.7321428571428571	564	15611	12	17	552	15594	16175	0.08754040722326685
M1	string	0	network_modules	125	TRUE	1.4006666469912184e-7	564	29	12	0.41379310344827586	0.02127659574468085	GO:0010562	GO:BP	positive regulation of phosphorus metabolic process	16175	4215		0.7090909090909091	0.7321428571428571	564	15611	12	17	552	15594	16175	0.08754040722326685
M1	string	0	network_modules	125	TRUE	2.810880176353724e-7	334	29	10	0.3448275862068966	0.029940119760479042	GO:0002250	GO:BP	adaptive immune response	16175	782		0.7454545454545455	0.75	334	15841	10	19	324	15822	16175	0.09661185188570623
M1	string	0	network_modules	125	TRUE	5.194644305628168e-7	632	29	12	0.41379310344827586	0.0189873417721519	GO:0031401	GO:BP	positive regulation of protein modification process	16175	7157		0.7636363636363637	0.7678571428571429	632	15543	12	17	620	15526	16175	0.08195817112185885
M1	string	0	network_modules	125	TRUE	5.383302732368051e-7	357	29	10	0.3448275862068966	0.028011204481792718	GO:1903131	GO:BP	mononuclear cell differentiation	16175	22787		0.7818181818181819	0.7857142857142857	357	15818	10	19	347	15799	16175	0.09310562136416596
M1	string	0	network_modules	125	TRUE	2.2394788156911325e-6	555	29	11	0.3793103448275862	0.01981981981981982	GO:0071345	GO:BP	cellular response to cytokine stimulus	16175	16597		0.8	0.8035714285714286	555	15620	11	18	544	15602	16175	0.08032311728040337
M1	string	0	network_modules	125	TRUE	2.9096969927343165e-6	569	29	11	0.3793103448275862	0.019332161687170474	GO:0046649	GO:BP	lymphocyte activation	16175	12286		0.8181818181818182	0.8214285714285714	569	15606	11	18	558	15588	16175	0.07916526997722907
M1	string	0	network_modules	125	TRUE	3.3403337954615786e-6	744	29	12	0.41379310344827586	0.016129032258064516	GO:0001932	GO:BP	regulation of protein phosphorylation	16175	546		0.8363636363636363	0.8392857142857143	744	15431	12	17	732	15414	16175	0.0744105547554572
M1	string	0	network_modules	125	TRUE	3.5704329148015764e-6	434	29	10	0.3448275862068966	0.02304147465437788	GO:0002521	GO:BP	leukocyte differentiation	16175	1043		0.8545454545454545	0.8571428571428571	434	15741	10	19	424	15722	16175	0.08340105102954165
M1	string	0	network_modules	125	TRUE	3.815312889425555e-6	437	29	10	0.3448275862068966	0.02288329519450801	GO:0014070	GO:BP	response to organic cyclic compound	16175	4635		0.8727272727272727	0.875	437	15738	10	19	427	15719	16175	0.08307372461269522
M1	string	0	network_modules	125	TRUE	6.775043783110797e-6	792	29	12	0.41379310344827586	0.015151515151515152	GO:0042325	GO:BP	regulation of phosphorylation	16175	10093		0.8909090909090909	0.8928571428571429	792	15383	12	17	780	15366	16175	0.07165007380504917
M1	string	0	network_modules	125	TRUE	7.771763998588039e-6	625	29	11	0.3793103448275862	0.0176	GO:1901652	GO:BP	response to peptide	16175	21619		0.9090909090909091	0.9285714285714286	625	15550	11	18	614	15532	16175	0.074910051664999
M1	string	0	network_modules	125	TRUE	7.771763998588039e-6	625	29	11	0.3793103448275862	0.0176	GO:0034097	GO:BP	response to cytokine	16175	8408		0.9090909090909091	0.9285714285714286	625	15550	11	18	614	15532	16175	0.074910051664999
M1	string	0	network_modules	125	TRUE	9.631765889507005e-6	638	29	11	0.3793103448275862	0.017241379310344827	GO:0018193	GO:BP	peptidyl-amino acid modification	16175	5353		0.9454545454545454	0.9464285714285714	638	15537	11	18	627	15519	16175	0.07399895421051061
M1	string	0	network_modules	125	TRUE	2.4846504493201848e-5	699	29	11	0.3793103448275862	0.015736766809728183	GO:0045321	GO:BP	leukocyte activation	16175	11356		0.9636363636363636	0.9642857142857143	699	15476	11	18	688	15458	16175	0.0700495859716499
M1	string	0	network_modules	125	TRUE	1.0478929035625556e-4	619	29	10	0.3448275862068966	0.01615508885298869	GO:1901698	GO:BP	response to nitrogen compound	16175	21651		0.9818181818181818	0.9821428571428571	619	15556	10	19	609	15537	16175	0.0677220507896053
M1	string	0	network_modules	125	TRUE	1.3914926529511796e-4	638	29	10	0.3448275862068966	0.01567398119122257	GO:0030097	GO:BP	hemopoiesis	16175	6675		1	1	638	15537	10	19	628	15518	16175	0.06649104704306923
M1	string	0	network_modules	126	TRUE	5.435618221975093e-12	15	16	6	0.375	0.4	REAC:R-HSA-1362300	REAC	Transcription of E2F targets under negative control by p107 (RBL1) and p130 (RBL2) in complex with HDAC1	10916	2537		0	0.1	15	10901	6	10	9	10891	10916	0.3864278420041737
M1	string	0	network_modules	126	TRUE	2.478841239554581e-10	26	16	6	0.375	0.23076923076923078	REAC:R-HSA-1538133	REAC	G0 and Early G1	10916	999		0.1111111111111111	0.2	26	10890	6	10	20	10880	10916	0.29286919272249406
M1	string	0	network_modules	126	TRUE	9.194375363738534e-9	18	16	5	0.3125	0.2777777777777778	REAC:R-HSA-1362277	REAC	Transcription of E2F targets under negative control by DREAM complex	10916	2536		0.2222222222222222	0.3	18	10898	5	11	13	10887	10916	0.29353030496506693
M1	string	0	network_modules	126	TRUE	1.078453319954379e-8	155	11	7	0.6363636363636364	0.04516129032258064	KEGG:04218	KEGG	Cellular senescence	8484	295		0	0.5	155	8329	7	4	148	8325	8484	0.166291715399717
M1	string	0	network_modules	126	TRUE	8.597843213252195e-8	27	16	5	0.3125	0.18518518518518517	REAC:R-HSA-69205	REAC	G1/S-Specific Transcription	10916	1003		0.3333333333333333	0.4	27	10889	5	11	22	10878	10916	0.23912957883891622
M1	string	0	network_modules	126	TRUE	2.3056042517070943e-7	147	16	7	0.4375	0.047619047619047616	REAC:R-HSA-453279	REAC	Mitotic G1 phase and G1/S transition	10916	1480		0.4444444444444444	0.5	147	10769	7	9	140	10760	10916	0.14094968562649987
M1	string	0	network_modules	126	TRUE	1.3336435900021015e-6	15	16	4	0.25	0.26666666666666666	REAC:R-HSA-156711	REAC	Polo-like kinase mediated events	10916	1768		0.5555555555555556	0.6	15	10901	4	12	11	10889	10916	0.25714482363597585
M1	string	0	network_modules	126	TRUE	2.7743055277674672e-5	82	16	5	0.3125	0.06097560975609756	REAC:R-HSA-69202	REAC	Cyclin E associated events during G1/S transition 	10916	421		0.6666666666666666	0.7	82	10834	5	11	77	10823	10916	0.13532929175855074
M1	string	0	network_modules	126	TRUE	3.1336959295626584e-5	84	16	5	0.3125	0.05952380952380952	REAC:R-HSA-69656	REAC	Cyclin A:Cdk2-associated events at S phase entry	10916	419		0.7777777777777778	0.8	84	10832	5	11	79	10821	10916	0.13364053555987643
M1	string	0	network_modules	126	TRUE	2.794758418092943e-4	130	16	5	0.3125	0.038461538461538464	REAC:R-HSA-69206	REAC	G1/S Transition	10916	1002		0.8888888888888888	0.9	130	10786	5	11	125	10775	10916	0.10616568811314155
M1	string	0	network_modules	126	TRUE	8.301797881689319e-4	162	16	5	0.3125	0.030864197530864196	REAC:R-HSA-69242	REAC	S Phase	10916	2111		1	1	162	10754	5	11	157	10743	10916	0.09431642844510754
M1	string	0	network_modules	126	TRUE	0.001970953177264988	157	11	4	0.36363636363636365	0.025477707006369428	KEGG:04110	KEGG	Cell cycle	8484	264		1	1	157	8327	4	7	153	8320	8484	0.09227162882767366
M1	string	0	network_modules	128	TRUE	1.3843246202336743e-35	397	27	25	0.9259259259259259	0.06297229219143577	GO:0008380	GO:BP	RNA splicing	16175	3186		0	0.047619047619047616	397	15778	25	2	372	15776	16175	0.23820693085471512
M1	string	0	network_modules	128	TRUE	1.594323301203548e-29	352	27	22	0.8148148148148148	0.0625	GO:0006397	GO:BP	mRNA processing	16175	2158		0.05	0.09523809523809523	352	15823	22	5	330	15818	16175	0.22225583832058238
M1	string	0	network_modules	128	TRUE	3.417013526039736e-29	287	27	21	0.7777777777777778	0.07317073170731707	GO:0000398	GO:BP	mRNA splicing, via spliceosome	16175	121		0.1	0.19047619047619047	287	15888	21	6	266	15882	16175	0.23540975532724306
M1	string	0	network_modules	128	TRUE	3.417013526039736e-29	287	27	21	0.7777777777777778	0.07317073170731707	GO:0000377	GO:BP	RNA splicing, via transesterification reactions with bulged adenosine as nucleophile	16175	109		0.1	0.19047619047619047	287	15888	21	6	266	15882	16175	0.23540975532724306
M1	string	0	network_modules	128	TRUE	4.6114777211241106e-29	291	27	21	0.7777777777777778	0.07216494845360824	GO:0000375	GO:BP	RNA splicing, via transesterification reactions	16175	107		0.2	0.23809523809523808	291	15884	21	6	270	15878	16175	0.23373957777061674
M1	string	0	network_modules	128	TRUE	1.6780154237059247e-24	590	27	22	0.8148148148148148	0.03728813559322034	GO:0016071	GO:BP	mRNA metabolic process	16175	5098		0.25	0.2857142857142857	590	15585	22	5	568	15580	16175	0.16976808762117512
M1	string	0	network_modules	128	TRUE	2.0700092842281565e-24	175	27	17	0.6296296296296297	0.09714285714285714	GO:0043484	GO:BP	regulation of RNA splicing	16175	10730		0.3	0.3333333333333333	175	16000	17	10	158	15990	16175	0.24459379449581023
M1	string	0	network_modules	128	TRUE	1.6909611067702984e-22	202	24	17	0.7083333333333334	0.08415841584158416	REAC:R-HSA-72163	REAC	mRNA Splicing - Major Pathway	10916	2707		0	0.125	202	10714	17	7	185	10707	10916	0.24027295379445904
M1	string	0	network_modules	128	TRUE	3.076974554033066e-22	209	24	17	0.7083333333333334	0.08133971291866028	REAC:R-HSA-72172	REAC	mRNA Splicing	10916	2706		0.14285714285714285	0.25	209	10707	17	7	192	10700	10916	0.2360725239747795
M1	string	0	network_modules	128	TRUE	3.7211768089361966e-22	276	24	18	0.75	0.06521739130434782	REAC:R-HSA-72203	REAC	Processing of Capped Intron-Containing Pre-mRNA	10916	1796		0.2857142857142857	0.375	276	10640	18	6	258	10634	10916	0.2166994624615757
M1	string	0	network_modules	128	TRUE	1.0029077995446962e-21	98	27	14	0.5185185185185185	0.14285714285714285	GO:0048024	GO:BP	regulation of mRNA splicing, via spliceosome	16175	12475		0.35	0.38095238095238093	98	16077	14	13	84	16064	16175	0.2700293979528302
M1	string	0	network_modules	128	TRUE	1.789035176263223e-20	119	27	14	0.5185185185185185	0.11764705882352941	GO:0050684	GO:BP	regulation of mRNA processing	16175	13215		0.4	0.42857142857142855	119	16056	14	13	105	16043	16175	0.24458665897648482
M1	string	0	network_modules	128	TRUE	1.670580218601957e-17	56	24	11	0.4583333333333333	0.19642857142857142	REAC:R-HSA-72187	REAC	mRNA 3'-end processing	10916	2701		0.42857142857142855	0.5	56	10860	11	13	45	10847	10916	0.29778267033407235
M1	string	0	network_modules	128	TRUE	9.943354284077217e-17	65	24	11	0.4583333333333333	0.16923076923076924	REAC:R-HSA-73856	REAC	RNA Polymerase II Transcription Termination	10916	1895		0.5714285714285714	0.625	65	10851	11	13	54	10838	10916	0.27601074419252664
M1	string	0	network_modules	128	TRUE	2.825840912500752e-16	71	24	11	0.4583333333333333	0.15492957746478872	REAC:R-HSA-159236	REAC	Transport of Mature mRNA derived from an Intron-Containing Transcript	10916	2586		0.7142857142857143	0.75	71	10845	11	13	60	10832	10916	0.2638430117315614
M1	string	0	network_modules	128	TRUE	4.03151727480584e-16	174	16	12	0.75	0.06896551724137931	KEGG:03040	KEGG	Spliceosome	8484	215		NA	1	174	8310	12	4	162	8306	8484	0.22372520428631665
M1	string	0	network_modules	128	TRUE	1.1449463861696358e-15	80	24	11	0.4583333333333333	0.1375	REAC:R-HSA-72202	REAC	Transport of Mature Transcript to Cytoplasm	10916	2584		0.8571428571428571	0.875	80	10836	11	13	69	10823	10916	0.24820861503006977
M1	string	0	network_modules	128	TRUE	2.8100978281424286e-15	273	27	14	0.5185185185185185	0.05128205128205128	GO:1903311	GO:BP	regulation of mRNA metabolic process	16175	22895		0.45	0.47619047619047616	273	15902	14	13	259	15889	16175	0.15924004783297277
M1	string	0	network_modules	128	TRUE	2.7385742717608185e-13	16	27	7	0.25925925925925924	0.4375	GO:0048025	GO:BP	negative regulation of mRNA splicing, via spliceosome	16175	12476		0.5	0.5238095238095238	16	16159	7	20	9	16139	16175	0.33594924055373004
M1	string	0	network_modules	128	TRUE	4.650535423550137e-13	17	27	7	0.25925925925925924	0.4117647058823529	GO:0050686	GO:BP	negative regulation of mRNA processing	16175	13217		0.55	0.5714285714285714	17	16158	7	20	10	16138	16175	0.32585070166592434
M1	string	0	network_modules	128	TRUE	2.768540640153109e-12	21	27	7	0.25925925925925924	0.3333333333333333	GO:0033119	GO:BP	negative regulation of RNA splicing	16175	8043		0.6	0.6190476190476191	21	16154	7	20	14	16134	16175	0.2929348876563031
M1	string	0	network_modules	128	TRUE	3.199344266372561e-12	73	27	9	0.3333333333333333	0.1232876712328767	GO:0000245	GO:BP	spliceosomal complex assembly	16175	69		0.65	0.6666666666666666	73	16102	9	18	64	16084	16175	0.20059677354005734
M1	string	0	network_modules	128	TRUE	4.8000433120887335e-11	30	27	7	0.25925925925925924	0.23333333333333334	GO:0006376	GO:BP	mRNA splice site recognition	16175	2146		0.7	0.7142857142857143	30	16145	7	20	23	16125	16175	0.24462642038130689
M1	string	0	network_modules	128	TRUE	1.8335639426311793e-10	67	27	8	0.2962962962962963	0.11940298507462686	GO:0000380	GO:BP	alternative mRNA splicing, via spliceosome	16175	112		0.75	0.7619047619047619	67	16108	8	19	59	16089	16175	0.18600326899529956
M1	string	0	network_modules	128	TRUE	1.2039004717255585e-9	84	27	8	0.2962962962962963	0.09523809523809523	GO:1903312	GO:BP	negative regulation of mRNA metabolic process	16175	22896		0.8	0.8095238095238095	84	16091	8	19	76	16072	16175	0.16560844004217928
M1	string	0	network_modules	128	TRUE	1.1931829646163439e-8	178	27	9	0.3333333333333333	0.05056179775280899	GO:0022618	GO:BP	protein-RNA complex assembly	16175	6625		0.85	0.8571428571428571	178	15997	9	18	169	15979	16175	0.12633872783419214
M1	string	0	network_modules	128	TRUE	1.953352054914087e-8	188	27	9	0.3333333333333333	0.047872340425531915	GO:0071826	GO:BP	protein-RNA complex organization	16175	16929		0.9	0.9047619047619048	188	15987	9	18	179	15969	16175	0.12273532264300575
M1	string	0	network_modules	128	TRUE	4.5565503355851465e-7	54	27	6	0.2222222222222222	0.1111111111111111	GO:0000381	GO:BP	regulation of alternative mRNA splicing, via spliceosome	16175	113		0.95	0.9523809523809523	54	16121	6	21	48	16100	16175	0.15516273522046828
M1	string	0	network_modules	128	TRUE	1.2528744271560187e-5	390	27	9	0.3333333333333333	0.023076923076923078	GO:0022613	GO:BP	ribonucleoprotein complex biogenesis	16175	6620		1	1	390	15785	9	18	381	15767	16175	0.08242949897724546
M1	string	0	network_modules	128	TRUE	0.0010117435128560806	48	24	4	0.16666666666666666	0.08333333333333333	REAC:R-HSA-72165	REAC	mRNA Splicing - Minor Pathway	10916	2708		1	1	48	10868	4	20	44	10848	10916	0.11512156007131033
M1	string	0	network_modules	129	TRUE	2.562337587485085e-26	26	28	13	0.4642857142857143	0.5	REAC:R-HSA-389960	REAC	Formation of tubulin folding intermediates by CCT/TriC	10916	975		0	0.02127659574468085	26	10890	13	15	13	10875	10916	0.48052887761737434
M1	string	0	network_modules	129	TRUE	1.3994829956791332e-24	33	28	13	0.4642857142857143	0.3939393939393939	REAC:R-HSA-389958	REAC	Cooperation of Prefoldin and TriC/CCT  in actin and tubulin folding	10916	411		0.021739130434782608	0.0425531914893617	33	10883	13	15	20	10868	10916	0.42607443024459024
M1	string	0	network_modules	129	TRUE	5.081886310855438e-23	28	28	12	0.42857142857142855	0.42857142857142855	REAC:R-HSA-389957	REAC	Prefoldin mediated transfer of substrate  to CCT/TriC	10916	1788		0.043478260869565216	0.06382978723404255	28	10888	12	16	16	10872	10916	0.42710192085651305
M1	string	0	network_modules	129	TRUE	3.802808172536857e-21	10	28	9	0.32142857142857145	0.9	REAC:R-HSA-390450	REAC	Folding of actin by CCT/TriC	10916	943		0.06521739130434782	0.0851063829787234	10	10906	9	19	1	10887	10916	0.5372552786102028
M1	string	0	network_modules	129	TRUE	3.355587549561504e-20	91	28	14	0.5	0.15384615384615385	REAC:R-HSA-390466	REAC	Chaperonin-mediated protein folding	10916	345		0.08695652173913043	0.10638297872340426	91	10825	14	14	77	10811	10916	0.2742217551393844
M1	string	0	network_modules	129	TRUE	1.0163010694165669e-19	98	28	14	0.5	0.14285714285714285	REAC:R-HSA-391251	REAC	Protein folding	10916	1812		0.10869565217391304	0.1276595744680851	98	10818	14	14	84	10804	10916	0.26398741469970516
M1	string	0	network_modules	129	TRUE	3.330760286122263e-18	10	30	8	0.26666666666666666	0.8	GO:1904851	GO:BP	positive regulation of establishment of protein localization to telomere	16175	24163		0	0.017543859649122806	10	16165	8	22	2	16143	16175	0.4613799692489671
M1	string	0	network_modules	129	TRUE	1.2198013966434539e-17	11	30	8	0.26666666666666666	0.7272727272727273	GO:1904871	GO:BP	positive regulation of protein localization to Cajal body	16175	24179		0.017857142857142856	0.07017543859649122	11	16164	8	22	3	16142	16175	0.4398199193295582
M1	string	0	network_modules	129	TRUE	1.2198013966434539e-17	11	30	8	0.26666666666666666	0.7272727272727273	GO:0070203	GO:BP	regulation of establishment of protein localization to telomere	16175	15986		0.017857142857142856	0.07017543859649122	11	16164	8	22	3	16142	16175	0.4398199193295582
M1	string	0	network_modules	129	TRUE	1.2198013966434539e-17	11	30	8	0.26666666666666666	0.7272727272727273	GO:1904869	GO:BP	regulation of protein localization to Cajal body	16175	24177		0.017857142857142856	0.07017543859649122	11	16164	8	22	3	16142	16175	0.4398199193295582
M1	string	0	network_modules	129	TRUE	3.654977247273889e-17	12	30	8	0.26666666666666666	0.6666666666666666	GO:1903405	GO:BP	protein localization to nuclear body	16175	22981		0.07142857142857142	0.12280701754385964	12	16163	8	22	4	16141	16175	0.42101066051706665
M1	string	0	network_modules	129	TRUE	3.654977247273889e-17	12	30	8	0.26666666666666666	0.6666666666666666	GO:1904867	GO:BP	protein localization to Cajal body	16175	24175		0.07142857142857142	0.12280701754385964	12	16163	8	22	4	16141	16175	0.42101066051706665
M1	string	0	network_modules	129	TRUE	3.654977247273889e-17	12	30	8	0.26666666666666666	0.6666666666666666	GO:0070202	GO:BP	regulation of establishment of protein localization to chromosome	16175	15985		0.07142857142857142	0.12280701754385964	12	16163	8	22	4	16141	16175	0.42101066051706665
M1	string	0	network_modules	129	TRUE	9.49144425043303e-17	13	30	8	0.26666666666666666	0.6153846153846154	GO:1904816	GO:BP	positive regulation of protein localization to chromosome, telomeric region	16175	24131		0.125	0.14035087719298245	13	16162	8	22	5	16140	16175	0.40441243023394335
M1	string	0	network_modules	129	TRUE	2.211990923623181e-16	14	30	8	0.26666666666666666	0.5714285714285714	GO:1990173	GO:BP	protein localization to nucleoplasm	16175	25107		0.14285714285714285	0.15789473684210525	14	16161	8	22	6	16139	16175	0.3896230014430868
M1	string	0	network_modules	129	TRUE	3.007279865157129e-16	38	28	10	0.35714285714285715	0.2631578947368421	REAC:R-HSA-390471	REAC	Association of TriC/CCT with target proteins during biosynthesis	10916	182		0.13043478260869565	0.14893617021276595	38	10878	10	18	28	10860	10916	0.30450205382646683
M1	string	0	network_modules	129	TRUE	4.73424569010797e-16	15	30	8	0.26666666666666666	0.5333333333333333	GO:1904814	GO:BP	regulation of protein localization to chromosome, telomeric region	16175	24129		0.16071428571428573	0.19298245614035087	15	16160	8	22	7	16138	16175	0.37633567255113964
M1	string	0	network_modules	129	TRUE	4.73424569010797e-16	15	30	8	0.26666666666666666	0.5333333333333333	GO:1904874	GO:BP	positive regulation of telomerase RNA localization to Cajal body	16175	24182		0.16071428571428573	0.19298245614035087	15	16160	8	22	7	16138	16175	0.37633567255113964
M1	string	0	network_modules	129	TRUE	1.78416740842414e-15	17	30	8	0.26666666666666666	0.47058823529411764	GO:0070200	GO:BP	establishment of protein localization to telomere	16175	15983		0.19642857142857142	0.21052631578947367	17	16158	8	22	9	16136	16175	0.3533631917801316
M1	string	0	network_modules	129	TRUE	3.207615295946211e-15	18	30	8	0.26666666666666666	0.4444444444444444	GO:1904872	GO:BP	regulation of telomerase RNA localization to Cajal body	16175	24180		0.21428571428571427	0.22807017543859648	18	16157	8	22	10	16135	16175	0.3433379896877745
M1	string	0	network_modules	129	TRUE	5.533722021277945e-15	19	30	8	0.26666666666666666	0.42105263157894735	GO:0090685	GO:BP	RNA localization to nucleus	16175	18411		0.23214285714285715	0.2982456140350877	19	16156	8	22	11	16134	16175	0.33411319856475696
M1	string	0	network_modules	129	TRUE	5.533722021277945e-15	19	30	8	0.26666666666666666	0.42105263157894735	GO:0090672	GO:BP	telomerase RNA localization	16175	18402		0.23214285714285715	0.2982456140350877	19	16156	8	22	11	16134	16175	0.33411319856475696
M1	string	0	network_modules	129	TRUE	5.533722021277945e-15	19	30	8	0.26666666666666666	0.42105263157894735	GO:0090670	GO:BP	RNA localization to Cajal body	16175	18400		0.23214285714285715	0.2982456140350877	19	16156	8	22	11	16134	16175	0.33411319856475696
M1	string	0	network_modules	129	TRUE	5.533722021277945e-15	19	30	8	0.26666666666666666	0.42105263157894735	GO:0090671	GO:BP	telomerase RNA localization to Cajal body	16175	18401		0.23214285714285715	0.2982456140350877	19	16156	8	22	11	16134	16175	0.33411319856475696
M1	string	0	network_modules	129	TRUE	5.932319656831404e-14	38	28	9	0.32142857142857145	0.23684210526315788	REAC:R-HSA-6814122	REAC	Cooperation of PDCL (PhLP1) and TRiC/CCT in G-protein beta folding	10916	410		0.15217391304347827	0.1702127659574468	38	10878	9	19	29	10859	10916	0.2737521239533012
M1	string	0	network_modules	129	TRUE	1.6097521707501089e-13	27	30	8	0.26666666666666666	0.2962962962962963	GO:0070199	GO:BP	establishment of protein localization to chromosome	16175	15982		0.30357142857142855	0.3157894736842105	27	16148	8	22	19	16126	16175	0.27982485786445094
M1	string	0	network_modules	129	TRUE	5.692380018435973e-13	31	30	8	0.26666666666666666	0.25806451612903225	GO:0070198	GO:BP	protein localization to chromosome, telomeric region	16175	15981		0.32142857142857145	0.3333333333333333	31	16144	8	22	23	16122	16175	0.2609369914322863
M1	string	0	network_modules	129	TRUE	9.994343533830817e-13	33	30	8	0.26666666666666666	0.24242424242424243	GO:0032212	GO:BP	positive regulation of telomere maintenance via telomerase	16175	7404		0.3392857142857143	0.3508771929824561	33	16142	8	22	25	16120	16175	0.25280377368299795
M1	string	0	network_modules	129	TRUE	2.170351181875233e-12	36	30	8	0.26666666666666666	0.2222222222222222	GO:1904358	GO:BP	positive regulation of telomere maintenance via telomere lengthening	16175	23745		0.35714285714285715	0.3684210526315789	36	16139	8	22	28	16117	16175	0.2418940231586297
M1	string	0	network_modules	129	TRUE	1.1315582988668817e-11	118	30	10	0.3333333333333333	0.0847457627118644	GO:0034502	GO:BP	protein localization to chromosome	16175	8668		0.375	0.38596491228070173	118	16057	10	20	108	16037	16175	0.1651509480716481
M1	string	0	network_modules	129	TRUE	5.293737491156388e-11	52	30	8	0.26666666666666666	0.15384615384615385	GO:2000573	GO:BP	positive regulation of DNA biosynthetic process	16175	25874		0.39285714285714285	0.40350877192982454	52	16123	8	22	44	16101	16175	0.2006145884141011
M1	string	0	network_modules	129	TRUE	7.301439838840248e-11	54	30	8	0.26666666666666666	0.14814814814814814	GO:0032210	GO:BP	regulation of telomere maintenance via telomerase	16175	7402		0.4107142857142857	0.42105263157894735	54	16121	8	22	46	16099	16175	0.19678426221308654
M1	string	0	network_modules	129	TRUE	2.6882896299502295e-10	63	30	8	0.26666666666666666	0.12698412698412698	GO:1904356	GO:BP	regulation of telomere maintenance via telomere lengthening	16175	23743		0.42857142857142855	0.43859649122807015	63	16112	8	22	55	16090	16175	0.1818526325386692
M1	string	0	network_modules	129	TRUE	3.9722991841130817e-10	66	30	8	0.26666666666666666	0.12121212121212122	GO:0061077	GO:BP	chaperone-mediated protein folding	16175	15193		0.44642857142857145	0.45614035087719296	66	16109	8	22	58	16087	16175	0.1775626795333123
M1	string	0	network_modules	129	TRUE	5.761837066369642e-10	69	30	8	0.26666666666666666	0.11594202898550725	GO:0032206	GO:BP	positive regulation of telomere maintenance	16175	7398		0.4642857142857143	0.47368421052631576	69	16106	8	22	61	16084	16175	0.17355322742450066
M1	string	0	network_modules	129	TRUE	7.313600356889081e-10	71	30	8	0.26666666666666666	0.11267605633802817	GO:0007004	GO:BP	telomere maintenance via telomerase	16175	2616		0.48214285714285715	0.5087719298245614	71	16104	8	22	63	16082	16175	0.17102135253970993
M1	string	0	network_modules	129	TRUE	7.313600356889081e-10	71	30	8	0.26666666666666666	0.11267605633802817	GO:0006278	GO:BP	RNA-templated DNA biosynthetic process	16175	2093		0.48214285714285715	0.5087719298245614	71	16104	8	22	63	16082	16175	0.17102135253970993
M1	string	0	network_modules	129	TRUE	1.4359906303827e-9	77	30	8	0.26666666666666666	0.1038961038961039	GO:1900182	GO:BP	positive regulation of protein localization to nucleus	16175	20458		0.5178571428571429	0.5263157894736842	77	16098	8	22	69	16076	16175	0.16402135810254673
M1	string	0	network_modules	129	TRUE	2.949925247376382e-9	84	30	8	0.26666666666666666	0.09523809523809523	GO:0010833	GO:BP	telomere maintenance via telomere lengthening	16175	4443		0.5357142857142857	0.543859649122807	84	16091	8	22	76	16069	16175	0.1568131061827338
M1	string	0	network_modules	129	TRUE	3.2524599253073304e-9	85	30	8	0.26666666666666666	0.09411764705882353	GO:2000278	GO:BP	regulation of DNA biosynthetic process	16175	25603		0.5535714285714286	0.5614035087719298	85	16090	8	22	77	16068	16175	0.15585593131666473
M1	string	0	network_modules	129	TRUE	3.79151164431365e-9	140	30	9	0.3	0.06428571428571428	GO:0071897	GO:BP	DNA biosynthetic process	16175	16970		0.5714285714285714	0.5789473684210527	140	16035	9	21	131	16014	16175	0.13557963672773213
M1	string	0	network_modules	129	TRUE	5.245484063686683e-9	23	28	6	0.21428571428571427	0.2608695652173913	REAC:R-HSA-5620922	REAC	BBSome-mediated cargo-targeting to cilium	10916	199		0.17391304347826086	0.19148936170212766	23	10893	6	22	17	10871	10916	0.23465652363114398
M1	string	0	network_modules	129	TRUE	9.167392718958199e-9	229	30	10	0.3333333333333333	0.043668122270742356	GO:0033044	GO:BP	regulation of chromosome organization	16175	7999		0.5892857142857143	0.5964912280701754	229	15946	10	20	219	15926	16175	0.11645873459303833
M1	string	0	network_modules	129	TRUE	1.0468910556342055e-8	98	30	8	0.26666666666666666	0.08163265306122448	GO:2001252	GO:BP	positive regulation of chromosome organization	16175	26441		0.6071428571428571	0.6140350877192983	98	16077	8	22	90	16055	16175	0.14476313568830718
M1	string	0	network_modules	129	TRUE	1.117701022632562e-8	200	28	10	0.35714285714285715	0.05	REAC:R-HSA-5617833	REAC	Cilium Assembly	10916	361		0.1956521739130435	0.2127659574468085	200	10716	10	18	190	10698	10916	0.12811725342454294
M1	string	0	network_modules	129	TRUE	1.7010938938724793e-8	104	30	8	0.26666666666666666	0.07692307692307693	GO:0032204	GO:BP	regulation of telomere maintenance	16175	7396		0.625	0.631578947368421	104	16071	8	22	96	16049	16175	0.1403514167805678
M1	string	0	network_modules	129	TRUE	2.6861434610479307e-8	110	30	8	0.26666666666666666	0.07272727272727272	GO:1900180	GO:BP	regulation of protein localization to nucleus	16175	20456		0.6428571428571429	0.6491228070175439	110	16065	8	22	102	16043	16175	0.1363009011005712
M1	string	0	network_modules	129	TRUE	4.069622686008466e-8	182	30	9	0.3	0.04945054945054945	GO:0006457	GO:BP	protein folding	16175	2203		0.6607142857142857	0.6666666666666666	182	15993	9	21	173	15972	16175	0.11800606167178006
M1	string	0	network_modules	129	TRUE	1.0313321535984806e-7	115	28	8	0.2857142857142857	0.06956521739130435	REAC:R-HSA-9648025	REAC	EML4 and NUDC in mitotic spindle formation	10916	817		0.21739130434782608	0.23404255319148937	115	10801	8	20	107	10781	10916	0.13667948415415013
M1	string	0	network_modules	129	TRUE	1.7722781378175653e-7	123	28	8	0.2857142857142857	0.06504065040650407	REAC:R-HSA-2500257	REAC	Resolution of Sister Chromatid Cohesion	10916	2079		0.2391304347826087	0.2553191489361702	123	10793	8	20	115	10773	10916	0.13185676472218447
M1	string	0	network_modules	129	TRUE	3.1117843848789877e-7	149	30	8	0.26666666666666666	0.053691275167785234	GO:0006403	GO:BP	RNA localization	16175	2164		0.6785714285714286	0.6842105263157895	149	16026	8	22	141	16004	16175	0.11616662836728273
M1	string	0	network_modules	129	TRUE	3.6504671218935743e-7	152	30	8	0.26666666666666666	0.05263157894736842	GO:0000723	GO:BP	telomere maintenance	16175	202		0.6964285714285714	0.7017543859649122	152	16023	8	22	144	16001	16175	0.11494243617140626
M1	string	0	network_modules	129	TRUE	3.964210367028419e-7	136	28	8	0.2857142857142857	0.058823529411764705	REAC:R-HSA-5663220	REAC	RHO GTPases Activate Formins	10916	1848		0.2608695652173913	0.2765957446808511	136	10780	8	20	128	10760	10916	0.12492765250016599
M1	string	0	network_modules	129	TRUE	4.5969860949713005e-7	292	28	10	0.35714285714285715	0.03424657534246575	REAC:R-HSA-1852241	REAC	Organelle biogenesis and maintenance	10916	1646		0.2826086956521739	0.2978723404255319	292	10624	10	18	282	10606	10916	0.1038398472736477
M1	string	0	network_modules	129	TRUE	8.915144243395273e-7	51	28	6	0.21428571428571427	0.11764705882352941	REAC:R-HSA-5620920	REAC	Cargo trafficking to the periciliary membrane	10916	310		0.30434782608695654	0.3191489361702128	51	10865	6	22	45	10843	10916	0.1558791904921862
M1	string	0	network_modules	129	TRUE	1.0535669550063469e-6	228	28	9	0.32142857142857145	0.039473684210526314	REAC:R-HSA-68882	REAC	Mitotic Anaphase	10916	1479		0.32608695652173914	0.3404255319148936	228	10688	9	19	219	10669	10916	0.10657558452199113
M1	string	0	network_modules	129	TRUE	1.0949225439758601e-6	229	28	9	0.32142857142857145	0.039301310043668124	REAC:R-HSA-2555396	REAC	Mitotic Metaphase and Anaphase	10916	1482		0.34782608695652173	0.3617021276595745	229	10687	9	19	220	10668	10916	0.10631519136461896
M1	string	0	network_modules	129	TRUE	1.5342626028021099e-6	182	30	8	0.26666666666666666	0.04395604395604396	GO:0032200	GO:BP	telomere organization	16175	7392		0.7142857142857143	0.7192982456140351	182	15993	8	22	174	15971	16175	0.10438333714163665
M1	string	0	network_modules	129	TRUE	3.93437602613791e-6	205	30	8	0.26666666666666666	0.03902439024390244	GO:0050821	GO:BP	protein stabilization	16175	13283		0.7321428571428571	0.7368421052631579	205	15970	8	22	197	15948	16175	0.0978763775000071
M1	string	0	network_modules	129	TRUE	5.145946181977825e-6	188	28	8	0.2857142857142857	0.0425531914893617	REAC:R-HSA-2467813	REAC	Separation of Sister Chromatids	10916	2204		0.3695652173913043	0.3829787234042553	188	10728	8	20	180	10708	10916	0.10465531829850373
M1	string	0	network_modules	129	TRUE	6.2802215069489915e-6	70	28	6	0.21428571428571427	0.08571428571428572	REAC:R-HSA-2995410	REAC	Nuclear Envelope (NE) Reassembly	10916	1612		0.391304347826087	0.40425531914893614	70	10846	6	22	64	10824	10916	0.1320635532024336
M1	string	0	network_modules	129	TRUE	8.031857360390155e-6	199	28	8	0.2857142857142857	0.04020100502512563	REAC:R-HSA-68877	REAC	Mitotic Prometaphase	10916	1484		0.41304347826086957	0.425531914893617	199	10717	8	20	191	10697	10916	0.10139193460123275
M1	string	0	network_modules	129	TRUE	9.56146062084323e-6	75	28	6	0.21428571428571427	0.08	REAC:R-HSA-9833482	REAC	PKR-mediated signaling	10916	1692		0.43478260869565216	0.44680851063829785	75	10841	6	22	69	10819	10916	0.12733373585296376
M1	string	0	network_modules	129	TRUE	1.4026856092301301e-5	241	30	8	0.26666666666666666	0.03319502074688797	GO:0034504	GO:BP	protein localization to nucleus	16175	8670		0.75	0.7543859649122807	241	15934	8	22	233	15912	16175	0.08958060560390517
M1	string	0	network_modules	129	TRUE	1.4963633770554053e-5	243	30	8	0.26666666666666666	0.03292181069958848	GO:1904951	GO:BP	positive regulation of establishment of protein localization	16175	24241		0.7678571428571429	0.7719298245614035	243	15932	8	22	235	15910	16175	0.08917298273414123
M1	string	0	network_modules	129	TRUE	1.647019866013245e-5	246	30	8	0.26666666666666666	0.032520325203252036	GO:0051054	GO:BP	positive regulation of DNA metabolic process	16175	13464		0.7857142857142857	0.7894736842105263	246	15929	8	22	238	15907	16175	0.08857059433554339
M1	string	0	network_modules	129	TRUE	2.5742068229053567e-5	44	28	5	0.17857142857142858	0.11363636363636363	REAC:R-HSA-9646399	REAC	Aggrephagy	10916	129		0.45652173913043476	0.46808510638297873	44	10872	5	23	39	10849	10916	0.13969601278610963
M1	string	0	network_modules	129	TRUE	3.738291085098835e-5	170	17	6	0.35294117647058826	0.03529411764705882	KEGG:04530	KEGG	Tight junction	8484	317		0	0.3333333333333333	170	8314	6	11	164	8303	8484	0.10645086058703056
M1	string	0	network_modules	129	TRUE	4.1793801519378176e-5	545	30	10	0.3333333333333333	0.01834862385321101	GO:0051276	GO:BP	chromosome organization	16175	13613		0.8035714285714286	0.8070175438596491	545	15630	10	20	535	15610	16175	0.07158252511916913
M1	string	0	network_modules	129	TRUE	5.4369434852958e-5	20	28	4	0.14285714285714285	0.2	REAC:R-HSA-190840	REAC	Microtubule-dependent trafficking of connexons from Golgi to the plasma membrane	10916	1451		0.4782608695652174	0.48936170212765956	20	10896	4	24	16	10872	10916	0.1672306805562951
M1	string	0	network_modules	129	TRUE	6.389515649509321e-5	420	30	9	0.3	0.02142857142857143	GO:0010638	GO:BP	positive regulation of organelle organization	16175	4284		0.8214285714285714	0.8245614035087719	420	15755	9	21	411	15734	16175	0.07427736659386673
M1	string	0	network_modules	129	TRUE	6.704406417267944e-5	21	28	4	0.14285714285714285	0.19047619047619047	REAC:R-HSA-190872	REAC	Transport of connexons to the plasma membrane	10916	2592		0.5	0.5106382978723404	21	10895	4	24	17	10871	10916	0.163101904366655
M1	string	0	network_modules	129	TRUE	7.125688677065583e-5	297	30	8	0.26666666666666666	0.026936026936026935	GO:0031647	GO:BP	regulation of protein stability	16175	7257		0.8392857142857143	0.8421052631578947	297	15878	8	22	289	15856	16175	0.07972512867882045
M1	string	0	network_modules	129	TRUE	8.445546892899441e-5	5	30	3	0.1	0.6	GO:0090666	GO:BP	scaRNA localization to Cajal body	16175	18396		0.8571428571428571	0.8596491228070176	5	16170	3	27	2	16143	16175	0.2444563448700135
M1	string	0	network_modules	129	TRUE	8.633087194680203e-5	435	30	9	0.3	0.020689655172413793	GO:0051052	GO:BP	regulation of DNA metabolic process	16175	13462		0.875	0.8771929824561403	435	15740	9	21	426	15719	16175	0.07277314908232005
M1	string	0	network_modules	129	TRUE	1.1840537105962163e-4	24	28	4	0.14285714285714285	0.16666666666666666	REAC:R-HSA-389977	REAC	Post-chaperonin tubulin folding pathway	10916	1773		0.5217391304347826	0.5319148936170213	24	10892	4	24	20	10868	10916	0.1522913161948195
M1	string	0	network_modules	129	TRUE	1.4970583109076265e-4	195	28	7	0.25	0.035897435897435895	REAC:R-HSA-69275	REAC	G2/M Transition	10916	1008		0.5434782608695652	0.5531914893617021	195	10721	7	21	188	10700	10916	0.08887438662701805
M1	string	0	network_modules	129	TRUE	1.5304404953980034e-4	406	28	9	0.32142857142857145	0.022167487684729065	REAC:R-HSA-68886	REAC	M Phase	10916	1343		0.5652173913043478	0.574468085106383	406	10510	9	19	397	10491	10916	0.07616972191907422
M1	string	0	network_modules	129	TRUE	1.604229142183633e-4	197	28	7	0.25	0.03553299492385787	REAC:R-HSA-453274	REAC	Mitotic G2-G2/M phases	10916	1481		0.5869565217391305	0.5957446808510638	197	10719	7	21	190	10698	10916	0.0883605503874493
M1	string	0	network_modules	129	TRUE	2.108772422782912e-4	483	30	9	0.3	0.018633540372670808	GO:0051604	GO:BP	protein maturation	16175	13821		0.8928571428571429	0.8947368421052632	483	15692	9	21	474	15671	16175	0.06841646505188584
M1	string	0	network_modules	129	TRUE	2.2655102486603932e-4	28	28	4	0.14285714285714285	0.14285714285714285	REAC:R-HSA-9619483	REAC	Activation of AMPK downstream of NMDARs	10916	73		0.6086956521739131	0.6170212765957447	28	10888	4	24	24	10864	10916	0.1406528812847696
M1	string	0	network_modules	129	TRUE	2.959029980539127e-4	318	28	8	0.2857142857142857	0.025157232704402517	REAC:R-HSA-195258	REAC	RHO GTPase Effectors	10916	1846		0.6304347826086957	0.6382978723404256	318	10598	8	20	310	10578	10916	0.07736960867843423
M1	string	0	network_modules	129	TRUE	3.9509570641568716e-4	32	28	4	0.14285714285714285	0.125	REAC:R-HSA-5626467	REAC	RHO GTPases activate IQGAPs	10916	1854		0.6521739130434783	0.6808510638297872	32	10884	4	24	28	10860	10916	0.131249184583613
M1	string	0	network_modules	129	TRUE	3.9509570641568716e-4	32	28	4	0.14285714285714285	0.125	REAC:R-HSA-9668328	REAC	Sealing of the nuclear envelope (NE) by ESCRT-III	10916	2185		0.6521739130434783	0.6808510638297872	32	10884	4	24	28	10860	10916	0.131249184583613
M1	string	0	network_modules	129	TRUE	4.096778093328746e-4	373	30	8	0.26666666666666666	0.021447721179624665	GO:0072594	GO:BP	establishment of protein localization to organelle	16175	17458		0.9107142857142857	0.9122807017543859	373	15802	8	22	365	15780	16175	0.06996230680711839
M1	string	0	network_modules	129	TRUE	4.354497373402532e-4	376	30	8	0.26666666666666666	0.02127659574468085	GO:1903829	GO:BP	positive regulation of protein localization	16175	23311		0.9285714285714286	0.9298245614035088	376	15799	8	22	368	15777	16175	0.06963620004953576
M1	string	0	network_modules	129	TRUE	5.295489525499881e-4	147	28	6	0.21428571428571427	0.04081632653061224	REAC:R-HSA-1169410	REAC	Antiviral mechanism by IFN-stimulated genes	10916	157		0.6956521739130435	0.7021276595744681	147	10769	6	22	141	10747	10916	0.08835425239517489
M1	string	0	network_modules	129	TRUE	5.348277596199932e-4	80	28	5	0.17857142857142858	0.0625	REAC:R-HSA-9663891	REAC	Selective autophagy	10916	2186		0.717391304347826	0.723404255319149	80	10836	5	23	75	10813	10916	0.10181251247318489
M1	string	0	network_modules	129	TRUE	6.967436836514757e-4	400	30	8	0.26666666666666666	0.02	GO:0070201	GO:BP	regulation of establishment of protein localization	16175	15984		0.9464285714285714	0.9473684210526315	400	15775	8	22	392	15753	16175	0.06715429053207589
M1	string	0	network_modules	129	TRUE	8.024869390644554e-4	38	28	4	0.14285714285714285	0.10526315789473684	REAC:R-HSA-190861	REAC	Gap junction assembly	10916	1033		0.7391304347826086	0.7446808510638298	38	10878	4	24	34	10854	10916	0.12000247458747305
M1	string	0	network_modules	129	TRUE	0.001329900876644402	43	28	4	0.14285714285714285	0.09302325581395349	REAC:R-HSA-9609736	REAC	Assembly and cell surface presentation of NMDA receptors	10916	173		0.7608695652173914	0.7659574468085106	43	10873	4	24	39	10849	10916	0.1124651576211815
M1	string	0	network_modules	129	TRUE	0.001352575625498323	792	30	10	0.3333333333333333	0.012626262626262626	GO:0000278	GO:BP	mitotic cell cycle	16175	76		0.9642857142857143	0.9649122807017544	792	15383	10	20	782	15363	16175	0.0568047760236387
M1	string	0	network_modules	129	TRUE	0.00142001927115441	88	17	4	0.23529411764705882	0.045454545454545456	KEGG:04540	KEGG	Gap junction	8484	318		0.5	0.6666666666666666	88	8396	4	13	84	8383	8484	0.09947502430571274
M1	string	0	network_modules	129	TRUE	0.001599966304579915	45	28	4	0.14285714285714285	0.08888888888888889	REAC:R-HSA-8955332	REAC	Carboxyterminal post-translational modifications of tubulin	10916	305		0.782608695652174	0.7872340425531915	45	10871	4	24	41	10847	10916	0.10980263172444771
M1	string	0	network_modules	129	TRUE	0.0016233014647364032	808	30	10	0.3333333333333333	0.012376237623762377	GO:0033365	GO:BP	protein localization to organelle	16175	8175		0.9821428571428571	0.9824561403508771	808	15367	10	20	798	15347	16175	0.056073078991856914
M1	string	0	network_modules	129	TRUE	0.0019572056150882694	32	17	3	0.17647058823529413	0.09375	KEGG:04136	KEGG	Autophagy - other	8484	273		1	1	32	8452	3	14	29	8438	8484	0.12623938878020086
M1	string	0	network_modules	129	TRUE	0.0020784647708732263	48	28	4	0.14285714285714285	0.08333333333333333	REAC:R-HSA-437239	REAC	Recycling pathway of L1	10916	1954		0.8043478260869565	0.8085106382978723	48	10868	4	24	44	10844	10916	0.10611997859182681
M1	string	0	network_modules	129	TRUE	0.0022592346565095127	49	28	4	0.14285714285714285	0.08163265306122448	REAC:R-HSA-190828	REAC	Gap junction trafficking	10916	1035		0.8260869565217391	0.8297872340425532	49	10867	4	24	45	10843	10916	0.1049668774982743
M1	string	0	network_modules	129	TRUE	0.002451368611378386	50	28	4	0.14285714285714285	0.08	REAC:R-HSA-157858	REAC	Gap junction trafficking and regulation	10916	1036		0.8478260869565217	0.851063829787234	50	10866	4	24	46	10842	10916	0.10384788916439051
M1	string	0	network_modules	129	TRUE	0.0029558999244426684	305	28	7	0.25	0.022950819672131147	REAC:R-HSA-446203	REAC	Asparagine N-linked glycosylation	10916	169		0.8695652173913043	0.8723404255319149	305	10611	7	21	298	10590	10916	0.06832969750786655
M1	string	0	network_modules	129	TRUE	0.0031004744103185896	53	28	4	0.14285714285714285	0.07547169811320754	REAC:R-HSA-6811436	REAC	COPI-independent Golgi-to-ER retrograde traffic	10916	278		0.8913043478260869	0.8936170212765957	53	10863	4	24	49	10839	10916	0.10067941399392634
M1	string	0	network_modules	129	TRUE	0.003342620028389221	54	28	4	0.14285714285714285	0.07407407407407407	REAC:R-HSA-5620924	REAC	Intraflagellar transport	10916	1267		0.9130434782608695	0.9148936170212766	54	10862	4	24	50	10838	10916	0.09968121769825093
M1	string	0	network_modules	129	TRUE	0.0038805484737583704	684	30	9	0.3	0.013157894736842105	GO:0032880	GO:BP	regulation of protein localization	16175	7877		1	1	684	15491	9	21	675	15470	16175	0.05520184975098629
M1	string	0	network_modules	129	TRUE	0.004153062853815473	57	28	4	0.14285714285714285	0.07017543859649122	REAC:R-HSA-3371497	REAC	HSP90 chaperone cycle for steroid hormone receptors (SHR) in the presence of ligand	10916	1111		0.9347826086956522	0.9361702127659575	57	10859	4	24	53	10835	10916	0.09684260186169096
M1	string	0	network_modules	129	TRUE	0.005099887424143101	60	28	4	0.14285714285714285	0.06666666666666667	REAC:R-HSA-983189	REAC	Kinesins	10916	1292		0.9565217391304348	0.9574468085106383	60	10856	4	24	56	10832	10916	0.09421503180602728
M1	string	0	network_modules	129	TRUE	0.006753013743562756	134	28	5	0.17857142857142858	0.03731343283582089	REAC:R-HSA-1632852	REAC	Macroautophagy	10916	1388		0.9782608695652174	0.9787234042553191	134	10782	5	23	129	10759	10916	0.07658573533100183
M1	string	0	network_modules	129	TRUE	0.008621658689588536	23	28	3	0.10714285714285714	0.13043478260869565	REAC:R-HSA-9013418	REAC	RHOBTB2 GTPase cycle	10916	1863		1	1	23	10893	3	25	20	10868	10916	0.11616315664365395
M1	string	0	network_modules	131	TRUE	6.16191612924479e-9	131	18	8	0.4444444444444444	0.061068702290076333	KEGG:04142	KEGG	Lysosome	8484	279		0	0.5	131	8353	8	10	123	8343	8484	0.16043600651445547
M1	string	0	network_modules	131	TRUE	2.3821130884417455e-7	11	15	4	0.26666666666666666	0.36363636363636365	REAC:R-HSA-2206281	REAC	Mucopolysaccharidoses	10916	1493		0	0.2	11	10905	4	11	7	10894	10916	0.31059273724498043
M1	string	0	network_modules	131	TRUE	3.315035680730174e-6	19	18	4	0.2222222222222222	0.21052631578947367	KEGG:00531	KEGG	Glycosaminoglycan degradation	8484	75		1	1	19	8465	4	14	15	8451	8484	0.2145833650689005
M1	string	0	network_modules	131	TRUE	2.9018166592100384e-5	33	15	4	0.26666666666666666	0.12121212121212122	REAC:R-HSA-5663084	REAC	Diseases of carbohydrate metabolism	10916	763		0.25	0.4	33	10883	4	11	29	10872	10916	0.17814018728378672
M1	string	0	network_modules	131	TRUE	0.00293052110335139	2	23	2	0.08695652173913043	1	GO:0051412	GO:BP	response to corticosterone	16175	13699		NA	1	2	16173	2	21	0	16152	16175	0.29469240258173435
M1	string	0	network_modules	131	TRUE	0.006379445879002114	125	15	4	0.26666666666666666	0.032	REAC:R-HSA-1630316	REAC	Glycosaminoglycan metabolism	10916	1076		0.5	0.6	125	10791	4	11	121	10780	10916	0.08898100909604133
M1	string	0	network_modules	131	TRUE	0.008287360130236775	6	15	2	0.13333333333333333	0.3333333333333333	REAC:R-HSA-193993	REAC	Mineralocorticoid biosynthesis	10916	1452		0.75	0.8	6	10910	2	13	4	10897	10916	0.21015159549681772
M1	string	0	network_modules	131	TRUE	0.00938329617160686	288	15	5	0.3333333333333333	0.017361111111111112	REAC:R-HSA-71387	REAC	Metabolism of carbohydrates	10916	1422		1	1	288	10628	5	10	283	10618	10916	0.07104306144757654
M1	string	0	network_modules	132	TRUE	2.265207769560927e-10	8	20	5	0.25	0.625	REAC:R-HSA-72731	REAC	Recycling of eIF2:GDP	10916	1953		0	0.08333333333333333	8	10908	5	15	3	10893	10916	0.3946321233008302
M1	string	0	network_modules	132	TRUE	5.886875540858033e-10	49	20	7	0.35	0.14285714285714285	REAC:R-HSA-373752	REAC	Netrin-1 signaling	10916	1586		0.09090909090909091	0.16666666666666666	49	10867	7	13	42	10854	10916	0.22143904717672358
M1	string	0	network_modules	132	TRUE	1.0888418407646668e-7	43	27	6	0.2222222222222222	0.13953488372093023	GO:0002183	GO:BP	cytoplasmic translational initiation	16175	731		0	0.034482758620689655	43	16132	6	21	37	16111	16175	0.17436094037085778
M1	string	0	network_modules	132	TRUE	1.9286656915919484e-7	8	20	4	0.2	0.5	REAC:R-HSA-418886	REAC	Netrin mediated repulsion signals	10916	1585		0.18181818181818182	0.25	8	10908	4	16	4	10892	10916	0.31547364741049827
M1	string	0	network_modules	132	TRUE	2.7336463569453397e-7	21	27	5	0.18518518518518517	0.23809523809523808	GO:0014003	GO:BP	oligodendrocyte development	16175	4576		0.03571428571428571	0.06896551724137931	21	16154	5	22	16	16132	16175	0.2088179708312094
M1	string	0	network_modules	132	TRUE	2.9087930136666974e-7	165	27	8	0.2962962962962963	0.048484848484848485	GO:0097485	GO:BP	neuron projection guidance	16175	18673		0.07142857142857142	0.13793103448275862	165	16010	8	19	157	15991	16175	0.11642332298393891
M1	string	0	network_modules	132	TRUE	2.9087930136666974e-7	165	27	8	0.2962962962962963	0.048484848484848485	GO:0007411	GO:BP	axon guidance	16175	2906		0.07142857142857142	0.13793103448275862	165	16010	8	19	157	15991	16175	0.11642332298393891
M1	string	0	network_modules	132	TRUE	1.0947542905025104e-6	181	16	7	0.4375	0.03867403314917127	KEGG:04360	KEGG	Axon guidance	8484	305		NA	1	181	8303	7	9	174	8294	8484	0.12519290818349751
M1	string	0	network_modules	132	TRUE	1.1520946777100353e-6	297	27	9	0.3333333333333333	0.030303030303030304	GO:0007409	GO:BP	axonogenesis	16175	2905		0.14285714285714285	0.1724137931034483	297	15878	9	18	288	15860	16175	0.09593170483733396
M1	string	0	network_modules	132	TRUE	1.784649603218882e-6	441	27	10	0.37037037037037035	0.022675736961451247	GO:0048812	GO:BP	neuron projection morphogenesis	16175	13058		0.17857142857142858	0.20689655172413793	441	15734	10	17	431	15717	16175	0.08615020978629657
M1	string	0	network_modules	132	TRUE	2.465632408754098e-6	456	27	10	0.37037037037037035	0.021929824561403508	GO:0120039	GO:BP	plasma membrane bounded cell projection morphogenesis	16175	19473		0.21428571428571427	0.2413793103448276	456	15719	10	17	446	15702	16175	0.08453273408311662
M1	string	0	network_modules	132	TRUE	2.6824879935238163e-6	460	27	10	0.37037037037037035	0.021739130434782608	GO:0048858	GO:BP	cell projection morphogenesis	16175	13102		0.25	0.27586206896551724	460	15715	10	17	450	15698	16175	0.08411427463879977
M1	string	0	network_modules	132	TRUE	3.6861159935004902e-6	339	27	9	0.3333333333333333	0.02654867256637168	GO:0061564	GO:BP	axon development	16175	15561		0.2857142857142857	0.3103448275862069	339	15836	9	18	330	15818	16175	0.08917036905325519
M1	string	0	network_modules	132	TRUE	9.767222354617183e-6	379	27	9	0.3333333333333333	0.023746701846965697	GO:0048667	GO:BP	cell morphogenesis involved in neuron differentiation	16175	12925		0.32142857142857145	0.3448275862068966	379	15796	9	18	370	15778	16175	0.08377186225775098
M1	string	0	network_modules	132	TRUE	1.7899249361227236e-5	46	27	5	0.18518518518518517	0.10869565217391304	GO:0048709	GO:BP	oligodendrocyte differentiation	16175	12966		0.35714285714285715	0.3793103448275862	46	16129	5	22	41	16107	16175	0.1400132665338203
M1	string	0	network_modules	132	TRUE	2.374138939143216e-5	761	27	11	0.4074074074074074	0.01445466491458607	GO:0048666	GO:BP	neuron development	16175	12924		0.39285714285714285	0.41379310344827586	761	15414	11	16	750	15398	16175	0.06959094976733249
M1	string	0	network_modules	132	TRUE	3.748390194306141e-5	111	27	6	0.2222222222222222	0.05405405405405406	GO:0006413	GO:BP	translational initiation	16175	2171		0.42857142857142855	0.4482758620689655	111	16064	6	21	105	16043	16175	0.10667018865687324
M1	string	0	network_modules	132	TRUE	7.377319299727788e-5	651	27	10	0.37037037037037035	0.015360983102918587	GO:0000902	GO:BP	cell morphogenesis	16175	240		0.4642857142857143	0.4827586206896552	651	15524	10	17	641	15507	16175	0.06868317638419978
M1	string	0	network_modules	132	TRUE	7.637173131794986e-5	61	27	5	0.18518518518518517	0.08196721311475409	GO:0021782	GO:BP	glial cell development	16175	6360		0.5	0.5172413793103449	61	16114	5	22	56	16092	16175	0.12102381621061131
M1	string	0	network_modules	132	TRUE	1.1747791029392317e-4	684	27	10	0.37037037037037035	0.014619883040935672	GO:0031175	GO:BP	neuron projection development	16175	7086		0.5357142857142857	0.5517241379310345	684	15491	10	17	674	15474	16175	0.06666265472529875
M1	string	0	network_modules	132	TRUE	1.6525441798566785e-4	71	27	5	0.18518518518518517	0.07042253521126761	GO:0009408	GO:BP	response to heat	16175	3473		0.5714285714285714	0.5862068965517241	71	16104	5	22	66	16082	16175	0.11183013042504673
M1	string	0	network_modules	132	TRUE	3.083113986940238e-4	158	27	6	0.2222222222222222	0.0379746835443038	GO:0002181	GO:BP	cytoplasmic translation	16175	729		0.6071428571428571	0.6206896551724138	158	16017	6	21	152	15996	16175	0.08833091062119745
M1	string	0	network_modules	132	TRUE	5.769938365037646e-4	91	27	5	0.18518518518518517	0.054945054945054944	GO:0009749	GO:BP	response to glucose	16175	3646		0.6428571428571429	0.6551724137931034	91	16084	5	22	86	16062	16175	0.09816502485527304
M1	string	0	network_modules	132	TRUE	6.433583724643929e-4	93	27	5	0.18518518518518517	0.053763440860215055	GO:0009746	GO:BP	response to hexose	16175	3643		0.6785714285714286	0.7241379310344828	93	16082	5	22	88	16060	16175	0.09704291652620041
M1	string	0	network_modules	132	TRUE	6.433583724643929e-4	93	27	5	0.18518518518518517	0.053763440860215055	GO:0034284	GO:BP	response to monosaccharide	16175	8541		0.6785714285714286	0.7241379310344828	93	16082	5	22	88	16060	16175	0.09704291652620041
M1	string	0	network_modules	132	TRUE	6.777786061181616e-4	120	20	5	0.25	0.041666666666666664	REAC:R-HSA-72613	REAC	Eukaryotic Translation Initiation	10916	871		0.2727272727272727	0.4166666666666667	120	10796	5	15	115	10781	10916	0.09820497031067665
M1	string	0	network_modules	132	TRUE	6.777786061181616e-4	120	20	5	0.25	0.041666666666666664	REAC:R-HSA-72737	REAC	Cap-dependent Translation Initiation	10916	304		0.2727272727272727	0.4166666666666667	120	10796	5	15	115	10781	10916	0.09820497031067665
M1	string	0	network_modules	132	TRUE	9.246076192810394e-4	100	27	5	0.18518518518518517	0.05	GO:0009266	GO:BP	response to temperature stimulus	16175	3431		0.75	0.7586206896551724	100	16075	5	22	95	16053	16175	0.09337941453069898
M1	string	0	network_modules	132	TRUE	9.716592571671246e-4	101	27	5	0.18518518518518517	0.04950495049504951	GO:0009743	GO:BP	response to carbohydrate	16175	3640		0.7857142857142857	0.7931034482758621	101	16074	5	22	96	16052	16175	0.09288678824431945
M1	string	0	network_modules	132	TRUE	0.0017744293527428986	114	27	5	0.18518518518518517	0.043859649122807015	GO:0050852	GO:BP	T cell receptor signaling pathway	16175	13300		0.8214285714285714	0.8275862068965517	114	16061	5	22	109	16039	16175	0.08707287430964225
M1	string	0	network_modules	132	TRUE	0.0021950455892014815	119	27	5	0.18518518518518517	0.04201680672268908	GO:0010001	GO:BP	glial cell differentiation	16175	3822		0.8571428571428571	0.8620689655172413	119	16056	5	22	114	16034	16175	0.0850893405189631
M1	string	0	network_modules	132	TRUE	0.0026765051786323546	22	20	3	0.15	0.13636363636363635	REAC:R-HSA-167242	REAC	Abortive elongation of HIV-1 transcript in the absence of Tat	10916	51		0.45454545454545453	0.5	22	10894	3	17	19	10877	10916	0.14136975430520027
M1	string	0	network_modules	132	TRUE	0.002909733243755928	15	27	3	0.1111111111111111	0.2	GO:0034244	GO:BP	negative regulation of transcription elongation by RNA polymerase II	16175	8520		0.8928571428571429	0.896551724137931	15	16160	3	24	12	16136	16175	0.14801920198550775
M1	string	0	network_modules	132	TRUE	0.006169238979555305	19	27	3	0.1111111111111111	0.15789473684210525	GO:0032785	GO:BP	negative regulation of DNA-templated transcription, elongation	16175	7820		0.9285714285714286	0.9310344827586207	19	16156	3	24	16	16132	16175	0.13123957709566395
M1	string	0	network_modules	132	TRUE	0.006990565280179796	30	20	3	0.15	0.1	REAC:R-HSA-167238	REAC	Pausing and recovery of Tat-mediated HIV elongation	10916	1720		0.5454545454545454	0.6666666666666666	30	10886	3	17	27	10869	10916	0.12050654140969698
M1	string	0	network_modules	132	TRUE	0.006990565280179796	30	20	3	0.15	0.1	REAC:R-HSA-167243	REAC	Tat-mediated HIV elongation arrest and recovery	10916	2484		0.5454545454545454	0.6666666666666666	30	10886	3	17	27	10869	10916	0.12050654140969698
M1	string	0	network_modules	132	TRUE	0.008315877801524223	156	27	5	0.18518518518518517	0.03205128205128205	GO:0042063	GO:BP	gliogenesis	16175	9949		0.9642857142857143	0.9655172413793104	156	16019	5	22	151	15997	16175	0.0734453928026276
M1	string	0	network_modules	132	TRUE	0.008520256921361111	32	20	3	0.15	0.09375	REAC:R-HSA-167290	REAC	Pausing and recovery of HIV elongation	10916	1719		0.7272727272727273	1	32	10884	3	17	29	10867	10916	0.11654548499042781
M1	string	0	network_modules	132	TRUE	0.008520256921361111	32	20	3	0.15	0.09375	REAC:R-HSA-167158	REAC	Formation of the HIV-1 Early Elongation Complex	10916	965		0.7272727272727273	1	32	10884	3	17	29	10867	10916	0.11654548499042781
M1	string	0	network_modules	132	TRUE	0.008520256921361111	32	20	3	0.15	0.09375	REAC:R-HSA-113418	REAC	Formation of the Early Elongation Complex	10916	963		0.7272727272727273	1	32	10884	3	17	29	10867	10916	0.11654548499042781
M1	string	0	network_modules	132	TRUE	0.008520256921361111	32	20	3	0.15	0.09375	REAC:R-HSA-167287	REAC	HIV elongation arrest and recovery	10916	1106		0.7272727272727273	1	32	10884	3	17	29	10867	10916	0.11654548499042781
M1	string	0	network_modules	132	TRUE	0.00884996427048926	158	27	5	0.18518518518518517	0.03164556962025317	GO:0050851	GO:BP	antigen receptor-mediated signaling pathway	16175	13299		1	1	158	16017	5	22	153	15995	16175	0.07293221602624715
M1	string	0	network_modules	133	TRUE	2.731421463920864e-4	2	11	2	0.18181818181818182	1	REAC:R-HSA-3359473	REAC	Defective MMADHC causes MMAHCD	10916	583		0	0.5	2	10914	2	9	0	10905	10916	0.4262255849756329
M1	string	0	network_modules	133	TRUE	4.960892978658017e-4	69	6	3	0.5	0.043478260869565216	KEGG:04924	KEGG	Renin secretion	8484	381		0	0.3333333333333333	69	8415	3	3	66	8412	8484	0.14568864304302157
M1	string	0	network_modules	133	TRUE	0.0013856302054649813	97	6	3	0.5	0.030927835051546393	KEGG:04713	KEGG	Circadian entrainment	8484	348		0.5	0.6666666666666666	97	8387	3	3	94	8384	8484	0.12225433434182988
M1	string	0	network_modules	133	TRUE	0.005720235538810698	7	11	2	0.18181818181818182	0.2857142857142857	REAC:R-HSA-9759218	REAC	Cobalamin (Cbl) metabolism	10916	380		1	1	7	10909	2	9	5	10900	10916	0.22730470180250678
M1	string	0	network_modules	133	TRUE	0.008225788231792394	29	6	2	0.3333333333333333	0.06896551724137931	KEGG:04744	KEGG	Phototransduction	8484	362		1	1	29	8455	2	4	27	8451	8484	0.15037512890164156
M1	string	0	network_modules	134	TRUE	3.496911537217232e-9	407	23	11	0.4782608695652174	0.02702702702702703	GO:0007015	GO:BP	actin filament organization	16175	2624		0	0.030303030303030304	407	15768	11	12	396	15756	16175	0.10916973277513443
M1	string	0	network_modules	134	TRUE	1.5775911770143766e-8	632	23	12	0.5217391304347826	0.0189873417721519	GO:0030036	GO:BP	actin cytoskeleton organization	16175	6660		0.03125	0.06060606060606061	632	15543	12	11	620	15532	16175	0.09399748584010155
M1	string	0	network_modules	134	TRUE	5.932199521231849e-8	708	23	12	0.5217391304347826	0.01694915254237288	GO:0030029	GO:BP	actin filament-based process	16175	6653		0.0625	0.09090909090909091	708	15467	12	11	696	15456	16175	0.08816051000842351
M1	string	0	network_modules	134	TRUE	1.1232407785253466e-7	748	23	12	0.5217391304347826	0.016042780748663103	GO:0097435	GO:BP	supramolecular fiber organization	16175	18657		0.09375	0.12121212121212122	748	15427	12	11	736	15416	16175	0.08543767136994736
M1	string	0	network_modules	134	TRUE	5.354106277085961e-7	215	23	8	0.34782608695652173	0.037209302325581395	GO:0110053	GO:BP	regulation of actin filament organization	16175	19377		0.125	0.15151515151515152	215	15960	8	15	207	15945	16175	0.11022994854980296
M1	string	0	network_modules	134	TRUE	8.830417462080636e-7	449	16	9	0.5625	0.0200445434298441	REAC:R-HSA-9012999	REAC	RHO GTPase cycle	10916	1847		0	0.1	449	10467	9	7	440	10460	10916	0.10058196667002663
M1	string	0	network_modules	134	TRUE	1.0420962556774097e-6	181	10	6	0.6	0.03314917127071823	KEGG:04360	KEGG	Axon guidance	8484	305		0	0.5	181	8303	6	4	175	8299	8484	0.13757115454428545
M1	string	0	network_modules	134	TRUE	3.6496658526360148e-6	274	23	8	0.34782608695652173	0.029197080291970802	GO:0032956	GO:BP	regulation of actin cytoskeleton organization	16175	7940		0.15625	0.18181818181818182	274	15901	8	15	266	15886	16175	0.09675789815527987
M1	string	0	network_modules	134	TRUE	3.7736460219160896e-6	19	16	4	0.25	0.21052631578947367	REAC:R-HSA-5627117	REAC	RHO GTPases Activate ROCKs	10916	1850		0.1111111111111111	0.2	19	10897	4	12	15	10885	10916	0.22818429863846065
M1	string	0	network_modules	134	TRUE	3.890252825424916e-6	583	23	10	0.43478260869565216	0.017152658662092625	GO:0051129	GO:BP	negative regulation of cellular component organization	16175	13513		0.1875	0.21212121212121213	583	15592	10	13	573	15579	16175	0.08072330617686733
M1	string	0	network_modules	134	TRUE	4.047490369471866e-6	227	10	6	0.6	0.02643171806167401	KEGG:04810	KEGG	Regulation of actin cytoskeleton	8484	365		1	1	227	8257	6	4	221	8253	8484	0.12203142697428793
M1	string	0	network_modules	134	TRUE	4.378876615759944e-6	793	23	11	0.4782608695652174	0.013871374527112233	GO:0044087	GO:BP	regulation of cellular component biogenesis	16175	10909		0.21875	0.24242424242424243	793	15382	11	12	782	15370	16175	0.0750147686425436
M1	string	0	network_modules	134	TRUE	4.7129051581282515e-6	20	16	4	0.25	0.2	REAC:R-HSA-416572	REAC	Sema4D induced cell migration and growth-cone collapse	10916	2191		0.2222222222222222	0.3	20	10896	4	12	16	10884	10916	0.2223346761994506
M1	string	0	network_modules	134	TRUE	6.508958353953891e-6	45	23	5	0.21739130434782608	0.1111111111111111	GO:0030837	GO:BP	negative regulation of actin filament polymerization	16175	6922		0.25	0.2727272727272727	45	16130	5	18	40	16112	16175	0.1537517319843106
M1	string	0	network_modules	134	TRUE	6.637087692254986e-6	440	23	9	0.391304347826087	0.020454545454545454	GO:0051493	GO:BP	regulation of cytoskeleton organization	16175	13748		0.28125	0.30303030303030304	440	15735	9	14	431	15721	16175	0.0844613964843639
M1	string	0	network_modules	134	TRUE	9.147443164083703e-6	308	23	8	0.34782608695652173	0.025974025974025976	GO:0032970	GO:BP	regulation of actin filament-based process	16175	7953		0.3125	0.3333333333333333	308	15867	8	15	300	15852	16175	0.0907785894345973
M1	string	0	network_modules	134	TRUE	1.0299939857580574e-5	24	16	4	0.25	0.16666666666666666	REAC:R-HSA-400685	REAC	Sema4D in semaphorin signaling	10916	2190		0.3333333333333333	0.4	24	10892	4	12	20	10880	10916	0.20270038548412667
M1	string	0	network_modules	134	TRUE	1.1747344516121951e-5	318	23	8	0.34782608695652173	0.025157232704402517	GO:1902903	GO:BP	regulation of supramolecular fiber organization	16175	22602		0.34375	0.36363636363636365	318	15857	8	15	310	15842	16175	0.08919997255856547
M1	string	0	network_modules	134	TRUE	1.5324643741645826e-5	329	23	8	0.34782608695652173	0.0243161094224924	GO:0090066	GO:BP	regulation of anatomical structure size	16175	17992		0.375	0.3939393939393939	329	15846	8	15	321	15831	16175	0.08754474712835483
M1	string	0	network_modules	134	TRUE	2.2059588912282696e-5	57	23	5	0.21739130434782608	0.08771929824561403	GO:0032272	GO:BP	negative regulation of protein polymerization	16175	7453		0.40625	0.42424242424242425	57	16118	5	18	52	16100	16175	0.13619041215321157
M1	string	0	network_modules	134	TRUE	2.8521900449566557e-5	127	23	6	0.2608695652173913	0.047244094488188976	GO:0051494	GO:BP	negative regulation of cytoskeleton organization	16175	13749		0.4375	0.45454545454545453	127	16048	6	17	121	16031	16175	0.10817678138207783
M1	string	0	network_modules	134	TRUE	2.2183648418414584e-4	304	23	7	0.30434782608695654	0.023026315789473683	GO:0010639	GO:BP	negative regulation of organelle organization	16175	4285		0.46875	0.48484848484848486	304	15871	7	16	297	15855	16175	0.07934936167761948
M1	string	0	network_modules	134	TRUE	3.2713501703564133e-4	97	23	5	0.21739130434782608	0.05154639175257732	GO:0030833	GO:BP	regulation of actin filament polymerization	16175	6918		0.5	0.5151515151515151	97	16078	5	18	92	16060	16175	0.10332053450935494
M1	string	0	network_modules	134	TRUE	5.945412848952421e-4	64	16	4	0.25	0.0625	REAC:R-HSA-373755	REAC	Semaphorin interactions	10916	2193		0.4444444444444444	0.5	64	10852	4	12	60	10840	10916	0.12251776795826572
M1	string	0	network_modules	134	TRUE	7.019765181937365e-4	113	23	5	0.21739130434782608	0.04424778761061947	GO:0008064	GO:BP	regulation of actin polymerization or depolymerization	16175	3113		0.53125	0.5454545454545454	113	16062	5	18	108	16044	16175	0.09532625268657395
M1	string	0	network_modules	134	TRUE	7.334943002228497e-4	114	23	5	0.21739130434782608	0.043859649122807015	GO:0031333	GO:BP	negative regulation of protein-containing complex assembly	16175	7124		0.5625	0.5757575757575758	114	16061	5	18	109	16043	16175	0.09488230104520948
M1	string	0	network_modules	134	TRUE	7.998867233547183e-4	116	23	5	0.21739130434782608	0.04310344827586207	GO:0030832	GO:BP	regulation of actin filament length	16175	6917		0.59375	0.6060606060606061	116	16059	5	18	111	16041	16175	0.09401135497030956
M1	string	0	network_modules	134	TRUE	0.001254975831370671	127	23	5	0.21739130434782608	0.03937007874015748	GO:0030041	GO:BP	actin filament polymerization	16175	6662		0.625	0.6363636363636364	127	16048	5	18	122	16030	16175	0.0895878296365466
M1	string	0	network_modules	134	TRUE	0.0013561244795143202	129	23	5	0.21739130434782608	0.03875968992248062	GO:1902904	GO:BP	negative regulation of supramolecular fiber organization	16175	22603		0.65625	0.6666666666666666	129	16046	5	18	124	16028	16175	0.08884372016468399
M1	string	0	network_modules	134	TRUE	0.001440679336214688	23	16	3	0.1875	0.13043478260869565	REAC:R-HSA-9013422	REAC	RHOBTB1 GTPase cycle	10916	1862		0.5555555555555556	0.6	23	10893	3	13	20	10880	10916	0.15490517770525605
M1	string	0	network_modules	134	TRUE	0.0016987313952280822	135	23	5	0.21739130434782608	0.037037037037037035	GO:0051017	GO:BP	actin filament bundle assembly	16175	13442		0.6875	0.696969696969697	135	16040	5	18	130	16022	16175	0.08670935621460232
M1	string	0	network_modules	134	TRUE	0.001850297678609618	257	23	6	0.2608695652173913	0.023346303501945526	GO:0032535	GO:BP	regulation of cellular component size	16175	7629		0.71875	0.7272727272727273	257	15918	6	17	251	15901	16175	0.07392926291777445
M1	string	0	network_modules	134	TRUE	0.0018938828404302104	138	23	5	0.21739130434782608	0.036231884057971016	GO:0061572	GO:BP	actin filament bundle organization	16175	15565		0.75	0.7575757575757576	138	16037	5	18	133	16019	16175	0.08569360816420832
M1	string	0	network_modules	134	TRUE	0.002105343104654225	16	23	3	0.13043478260869565	0.1875	GO:1901550	GO:BP	regulation of endothelial cell development	16175	21558		0.78125	0.8181818181818182	16	16159	3	20	13	16139	16175	0.15538715721260482
M1	string	0	network_modules	134	TRUE	0.002105343104654225	16	23	3	0.13043478260869565	0.1875	GO:1903140	GO:BP	regulation of establishment of endothelial barrier	16175	22793		0.78125	0.8181818181818182	16	16159	3	20	13	16139	16175	0.15538715721260482
M1	string	0	network_modules	134	TRUE	0.0021093916839663653	26	16	3	0.1875	0.11538461538461539	REAC:R-HSA-5223345	REAC	Miscellaneous transport and binding events	10916	1456		0.6666666666666666	0.7	26	10890	3	13	23	10877	10916	0.14549856698069571
M1	string	0	network_modules	134	TRUE	0.00293052110335139	2	23	2	0.08695652173913043	1	GO:1905205	GO:BP	positive regulation of connective tissue replacement	16175	24441		0.84375	0.8484848484848485	2	16173	2	21	0	16152	16175	0.29469240258173435
M1	string	0	network_modules	134	TRUE	0.003151356908831497	153	23	5	0.21739130434782608	0.032679738562091505	GO:0008154	GO:BP	actin polymerization or depolymerization	16175	3127		0.875	0.8787878787878788	153	16022	5	18	148	16004	16175	0.08106116753338104
M1	string	0	network_modules	134	TRUE	0.0040492134658724034	161	23	5	0.21739130434782608	0.031055900621118012	GO:0032271	GO:BP	regulation of protein polymerization	16175	7452		0.90625	0.9090909090909091	161	16014	5	18	156	15996	16175	0.07885329298089594
M1	string	0	network_modules	134	TRUE	0.005267427951212809	35	16	3	0.1875	0.08571428571428572	REAC:R-HSA-9706574	REAC	RHOBTB GTPase Cycle	10916	1861		0.7777777777777778	0.8	35	10881	3	13	32	10868	10916	0.12489709150853656
M1	string	0	network_modules	134	TRUE	0.006242136558762132	37	16	3	0.1875	0.08108108108108109	REAC:R-HSA-9013407	REAC	RHOH GTPase cycle	10916	1869		0.8888888888888888	0.9	37	10879	3	13	34	10866	10916	0.12136499135164136
M1	string	0	network_modules	134	TRUE	0.007553043285001973	24	23	3	0.13043478260869565	0.125	GO:0051016	GO:BP	barbed-end actin filament capping	16175	13441		0.9375	0.9696969696969697	24	16151	3	20	21	16131	16175	0.12641961913648028
M1	string	0	network_modules	134	TRUE	0.007553043285001973	24	23	3	0.13043478260869565	0.125	GO:0051693	GO:BP	actin filament capping	16175	13896		0.9375	0.9696969696969697	24	16151	3	20	21	16131	16175	0.12641961913648028
M1	string	0	network_modules	134	TRUE	0.0079159691678501	40	16	3	0.1875	0.075	REAC:R-HSA-3928662	REAC	EPHB-mediated forward signaling	10916	821		1	1	40	10876	3	13	37	10863	10916	0.11656694615548616
M1	string	0	network_modules	134	TRUE	0.00968454045612034	26	23	3	0.13043478260869565	0.11538461538461539	GO:0045601	GO:BP	regulation of endothelial cell differentiation	16175	11452		1	1	26	16149	3	20	23	16129	16175	0.12135109035153473
M1	string	0	network_modules	135	TRUE	0.007269351993320072	102	9	3	0.3333333333333333	0.029411764705882353	KEGG:04914	KEGG	Progesterone-mediated oocyte maturation	8484	371		NA	1	102	8382	3	6	99	8376	8484	0.09607343941330565
M1	string	0	network_modules	136	TRUE	8.30274106127912e-15	279	28	14	0.5	0.05017921146953405	GO:0006401	GO:BP	RNA catabolic process	16175	2162		0	0.023809523809523808	279	15896	14	14	265	15882	16175	0.1544026248129918
M1	string	0	network_modules	136	TRUE	2.201955232216662e-14	299	28	14	0.5	0.046822742474916385	GO:0141188	GO:BP	nucleic acid catabolic process	16175	20075		0.024390243902439025	0.047619047619047616	299	15876	14	14	285	15862	16175	0.14886094717195242
M1	string	0	network_modules	136	TRUE	2.9344066809088187e-14	226	28	13	0.4642857142857143	0.05752212389380531	GO:0006402	GO:BP	mRNA catabolic process	16175	2163		0.04878048780487805	0.07142857142857142	226	15949	13	15	213	15934	16175	0.15976124432732522
M1	string	0	network_modules	136	TRUE	6.418884947257291e-14	172	28	12	0.42857142857142855	0.06976744186046512	GO:0061013	GO:BP	regulation of mRNA catabolic process	16175	15136		0.07317073170731707	0.09523809523809523	172	16003	12	16	160	15987	16175	0.16967741556759716
M1	string	0	network_modules	136	TRUE	1.4044980143769388e-13	28	28	8	0.2857142857142857	0.2857142857142857	GO:0034063	GO:BP	stress granule assembly	16175	8390		0.0975609756097561	0.11904761904761904	28	16147	8	20	20	16127	16175	0.28447566553716297
M1	string	0	network_modules	136	TRUE	1.5115273976702475e-12	156	28	11	0.39285714285714285	0.07051282051282051	GO:0043488	GO:BP	regulation of mRNA stability	16175	10733		0.12195121951219512	0.14285714285714285	156	16019	11	17	145	16002	16175	0.16328158082759395
M1	string	0	network_modules	136	TRUE	3.2421227050968356e-12	167	28	11	0.39285714285714285	0.0658682634730539	GO:0043487	GO:BP	regulation of RNA stability	16175	10732		0.14634146341463414	0.16666666666666666	167	16008	11	17	156	15991	16175	0.15758650540316824
M1	string	0	network_modules	136	TRUE	6.208953664346451e-12	448	28	14	0.5	0.03125	GO:0034655	GO:BP	nucleobase-containing compound catabolic process	16175	8711		0.17073170731707318	0.19047619047619047	448	15727	14	14	434	15713	16175	0.11984945897296674
M1	string	0	network_modules	136	TRUE	1.7318852538128407e-11	273	28	12	0.42857142857142855	0.04395604395604396	GO:1903311	GO:BP	regulation of mRNA metabolic process	16175	22895		0.1951219512195122	0.21428571428571427	273	15902	12	16	261	15886	16175	0.1330896327826288
M1	string	0	network_modules	136	TRUE	3.5712997706736895e-11	290	28	12	0.42857142857142855	0.041379310344827586	GO:0006417	GO:BP	regulation of translation	16175	2174		0.21951219512195122	0.23809523809523808	290	15885	12	16	278	15869	16175	0.12886907063718375
M1	string	0	network_modules	136	TRUE	7.439347387886208e-11	97	28	9	0.32142857142857145	0.09278350515463918	GO:0061014	GO:BP	positive regulation of mRNA catabolic process	16175	15137		0.24390243902439024	0.2619047619047619	97	16078	9	19	88	16059	16175	0.17012995540697554
M1	string	0	network_modules	136	TRUE	1.1012898633214469e-10	6	28	5	0.17857142857142858	0.8333333333333334	GO:0062028	GO:BP	regulation of stress granule assembly	16175	15789		0.2682926829268293	0.2857142857142857	6	16169	5	23	1	16146	16175	0.3853621534594274
M1	string	0	network_modules	136	TRUE	1.4001583137789387e-10	434	28	13	0.4642857142857143	0.029953917050691243	GO:0010608	GO:BP	post-transcriptional regulation of gene expression	16175	4255		0.2926829268292683	0.30952380952380953	434	15741	13	15	421	15726	16175	0.11273244672920138
M1	string	0	network_modules	136	TRUE	1.551301258657048e-10	566	28	14	0.5	0.024734982332155476	GO:0006412	GO:BP	translation	16175	2170		0.3170731707317073	0.3333333333333333	566	15609	14	14	552	15595	16175	0.10537602133780495
M1	string	0	network_modules	136	TRUE	2.737682959403568e-10	590	28	14	0.5	0.023728813559322035	GO:0016071	GO:BP	mRNA metabolic process	16175	5098		0.34146341463414637	0.35714285714285715	590	15585	14	14	576	15571	16175	0.10296038511370657
M1	string	0	network_modules	136	TRUE	7.725820163374096e-10	125	28	9	0.32142857142857145	0.072	GO:1903313	GO:BP	positive regulation of mRNA metabolic process	16175	22897		0.36585365853658536	0.38095238095238093	125	16050	9	19	116	16031	16175	0.14917642720592111
M1	string	0	network_modules	136	TRUE	3.919575004043421e-9	92	28	8	0.2857142857142857	0.08695652173913043	GO:0061157	GO:BP	mRNA destabilization	16175	15262		0.3902439024390244	0.40476190476190477	92	16083	8	20	84	16063	16175	0.1550597443704084
M1	string	0	network_modules	136	TRUE	5.101503251282111e-9	95	28	8	0.2857142857142857	0.08421052631578947	GO:0050779	GO:BP	RNA destabilization	16175	13253		0.4146341463414634	0.42857142857142855	95	16080	8	20	87	16060	16175	0.15250494979067264
M1	string	0	network_modules	136	TRUE	8.429790810485311e-9	11	28	5	0.17857142857142858	0.45454545454545453	GO:0070934	GO:BP	CRD-mediated mRNA stabilization	16175	16378		0.43902439024390244	0.4523809523809524	11	16164	5	23	6	16141	16175	0.28415904906777284
M1	string	0	network_modules	136	TRUE	1.2382008883309175e-8	4	28	4	0.14285714285714285	1	GO:0062029	GO:BP	positive regulation of stress granule assembly	16175	15790		0.4634146341463415	0.47619047619047616	4	16171	4	24	0	16147	16175	0.37768389309575967
M1	string	0	network_modules	136	TRUE	1.6912824695293137e-8	110	28	8	0.2857142857142857	0.07272727272727272	GO:0017148	GO:BP	negative regulation of translation	16175	5285		0.4878048780487805	0.5	110	16065	8	20	102	16045	16175	0.14132222654538795
M1	string	0	network_modules	136	TRUE	1.4238825342390376e-6	3	19	3	0.15789473684210525	1	REAC:R-HSA-428359	REAC	Insulin-like Growth Factor-2 mRNA Binding Proteins (IGF2BPs/IMPs/VICKZs) bind RNA	10916	1212		NA	1	3	10913	3	16	0	10897	10916	0.39706830753343725
M1	string	0	network_modules	136	TRUE	2.429143789328149e-6	67	28	6	0.21428571428571427	0.08955223880597014	GO:1902373	GO:BP	negative regulation of mRNA catabolic process	16175	22245		0.5121951219512195	0.5238095238095238	67	16108	6	22	61	16086	16175	0.13624958000509738
M1	string	0	network_modules	136	TRUE	5.704056534533207e-6	77	28	6	0.21428571428571427	0.07792207792207792	GO:1902369	GO:BP	negative regulation of RNA catabolic process	16175	22241		0.5365853658536586	0.5476190476190477	77	16098	6	22	71	16076	16175	0.1267600760598011
M1	string	0	network_modules	136	TRUE	6.361661470211158e-6	477	28	10	0.35714285714285715	0.020964360587002098	GO:0009896	GO:BP	positive regulation of catabolic process	16175	3756		0.5609756097560976	0.5714285714285714	477	15698	10	18	467	15680	16175	0.08065105472551162
M1	string	0	network_modules	136	TRUE	6.519629330222843e-6	343	28	9	0.32142857142857145	0.026239067055393587	GO:0140694	GO:BP	membraneless organelle assembly	16175	19860		0.5853658536585366	0.5952380952380952	343	15832	9	19	334	15813	16175	0.08677735381836801
M1	string	0	network_modules	136	TRUE	9.69949629269952e-6	84	28	6	0.21428571428571427	0.07142857142857142	GO:1903312	GO:BP	negative regulation of mRNA metabolic process	16175	22896		0.6097560975609756	0.6190476190476191	84	16091	6	22	78	16069	16175	0.12113920191736793
M1	string	0	network_modules	136	TRUE	5.827755927272516e-5	113	28	6	0.21428571428571427	0.05309734513274336	GO:0000956	GO:BP	nuclear-transcribed mRNA catabolic process	16175	264		0.6341463414634146	0.6428571428571429	113	16062	6	22	107	16040	16175	0.10364225785602739
M1	string	0	network_modules	136	TRUE	7.55620735132295e-5	118	28	6	0.21428571428571427	0.05084745762711865	GO:0045727	GO:BP	positive regulation of translation	16175	11569		0.6585365853658537	0.6666666666666666	118	16057	6	22	112	16035	16175	0.10128720813187464
M1	string	0	network_modules	136	TRUE	7.907126113317323e-5	58	28	5	0.17857142857142858	0.08620689655172414	GO:0048255	GO:BP	mRNA stabilization	16175	12610		0.6829268292682927	0.6904761904761905	58	16117	5	23	53	16094	16175	0.12190561586589911
M1	string	0	network_modules	136	TRUE	1.6488579363975963e-4	67	28	5	0.17857142857142858	0.07462686567164178	GO:0043489	GO:BP	RNA stabilization	16175	10734		0.7073170731707317	0.7142857142857143	67	16108	5	23	62	16085	16175	0.11309370805916204
M1	string	0	network_modules	136	TRUE	3.035123263911171e-4	149	28	6	0.21428571428571427	0.040268456375838924	GO:0006403	GO:BP	RNA localization	16175	2164		0.7317073170731707	0.7380952380952381	149	16026	6	22	143	16004	16175	0.08938861600242556
M1	string	0	network_modules	136	TRUE	4.895125629886689e-4	33	28	4	0.14285714285714285	0.12121212121212122	GO:2000765	GO:BP	regulation of cytoplasmic translation	16175	26025		0.7560975609756098	0.7619047619047619	33	16142	4	24	29	16118	16175	0.12995610827480467
M1	string	0	network_modules	136	TRUE	7.387932079124897e-4	595	28	9	0.32142857142857145	0.015126050420168067	GO:0051248	GO:BP	negative regulation of protein metabolic process	16175	13595		0.7804878048780488	0.7857142857142857	595	15580	9	19	586	15561	16175	0.06297037869662944
M1	string	0	network_modules	136	TRUE	0.001743828060791088	12	28	3	0.10714285714285714	0.25	GO:1900152	GO:BP	negative regulation of nuclear-transcribed mRNA catabolic process, deadenylation-dependent decay	16175	20436		0.8048780487804879	0.8333333333333334	12	16163	3	25	9	16138	16175	0.16273140207277706
M1	string	0	network_modules	136	TRUE	0.001743828060791088	12	28	3	0.10714285714285714	0.25	GO:0006388	GO:BP	tRNA splicing, via endonucleolytic cleavage and ligation	16175	2152		0.8048780487804879	0.8333333333333334	12	16163	3	25	9	16138	16175	0.16273140207277706
M1	string	0	network_modules	136	TRUE	0.0022643487847682177	13	28	3	0.10714285714285714	0.23076923076923078	GO:0000394	GO:BP	RNA splicing, via endonucleolytic cleavage and ligation	16175	119		0.8536585365853658	0.8571428571428571	13	16162	3	25	10	16137	16175	0.15626126299911722
M1	string	0	network_modules	136	TRUE	0.0023702840048648146	114	28	5	0.17857142857142858	0.043859649122807015	GO:0050658	GO:BP	RNA transport	16175	13198		0.8780487804878049	0.9047619047619048	114	16061	5	23	109	16038	16175	0.08538121565712763
M1	string	0	network_modules	136	TRUE	0.0023702840048648146	114	28	5	0.17857142857142858	0.043859649122807015	GO:0050657	GO:BP	nucleic acid transport	16175	13197		0.8780487804878049	0.9047619047619048	114	16061	5	23	109	16038	16175	0.08538121565712763
M1	string	0	network_modules	136	TRUE	0.0026956282650344703	117	28	5	0.17857142857142858	0.042735042735042736	GO:0051236	GO:BP	establishment of RNA localization	16175	13586		0.926829268292683	0.9285714285714286	117	16058	5	23	112	16035	16175	0.08419620729007256
M1	string	0	network_modules	136	TRUE	0.003594027106055537	15	28	3	0.10714285714285714	0.2	GO:2000767	GO:BP	positive regulation of cytoplasmic translation	16175	26027		0.9512195121951219	0.9523809523809523	15	16160	3	25	12	16135	16175	0.14531116107917666
M1	string	0	network_modules	136	TRUE	0.004592537865871111	57	28	4	0.14285714285714285	0.07017543859649122	GO:0000288	GO:BP	nuclear-transcribed mRNA catabolic process, deadenylation-dependent decay	16175	81		0.975609756097561	0.9761904761904762	57	16118	4	24	53	16094	16175	0.09791268205506579
M1	string	0	network_modules	136	TRUE	0.00990873611555366	69	28	4	0.14285714285714285	0.057971014492753624	GO:1902117	GO:BP	positive regulation of organelle assembly	16175	22030		1	1	69	16106	4	24	65	16082	16175	0.08855130374876646
M1	string	0	network_modules	137	TRUE	2.008145971685007e-20	791	29	22	0.7586206896551724	0.02781289506953224	GO:0000122	GO:BP	negative regulation of transcription by RNA polymerase II	16175	48		0	0.034482758620689655	791	15384	22	7	769	15377	16175	0.13946775010145968
M1	string	0	network_modules	137	TRUE	5.662017229728538e-19	59	26	12	0.46153846153846156	0.2033898305084746	REAC:R-HSA-8943724	REAC	Regulation of PTEN gene transcription	10916	1999		0	0.037037037037037035	59	10857	12	14	47	10843	10916	0.30398164069504197
M1	string	0	network_modules	137	TRUE	5.513679279430928e-17	529	29	18	0.6206896551724138	0.034026465028355386	GO:0006325	GO:BP	chromatin organization	16175	2122		0.03571428571428571	0.06896551724137931	529	15646	18	11	511	15635	16175	0.1401030086473
M1	string	0	network_modules	137	TRUE	4.453474749612035e-15	19	29	8	0.27586206896551724	0.42105263157894735	GO:0042659	GO:BP	regulation of cell fate specification	16175	10274		0.07142857142857142	0.10344827586206896	19	16156	8	21	11	16135	16175	0.33986454160284724
M1	string	0	network_modules	137	TRUE	1.618582830531319e-14	65	29	10	0.3448275862068966	0.15384615384615385	GO:0001708	GO:BP	cell fate specification	16175	400		0.10714285714285714	0.13793103448275862	65	16110	10	19	55	16091	16175	0.22830607639972317
M1	string	0	network_modules	137	TRUE	1.7579193772171038e-14	185	26	13	0.5	0.07027027027027027	REAC:R-HSA-212165	REAC	Epigenetic regulation of gene expression	10916	852		0.038461538461538464	0.07407407407407407	185	10731	13	13	172	10718	10916	0.18286245405633555
M1	string	0	network_modules	137	TRUE	2.8020408775117272e-14	138	26	12	0.46153846153846156	0.08695652173913043	REAC:R-HSA-6807070	REAC	PTEN Regulation	10916	1703		0.07692307692307693	0.1111111111111111	138	10778	12	14	126	10764	10916	0.1963241910883246
M1	string	0	network_modules	137	TRUE	2.499968089151642e-13	29	29	8	0.27586206896551724	0.27586206896551724	GO:0010453	GO:BP	regulation of cell fate commitment	16175	4149		0.14285714285714285	0.1724137931034483	29	16146	8	21	21	16125	16175	0.2745614372301029
M1	string	0	network_modules	137	TRUE	3.671944370059241e-13	454	29	15	0.5172413793103449	0.03303964757709251	GO:0006338	GO:BP	chromatin remodeling	16175	2126		0.17857142857142858	0.20689655172413793	454	15721	15	14	439	15707	16175	0.12551788516344423
M1	string	0	network_modules	137	TRUE	2.1412884616575787e-12	94	26	10	0.38461538461538464	0.10638297872340426	REAC:R-HSA-3214815	REAC	HDACs deacetylate histones	10916	1092		0.11538461538461539	0.14814814814814814	94	10822	10	16	84	10806	10916	0.198843424001134
M1	string	0	network_modules	137	TRUE	2.6222950050424936e-12	271	26	13	0.5	0.04797047970479705	REAC:R-HSA-3247509	REAC	Chromatin modifying enzymes	10916	355		0.15384615384615385	0.2222222222222222	271	10645	13	13	258	10632	10916	0.14922153521813994
M1	string	0	network_modules	137	TRUE	2.6222950050424936e-12	271	26	13	0.5	0.04797047970479705	REAC:R-HSA-4839726	REAC	Chromatin organization	10916	356		0.15384615384615385	0.2222222222222222	271	10645	13	13	258	10632	10916	0.14922153521813994
M1	string	0	network_modules	137	TRUE	3.0597060256116895e-11	47	26	8	0.3076923076923077	0.1702127659574468	REAC:R-HSA-73762	REAC	RNA Polymerase I Transcription Initiation	10916	1885		0.23076923076923078	0.25925925925925924	47	10869	8	18	39	10851	10916	0.22640659726561413
M1	string	0	network_modules	137	TRUE	4.3675550925739584e-11	116	26	10	0.38461538461538464	0.08620689655172414	KEGG:03082	KEGG	ATP-dependent chromatin remodeling	8484	219		0	0.25	116	8368	10	16	106	8352	8484	0.17710073417874025
M1	string	0	network_modules	137	TRUE	4.4153461157402646e-11	253	26	12	0.46153846153846156	0.04743083003952569	REAC:R-HSA-1257604	REAC	PIP3 activates AKT signaling	10916	1679		0.2692307692307692	0.2962962962962963	253	10663	12	14	241	10649	10916	0.14235367197400303
M1	string	0	network_modules	137	TRUE	1.1628751463612366e-10	30	26	7	0.2692307692307692	0.23333333333333334	REAC:R-HSA-6804758	REAC	Regulation of TP53 Activity through Acetylation	10916	2013		0.3076923076923077	0.3333333333333333	30	10886	7	19	23	10867	10916	0.24871969630367913
M1	string	0	network_modules	137	TRUE	1.6528763737856947e-10	61	29	8	0.27586206896551724	0.13114754098360656	GO:2000736	GO:BP	regulation of stem cell differentiation	16175	25999		0.21428571428571427	0.2413793103448276	61	16114	8	21	53	16093	16175	0.188130020059865
M1	string	0	network_modules	137	TRUE	2.5399231188404356e-10	293	26	12	0.46153846153846156	0.040955631399317405	REAC:R-HSA-9006925	REAC	Intracellular signaling by second messengers	10916	1266		0.34615384615384615	0.37037037037037035	293	10623	12	14	281	10609	10916	0.1314212612402118
M1	string	0	network_modules	137	TRUE	2.568875767651911e-10	150	26	10	0.38461538461538464	0.06666666666666667	REAC:R-HSA-9679191	REAC	Potential therapeutics for SARS	10916	1782		0.38461538461538464	0.4074074074074074	150	10766	10	16	140	10750	10916	0.15566462671604658
M1	string	0	network_modules	137	TRUE	4.086639677956326e-10	104	26	9	0.34615384615384615	0.08653846153846154	REAC:R-HSA-5250913	REAC	Positive epigenetic regulation of rRNA expression	10916	1771		0.4230769230769231	0.4444444444444444	104	10812	9	17	95	10795	10916	0.16932260247352487
M1	string	0	network_modules	137	TRUE	4.589562459603643e-10	175	29	10	0.3448275862068966	0.05714285714285714	GO:0045165	GO:BP	cell fate commitment	16175	11307		0.25	0.27586206896551724	175	16000	10	19	165	15981	16175	0.13683248514816493
M1	string	0	network_modules	137	TRUE	1.5752514131809268e-9	75	26	8	0.3076923076923077	0.10666666666666667	REAC:R-HSA-427389	REAC	ERCC6 (CSB) and EHMT2 (G9a) positively regulate rRNA expression	10916	827		0.46153846153846156	0.48148148148148145	75	10841	8	18	67	10823	10916	0.17794265220486705
M1	string	0	network_modules	137	TRUE	6.194105655463986e-9	152	29	9	0.3103448275862069	0.05921052631578947	GO:0048863	GO:BP	stem cell differentiation	16175	13106		0.2857142857142857	0.3103448275862069	152	16023	9	20	143	16003	16175	0.1321928610417976
M1	string	0	network_modules	137	TRUE	3.3736183209401865e-8	109	26	8	0.3076923076923077	0.07339449541284404	REAC:R-HSA-73854	REAC	RNA Polymerase I Promoter Clearance	10916	1881		0.5	0.5185185185185185	109	10807	8	18	101	10789	10916	0.14630508871305237
M1	string	0	network_modules	137	TRUE	3.632844654915348e-8	110	26	8	0.3076923076923077	0.07272727272727272	REAC:R-HSA-73864	REAC	RNA Polymerase I Transcription	10916	1884		0.5384615384615384	0.5555555555555556	110	10806	8	18	102	10788	10916	0.14560046876624824
M1	string	0	network_modules	137	TRUE	1.0746018329149908e-7	134	29	8	0.27586206896551724	0.05970149253731343	GO:0045814	GO:BP	negative regulation of gene expression, epigenetic	16175	11636		0.32142857142857145	0.3448275862068966	134	16041	8	21	126	16020	16175	0.12511015976749998
M1	string	0	network_modules	137	TRUE	3.7264503523804653e-6	209	29	8	0.27586206896551724	0.03827751196172249	GO:0040029	GO:BP	epigenetic regulation of gene expression	16175	9916		0.35714285714285715	0.3793103448275862	209	15966	8	21	201	15945	16175	0.09867286639525003
M1	string	0	network_modules	137	TRUE	1.0592629995145567e-5	83	29	6	0.20689655172413793	0.07228915662650602	GO:0030512	GO:BP	negative regulation of transforming growth factor beta receptor signaling pathway	16175	6828		0.39285714285714285	0.41379310344827586	83	16092	6	23	77	16069	16175	0.11967762635889231
M1	string	0	network_modules	137	TRUE	1.4935247793336792e-5	459	26	10	0.38461538461538464	0.02178649237472767	REAC:R-HSA-9679506	REAC	SARS-CoV Infections	10916	2112		0.5769230769230769	0.5925925925925926	459	10457	10	16	449	10441	10916	0.08340112484049038
M1	string	0	network_modules	137	TRUE	2.1821357285408368e-5	160	26	7	0.2692307692307692	0.04375	REAC:R-HSA-5633007	REAC	Regulation of TP53 Activity	10916	2012		0.6153846153846154	0.6296296296296297	160	10756	7	19	153	10737	10916	0.10350560573701797
M1	string	0	network_modules	137	TRUE	3.4469017409267893e-5	171	26	7	0.2692307692307692	0.04093567251461988	REAC:R-HSA-3108232	REAC	SUMO E3 ligases SUMOylate target proteins	10916	2163		0.6538461538461539	0.6666666666666666	171	10745	7	19	164	10726	10916	0.09977586131413932
M1	string	0	network_modules	137	TRUE	4.366278609788988e-5	177	26	7	0.2692307692307692	0.03954802259887006	REAC:R-HSA-2990846	REAC	SUMOylation	10916	2167		0.6923076923076923	0.7037037037037037	177	10739	7	19	170	10720	10916	0.09788491284986428
M1	string	0	network_modules	137	TRUE	5.617806153548398e-5	60	26	5	0.19230769230769232	0.08333333333333333	KEGG:04330	KEGG	Notch signaling pathway	8484	301		0.3333333333333333	0.5	60	8424	5	21	55	8403	8484	0.12255838899818507
M1	string	0	network_modules	137	TRUE	1.1355964145813704e-4	123	29	6	0.20689655172413793	0.04878048780487805	GO:0017015	GO:BP	regulation of transforming growth factor beta receptor signaling pathway	16175	5276		0.42857142857142855	0.4482758620689655	123	16052	6	23	117	16029	16175	0.09722636224399356
M1	string	0	network_modules	137	TRUE	1.1621501669233054e-4	23	29	4	0.13793103448275862	0.17391304347826086	GO:1902455	GO:BP	negative regulation of stem cell population maintenance	16175	22293		0.4642857142857143	0.4827586206896552	23	16152	4	25	19	16127	16175	0.15353072663351128
M1	string	0	network_modules	137	TRUE	1.25044195589787e-4	125	29	6	0.20689655172413793	0.048	GO:1903844	GO:BP	regulation of cellular response to transforming growth factor beta stimulus	16175	23323		0.5	0.5172413793103449	125	16050	6	23	119	16027	16175	0.09639158212364698
M1	string	0	network_modules	137	TRUE	1.3113578233136245e-4	126	29	6	0.20689655172413793	0.047619047619047616	GO:0090101	GO:BP	negative regulation of transmembrane receptor protein serine/threonine kinase signaling pathway	16175	18019		0.5357142857142857	0.5517241379310345	126	16049	6	23	120	16026	16175	0.09598150211721992
M1	string	0	network_modules	137	TRUE	1.3909419928322033e-4	217	29	7	0.2413793103448276	0.03225806451612903	GO:0090092	GO:BP	regulation of transmembrane receptor protein serine/threonine kinase signaling pathway	16175	18013		0.5714285714285714	0.5862068965517241	217	15958	7	22	210	15936	16175	0.08397637419573153
M1	string	0	network_modules	137	TRUE	1.8281673612772573e-4	70	26	5	0.19230769230769232	0.07142857142857142	REAC:R-HSA-3214841	REAC	PKMTs methylate histone lysines	10916	1691		0.7307692307692307	0.7407407407407407	70	10846	5	21	65	10825	10916	0.11379425921039864
M1	string	0	network_modules	137	TRUE	2.1066427940750568e-4	72	26	5	0.19230769230769232	0.06944444444444445	REAC:R-HSA-212300	REAC	PRC2 methylates histones and DNA	10916	1701		0.7692307692307693	0.8148148148148148	72	10844	5	21	67	10823	10916	0.11210240264011825
M1	string	0	network_modules	137	TRUE	2.1066427940750568e-4	72	26	5	0.19230769230769232	0.06944444444444445	REAC:R-HSA-9710421	REAC	Defective pyroptosis	10916	702		0.7692307692307693	0.8148148148148148	72	10844	5	21	67	10823	10916	0.11210240264011825
M1	string	0	network_modules	137	TRUE	3.0215219429254936e-4	84	26	5	0.19230769230769232	0.05952380952380952	KEGG:03083	KEGG	Polycomb repressive complex	8484	220		0.6666666666666666	0.75	84	8400	5	21	79	8379	8484	0.10214450285459307
M1	string	0	network_modules	137	TRUE	4.2850026716374225e-4	256	29	7	0.2413793103448276	0.02734375	GO:0090287	GO:BP	regulation of cellular response to growth factor stimulus	16175	18171		0.6071428571428571	0.6206896551724138	256	15919	7	22	249	15897	16175	0.07659147363105717
M1	string	0	network_modules	137	TRUE	6.170972964089949e-4	85	29	5	0.1724137931034483	0.058823529411764705	GO:0031507	GO:BP	heterochromatin formation	16175	7192		0.6428571428571429	0.6551724137931034	85	16090	5	24	80	16066	16175	0.09798339788652462
M1	string	0	network_modules	137	TRUE	6.953154862401947e-4	275	29	7	0.2413793103448276	0.025454545454545455	GO:0141091	GO:BP	transforming growth factor beta receptor superfamily signaling pathway	16175	20020		0.6785714285714286	0.6896551724137931	275	15900	7	22	268	15878	16175	0.0735572903115441
M1	string	0	network_modules	137	TRUE	9.485044073296373e-4	176	29	6	0.20689655172413793	0.03409090909090909	GO:0007179	GO:BP	transforming growth factor beta receptor signaling pathway	16175	2741		0.7142857142857143	0.7241379310344828	176	15999	6	23	170	15976	16175	0.08007530737214404
M1	string	0	network_modules	137	TRUE	9.94361900712968e-4	290	29	7	0.2413793103448276	0.02413793103448276	GO:0007178	GO:BP	cell surface receptor protein serine/threonine kinase signaling pathway	16175	2740		0.75	0.7586206896551724	290	15885	7	22	283	15863	16175	0.0713673148673379
M1	string	0	network_modules	137	TRUE	0.001253923390949768	103	26	5	0.19230769230769232	0.04854368932038835	REAC:R-HSA-9645723	REAC	Diseases of programmed cell death	10916	771		0.8461538461538461	0.8518518518518519	103	10813	5	21	98	10792	10916	0.09242549083855327
M1	string	0	network_modules	137	TRUE	0.001299811319179866	41	29	4	0.13793103448275862	0.0975609756097561	GO:1902459	GO:BP	positive regulation of stem cell population maintenance	16175	22297		0.7857142857142857	0.7931034482758621	41	16134	4	25	37	16109	16175	0.1141180976115427
M1	string	0	network_modules	137	TRUE	0.001322422708479238	99	29	5	0.1724137931034483	0.050505050505050504	GO:0019827	GO:BP	stem cell population maintenance	16175	6046		0.8214285714285714	0.8275862068965517	99	16076	5	24	94	16052	16175	0.09036053727925747
M1	string	0	network_modules	137	TRUE	0.0013786685574323889	105	26	5	0.19230769230769232	0.047619047619047616	REAC:R-HSA-427413	REAC	NoRC negatively regulates rRNA expression	10916	1602		0.8846153846153846	0.8888888888888888	105	10811	5	21	100	10790	10916	0.09145776069429724
M1	string	0	network_modules	137	TRUE	0.0013902994150203941	100	29	5	0.1724137931034483	0.05	GO:0098727	GO:BP	maintenance of cell number	16175	18856		0.8571428571428571	0.8620689655172413	100	16075	5	24	95	16051	16175	0.0898769693535218
M1	string	0	network_modules	137	TRUE	0.001583858847166286	108	26	5	0.19230769230769232	0.046296296296296294	REAC:R-HSA-5250941	REAC	Negative epigenetic regulation of rRNA expression	10916	1566		0.9230769230769231	0.9259259259259259	108	10808	5	21	103	10787	10916	0.09005540483407351
M1	string	0	network_modules	137	TRUE	0.002123656643320758	202	29	6	0.20689655172413793	0.0297029702970297	GO:0071560	GO:BP	cellular response to transforming growth factor beta stimulus	16175	16762		0.8928571428571429	0.896551724137931	202	15973	6	23	196	15950	16175	0.07419187333087111
M1	string	0	network_modules	137	TRUE	0.002518295308981323	208	29	6	0.20689655172413793	0.028846153846153848	GO:0071559	GO:BP	response to transforming growth factor beta	16175	16761		0.9285714285714286	0.9310344827586207	208	15967	6	23	202	15944	16175	0.0729881717083502
M1	string	0	network_modules	137	TRUE	0.004064488824481644	519	29	8	0.27586206896551724	0.015414258188824663	GO:0070848	GO:BP	response to growth factor	16175	16340		0.9642857142857143	0.9655172413793104	519	15656	8	21	511	15635	16175	0.05862418426552583
M1	string	0	network_modules	137	TRUE	0.004907513414524612	76	26	4	0.15384615384615385	0.05263157894736842	KEGG:05220	KEGG	Chronic myeloid leukemia	8484	471		1	1	76	8408	4	22	72	8386	8484	0.08525760107967441
M1	string	0	network_modules	137	TRUE	0.004945840425152132	359	26	7	0.2692307692307692	0.019498607242339833	REAC:R-HSA-3700989	REAC	Transcriptional Regulation by TP53	10916	2546		0.9615384615384616	0.9629629629629629	359	10557	7	19	352	10538	10916	0.06475331493104743
M1	string	0	network_modules	137	TRUE	0.005375719689054371	3	26	2	0.07692307692307693	0.6666666666666666	REAC:R-HSA-5339700	REAC	Signaling by TCF7L2 mutants	10916	2307		1	1	3	10913	2	24	1	10889	10916	0.22594659731211975
M1	string	0	network_modules	137	TRUE	0.005712906603505568	59	29	4	0.13793103448275862	0.06779661016949153	GO:2000036	GO:BP	regulation of stem cell population maintenance	16175	25399		1	1	59	16116	4	25	55	16091	16175	0.0944014370343505
M1	string	0	network_modules	138	TRUE	1.2506539261032072e-23	153	26	16	0.6153846153846154	0.10457516339869281	GO:0008154	GO:BP	actin polymerization or depolymerization	16175	3127		0	0.017857142857142856	153	16022	16	10	137	16012	16175	0.25117322950049176
M1	string	0	network_modules	138	TRUE	1.1453235274179256e-22	35	24	12	0.5	0.34285714285714286	REAC:R-HSA-5663213	REAC	RHO GTPases Activate WASPs and WAVEs	10916	1852		0	0.05555555555555555	35	10881	12	12	23	10869	10916	0.41249907748825776
M1	string	0	network_modules	138	TRUE	9.564778980039086e-19	632	26	19	0.7307692307692307	0.030063291139240507	GO:0030036	GO:BP	actin cytoskeleton organization	16175	6660		0.01818181818181818	0.03571428571428571	632	15543	19	7	613	15536	16175	0.14323455946904526
M1	string	0	network_modules	138	TRUE	1.6466863052359784e-18	407	26	17	0.6538461538461539	0.04176904176904177	GO:0007015	GO:BP	actin filament organization	16175	2624		0.03636363636363636	0.05357142857142857	407	15768	17	9	390	15759	16175	0.16106639975335546
M1	string	0	network_modules	138	TRUE	8.249234655038043e-18	708	26	19	0.7307692307692307	0.026836158192090395	GO:0030029	GO:BP	actin filament-based process	16175	6653		0.05454545454545454	0.07142857142857142	708	15467	19	7	689	15460	16175	0.13473919049423072
M1	string	0	network_modules	138	TRUE	3.9438803636099366e-16	127	26	12	0.46153846153846156	0.09448818897637795	GO:0030041	GO:BP	actin filament polymerization	16175	6662		0.07272727272727272	0.08928571428571429	127	16048	12	14	115	16034	16175	0.2062538236161253
M1	string	0	network_modules	138	TRUE	6.263310813859842e-16	113	24	12	0.5	0.10619469026548672	REAC:R-HSA-9664417	REAC	Leishmania phagocytosis	10916	1312		0.058823529411764705	0.2222222222222222	113	10803	12	12	101	10791	10916	0.22708482025589344
M1	string	0	network_modules	138	TRUE	6.263310813859842e-16	113	24	12	0.5	0.10619469026548672	REAC:R-HSA-9664422	REAC	FCGR3A-mediated phagocytosis	10916	899		0.058823529411764705	0.2222222222222222	113	10803	12	12	101	10791	10916	0.22708482025589344
M1	string	0	network_modules	138	TRUE	6.263310813859842e-16	113	24	12	0.5	0.10619469026548672	REAC:R-HSA-9664407	REAC	Parasite infection	10916	1716		0.058823529411764705	0.2222222222222222	113	10803	12	12	101	10791	10916	0.22708482025589344
M1	string	0	network_modules	138	TRUE	8.69078338582513e-16	116	24	12	0.5	0.10344827586206896	REAC:R-HSA-2029482	REAC	Regulation of actin dynamics for phagocytic cup formation	10916	2020		0.23529411764705882	0.2777777777777778	116	10800	12	12	104	10788	10916	0.22403445540979125
M1	string	0	network_modules	138	TRUE	8.98494561117729e-15	140	24	12	0.5	0.08571428571428572	REAC:R-HSA-2029480	REAC	Fcgamma receptor (FCGR) dependent phagocytosis	10916	939		0.29411764705882354	0.3333333333333333	140	10776	12	12	128	10764	10916	0.2032391305384909
M1	string	0	network_modules	138	TRUE	2.972355984848968e-14	215	24	13	0.5416666666666666	0.06046511627906977	REAC:R-HSA-9824443	REAC	Parasitic Infection Pathways	10916	1717		0.35294117647058826	0.4444444444444444	215	10701	13	11	202	10690	10916	0.1763315942707333
M1	string	0	network_modules	138	TRUE	2.972355984848968e-14	215	24	13	0.5416666666666666	0.06046511627906977	REAC:R-HSA-9658195	REAC	Leishmania infection	10916	1310		0.35294117647058826	0.4444444444444444	215	10701	13	11	202	10690	10916	0.1763315942707333
M1	string	0	network_modules	138	TRUE	4.976336209264638e-14	748	26	17	0.6538461538461539	0.022727272727272728	GO:0097435	GO:BP	supramolecular fiber organization	16175	18657		0.09090909090909091	0.10714285714285714	748	15427	17	9	731	15418	16175	0.1160875822423311
M1	string	0	network_modules	138	TRUE	2.5680012818031705e-13	184	24	12	0.5	0.06521739130434782	REAC:R-HSA-9013149	REAC	RAC1 GTPase cycle	10916	1836		0.47058823529411764	0.5	184	10732	12	12	172	10720	10916	0.17617435350626684
M1	string	0	network_modules	138	TRUE	2.7704907617397067e-13	197	21	12	0.5714285714285714	0.06091370558375635	KEGG:05130	KEGG	Pathogenic Escherichia coli infection	8484	427		0	0.125	197	8287	12	9	185	8278	8484	0.18132681528809538
M1	string	0	network_modules	138	TRUE	8.723830570690109e-13	238	26	12	0.46153846153846156	0.05042016806722689	GO:0051258	GO:BP	protein polymerization	16175	13605		0.10909090909090909	0.125	238	15937	12	14	226	15923	16175	0.1489029352233096
M1	string	0	network_modules	138	TRUE	4.930689351810656e-12	318	24	13	0.5416666666666666	0.040880503144654086	REAC:R-HSA-195258	REAC	RHO GTPase Effectors	10916	1846		0.5294117647058824	0.5555555555555556	318	10598	13	11	305	10587	10916	0.14305842541352592
M1	string	0	network_modules	138	TRUE	7.1518138794317124e-12	651	26	15	0.5769230769230769	0.02304147465437788	GO:0000902	GO:BP	cell morphogenesis	16175	240		0.12727272727272726	0.14285714285714285	651	15524	15	11	636	15513	16175	0.10956651098807597
M1	string	0	network_modules	138	TRUE	1.350514190365674e-11	449	24	14	0.5833333333333334	0.031180400890868598	REAC:R-HSA-9012999	REAC	RHO GTPase cycle	10916	1847		0.5882352941176471	0.6111111111111112	449	10467	14	10	435	10457	10916	0.1281567258648013
M1	string	0	network_modules	138	TRUE	1.5955155507383273e-11	215	26	11	0.4230769230769231	0.05116279069767442	GO:0110053	GO:BP	regulation of actin filament organization	16175	19377		0.14545454545454545	0.16071428571428573	215	15960	11	15	204	15945	16175	0.14357483431402096
M1	string	0	network_modules	138	TRUE	6.38963441823642e-11	94	24	9	0.375	0.09574468085106383	REAC:R-HSA-4420097	REAC	VEGFA-VEGFR2 Pathway	10916	2634		0.6470588235294118	0.6666666666666666	94	10822	9	15	85	10807	10916	0.18614004477677434
M1	string	0	network_modules	138	TRUE	1.629995653052463e-10	104	24	9	0.375	0.08653846153846154	REAC:R-HSA-194138	REAC	Signaling by VEGF	10916	2313		0.7058823529411765	0.7222222222222222	104	10812	9	15	95	10797	10916	0.17660402026862834
M1	string	0	network_modules	138	TRUE	2.311570571232037e-10	274	26	11	0.4230769230769231	0.040145985401459854	GO:0032956	GO:BP	regulation of actin cytoskeleton organization	16175	7940		0.16363636363636364	0.17857142857142858	274	15901	11	15	263	15886	16175	0.1262825717104612
M1	string	0	network_modules	138	TRUE	5.530531619357946e-10	8	26	5	0.19230769230769232	0.625	GO:2000601	GO:BP	positive regulation of Arp2/3 complex-mediated actin nucleation	16175	25890		0.18181818181818182	0.19642857142857142	8	16167	5	21	3	16146	16175	0.34615985634123897
M1	string	0	network_modules	138	TRUE	8.314250209022051e-10	308	26	11	0.4230769230769231	0.03571428571428571	GO:0032970	GO:BP	regulation of actin filament-based process	16175	7953		0.2	0.21428571428571427	308	15867	11	15	297	15852	16175	0.11861908545578911
M1	string	0	network_modules	138	TRUE	1.1781609705717698e-9	318	26	11	0.4230769230769231	0.03459119496855346	GO:1902903	GO:BP	regulation of supramolecular fiber organization	16175	22602		0.21818181818181817	0.23214285714285715	318	15857	11	15	307	15842	16175	0.11659722620496461
M1	string	0	network_modules	138	TRUE	1.5108277437065119e-9	150	26	9	0.34615384615384615	0.06	GO:1902905	GO:BP	positive regulation of supramolecular fiber organization	16175	22604		0.23636363636363636	0.25	150	16025	9	17	141	16008	16175	0.1410227182094328
M1	string	0	network_modules	138	TRUE	2.2696342244009387e-9	460	26	12	0.46153846153846156	0.02608695652173913	GO:0048858	GO:BP	cell projection morphogenesis	16175	13102		0.2545454545454545	0.26785714285714285	460	15715	12	14	448	15701	16175	0.10454655641459697
M1	string	0	network_modules	138	TRUE	2.2878040413816167e-9	157	26	9	0.34615384615384615	0.05732484076433121	GO:0051495	GO:BP	positive regulation of cytoskeleton organization	16175	13750		0.2727272727272727	0.2857142857142857	157	16018	9	17	148	16001	16175	0.13769605335194918
M1	string	0	network_modules	138	TRUE	4.547889386021267e-9	11	26	5	0.19230769230769232	0.45454545454545453	GO:0051127	GO:BP	positive regulation of actin nucleation	16175	13511		0.2909090909090909	0.30357142857142855	11	16164	5	21	6	16143	16175	0.29494803834232025
M1	string	0	network_modules	138	TRUE	8.62423671737014e-9	113	26	8	0.3076923076923077	0.07079646017699115	GO:0008064	GO:BP	regulation of actin polymerization or depolymerization	16175	3113		0.3090909090909091	0.32142857142857145	113	16062	8	18	105	16044	16175	0.14486435001184422
M1	string	0	network_modules	138	TRUE	1.0675100250927522e-8	116	26	8	0.3076923076923077	0.06896551724137931	GO:0030832	GO:BP	regulation of actin filament length	16175	6917		0.32727272727272727	0.3392857142857143	116	16059	8	18	108	16041	16175	0.14290399221609817
M1	string	0	network_modules	138	TRUE	3.960643807114263e-8	440	26	11	0.4230769230769231	0.025	GO:0051493	GO:BP	regulation of cytoskeleton organization	16175	13748		0.34545454545454546	0.35714285714285715	440	15735	11	15	429	15720	16175	0.09764632599596826
M1	string	0	network_modules	138	TRUE	5.811481947970693e-8	456	26	11	0.4230769230769231	0.02412280701754386	GO:0120039	GO:BP	plasma membrane bounded cell projection morphogenesis	16175	19473		0.36363636363636365	0.375	456	15719	11	15	445	15704	16175	0.0957269453908586
M1	string	0	network_modules	138	TRUE	2.5593402634525014e-7	172	26	8	0.3076923076923077	0.046511627906976744	GO:0120032	GO:BP	regulation of plasma membrane bounded cell projection assembly	16175	19468		0.38181818181818183	0.39285714285714285	172	16003	8	18	164	15985	16175	0.11620782424669332
M1	string	0	network_modules	138	TRUE	2.680754910400367e-7	173	26	8	0.3076923076923077	0.046242774566473986	GO:0060491	GO:BP	regulation of cell projection assembly	16175	14685		0.4	0.4107142857142857	173	16002	8	18	165	15984	16175	0.11585098129075883
M1	string	0	network_modules	138	TRUE	7.810454619699322e-7	27	26	5	0.19230769230769232	0.18518518518518517	GO:0034315	GO:BP	regulation of Arp2/3 complex-mediated actin nucleation	16175	8569		0.41818181818181815	0.42857142857142855	27	16148	5	21	22	16127	16175	0.18738179335952448
M1	string	0	network_modules	138	TRUE	1.0235640192743096e-6	441	26	10	0.38461538461538464	0.022675736961451247	GO:0048812	GO:BP	neuron projection morphogenesis	16175	13058		0.43636363636363634	0.44642857142857145	441	15734	10	16	431	15718	16175	0.08804696431391085
M1	string	0	network_modules	138	TRUE	1.4457682613579122e-6	136	21	7	0.3333333333333333	0.051470588235294115	KEGG:05135	KEGG	Yersinia infection	8484	432		0.14285714285714285	0.25	136	8348	7	14	129	8334	8484	0.12585250320977598
M1	string	0	network_modules	138	TRUE	1.7458599165830176e-6	466	26	10	0.38461538461538464	0.02145922746781116	GO:0120035	GO:BP	regulation of plasma membrane bounded cell projection organization	16175	19471		0.45454545454545453	0.4642857142857143	466	15709	10	16	456	15693	16175	0.0853500079999304
M1	string	0	network_modules	138	TRUE	2.0400324172195197e-6	73	26	6	0.23076923076923078	0.0821917808219178	GO:0097581	GO:BP	lamellipodium organization	16175	18706		0.4727272727272727	0.48214285714285715	73	16102	6	20	67	16082	16175	0.13544316343780874
M1	string	0	network_modules	138	TRUE	2.252851731416212e-6	227	21	8	0.38095238095238093	0.03524229074889868	KEGG:04810	KEGG	Regulation of actin cytoskeleton	8484	365		0.2857142857142857	0.375	227	8257	8	13	219	8244	8484	0.10933718349930692
M1	string	0	network_modules	138	TRUE	2.281297063397389e-6	33	26	5	0.19230769230769232	0.15151515151515152	GO:0051125	GO:BP	regulation of actin nucleation	16175	13509		0.4909090909090909	0.5	33	16142	5	21	28	16121	16175	0.1691948470231696
M1	string	0	network_modules	138	TRUE	2.3238204743734658e-6	480	26	10	0.38461538461538464	0.020833333333333332	GO:0031344	GO:BP	regulation of cell projection organization	16175	7135		0.509090909090909	0.5178571428571429	480	15695	10	16	470	15679	16175	0.08392894477995745
M1	string	0	network_modules	138	TRUE	2.6717277522376347e-6	34	26	5	0.19230769230769232	0.14705882352941177	GO:0010591	GO:BP	regulation of lamellipodium assembly	16175	4239		0.5272727272727272	0.5357142857142857	34	16141	5	21	29	16120	16175	0.16663911773299533
M1	string	0	network_modules	138	TRUE	3.159418725993219e-6	35	24	5	0.20833333333333334	0.14285714285714285	REAC:R-HSA-202433	REAC	Generation of second messenger molecules	10916	1044		0.7647058823529411	0.7777777777777778	35	10881	5	19	30	10862	10916	0.17032162720679644
M1	string	0	network_modules	138	TRUE	4.4929712028964e-6	514	26	10	0.38461538461538464	0.019455252918287938	GO:0030031	GO:BP	cell projection assembly	16175	6655		0.5454545454545454	0.5535714285714286	514	15661	10	16	504	15645	16175	0.0807127477139832
M1	string	0	network_modules	138	TRUE	4.509542581102442e-6	93	21	6	0.2857142857142857	0.06451612903225806	KEGG:04520	KEGG	Adherens junction	8484	316		0.42857142857142855	0.5	93	8391	6	15	87	8376	8484	0.1314441963946479
M1	string	0	network_modules	138	TRUE	6.172393876014701e-6	257	26	8	0.3076923076923077	0.0311284046692607	GO:0032535	GO:BP	regulation of cellular component size	16175	7629		0.5636363636363636	0.5714285714285714	257	15918	8	18	249	15900	16175	0.09363494627413493
M1	string	0	network_modules	138	TRUE	8.097350159393802e-6	42	26	5	0.19230769230769232	0.11904761904761904	GO:0034314	GO:BP	Arp2/3 complex-mediated actin nucleation	16175	8568		0.5818181818181818	0.6071428571428571	42	16133	5	21	37	16112	16175	0.14957832281080038
M1	string	0	network_modules	138	TRUE	8.097350159393802e-6	42	26	5	0.19230769230769232	0.11904761904761904	GO:0030838	GO:BP	positive regulation of actin filament polymerization	16175	6923		0.5818181818181818	0.6071428571428571	42	16133	5	21	37	16112	16175	0.14957832281080038
M1	string	0	network_modules	138	TRUE	1.1543783948462157e-5	97	26	6	0.23076923076923078	0.061855670103092786	GO:0030833	GO:BP	regulation of actin filament polymerization	16175	6918		0.6181818181818182	0.625	97	16078	6	20	91	16058	16175	0.11681513056961276
M1	string	0	network_modules	138	TRUE	1.222922627653139e-5	412	26	9	0.34615384615384615	0.021844660194174758	GO:0044089	GO:BP	positive regulation of cellular component biogenesis	16175	10911		0.6363636363636364	0.6428571428571429	412	15763	9	17	403	15746	16175	0.08167051218122573
M1	string	0	network_modules	138	TRUE	1.2722479850733248e-5	94	24	6	0.25	0.06382978723404255	REAC:R-HSA-9013423	REAC	RAC3 GTPase cycle	10916	1838		0.8235294117647058	0.8333333333333334	94	10822	6	18	88	10804	10916	0.12263508388218537
M1	string	0	network_modules	138	TRUE	1.2991511466685919e-5	46	26	5	0.19230769230769232	0.10869565217391304	GO:1902743	GO:BP	regulation of lamellipodium organization	16175	22469		0.6545454545454545	0.6607142857142857	46	16129	5	21	41	16108	16175	0.14275842465361757
M1	string	0	network_modules	138	TRUE	1.44526575705191e-5	420	26	9	0.34615384615384615	0.02142857142857143	GO:0010638	GO:BP	positive regulation of organelle organization	16175	4284		0.6727272727272727	0.6785714285714286	420	15755	9	17	411	15738	16175	0.0807847051152998
M1	string	0	network_modules	138	TRUE	1.9993972771539603e-5	50	26	5	0.19230769230769232	0.1	GO:0045010	GO:BP	actin nucleation	16175	11227		0.6909090909090909	0.6964285714285714	50	16125	5	21	45	16104	16175	0.1367673059403245
M1	string	0	network_modules	138	TRUE	2.0028867051913315e-5	793	26	11	0.4230769230769231	0.013871374527112233	GO:0044087	GO:BP	regulation of cellular component biogenesis	16175	10909		0.7090909090909091	0.7142857142857143	793	15382	11	15	782	15367	16175	0.06950972339442818
M1	string	0	network_modules	138	TRUE	3.9213530612822485e-5	57	26	5	0.19230769230769232	0.08771929824561403	GO:0030032	GO:BP	lamellipodium assembly	16175	6656		0.7272727272727273	0.7321428571428571	57	16118	5	21	52	16097	16175	0.12782909611178953
M1	string	0	network_modules	138	TRUE	4.243754446717733e-5	329	26	8	0.3076923076923077	0.0243161094224924	GO:0090066	GO:BP	regulation of anatomical structure size	16175	17992		0.7454545454545455	0.75	329	15846	8	18	321	15828	16175	0.08167986547773377
M1	string	0	network_modules	138	TRUE	6.832699093443104e-5	684	26	10	0.38461538461538464	0.014619883040935672	GO:0031175	GO:BP	neuron projection development	16175	7086		0.7636363636363637	0.7678571428571429	684	15491	10	16	674	15475	16175	0.06825471681781892
M1	string	0	network_modules	138	TRUE	6.857676376043942e-5	503	26	9	0.34615384615384615	0.017892644135188866	GO:0120031	GO:BP	plasma membrane bounded cell projection assembly	16175	19467		0.7818181818181819	0.7857142857142857	503	15672	9	17	494	15655	16175	0.07282832972920643
M1	string	0	network_modules	138	TRUE	1.4545623507437755e-4	252	26	7	0.2692307692307692	0.027777777777777776	GO:0031346	GO:BP	positive regulation of cell projection organization	16175	7137		0.8	0.8035714285714286	252	15923	7	19	245	15904	16175	0.08218305851404821
M1	string	0	network_modules	138	TRUE	1.8604244931758428e-4	761	26	10	0.38461538461538464	0.013140604467805518	GO:0048666	GO:BP	neuron development	16175	12924		0.8181818181818182	0.8214285714285714	761	15414	10	16	751	15398	16175	0.06396887759924609
M1	string	0	network_modules	138	TRUE	1.8951464296641113e-4	96	21	5	0.23809523809523808	0.052083333333333336	KEGG:04666	KEGG	Fc gamma R-mediated phagocytosis	8484	341		0.5714285714285714	0.625	96	8388	5	16	91	8372	8484	0.10680404896765461
M1	string	0	network_modules	138	TRUE	2.0238415239654496e-4	507	24	9	0.375	0.01775147928994083	REAC:R-HSA-9006934	REAC	Signaling by Receptor Tyrosine Kinases	10916	2302		0.8823529411764706	0.8888888888888888	507	10409	9	15	498	10394	10916	0.07328484198255386
M1	string	0	network_modules	138	TRUE	2.060952620036114e-4	79	26	5	0.19230769230769232	0.06329113924050633	GO:0032273	GO:BP	positive regulation of protein polymerization	16175	7454		0.8363636363636363	0.8392857142857143	79	16096	5	21	74	16075	16175	0.1078722958313537
M1	string	0	network_modules	138	TRUE	2.4021948182593008e-4	161	26	6	0.23076923076923078	0.037267080745341616	GO:0032271	GO:BP	regulation of protein polymerization	16175	7452		0.8545454545454545	0.8571428571428571	161	16014	6	20	155	15994	16175	0.0892534567312608
M1	string	0	network_modules	138	TRUE	2.5017386181563374e-4	155	24	6	0.25	0.03870967741935484	REAC:R-HSA-9013148	REAC	CDC42 GTPase cycle	10916	269		0.9411764705882353	0.9444444444444444	155	10761	6	18	149	10743	10916	0.09355525402175481
M1	string	0	network_modules	138	TRUE	3.674879177257877e-4	173	26	6	0.23076923076923078	0.03468208092485549	GO:0031334	GO:BP	positive regulation of protein-containing complex assembly	16175	7125		0.8727272727272727	0.875	173	16002	6	20	167	15982	16175	0.08584522281806786
M1	string	0	network_modules	138	TRUE	4.143056970750181e-4	36	26	4	0.15384615384615385	0.1111111111111111	GO:0016601	GO:BP	Rac protein signal transduction	16175	5257		0.8909090909090909	0.8928571428571429	36	16139	4	22	32	16117	16175	0.12910007681605098
M1	string	0	network_modules	138	TRUE	4.938520171545708e-4	94	26	5	0.19230769230769232	0.05319148936170213	GO:0120034	GO:BP	positive regulation of plasma membrane bounded cell projection assembly	16175	19470		0.9090909090909091	0.9107142857142857	94	16081	5	21	89	16060	16175	0.09844820641075007
M1	string	0	network_modules	138	TRUE	0.0012415753158373803	346	26	7	0.2692307692307692	0.02023121387283237	GO:0043254	GO:BP	regulation of protein-containing complex assembly	16175	10588		0.9272727272727272	0.9285714285714286	346	15829	7	19	339	15810	16175	0.06873284028278835
M1	string	0	network_modules	138	TRUE	0.0014505024923884599	249	21	6	0.2857142857142857	0.024096385542168676	KEGG:05132	KEGG	Salmonella infection	8484	429		0.7142857142857143	0.75	249	8235	6	15	243	8220	8484	0.07566155503995599
M1	string	0	network_modules	138	TRUE	0.0016388556547663501	120	24	5	0.20833333333333334	0.041666666666666664	REAC:R-HSA-202403	REAC	TCR signaling	10916	2422		1	1	120	10796	5	19	115	10777	10916	0.08884010127069819
M1	string	0	network_modules	138	TRUE	0.0022818804023979978	379	26	7	0.2692307692307692	0.018469656992084433	GO:0048667	GO:BP	cell morphogenesis involved in neuron differentiation	16175	12925		0.9454545454545454	0.9464285714285714	379	15796	7	19	372	15777	16175	0.06519976926948508
M1	string	0	network_modules	138	TRUE	0.0029834820484447304	135	26	5	0.19230769230769232	0.037037037037037035	GO:0051017	GO:BP	actin filament bundle assembly	16175	13442		0.9636363636363636	0.9642857142857143	135	16040	5	21	130	16019	16175	0.08113644448844501
M1	string	0	network_modules	138	TRUE	0.0033246838554198887	138	26	5	0.19230769230769232	0.036231884057971016	GO:0061572	GO:BP	actin filament bundle organization	16175	15565		0.9818181818181818	0.9821428571428571	138	16037	5	21	133	16016	16175	0.0801762705384084
M1	string	0	network_modules	138	TRUE	0.00487808005922128	19	26	3	0.11538461538461539	0.15789473684210525	GO:0097320	GO:BP	plasma membrane tubulation	16175	18595		1	1	19	16156	3	23	16	16133	16175	0.13378838606206206
M1	string	0	network_modules	138	TRUE	0.0055449022316138895	98	21	4	0.19047619047619047	0.04081632653061224	KEGG:05231	KEGG	Choline metabolism in cancer	8484	479		0.8571428571428571	0.875	98	8386	4	17	94	8369	8484	0.08341204744954542
M1	string	0	network_modules	138	TRUE	0.00839405002538442	210	21	5	0.23809523809523808	0.023809523809523808	KEGG:04015	KEGG	Rap1 signaling pathway	8484	248		1	1	210	8274	5	16	205	8258	8484	0.06840040074109319
M1	string	0	network_modules	139	TRUE	2.191503903528963e-18	11	25	8	0.32	0.7272727272727273	GO:0001867	GO:BP	complement activation, lectin pathway	16175	504		0	0.023809523809523808	11	16164	8	17	3	16147	16175	0.48192926932624636
M1	string	0	network_modules	139	TRUE	1.0060960444928797e-17	7	21	7	0.3333333333333333	1	REAC:R-HSA-166662	REAC	Lectin pathway of complement activation	10916	1309		0	0.01694915254237288	7	10909	7	14	0	10895	10916	0.5769796807433613
M1	string	0	network_modules	139	TRUE	1.0174766516860857e-13	56	25	9	0.36	0.16071428571428573	GO:0006956	GO:BP	complement activation	16175	2587		0.024390243902439025	0.047619047619047616	56	16119	9	16	47	16103	16175	0.23881996549886403
M1	string	0	network_modules	139	TRUE	8.526216699478851e-13	9	25	6	0.24	0.6666666666666666	GO:1903028	GO:BP	positive regulation of opsonization	16175	22710		0.04878048780487805	0.07142857142857142	9	16166	6	19	3	16147	16175	0.3994925604141813
M1	string	0	network_modules	139	TRUE	4.679976310232698e-12	11	25	6	0.24	0.5454545454545454	GO:1903027	GO:BP	regulation of opsonization	16175	22709		0.07317073170731707	0.09523809523809523	11	16164	6	19	5	16145	16175	0.3611903584824588
M1	string	0	network_modules	139	TRUE	5.049574509616171e-11	15	25	6	0.24	0.4	GO:0008228	GO:BP	opsonization	16175	3147		0.0975609756097561	0.11904761904761904	15	16160	6	19	9	16141	16175	0.30902356993931707
M1	string	0	network_modules	139	TRUE	8.955076689273158e-11	68	21	8	0.38095238095238093	0.11764705882352941	REAC:R-HSA-166786	REAC	Creation of C4 and C2 activators	10916	413		0.017241379310344827	0.03389830508474576	68	10848	8	13	60	10835	10916	0.20909353478873344
M1	string	0	network_modules	139	TRUE	2.1094357234891736e-10	72	13	7	0.5384615384615384	0.09722222222222222	KEGG:05218	KEGG	Melanoma	8484	469		0	0.08333333333333333	72	8412	7	6	65	8406	8484	0.2263312272707767
M1	string	0	network_modules	139	TRUE	2.2649303971015564e-10	76	21	8	0.38095238095238093	0.10526315789473684	REAC:R-HSA-166663	REAC	Initial triggering of complement	10916	1200		0.034482758620689655	0.05084745762711865	76	10840	8	13	68	10827	10916	0.1974686937755949
M1	string	0	network_modules	139	TRUE	3.8908583970874627e-10	20	25	6	0.24	0.3	GO:0006910	GO:BP	phagocytosis, recognition	16175	2560		0.12195121951219512	0.14285714285714285	20	16155	6	19	14	16136	16175	0.26731758652032983
M1	string	0	network_modules	139	TRUE	3.2031180307105722e-9	4	21	4	0.19047619047619047	1	REAC:R-HSA-2855086	REAC	Ficolins bind to repetitive carbohydrate structures on the target cell surface	10916	942		0.05172413793103448	0.06779661016949153	4	10912	4	17	0	10895	10916	0.43609568240433466
M1	string	0	network_modules	139	TRUE	4.95149100212572e-9	61	25	7	0.28	0.11475409836065574	GO:0008543	GO:BP	fibroblast growth factor receptor signaling pathway	16175	3191		0.14634146341463414	0.16666666666666666	61	16114	7	18	54	16096	16175	0.1773088072318055
M1	string	0	network_modules	139	TRUE	5.109274447607802e-9	111	21	8	0.38095238095238093	0.07207207207207207	REAC:R-HSA-166658	REAC	Complement cascade	10916	390		0.06896551724137931	0.0847457627118644	111	10805	8	13	103	10792	10916	0.16225812673038084
M1	string	0	network_modules	139	TRUE	9.88101188798817e-9	14	21	5	0.23809523809523808	0.35714285714285715	REAC:R-HSA-5654221	REAC	Phospholipase C-mediated cascade; FGFR2	10916	1745		0.08620689655172414	0.11864406779661017	14	10902	5	16	9	10886	10916	0.2905008925076168
M1	string	0	network_modules	139	TRUE	9.88101188798817e-9	14	21	5	0.23809523809523808	0.35714285714285715	REAC:R-HSA-2033519	REAC	Activated point mutants of FGFR2	10916	69		0.08620689655172414	0.11864406779661017	14	10902	5	16	9	10886	10916	0.2905008925076168
M1	string	0	network_modules	139	TRUE	2.150589230674638e-8	16	21	5	0.23809523809523808	0.3125	REAC:R-HSA-190241	REAC	FGFR2 ligand binding and activation	10916	906		0.1206896551724138	0.15254237288135594	16	10900	5	16	11	10884	10916	0.27155337346747044
M1	string	0	network_modules	139	TRUE	2.150589230674638e-8	16	21	5	0.23809523809523808	0.3125	REAC:R-HSA-5654699	REAC	SHC-mediated cascade:FGFR2	10916	2134		0.1206896551724138	0.15254237288135594	16	10900	5	16	11	10884	10916	0.27155337346747044
M1	string	0	network_modules	139	TRUE	3.2326112387671155e-8	79	25	7	0.28	0.08860759493670886	GO:0044344	GO:BP	cellular response to fibroblast growth factor stimulus	16175	10963		0.17073170731707318	0.19047619047619047	79	16096	7	18	72	16078	16175	0.15526416235753004
M1	string	0	network_modules	139	TRUE	3.4783125426263386e-8	147	13	7	0.5384615384615384	0.047619047619047616	KEGG:05224	KEGG	Breast cancer	8484	475		0.09090909090909091	0.16666666666666666	147	8337	7	6	140	8331	8484	0.15645574214737448
M1	string	0	network_modules	139	TRUE	3.6487031526757476e-8	148	13	7	0.5384615384615384	0.0472972972972973	KEGG:05226	KEGG	Gastric cancer	8484	477		0.18181818181818182	0.25	148	8336	7	6	141	8330	8484	0.15590036275600472
M1	string	0	network_modules	139	TRUE	3.8409245354353426e-8	224	25	9	0.36	0.04017857142857143	GO:0006959	GO:BP	humoral immune response	16175	2590		0.1951219512195122	0.21428571428571427	224	15951	9	16	215	15935	16175	0.11654032954191254
M1	string	0	network_modules	139	TRUE	3.870124501576544e-8	81	25	7	0.28	0.08641975308641975	GO:0071774	GO:BP	response to fibroblast growth factor	16175	16903		0.21951219512195122	0.23809523809523808	81	16094	7	18	74	16076	16175	0.15327594826680757
M1	string	0	network_modules	139	TRUE	4.208154639744775e-8	18	21	5	0.23809523809523808	0.2777777777777778	REAC:R-HSA-5654695	REAC	PI-3K cascade:FGFR2	10916	1668		0.15517241379310345	0.1694915254237288	18	10898	5	16	13	10882	10916	0.25584821590693674
M1	string	0	network_modules	139	TRUE	5.704084090434231e-8	19	21	5	0.23809523809523808	0.2631578947368421	REAC:R-HSA-5654700	REAC	FRS-mediated FGFR2 signaling	10916	928		0.1724137931034483	0.1864406779661017	19	10897	5	16	14	10881	10916	0.24893930676543213
M1	string	0	network_modules	139	TRUE	1.6425835938996668e-7	23	21	5	0.23809523809523808	0.21739130434782608	REAC:R-HSA-5654696	REAC	Downstream signaling of activated FGFR2	10916	793		0.1896551724137931	0.2033898305084746	23	10893	5	16	18	10877	10916	0.22594994870933782
M1	string	0	network_modules	139	TRUE	4.0108395325497193e-7	9	21	4	0.19047619047619047	0.4444444444444444	REAC:R-HSA-190375	REAC	FGFR2c ligand binding and activation	10916	909		0.20689655172413793	0.3050847457627119	9	10907	4	17	5	10890	10916	0.2900964503272823
M1	string	0	network_modules	139	TRUE	4.0108395325497193e-7	9	21	4	0.19047619047619047	0.4444444444444444	REAC:R-HSA-2033514	REAC	FGFR3 mutant receptor activation	10916	911		0.20689655172413793	0.3050847457627119	9	10907	4	17	5	10890	10916	0.2900964503272823
M1	string	0	network_modules	139	TRUE	4.0108395325497193e-7	9	21	4	0.19047619047619047	0.4444444444444444	REAC:R-HSA-190372	REAC	FGFR3c ligand binding and activation	10916	913		0.20689655172413793	0.3050847457627119	9	10907	4	17	5	10890	10916	0.2900964503272823
M1	string	0	network_modules	139	TRUE	4.0108395325497193e-7	9	21	4	0.19047619047619047	0.4444444444444444	REAC:R-HSA-190239	REAC	FGFR3 ligand binding and activation	10916	910		0.20689655172413793	0.3050847457627119	9	10907	4	17	5	10890	10916	0.2900964503272823
M1	string	0	network_modules	139	TRUE	4.0108395325497193e-7	9	21	4	0.19047619047619047	0.4444444444444444	REAC:R-HSA-1839130	REAC	Signaling by activated point mutants of FGFR3	10916	2317		0.20689655172413793	0.3050847457627119	9	10907	4	17	5	10890	10916	0.2900964503272823
M1	string	0	network_modules	139	TRUE	4.0108395325497193e-7	9	21	4	0.19047619047619047	0.4444444444444444	REAC:R-HSA-5654227	REAC	Phospholipase C-mediated cascade; FGFR3	10916	1746		0.20689655172413793	0.3050847457627119	9	10907	4	17	5	10890	10916	0.2900964503272823
M1	string	0	network_modules	139	TRUE	4.241751385071793e-7	210	13	7	0.5384615384615384	0.03333333333333333	KEGG:04015	KEGG	Rap1 signaling pathway	8484	248		0.2727272727272727	0.3333333333333333	210	8274	7	6	203	8268	8484	0.1295253627943926
M1	string	0	network_modules	139	TRUE	4.348520676901652e-7	59	25	6	0.24	0.1016949152542373	GO:0050766	GO:BP	positive regulation of phagocytosis	16175	13240		0.24390243902439024	0.2619047619047619	59	16116	6	19	53	16097	16175	0.15425292351149178
M1	string	0	network_modules	139	TRUE	4.3845312248684765e-7	211	13	7	0.5384615384615384	0.03317535545023697	KEGG:05207	KEGG	Chemical carcinogenesis - receptor activation	8484	459		0.36363636363636365	0.4166666666666667	211	8273	7	6	204	8267	8484	0.12919622504582226
M1	string	0	network_modules	139	TRUE	4.768293457044268e-7	28	21	5	0.23809523809523808	0.17857142857142858	REAC:R-HSA-5654727	REAC	Negative regulation of FGFR2 signaling	10916	1569		0.3103448275862069	0.3220338983050847	28	10888	5	16	23	10872	10916	0.2044339776340523
M1	string	0	network_modules	139	TRUE	5.754640056353284e-7	29	21	5	0.23809523809523808	0.1724137931034483	REAC:R-HSA-1839126	REAC	FGFR2 mutant receptor activation	10916	907		0.3275862068965517	0.3389830508474576	29	10887	5	16	24	10871	10916	0.2008094237516726
M1	string	0	network_modules	139	TRUE	7.291928797688509e-7	227	13	7	0.5384615384615384	0.030837004405286344	KEGG:04810	KEGG	Regulation of actin cytoskeleton	8484	365		0.45454545454545453	0.5	227	8257	7	6	220	8251	8484	0.12422266215224387
M1	string	0	network_modules	139	TRUE	9.275373523554765e-7	235	13	7	0.5384615384615384	0.029787234042553193	KEGG:04014	KEGG	Ras signaling pathway	8484	247		0.5454545454545454	0.5833333333333334	235	8249	7	6	228	8243	8484	0.12192402186022855
M1	string	0	network_modules	139	TRUE	9.55385799623929e-7	67	25	6	0.24	0.08955223880597014	GO:0002752	GO:BP	cell surface pattern recognition receptor signaling pathway	16175	1263		0.2682926829268293	0.2857142857142857	67	16108	6	19	61	16089	16175	0.14448410480150697
M1	string	0	network_modules	139	TRUE	1.0478408113140293e-6	11	21	4	0.19047619047619047	0.36363636363636365	REAC:R-HSA-5654704	REAC	SHC-mediated cascade:FGFR3	10916	2135		0.3448275862068966	0.3559322033898305	11	10905	4	17	7	10888	10916	0.2621726511353661
M1	string	0	network_modules	139	TRUE	1.4644963860325052e-6	251	13	7	0.5384615384615384	0.027888446215139442	KEGG:04020	KEGG	Calcium signaling pathway	8484	250		0.6363636363636364	0.6666666666666666	251	8233	7	6	244	8227	8484	0.11765257005604618
M1	string	0	network_modules	139	TRUE	1.569801943970576e-6	12	21	4	0.19047619047619047	0.3333333333333333	REAC:R-HSA-190322	REAC	FGFR4 ligand binding and activation	10916	914		0.3620689655172414	0.3728813559322034	12	10904	4	17	8	10887	10916	0.25090134258013275
M1	string	0	network_modules	139	TRUE	1.8112432451447183e-6	36	21	5	0.23809523809523808	0.1388888888888889	REAC:R-HSA-109704	REAC	PI3K Cascade	10916	1671		0.3793103448275862	0.3898305084745763	36	10880	5	16	31	10864	10916	0.1797988903305315
M1	string	0	network_modules	139	TRUE	2.091687365567537e-6	37	21	5	0.23809523809523808	0.13513513513513514	REAC:R-HSA-5655253	REAC	Signaling by FGFR2 in disease	10916	2248		0.39655172413793105	0.4067796610169492	37	10879	5	16	32	10863	10916	0.17729148475059908
M1	string	0	network_modules	139	TRUE	2.2646650952583986e-6	13	21	4	0.19047619047619047	0.3076923076923077	REAC:R-HSA-5654710	REAC	PI-3K cascade:FGFR3	10916	1669		0.41379310344827586	0.4406779661016949	13	10903	4	17	9	10886	10916	0.24095265289158788
M1	string	0	network_modules	139	TRUE	2.2646650952583986e-6	13	21	4	0.19047619047619047	0.3076923076923077	REAC:R-HSA-5654228	REAC	Phospholipase C-mediated cascade; FGFR4	10916	1747		0.41379310344827586	0.4406779661016949	13	10903	4	17	9	10886	10916	0.24095265289158788
M1	string	0	network_modules	139	TRUE	2.756059238677477e-6	39	21	5	0.23809523809523808	0.1282051282051282	REAC:R-HSA-112399	REAC	IRS-mediated signalling	10916	1164		0.4482758620689655	0.4576271186440678	39	10877	5	16	34	10861	10916	0.17256678414907148
M1	string	0	network_modules	139	TRUE	3.0633368268367838e-6	81	25	6	0.24	0.07407407407407407	GO:0050764	GO:BP	regulation of phagocytosis	16175	13238		0.2926829268292683	0.30952380952380953	81	16094	6	19	75	16075	16175	0.13098063834580387
M1	string	0	network_modules	139	TRUE	3.16657872860657e-6	14	21	4	0.19047619047619047	0.2857142857142857	REAC:R-HSA-5654706	REAC	FRS-mediated FGFR3 signaling	10916	929		0.46551724137931033	0.4745762711864407	14	10902	4	17	10	10885	10916	0.23208605732703347
M1	string	0	network_modules	139	TRUE	4.004235073568568e-6	531	25	10	0.4	0.018832391713747645	GO:0032103	GO:BP	positive regulation of response to external stimulus	16175	7367		0.3170731707317073	0.3333333333333333	531	15644	10	15	521	15629	16175	0.08107293620982033
M1	string	0	network_modules	139	TRUE	4.111533970570087e-6	85	25	6	0.24	0.07058823529411765	GO:0002220	GO:BP	innate immune response activating cell surface receptor signaling pathway	16175	754		0.34146341463414637	0.35714285714285715	85	16090	6	19	79	16071	16175	0.12774292412352595
M1	string	0	network_modules	139	TRUE	4.3126788485672585e-6	15	21	4	0.19047619047619047	0.26666666666666666	REAC:R-HSA-5654719	REAC	SHC-mediated cascade:FGFR4	10916	2136		0.4827586206896552	0.4915254237288136	15	10901	4	17	11	10884	10916	0.22411814508086372
M1	string	0	network_modules	139	TRUE	4.585290515633626e-6	43	21	5	0.23809523809523808	0.11627906976744186	REAC:R-HSA-2428928	REAC	IRS-related events triggered by IGF1R	10916	1165		0.5	0.5254237288135594	43	10873	5	16	38	10857	10916	0.16411793683731565
M1	string	0	network_modules	139	TRUE	4.585290515633626e-6	43	21	5	0.23809523809523808	0.11627906976744186	REAC:R-HSA-2428924	REAC	IGF1R signaling cascade	10916	1142		0.5	0.5254237288135594	43	10873	5	16	38	10857	10916	0.16411793683731565
M1	string	0	network_modules	139	TRUE	5.131769503971683e-6	301	13	7	0.5384615384615384	0.023255813953488372	KEGG:04010	KEGG	MAPK signaling pathway	8484	243		0.7272727272727273	0.75	301	8183	7	6	294	8177	8484	0.10651696180026836
M1	string	0	network_modules	139	TRUE	5.166816219400867e-6	44	21	5	0.23809523809523808	0.11363636363636363	REAC:R-HSA-2404192	REAC	Signaling by Type 1 Insulin-like Growth Factor 1 Receptor (IGF1R)	10916	2312		0.5344827586206896	0.5423728813559322	44	10872	5	16	39	10856	10916	0.16218622618045406
M1	string	0	network_modules	139	TRUE	5.805553097997886e-6	45	21	5	0.23809523809523808	0.1111111111111111	REAC:R-HSA-74751	REAC	Insulin receptor signalling cascade	10916	1211		0.5517241379310345	0.559322033898305	45	10871	5	16	40	10855	10916	0.16031863834051743
M1	string	0	network_modules	139	TRUE	7.500805342168413e-6	17	21	4	0.19047619047619047	0.23529411764705882	REAC:R-HSA-5655332	REAC	Signaling by FGFR3 in disease	10916	2251		0.5689655172413793	0.5932203389830508	17	10899	4	17	13	10882	10916	0.2103376649462788
M1	string	0	network_modules	139	TRUE	7.500805342168413e-6	17	21	4	0.19047619047619047	0.23529411764705882	REAC:R-HSA-5654720	REAC	PI-3K cascade:FGFR4	10916	1670		0.5689655172413793	0.5932203389830508	17	10899	4	17	13	10882	10916	0.2103376649462788
M1	string	0	network_modules	139	TRUE	7.75830777238441e-6	4	21	3	0.14285714285714285	0.75	REAC:R-HSA-190371	REAC	FGFR3b ligand binding and activation	10916	912		0.603448275862069	0.6101694915254238	4	10912	3	18	1	10894	10916	0.3268616193220557
M1	string	0	network_modules	139	TRUE	9.631869283817229e-6	18	21	4	0.19047619047619047	0.2222222222222222	REAC:R-HSA-5654712	REAC	FRS-mediated FGFR4 signaling	10916	930		0.6206896551724138	0.6440677966101694	18	10898	4	17	14	10881	10916	0.20432172011637328
M1	string	0	network_modules	139	TRUE	9.631869283817229e-6	18	21	4	0.19047619047619047	0.2222222222222222	REAC:R-HSA-5654708	REAC	Downstream signaling of activated FGFR3	10916	794		0.6206896551724138	0.6440677966101694	18	10898	4	17	14	10881	10916	0.20432172011637328
M1	string	0	network_modules	139	TRUE	1.6215650565746964e-5	356	13	7	0.5384615384615384	0.019662921348314606	KEGG:04151	KEGG	PI3K-Akt signaling pathway	8484	285		0.8181818181818182	0.8333333333333334	356	8128	7	6	349	8122	8484	0.09700800560448765
M1	string	0	network_modules	139	TRUE	1.7908025262945627e-5	56	21	5	0.23809523809523808	0.08928571428571429	REAC:R-HSA-1226099	REAC	Signaling by FGFR in disease	10916	2240		0.6551724137931034	0.6610169491525424	56	10860	5	16	51	10844	10916	0.14316656216553408
M1	string	0	network_modules	139	TRUE	1.861853022027406e-5	4	25	3	0.12	0.75	GO:0043654	GO:BP	recognition of apoptotic cell	16175	10834		0.36585365853658536	0.38095238095238093	4	16171	3	22	1	16149	16175	0.29965044535356145
M1	string	0	network_modules	139	TRUE	2.07339046149732e-5	111	25	6	0.24	0.05405405405405406	GO:0008037	GO:BP	cell recognition	16175	3099		0.3902439024390244	0.40476190476190477	111	16064	6	19	105	16045	16175	0.11110969009812913
M1	string	0	network_modules	139	TRUE	2.2910586988732763e-5	22	21	4	0.19047619047619047	0.18181818181818182	REAC:R-HSA-5654716	REAC	Downstream signaling of activated FGFR4	10916	795		0.6724137931034483	0.6779661016949152	22	10894	4	17	18	10877	10916	0.18449116021832385
M1	string	0	network_modules	139	TRUE	2.7699287752804952e-5	23	21	4	0.19047619047619047	0.17391304347826086	REAC:R-HSA-5654732	REAC	Negative regulation of FGFR3 signaling	10916	1570		0.6896551724137931	0.6949152542372882	23	10893	4	17	19	10876	10916	0.18035648437469576
M1	string	0	network_modules	139	TRUE	2.892765343822231e-5	475	25	9	0.36	0.018947368421052633	GO:0002253	GO:BP	activation of immune response	16175	785		0.4146341463414634	0.42857142857142855	475	15700	9	16	466	15684	16175	0.07705104063361927
M1	string	0	network_modules	139	TRUE	3.539639120645687e-5	64	21	5	0.23809523809523808	0.078125	REAC:R-HSA-5654738	REAC	Signaling by FGFR2	10916	2244		0.7068965517241379	0.711864406779661	64	10852	5	16	59	10836	10916	0.13354796424773305
M1	string	0	network_modules	139	TRUE	3.829911157088939e-5	65	21	5	0.23809523809523808	0.07692307692307693	REAC:R-HSA-2219530	REAC	Constitutive Signaling by Aberrant PI3K in Cancer	10916	401		0.7241379310344828	0.7288135593220338	65	10851	5	16	60	10835	10916	0.13247052020436842
M1	string	0	network_modules	139	TRUE	3.8816093151913296e-5	339	25	8	0.32	0.02359882005899705	GO:0002833	GO:BP	positive regulation of response to biotic stimulus	16175	1343		0.43902439024390244	0.4523809523809524	339	15836	8	17	331	15819	16175	0.08213669668986362
M1	string	0	network_modules	139	TRUE	4.0356688314331684e-5	124	25	6	0.24	0.04838709677419355	GO:0045807	GO:BP	positive regulation of endocytosis	16175	11631		0.4634146341463415	0.47619047619047616	124	16051	6	19	118	16032	16175	0.1048041854201998
M1	string	0	network_modules	139	TRUE	5.462477105970423e-5	27	21	4	0.19047619047619047	0.14814814814814814	REAC:R-HSA-5654733	REAC	Negative regulation of FGFR4 signaling	10916	1571		0.7413793103448276	0.7457627118644068	27	10889	4	17	23	10872	10916	0.16616819185483825
M1	string	0	network_modules	139	TRUE	6.89658616648413e-5	73	21	5	0.23809523809523808	0.0684931506849315	REAC:R-HSA-74752	REAC	Signaling by Insulin receptor	10916	2260		0.7586206896551724	0.7627118644067796	73	10843	5	16	68	10827	10916	0.12465261807265644
M1	string	0	network_modules	139	TRUE	7.3946038548691745e-05	721	25	10	0.4	0.013869625520110958	GO:0045087	GO:BP	innate immune response	16175	11270		0.4878048780487805	0.5	721	15454	10	15	711	15439	16175	0.06776227267335051
M1	string	0	network_modules	139	TRUE	8.187929124072839e-5	536	25	9	0.36	0.016791044776119403	GO:0002252	GO:BP	immune effector process	16175	784		0.5121951219512195	0.5238095238095238	536	15639	9	16	527	15623	16175	0.07184659105327723
M1	string	0	network_modules	139	TRUE	8.451570137942398e-5	76	21	5	0.23809523809523808	0.06578947368421052	REAC:R-HSA-190236	REAC	Signaling by FGFR	10916	2239		0.7758620689655172	0.7796610169491526	76	10840	5	16	71	10824	10916	0.12203939335377828
M1	string	0	network_modules	139	TRUE	1.1123014206002465e-4	32	21	4	0.19047619047619047	0.125	REAC:R-HSA-5654741	REAC	Signaling by FGFR3	10916	2249		0.7931034482758621	0.7966101694915254	32	10884	4	17	28	10867	10916	0.15229832562815024
M1	string	0	network_modules	139	TRUE	1.6135278730790086e-4	35	21	4	0.19047619047619047	0.11428571428571428	REAC:R-HSA-5654743	REAC	Signaling by FGFR4	10916	2252		0.8103448275862069	0.8135593220338984	35	10881	4	17	31	10864	10916	0.14543169975716894
M1	string	0	network_modules	139	TRUE	2.0607501174965578e-4	276	25	7	0.28	0.025362318840579712	GO:0002697	GO:BP	regulation of immune effector process	16175	1215		0.5365853658536586	0.5476190476190477	276	15899	7	18	269	15881	16175	0.07988029830154736
M1	string	0	network_modules	139	TRUE	2.1413199024788616e-4	423	25	8	0.32	0.018912529550827423	GO:0031349	GO:BP	positive regulation of defense response	16175	7140		0.5609756097560976	0.5714285714285714	423	15752	8	17	415	15735	16175	0.07244585128805206
M1	string	0	network_modules	139	TRUE	2.205944013397169e-4	92	21	5	0.23809523809523808	0.05434782608695652	REAC:R-HSA-2219528	REAC	PI3K/AKT Signaling in Cancer	10916	1674		0.8275862068965517	0.847457627118644	92	10824	5	16	87	10808	10916	0.11029880511088
M1	string	0	network_modules	139	TRUE	2.205944013397169e-4	92	21	5	0.23809523809523808	0.05434782608695652	REAC:R-HSA-6811558	REAC	PI5P, PP2A and IER3 Regulate PI3K/AKT Signaling	10916	1677		0.8275862068965517	0.847457627118644	92	10824	5	16	87	10808	10916	0.11029880511088
M1	string	0	network_modules	139	TRUE	3.120255892725669e-4	627	25	9	0.36	0.014354066985645933	GO:0050778	GO:BP	positive regulation of immune response	16175	13252		0.5853658536585366	0.5952380952380952	627	15548	9	16	618	15532	16175	0.06547595582314168
M1	string	0	network_modules	139	TRUE	3.1726929367907207e-4	11	21	3	0.14285714285714285	0.2727272727272727	REAC:R-HSA-5654219	REAC	Phospholipase C-mediated cascade: FGFR1	10916	1744		0.8620689655172413	0.864406779661017	11	10905	3	18	8	10887	10916	0.19628089464160198
M1	string	0	network_modules	139	TRUE	3.1808723190321695e-4	99	21	5	0.23809523809523808	0.050505050505050504	REAC:R-HSA-199418	REAC	Negative regulation of the PI3K/AKT network	10916	1580		0.8793103448275862	0.8813559322033898	99	10817	5	16	94	10801	10916	0.10606529367759841
M1	string	0	network_modules	139	TRUE	3.4192349859413825e-4	42	21	4	0.19047619047619047	0.09523809523809523	REAC:R-HSA-5654736	REAC	Signaling by FGFR1	10916	2241		0.896551724137931	0.8983050847457628	42	10874	4	17	38	10857	10916	0.13234834326962486
M1	string	0	network_modules	139	TRUE	3.4961488338514443e-4	451	25	8	0.32	0.017738359201773836	GO:0002831	GO:BP	regulation of response to biotic stimulus	16175	1341		0.6097560975609756	0.6190476190476191	451	15724	8	17	443	15707	16175	0.06980969898091713
M1	string	0	network_modules	139	TRUE	3.5711934535944496e-4	86	13	4	0.3076923076923077	0.046511627906976744	KEGG:04610	KEGG	Complement and coagulation cascades	8484	320		0.9090909090909091	1	86	8398	4	9	82	8389	8484	0.11636863306804214
M1	string	0	network_modules	139	TRUE	3.5711934535944496e-4	86	13	4	0.3076923076923077	0.046511627906976744	KEGG:05150	KEGG	Staphylococcus aureus infection	8484	439		0.9090909090909091	1	86	8398	4	9	82	8389	8484	0.11636863306804214
M1	string	0	network_modules	139	TRUE	4.358651633375928e-4	185	25	6	0.24	0.032432432432432434	GO:0006909	GO:BP	phagocytosis	16175	2559		0.6341463414634146	0.6428571428571429	185	15990	6	19	179	15971	16175	0.0845713173385593
M1	string	0	network_modules	139	TRUE	5.424462426161215e-4	192	25	6	0.24	0.03125	GO:0002699	GO:BP	positive regulation of immune effector process	16175	1217		0.6585365853658537	0.6666666666666666	192	15983	6	19	186	15964	16175	0.08287629795044289
M1	string	0	network_modules	139	TRUE	5.485737953394275e-4	13	21	3	0.14285714285714285	0.23076923076923078	REAC:R-HSA-190242	REAC	FGFR1 ligand binding and activation	10916	900		0.9137931034482759	0.9322033898305084	13	10903	3	18	10	10885	10916	0.18033549359669784
M1	string	0	network_modules	139	TRUE	5.485737953394275e-4	13	21	3	0.14285714285714285	0.23076923076923078	REAC:R-HSA-5654688	REAC	SHC-mediated cascade:FGFR1	10916	2133		0.9137931034482759	0.9322033898305084	13	10903	3	18	10	10885	10916	0.18033549359669784
M1	string	0	network_modules	139	TRUE	7.896515473246213e-4	502	25	8	0.32	0.01593625498007968	GO:0071363	GO:BP	cellular response to growth factor stimulus	16175	16615		0.6829268292682927	0.6904761904761905	502	15673	8	17	494	15656	16175	0.06556084216564036
M1	string	0	network_modules	139	TRUE	8.705733528521941e-4	15	21	3	0.14285714285714285	0.2	REAC:R-HSA-5654689	REAC	PI-3K cascade:FGFR1	10916	1667		0.9482758620689655	0.9491525423728814	15	10901	3	18	12	10883	10916	0.1676814643799777
M1	string	0	network_modules	139	TRUE	0.00089008314021165485	510	25	8	0.32	0.01568627450980392	GO:0007169	GO:BP	cell surface receptor protein tyrosine kinase signaling pathway	16175	2733		0.7073170731707317	0.7142857142857143	510	15665	8	17	502	15648	16175	0.06494985529177366
M1	string	0	network_modules	139	TRUE	0.0010159884729032229	519	25	8	0.32	0.015414258188824663	GO:0070848	GO:BP	response to growth factor	16175	16340		0.7317073170731707	0.7380952380952381	519	15656	8	17	511	15639	16175	0.06427852370352836
M1	string	0	network_modules	139	TRUE	0.0010701495720102417	16	21	3	0.14285714285714285	0.1875	REAC:R-HSA-5654693	REAC	FRS-mediated FGFR1 signaling	10916	927		0.9655172413793104	0.9661016949152542	16	10900	3	18	13	10882	10916	0.16225919808324704
M1	string	0	network_modules	139	TRUE	0.0012378312936682661	221	25	6	0.24	0.027149321266968326	GO:0030100	GO:BP	regulation of endocytosis	16175	6678		0.7560975609756098	0.7619047619047619	221	15954	6	19	215	15935	16175	0.0767100982844017
M1	string	0	network_modules	139	TRUE	0.0014474731950201675	227	25	6	0.24	0.02643171806167401	GO:0002221	GO:BP	pattern recognition receptor signaling pathway	16175	755		0.7804878048780488	0.7857142857142857	227	15948	6	19	221	15929	16175	0.07557968546405808
M1	string	0	network_modules	139	TRUE	0.0015073289752482023	756	25	9	0.36	0.011904761904761904	GO:0050776	GO:BP	regulation of immune response	16175	13250		0.8048780487804879	0.8095238095238095	756	15419	9	16	747	15403	16175	0.05839096374050037
M1	string	0	network_modules	139	TRUE	0.0019770123078114406	781	25	9	0.36	0.011523687580025609	GO:0030334	GO:BP	regulation of cell migration	16175	6780		0.8292682926829268	0.8333333333333334	781	15394	9	16	772	15378	16175	0.05721176212896484
M1	string	0	network_modules	139	TRUE	0.0021525737150298644	243	25	6	0.24	0.024691358024691357	GO:0002758	GO:BP	innate immune response-activating signaling pathway	16175	1269		0.8536585365853658	0.8571428571428571	243	15932	6	19	237	15913	16175	0.07276583392927373
M1	string	0	network_modules	139	TRUE	0.002907886766272258	409	25	7	0.28	0.017114914425427872	GO:0060627	GO:BP	regulation of vesicle-mediated transport	16175	14803		0.8780487804878049	0.8809523809523809	409	15766	7	18	402	15748	16175	0.06383495284706689
M1	string	0	network_modules	139	TRUE	0.0029211387049777457	22	21	3	0.14285714285714285	0.13636363636363635	REAC:R-HSA-5654687	REAC	Downstream signaling of activated FGFR1	10916	792		0.9827586206896551	0.9830508474576272	22	10894	3	18	19	10876	10916	0.13787513538282495
M1	string	0	network_modules	139	TRUE	0.003406436549343877	263	25	6	0.24	0.022813688212927757	GO:0002218	GO:BP	activation of innate immune response	16175	753		0.9024390243902439	0.9047619047619048	263	15912	6	19	257	15893	16175	0.06960365806043334
M1	string	0	network_modules	139	TRUE	0.0035591639618353433	265	25	6	0.24	0.022641509433962263	GO:0002429	GO:BP	immune response-activating cell surface receptor signaling pathway	16175	952		0.926829268292683	0.9285714285714286	265	15910	6	19	259	15891	16175	0.069306540786384
M1	string	0	network_modules	139	TRUE	0.00444181271442159	19	25	3	0.12	0.15789473684210525	GO:0046597	GO:BP	negative regulation of viral entry into host cell	16175	12247		0.9512195121951219	0.9523809523809523	19	16156	3	22	16	16134	16175	0.13648766424315323
M1	string	0	network_modules	139	TRUE	0.004907439070020555	26	21	3	0.14285714285714285	0.11538461538461539	REAC:R-HSA-5654726	REAC	Negative regulation of FGFR1 signaling	10916	1568		1	1	26	10890	3	18	23	10872	10916	0.12651993704673264
M1	string	0	network_modules	139	TRUE	0.005641066925251647	287	25	6	0.24	0.020905923344947737	GO:0002768	GO:BP	immune response-regulating cell surface receptor signaling pathway	16175	1279		0.975609756097561	0.9761904761904762	287	15888	6	19	281	15869	16175	0.0662379787931944
M1	string	0	network_modules	139	TRUE	0.00573883769282945	654	25	8	0.32	0.012232415902140673	GO:0031347	GO:BP	regulation of defense response	16175	7138		1	1	654	15521	8	17	646	15504	16175	0.05584259290239571
M1	string	0	network_modules	140	TRUE	2.7060575789002728e-15	24	22	8	0.36363636363636365	0.3333333333333333	GO:0042744	GO:BP	hydrogen peroxide catabolic process	16175	10337		0	0.14285714285714285	24	16151	8	14	16	16137	16175	0.34722845036710304
M1	string	0	network_modules	140	TRUE	5.257794415557185e-13	43	22	8	0.36363636363636365	0.18604651162790697	GO:0042743	GO:BP	hydrogen peroxide metabolic process	16175	10336		0.16666666666666666	0.2857142857142857	43	16132	8	14	35	16118	16175	0.2587208093417619
M1	string	0	network_modules	140	TRUE	6.921332461617252e-12	13	22	6	0.2727272727272727	0.46153846153846156	GO:0015671	GO:BP	oxygen transport	16175	4800		0.3333333333333333	0.42857142857142855	13	16162	6	16	7	16146	16175	0.3541250496957507
M1	string	0	network_modules	140	TRUE	7.455912340024533e-11	18	22	6	0.2727272727272727	0.3333333333333333	GO:0015669	GO:BP	gas transport	16175	4798		0.5	0.5714285714285714	18	16157	6	16	12	16141	16175	0.30065281875730226
M1	string	0	network_modules	140	TRUE	9.839477352186764e-10	175	22	9	0.4090909090909091	0.05142857142857143	GO:0072593	GO:BP	reactive oxygen species metabolic process	16175	17457		0.6666666666666666	0.7142857142857143	175	16000	9	13	166	15987	16175	0.14207887611215095
M1	string	0	network_modules	140	TRUE	4.932265393535039e-9	13	22	5	0.22727272727272727	0.38461538461538464	GO:0015670	GO:BP	carbon dioxide transport	16175	4799		0.8333333333333334	0.8571428571428571	13	16162	5	17	8	16145	16175	0.2949297634443683
M1	string	0	network_modules	140	TRUE	3.269215413981453e-8	18	22	5	0.22727272727272727	0.2777777777777778	GO:0019755	GO:BP	one-carbon compound transport	16175	6037		1	1	18	16157	5	17	13	16140	16175	0.2503387154258378
M1	string	0	network_modules	141	TRUE	2.1218316206782906e-16	10	17	7	0.4117647058823529	0.7	REAC:R-HSA-9754560	REAC	SARS-CoV-2 modulates autophagy	10916	2124		0	0.25	10	10906	7	10	3	10896	10916	0.5363443952567948
M1	string	0	network_modules	141	TRUE	1.5116476647160433e-15	99	25	11	0.44	0.1111111111111111	GO:0006906	GO:BP	vesicle fusion	16175	2557		0	0.05	99	16076	11	14	88	16062	16175	0.21887215240577654
M1	string	0	network_modules	141	TRUE	1.6590872605899078e-15	20	25	8	0.32	0.4	GO:0035493	GO:BP	SNARE complex assembly	16175	9063		0.05263157894736842	0.1	20	16155	8	17	12	16138	16175	0.356884898005909
M1	string	0	network_modules	141	TRUE	1.903033305891107e-15	101	25	11	0.44	0.10891089108910891	GO:0090174	GO:BP	organelle membrane fusion	16175	18081		0.10526315789473684	0.15	101	16074	11	14	90	16060	16175	0.21664598879487562
M1	string	0	network_modules	141	TRUE	3.932613467704159e-15	11	25	7	0.28	0.6363636363636364	GO:0034058	GO:BP	endosomal vesicle fusion	16175	8388		0.15789473684210525	0.2	11	16164	7	18	4	16146	16175	0.42155981390435254
M1	string	0	network_modules	141	TRUE	9.429076610400072e-15	12	25	7	0.28	0.5833333333333334	GO:0035542	GO:BP	regulation of SNARE complex assembly	16175	9085		0.21052631578947367	0.25	12	16163	7	18	5	16145	16175	0.40353594172354845
M1	string	0	network_modules	141	TRUE	5.669031548330624e-14	136	25	11	0.44	0.08088235294117647	GO:0048284	GO:BP	organelle fusion	16175	12626		0.2631578947368421	0.3	136	16039	11	14	125	16025	16175	0.18597016702765148
M1	string	0	network_modules	141	TRUE	2.863307116959364e-13	157	25	11	0.44	0.07006369426751592	GO:0061025	GO:BP	membrane fusion	16175	15142		0.3157894736842105	0.35	157	16018	11	14	146	16004	16175	0.17267879514954407
M1	string	0	network_modules	141	TRUE	1.4310360564472885e-11	315	25	12	0.48	0.0380952380952381	GO:0016050	GO:BP	vesicle organization	16175	5082		0.3684210526315789	0.4	315	15860	12	13	303	15847	16175	0.1311217832210882
M1	string	0	network_modules	141	TRUE	8.220342820135508e-11	67	25	8	0.32	0.11940298507462686	GO:0008333	GO:BP	endosome to lysosome transport	16175	3164		0.42105263157894735	0.45	67	16108	8	17	59	16091	16175	0.1934912952636695
M1	string	0	network_modules	141	TRUE	1.3805578887504353e-9	155	25	9	0.36	0.05806451612903226	GO:0007034	GO:BP	vacuolar transport	16175	2639		0.47368421052631576	0.5	155	16020	9	16	146	16004	16175	0.1415195626018512
M1	string	0	network_modules	141	TRUE	1.4038187844427163e-8	125	25	8	0.32	0.064	GO:0007041	GO:BP	lysosomal transport	16175	2645		0.5263157894736842	0.55	125	16050	8	17	117	16033	16175	0.1403035257159895
M1	string	0	network_modules	141	TRUE	2.5143471301208877e-8	156	18	8	0.4444444444444444	0.05128205128205128	KEGG:04148	KEGG	Efferocytosis	8484	283		0	0.3333333333333333	156	8328	8	10	148	8318	8484	0.14622873306061943
M1	string	0	network_modules	141	TRUE	3.9403005649354275e-8	165	18	8	0.4444444444444444	0.048484848484848485	KEGG:04140	KEGG	Autophagy - animal	8484	277		0.5	0.6666666666666666	165	8319	8	10	157	8309	8484	0.1419074386062653
M1	string	0	network_modules	141	TRUE	1.7307569517589515e-6	657	25	11	0.44	0.0167427701674277	GO:0061024	GO:BP	membrane organization	16175	15141		0.5789473684210527	0.6	657	15518	11	14	646	15504	16175	0.07960048254047494
M1	string	0	network_modules	141	TRUE	3.1185361268936963e-6	197	17	7	0.4117647058823529	0.03553299492385787	REAC:R-HSA-9705683	REAC	SARS-CoV-2-host interactions	10916	2128		0.3333333333333333	0.5	197	10719	7	10	190	10709	10916	0.11680716006499559
M1	string	0	network_modules	141	TRUE	2.4232266384101905e-5	202	25	7	0.28	0.034653465346534656	GO:0007033	GO:BP	vacuole organization	16175	2638		0.631578947368421	0.65	202	15973	7	18	195	15955	16175	0.09477672675156903
M1	string	0	network_modules	141	TRUE	2.56029882456344e-5	249	18	7	0.3888888888888889	0.028112449799196786	KEGG:05132	KEGG	Salmonella infection	8484	429		1	1	249	8235	7	11	242	8224	8484	0.09822294374541743
M1	string	0	network_modules	141	TRUE	4.6996038922343323e-5	292	17	7	0.4117647058823529	0.023972602739726026	REAC:R-HSA-9694516	REAC	SARS-CoV-2 Infection	10916	2122		0.6666666666666666	0.75	292	10624	7	10	285	10614	10916	0.09424033747193046
M1	string	0	network_modules	141	TRUE	4.5801946200360843e-4	96	25	5	0.2	0.052083333333333336	GO:0007040	GO:BP	lysosome organization	16175	2644		0.6842105263157895	0.75	96	16079	5	20	91	16059	16175	0.0994053874932114
M1	string	0	network_modules	141	TRUE	4.5801946200360843e-4	96	25	5	0.2	0.052083333333333336	GO:0080171	GO:BP	lytic vacuole organization	16175	17845		0.6842105263157895	0.75	96	16079	5	20	91	16059	16175	0.0994053874932114
M1	string	0	network_modules	141	TRUE	9.505892393729258e-4	346	25	7	0.28	0.02023121387283237	GO:0043254	GO:BP	regulation of protein-containing complex assembly	16175	10588		0.7894736842105263	0.8	346	15829	7	18	339	15811	16175	0.07032452648827617
M1	string	0	network_modules	141	TRUE	9.974257158181293e-4	459	17	7	0.4117647058823529	0.015250544662309368	REAC:R-HSA-9679506	REAC	SARS-CoV Infections	10916	2112		1	1	459	10457	7	10	452	10447	10916	0.07275341868081858
M1	string	0	network_modules	141	TRUE	0.0020501471199972404	55	25	4	0.16	0.07272727272727272	GO:0097352	GO:BP	autophagosome maturation	16175	18619		0.8421052631578947	0.85	55	16120	4	21	51	16099	16175	0.10584127608239254
M1	string	0	network_modules	141	TRUE	0.008624571608168203	309	25	6	0.24	0.019417475728155338	GO:0016236	GO:BP	macroautophagy	16175	5179		0.8947368421052632	0.9	309	15866	6	19	303	15847	16175	0.06348977566178539
M1	string	0	network_modules	141	TRUE	0.009717060464258786	491	25	7	0.28	0.014256619144602852	GO:0006914	GO:BP	autophagy	16175	2563		0.9473684210526315	1	491	15684	7	18	484	15666	16175	0.05725071207568604
M1	string	0	network_modules	141	TRUE	0.009717060464258786	491	25	7	0.28	0.014256619144602852	GO:0061919	GO:BP	process utilizing autophagic mechanism	16175	15723		0.9473684210526315	1	491	15684	7	18	484	15666	16175	0.05725071207568604
M1	string	0	network_modules	142	TRUE	6.676400129959691e-7	10	21	4	0.19047619047619047	0.4	REAC:R-HSA-193697	REAC	p75NTR regulates axonogenesis	10916	2724		0	0.14285714285714285	10	10906	4	17	6	10889	10916	0.2750893319817234
M1	string	0	network_modules	142	TRUE	1.2156953963553982e-6	10	24	4	0.16666666666666666	0.4	GO:0038180	GO:BP	nerve growth factor signaling pathway	16175	9754		0	0.06666666666666667	10	16165	4	20	6	16145	16175	0.2575117897471632
M1	string	0	network_modules	142	TRUE	4.184660472996148e-5	22	24	4	0.16666666666666666	0.18181818181818182	GO:0038179	GO:BP	neurotrophin signaling pathway	16175	9753		0.07142857142857142	0.26666666666666666	22	16153	4	20	18	16133	16175	0.17290291232352828
M1	string	0	network_modules	142	TRUE	4.184660472996148e-5	22	24	4	0.16666666666666666	0.18181818181818182	GO:1990090	GO:BP	cellular response to nerve growth factor stimulus	16175	25079		0.07142857142857142	0.26666666666666666	22	16153	4	20	18	16133	16175	0.17290291232352828
M1	string	0	network_modules	142	TRUE	4.184660472996148e-5	22	24	4	0.16666666666666666	0.18181818181818182	GO:1990089	GO:BP	response to nerve growth factor	16175	25078		0.07142857142857142	0.26666666666666666	22	16153	4	20	18	16133	16175	0.17290291232352828
M1	string	0	network_modules	142	TRUE	6.13591482104899e-5	137	24	6	0.25	0.043795620437956206	GO:0051402	GO:BP	neuron apoptotic process	16175	13695		0.2857142857142857	0.3333333333333333	137	16038	6	18	131	16020	16175	0.10159823071118021
M1	string	0	network_modules	142	TRUE	1.1184464864327594e-4	356	16	7	0.4375	0.019662921348314606	KEGG:04151	KEGG	PI3K-Akt signaling pathway	8484	285		0	0.25	356	8128	7	9	349	8119	8484	0.08575161717117187
M1	string	0	network_modules	142	TRUE	1.1606046752558064e-4	118	16	5	0.3125	0.0423728813559322	KEGG:04722	KEGG	Neurotrophin signaling pathway	8484	352		0.3333333333333333	0.5	118	8366	5	11	113	8355	8484	0.11082753763762505
M1	string	0	network_modules	142	TRUE	0.00016086962493168855	80	24	5	0.20833333333333334	0.0625	GO:0043524	GO:BP	negative regulation of neuron apoptotic process	16175	10753		0.35714285714285715	0.4	80	16095	5	19	75	16076	16175	0.11175933899045534
M1	string	0	network_modules	142	TRUE	1.6191924748631408e-4	9	21	3	0.14285714285714285	0.3333333333333333	REAC:R-HSA-193634	REAC	Axonal growth inhibition (RHOA activation)	10916	195		0.16666666666666666	0.2857142857142857	9	10907	3	18	6	10889	10916	0.2172570517816213
M1	string	0	network_modules	142	TRUE	2.87317498939658e-4	97	21	5	0.23809523809523808	0.05154639175257732	REAC:R-HSA-193704	REAC	p75 NTR receptor-mediated signalling	10916	2721		0.3333333333333333	0.42857142857142855	97	10819	5	16	92	10803	10916	0.10722897966484864
M1	string	0	network_modules	142	TRUE	4.1563309020476303e-4	38	24	4	0.16666666666666666	0.10526315789473684	GO:0021675	GO:BP	nerve development	16175	6258		0.42857142857142855	0.4666666666666667	38	16137	4	20	34	16117	16175	0.13083696409617954
M1	string	0	network_modules	142	TRUE	6.914575069080787e-4	43	24	4	0.16666666666666666	0.09302325581395349	GO:0007422	GO:BP	peripheral nervous system development	16175	2917		0.5	0.5333333333333333	43	16132	4	20	39	16112	16175	0.12278280302522317
M1	string	0	network_modules	142	TRUE	0.0012261795236475942	120	24	5	0.20833333333333334	0.041666666666666664	GO:0043523	GO:BP	regulation of neuron apoptotic process	16175	10752		0.5714285714285714	0.6	120	16055	5	19	115	16036	16175	0.09025383298770676
M1	string	0	network_modules	142	TRUE	0.0025099494621158825	59	24	4	0.16666666666666666	0.06779661016949153	GO:0007613	GO:BP	memory	16175	3070		0.6428571428571429	0.6666666666666666	59	16116	4	20	55	16096	16175	0.10423989308450525
M1	string	0	network_modules	142	TRUE	0.0025259257797974324	21	21	3	0.14285714285714285	0.14285714285714285	REAC:R-HSA-9006115	REAC	Signaling by NTRK2 (TRKB)	10916	2285		0.5	0.5714285714285714	21	10895	3	18	18	10877	10916	0.14120500885071788
M1	string	0	network_modules	142	TRUE	0.002721971094873423	153	21	5	0.23809523809523808	0.032679738562091505	REAC:R-HSA-73887	REAC	Death Receptor Signaling	10916	455		0.6666666666666666	0.7142857142857143	153	10763	5	16	148	10747	10916	0.0836851795086019
M1	string	0	network_modules	142	TRUE	0.0030658254151801853	266	24	6	0.25	0.022556390977443608	GO:0051960	GO:BP	regulation of nervous system development	16175	14029		0.7142857142857143	0.7333333333333333	266	15909	6	18	260	15891	16175	0.07079080766549671
M1	string	0	network_modules	142	TRUE	0.0033394490633070553	235	16	5	0.3125	0.02127659574468085	KEGG:04014	KEGG	Ras signaling pathway	8484	247		0.6666666666666666	0.75	235	8249	5	11	230	8238	8484	0.07543568715583594
M1	string	0	network_modules	142	TRUE	0.003711647367798777	65	24	4	0.16666666666666666	0.06153846153846154	GO:0061387	GO:BP	regulation of extent of cell growth	16175	15458		0.7857142857142857	0.8	65	16110	4	20	61	16090	16175	0.0991048251410368
M1	string	0	network_modules	142	TRUE	0.006175731344368829	684	24	8	0.3333333333333333	0.011695906432748537	GO:0031175	GO:BP	neuron projection development	16175	7086		0.8571428571428571	0.8666666666666667	684	15491	8	16	676	15475	16175	0.055749867411779244
M1	string	0	network_modules	142	TRUE	0.006677556473919444	4	21	2	0.09523809523809523	0.5	REAC:R-HSA-9026527	REAC	Activated NTRK2 signals through PLCG1	10916	63		0.8333333333333334	0.8571428571428571	4	10912	2	19	2	10893	10916	0.21762755623977673
M1	string	0	network_modules	142	TRUE	0.008893134236368538	24	24	3	0.125	0.125	GO:0031102	GO:BP	neuron projection regeneration	16175	7028		0.9285714285714286	0.9333333333333333	24	16151	3	21	21	16130	16175	0.12369977091201784
M1	string	0	network_modules	142	TRUE	0.008977483132726609	81	24	4	0.16666666666666666	0.04938271604938271	GO:0033138	GO:BP	positive regulation of peptidyl-serine phosphorylation	16175	8053		1	1	81	16094	4	20	77	16074	16175	0.08828266137878188
M1	string	0	network_modules	142	TRUE	0.009318134816725061	507	21	7	0.3333333333333333	0.013806706114398421	REAC:R-HSA-9006934	REAC	Signaling by Receptor Tyrosine Kinases	10916	2302		1	1	507	10409	7	14	500	10395	10916	0.059849851319416385
M1	string	0	network_modules	142	TRUE	0.009818959584523196	153	16	4	0.25	0.026143790849673203	KEGG:04514	KEGG	Cell adhesion molecules	8484	315		1	1	153	8331	4	12	149	8319	8484	0.0757705392539701
M1	string	0	network_modules	144	TRUE	1.1509281638742275e-5	365	17	8	0.47058823529411764	0.021917808219178082	KEGG:04080	KEGG	Neuroactive ligand-receptor interaction	8484	263		NA	1	365	8119	8	9	357	8110	8484	0.0944204090826582
M1	string	0	network_modules	144	TRUE	1.792116726740919e-5	4	24	3	0.125	0.75	GO:0051459	GO:BP	regulation of corticotropin secretion	16175	13720		0	0.16666666666666666	4	16171	3	21	1	16150	16175	0.3058452484972161
M1	string	0	network_modules	144	TRUE	4.4759285037255744e-5	5	24	3	0.125	0.6	GO:0051458	GO:BP	corticotropin secretion	16175	13719		0.2	0.3333333333333333	5	16170	3	21	2	16149	16175	0.27342919440425356
M1	string	0	network_modules	144	TRUE	1.5553768720780924e-4	30	24	4	0.16666666666666666	0.13333333333333333	GO:0060986	GO:BP	endocrine hormone secretion	16175	15113		0.4	0.5	30	16145	4	20	26	16125	16175	0.14765877267498656
M1	string	0	network_modules	144	TRUE	1.9066957252874273e-4	93	20	5	0.25	0.053763440860215055	REAC:R-HSA-373080	REAC	Class B/2 (Secretin family receptors)	10916	366		0	0.5	93	10823	5	15	88	10808	10916	0.11256711949392796
M1	string	0	network_modules	144	TRUE	2.546401071168365e-4	460	20	8	0.4	0.017391304347826087	REAC:R-HSA-500792	REAC	GPCR ligand binding	10916	1019		1	1	460	10456	8	12	452	10444	10916	0.0763126366031155
M1	string	0	network_modules	144	TRUE	0.0021827384827985113	57	24	4	0.16666666666666666	0.07017543859649122	GO:0050886	GO:BP	endocrine process	16175	13330		0.6	0.6666666666666666	57	16118	4	20	53	16098	16175	0.10612675132307738
M1	string	0	network_modules	144	TRUE	0.007789075887658279	23	24	3	0.125	0.13043478260869565	GO:0044060	GO:BP	regulation of endocrine process	16175	10895		0.8	0.8333333333333334	23	16152	3	21	20	16131	16175	0.12641961913648028
M1	string	0	network_modules	144	TRUE	0.009881539404908083	3	24	2	0.08333333333333333	0.6666666666666666	GO:0051461	GO:BP	positive regulation of corticotropin secretion	16175	13722		1	1	3	16172	2	22	1	16150	16175	0.23537416597204877
M1	string	0	network_modules	145	TRUE	0.001440679336214688	23	16	3	0.1875	0.13043478260869565	REAC:R-HSA-73980	REAC	RNA Polymerase III Transcription Termination	10916	1903		0	0.3333333333333333	23	10893	3	13	20	10880	10916	0.15490517770525605
M1	string	0	network_modules	145	TRUE	0.003613623091254327	63	11	3	0.2727272727272727	0.047619047619047616	KEGG:00310	KEGG	Lysine degradation	8484	34		NA	1	63	8421	3	8	60	8413	8484	0.11134380168885848
M1	string	0	network_modules	145	TRUE	0.00853327964827157	41	16	3	0.1875	0.07317073170731707	REAC:R-HSA-74158	REAC	RNA Polymerase III Transcription	10916	1898		0.5	1	41	10875	3	13	38	10862	10916	0.11508453891527895
M1	string	0	network_modules	145	TRUE	0.00853327964827157	41	16	3	0.1875	0.07317073170731707	REAC:R-HSA-749476	REAC	RNA Polymerase III Abortive And Retractive Initiation	10916	1896		0.5	1	41	10875	3	13	38	10862	10916	0.11508453891527895
M1	string	0	network_modules	146	TRUE	3.932613467704159e-15	11	25	7	0.28	0.6363636363636364	GO:0140588	GO:BP	chromatin looping	16175	19829		0	0.047619047619047616	11	16164	7	18	4	16146	16175	0.42155981390435254
M1	string	0	network_modules	146	TRUE	9.248935842576912e-11	72	12	7	0.5833333333333334	0.09722222222222222	REAC:R-HSA-3108214	REAC	SUMOylation of DNA damage response and repair proteins	10916	2168		0	0.3333333333333333	72	10844	7	5	65	10839	10916	0.23636241819283638
M1	string	0	network_modules	146	TRUE	4.387570193187007e-9	60	25	7	0.28	0.11666666666666667	GO:0016925	GO:BP	protein sumoylation	16175	5258		0.05	0.09523809523809523	60	16115	7	18	53	16097	16175	0.17881473999430866
M1	string	0	network_modules	146	TRUE	1.7016113678096085e-8	128	25	8	0.32	0.0625	GO:0018205	GO:BP	peptidyl-lysine modification	16175	5364		0.1	0.14285714285714285	128	16047	8	17	120	16030	16175	0.13858019755329792
M1	string	0	network_modules	146	TRUE	4.5183542802930836e-8	171	12	7	0.5833333333333334	0.04093567251461988	REAC:R-HSA-3108232	REAC	SUMO E3 ligases SUMOylate target proteins	10916	2163		0.5	0.6666666666666666	171	10745	7	5	164	10740	10916	0.15165424509339417
M1	string	0	network_modules	146	TRUE	5.762569648464053e-8	177	12	7	0.5833333333333334	0.03954802259887006	REAC:R-HSA-2990846	REAC	SUMOylation	10916	2167		1	1	177	10739	7	5	170	10734	10916	0.14895893805526525
M1	string	0	network_modules	146	TRUE	1.8390410648190732e-7	172	25	8	0.32	0.046511627906976744	GO:0000724	GO:BP	double-strand break repair via homologous recombination	16175	203		0.15	0.19047619047619047	172	16003	8	17	164	15986	16175	0.11866868120042703
M1	string	0	network_modules	146	TRUE	2.2104636768442974e-7	176	25	8	0.32	0.045454545454545456	GO:0000725	GO:BP	recombinational repair	16175	204		0.2	0.23809523809523808	176	15999	8	17	168	15982	16175	0.1172333005715233
M1	string	0	network_modules	146	TRUE	2.3117885342417865e-7	104	25	7	0.28	0.0673076923076923	GO:0032204	GO:BP	regulation of telomere maintenance	16175	7396		0.25	0.2857142857142857	104	16071	7	18	97	16053	16175	0.13466629005766664
M1	string	0	network_modules	146	TRUE	7.86282091479108e-7	798	25	12	0.48	0.015037593984962405	GO:0043687	GO:BP	post-translational protein modification	16175	10838		0.3	0.3333333333333333	798	15377	12	13	786	15364	16175	0.07824020114023499
M1	string	0	network_modules	146	TRUE	2.029475704669092e-6	667	25	11	0.44	0.01649175412293853	GO:0032446	GO:BP	protein modification by small protein conjugation	16175	7568		0.35	0.38095238095238093	667	15508	11	14	656	15494	16175	0.07890465813120409
M1	string	0	network_modules	146	TRUE	3.3566884699699183e-6	152	25	7	0.28	0.046052631578947366	GO:0000723	GO:BP	telomere maintenance	16175	202		0.4	0.42857142857142855	152	16023	7	18	145	16005	16175	0.11034853639924418
M1	string	0	network_modules	146	TRUE	6.85376415495713e-6	749	25	11	0.44	0.014686248331108143	GO:0070647	GO:BP	protein modification by small protein conjugation or removal	16175	16231		0.45	0.47619047619047616	749	15426	11	14	738	15412	16175	0.07370878006597935
M1	string	0	network_modules	146	TRUE	8.98268939381147e-6	281	25	8	0.32	0.028469750889679714	GO:0006310	GO:BP	DNA recombination	16175	2115		0.5	0.5238095238095238	281	15894	8	17	273	15877	16175	0.09113111267041792
M1	string	0	network_modules	146	TRUE	1.1772927834002652e-5	182	25	7	0.28	0.038461538461538464	GO:0032200	GO:BP	telomere organization	16175	7392		0.55	0.5714285714285714	182	15993	7	18	175	15975	16175	0.10024730788346166
M1	string	0	network_modules	146	TRUE	1.2111762579911088e-5	791	25	11	0.44	0.01390644753476612	GO:0000122	GO:BP	negative regulation of transcription by RNA polymerase II	16175	48		0.6	0.6190476190476191	791	15384	11	14	780	15370	16175	0.07134935496434307
M1	string	0	network_modules	146	TRUE	1.3496445501987827e-5	435	25	9	0.36	0.020689655172413793	GO:0051052	GO:BP	regulation of DNA metabolic process	16175	13462		0.65	0.6666666666666666	435	15740	9	16	426	15724	16175	0.08101479465786597
M1	string	0	network_modules	146	TRUE	1.4223567632174282e-5	298	25	8	0.32	0.026845637583892617	GO:0006302	GO:BP	double-strand break repair	16175	2109		0.7	0.7142857142857143	298	15877	8	17	290	15860	16175	0.08823343409676615
M1	string	0	network_modules	146	TRUE	5.750347364300217e-5	229	25	7	0.28	0.03056768558951965	GO:0033044	GO:BP	regulation of chromosome organization	16175	7999		0.75	0.7619047619047619	229	15946	7	18	222	15928	16175	0.08853369202951425
M1	string	0	network_modules	146	TRUE	7.62546401250899e-4	11	25	3	0.12	0.2727272727272727	GO:0000722	GO:BP	telomere maintenance via recombination	16175	201		0.8	0.8095238095238095	11	16164	3	22	8	16142	16175	0.18008199221677743
M1	string	0	network_modules	146	TRUE	0.0011568746114713872	528	25	8	0.32	0.015151515151515152	GO:0006281	GO:BP	DNA repair	16175	2095		0.85	0.8571428571428571	528	15647	8	17	520	15630	16175	0.06362347090269943
M1	string	0	network_modules	146	TRUE	0.0014690852146200892	545	25	8	0.32	0.014678899082568808	GO:0051276	GO:BP	chromosome organization	16175	13613		0.9	0.9047619047619048	545	15630	8	17	537	15613	16175	0.06242819551555643
M1	string	0	network_modules	146	TRUE	0.004775056080969281	638	25	8	0.32	0.012539184952978056	GO:0018193	GO:BP	peptidyl-amino acid modification	16175	5353		0.95	0.9523809523809523	638	15537	8	17	630	15520	16175	0.05670930310565657
M1	string	0	network_modules	146	TRUE	0.00522033197525266	20	25	3	0.12	0.15	GO:0006312	GO:BP	mitotic recombination	16175	2117		1	1	20	16155	3	22	17	16133	16175	0.13296661929196105
M1	string	0	network_modules	148	TRUE	6.329693287017855e-25	83	21	15	0.7142857142857143	0.18072289156626506	KEGG:04146	KEGG	Peroxisome	8484	282		NA	1	83	8401	15	6	68	8395	8484	0.35655472352653916
M1	string	0	network_modules	148	TRUE	7.385630724419438e-23	37	27	12	0.4444444444444444	0.32432432432432434	GO:0007031	GO:BP	peroxisome organization	16175	2636		0	0.041666666666666664	37	16138	12	15	25	16123	16175	0.37845788046281315
M1	string	0	network_modules	148	TRUE	1.365697348706906e-20	21	27	10	0.37037037037037035	0.47619047619047616	GO:0015919	GO:BP	peroxisomal membrane transport	16175	5014		0.043478260869565216	0.125	21	16154	10	17	11	16137	16175	0.4191102628939436
M1	string	0	network_modules	148	TRUE	1.365697348706906e-20	21	27	10	0.37037037037037035	0.47619047619047616	GO:0043574	GO:BP	peroxisomal transport	16175	10779		0.043478260869565216	0.125	21	16154	10	17	11	16137	16175	0.4191102628939436
M1	string	0	network_modules	148	TRUE	2.506869616729095e-18	19	22	9	0.4090909090909091	0.47368421052631576	REAC:R-HSA-9603798	REAC	Class I peroxisomal membrane protein import	10916	369		0	0.16666666666666666	19	10897	9	13	10	10884	10916	0.4391561754842622
M1	string	0	network_modules	148	TRUE	3.719842548299383e-15	20	27	8	0.2962962962962963	0.4	GO:0072663	GO:BP	establishment of protein localization to peroxisome	16175	17483		0.13043478260869565	0.20833333333333334	20	16155	8	19	12	16136	16175	0.34332734538590187
M1	string	0	network_modules	148	TRUE	3.719842548299383e-15	20	27	8	0.2962962962962963	0.4	GO:0072662	GO:BP	protein localization to peroxisome	16175	17482		0.13043478260869565	0.20833333333333334	20	16155	8	19	12	16136	16175	0.34332734538590187
M1	string	0	network_modules	148	TRUE	1.0551105432469672e-14	158	22	12	0.5454545454545454	0.0759493670886076	REAC:R-HSA-9609507	REAC	Protein localization	10916	1815		0.2	0.3333333333333333	158	10758	12	10	146	10748	10916	0.19978613338021312
M1	string	0	network_modules	148	TRUE	8.233541936209328e-14	14	27	7	0.25925925925925924	0.5	GO:0016558	GO:BP	protein import into peroxisome matrix	16175	5249		0.21739130434782608	0.25	14	16161	7	20	7	16141	16175	0.35929455245091074
M1	string	0	network_modules	148	TRUE	1.1395610240672012e-11	25	27	7	0.25925925925925924	0.28	GO:0065002	GO:BP	intracellular protein transmembrane transport	16175	15886		0.2608695652173913	0.2916666666666667	25	16150	7	20	18	16130	16175	0.26825509493622623
M1	string	0	network_modules	148	TRUE	1.9554699679716568e-10	36	27	7	0.25925925925925924	0.19444444444444445	GO:0044743	GO:BP	protein transmembrane import into intracellular organelle	16175	11137		0.30434782608695654	0.3333333333333333	36	16139	7	20	29	16119	16175	0.22303198151727538
M1	string	0	network_modules	148	TRUE	1.9840797537178753e-9	49	27	7	0.25925925925925924	0.14285714285714285	GO:0071806	GO:BP	protein transmembrane transport	16175	16919		0.34782608695652173	0.375	49	16126	7	20	42	16106	16175	0.1906493058929366
M1	string	0	network_modules	148	TRUE	5.631211197498159e-9	60	22	7	0.3181818181818182	0.11666666666666667	REAC:R-HSA-9033241	REAC	Peroxisomal protein import	10916	1728		0.4	0.5	60	10856	7	15	53	10841	10916	0.1900544763900253
M1	string	0	network_modules	148	TRUE	2.589531327467998e-5	4	27	3	0.1111111111111111	0.75	GO:0016560	GO:BP	protein import into peroxisome matrix, docking	16175	5251		0.391304347826087	0.4166666666666667	4	16171	3	24	1	16147	16175	0.2883089932851915
M1	string	0	network_modules	148	TRUE	6.466622900906119e-5	5	27	3	0.1111111111111111	0.6	GO:0044721	GO:BP	protein import into peroxisome matrix, substrate release	16175	11123		0.43478260869565216	0.4583333333333333	5	16170	3	24	2	16146	16175	0.25773556882201987
M1	string	0	network_modules	148	TRUE	1.7541510843719496e-4	373	27	8	0.2962962962962963	0.021447721179624665	GO:0072594	GO:BP	establishment of protein localization to organelle	16175	17458		0.4782608695652174	0.5	373	15802	8	19	365	15783	16175	0.07443793282711121
M1	string	0	network_modules	148	TRUE	3.8079256754729597e-4	33	27	4	0.14814814814814814	0.12121212121212122	GO:0000038	GO:BP	very long-chain fatty acid metabolic process	16175	15		0.5217391304347826	0.5416666666666666	33	16142	4	23	29	16119	16175	0.13240520091052038
M1	string	0	network_modules	148	TRUE	5.769938365037646e-4	91	27	5	0.18518518518518517	0.054945054945054944	GO:0019395	GO:BP	fatty acid oxidation	16175	5752		0.5652173913043478	0.5833333333333334	91	16084	5	22	86	16062	16175	0.09816502485527304
M1	string	0	network_modules	148	TRUE	6.78730328217653e-4	94	27	5	0.18518518518518517	0.05319148936170213	GO:0009062	GO:BP	fatty acid catabolic process	16175	3238		0.6086956521739131	0.625	94	16081	5	22	89	16059	16175	0.0964950933371314
M1	string	0	network_modules	148	TRUE	7.540863266047635e-4	96	27	5	0.18518518518518517	0.052083333333333336	GO:0034440	GO:BP	lipid oxidation	16175	8634		0.6521739130434783	0.6666666666666666	96	16079	5	22	91	16057	16175	0.09542475948131013
M1	string	0	network_modules	148	TRUE	7.716862327132514e-4	10	27	3	0.1111111111111111	0.3	GO:0016559	GO:BP	peroxisome fission	16175	5250		0.6956521739130435	0.7083333333333334	10	16165	3	24	7	16141	16175	0.1817662356064549
M1	string	0	network_modules	148	TRUE	0.001074115701289312	319	27	7	0.25925925925925924	0.0219435736677116	GO:0006631	GO:BP	fatty acid metabolic process	16175	2343		0.7391304347826086	0.75	319	15856	7	20	312	15836	16175	0.07044466247043583
M1	string	0	network_modules	148	TRUE	0.0013565633181552479	108	27	5	0.18518518518518517	0.046296296296296294	GO:0072329	GO:BP	monocarboxylic acid catabolic process	16175	17352		0.782608695652174	0.7916666666666666	108	16067	5	22	103	16045	16175	0.08962841835716741
M1	string	0	network_modules	148	TRUE	0.0016290913988155108	58	22	4	0.18181818181818182	0.06896551724137931	REAC:R-HSA-8866654	REAC	E3 ubiquitin ligases ubiquitinate target proteins	10916	811		0.6	0.6666666666666666	58	10858	4	18	54	10840	10916	0.10910608798050697
M1	string	0	network_modules	148	TRUE	0.0018952151985748007	18	22	3	0.13636363636363635	0.16666666666666666	REAC:R-HSA-1369062	REAC	ABC transporters in lipid homeostasis	10916	8		0.8	0.8333333333333334	18	10898	3	19	15	10879	10916	0.14920605702556994
M1	string	0	network_modules	148	TRUE	0.0023159216717634754	524	27	8	0.2962962962962963	0.015267175572519083	GO:0006886	GO:BP	intracellular protein transport	16175	2542		0.8260869565217391	0.8333333333333334	524	15651	8	19	516	15632	16175	0.060949553564095774
M1	string	0	network_modules	148	TRUE	0.0036706990698999317	761	27	9	0.3333333333333333	0.011826544021024968	GO:0043436	GO:BP	oxoacid metabolic process	16175	10693		0.8695652173913043	0.875	761	15414	9	18	752	15396	16175	0.055286109033728006
M1	string	0	network_modules	148	TRUE	0.003916539555755899	767	27	9	0.3333333333333333	0.011734028683181226	GO:0006082	GO:BP	organic acid metabolic process	16175	1947		0.9130434782608695	0.9166666666666666	767	15408	9	18	758	15390	16175	0.05500879483679755
M1	string	0	network_modules	148	TRUE	0.004317316925673952	248	27	6	0.2222222222222222	0.024193548387096774	GO:0016042	GO:BP	lipid catabolic process	16175	5076		0.9565217391304348	0.9583333333333334	248	15927	6	21	242	15906	16175	0.06885148328081522
M1	string	0	network_modules	148	TRUE	0.005334174899498794	78	22	4	0.18181818181818182	0.05128205128205128	REAC:R-HSA-8852135	REAC	Protein ubiquitination	10916	1818		1	1	78	10838	4	18	74	10820	10916	0.09319322881732645
M1	string	0	network_modules	148	TRUE	0.006329990056813662	265	27	6	0.2222222222222222	0.022641509433962263	GO:0006979	GO:BP	response to oxidative stress	16175	2604		1	1	265	15910	6	21	259	15889	16175	0.06630346994791635
M1	string	0	network_modules	149	TRUE	3.2126231849438457e-14	14	24	7	0.2916666666666667	0.5	GO:0035721	GO:BP	intraciliary retrograde transport	16175	9191		0	0.07692307692307693	14	16161	7	17	7	16144	16175	0.38119584969338927
M1	string	0	network_modules	149	TRUE	1.1814556613494672e-13	59	24	9	0.375	0.15254237288135594	GO:0061512	GO:BP	protein localization to cilium	16175	15514		0.08333333333333333	0.15384615384615385	59	16116	9	15	50	16101	16175	0.23745526115873195
M1	string	0	network_modules	149	TRUE	2.0668294570233612e-12	45	24	8	0.3333333333333333	0.17777777777777778	GO:0042073	GO:BP	intraciliary transport	16175	9956		0.16666666666666666	0.23076923076923078	45	16130	8	16	37	16114	16175	0.2419165503308644
M1	string	0	network_modules	149	TRUE	1.7208790503601975e-9	165	24	9	0.375	0.05454545454545454	GO:0099111	GO:BP	microtubule-based transport	16175	19044		0.25	0.3076923076923077	165	16010	9	15	156	15995	16175	0.1399478688039567
M1	string	0	network_modules	149	TRUE	1.0083844687182527e-8	54	14	6	0.42857142857142855	0.1111111111111111	REAC:R-HSA-5620924	REAC	Intraflagellar transport	10916	1267		0	0.2	54	10862	6	8	48	10854	10916	0.2163733700027895
M1	string	0	network_modules	149	TRUE	2.209397618361654e-8	137	24	8	0.3333333333333333	0.058394160583941604	GO:0031503	GO:BP	protein-containing complex localization	16175	7188		0.3333333333333333	0.38461538461538464	137	16038	8	16	129	16022	16175	0.1366519066513978
M1	string	0	network_modules	149	TRUE	3.305161951071127e-8	144	24	8	0.3333333333333333	0.05555555555555555	GO:0010970	GO:BP	transport along microtubule	16175	4546		0.4166666666666667	0.46153846153846156	144	16031	8	16	136	16015	16175	0.13314062763382134
M1	string	0	network_modules	149	TRUE	4.3815780276758244e-8	348	24	10	0.4166666666666667	0.028735632183908046	GO:0007018	GO:BP	microtubule-based movement	16175	2626		0.5	0.5384615384615384	348	15827	10	14	338	15813	16175	0.10498456298468653
M1	string	0	network_modules	149	TRUE	7.59383871470953e-8	368	24	10	0.4166666666666667	0.02717391304347826	GO:0044782	GO:BP	cilium organization	16175	11155		0.5833333333333334	0.6153846153846154	368	15807	10	14	358	15793	16175	0.10183677650007047
M1	string	0	network_modules	149	TRUE	2.472862168180617e-7	185	24	8	0.3333333333333333	0.043243243243243246	GO:0030705	GO:BP	cytoskeleton-dependent intracellular transport	16175	6886		0.6666666666666666	0.6923076923076923	185	15990	8	16	177	15974	16175	0.11669589818574219
M1	string	0	network_modules	149	TRUE	9.503550876067917e-7	113	14	6	0.42857142857142855	0.05309734513274336	REAC:R-HSA-5610787	REAC	Hedgehog 'off' state	10916	1112		0.25	0.4	113	10803	6	8	107	10795	10916	0.14807013824225573
M1	string	0	network_modules	149	TRUE	5.046146605937602e-6	149	14	6	0.42857142857142855	0.040268456375838924	REAC:R-HSA-5358351	REAC	Signaling by Hedgehog	10916	2258		0.5	0.6	149	10767	6	8	143	10759	10916	0.12814455455647691
M1	string	0	network_modules	149	TRUE	2.933139528749182e-5	200	14	6	0.42857142857142855	0.03	REAC:R-HSA-5617833	REAC	Cilium Assembly	10916	361		0.75	0.8	200	10716	6	8	194	10708	10916	0.10962039856488788
M1	string	0	network_modules	149	TRUE	3.221217963855254e-5	343	24	8	0.3333333333333333	0.023323615160349854	GO:0060271	GO:BP	cilium assembly	16175	14488		0.75	0.7692307692307693	343	15832	8	16	335	15816	16175	0.0835156103612879
M1	string	0	network_modules	149	TRUE	2.743753514687214e-4	292	14	6	0.42857142857142855	0.02054794520547945	REAC:R-HSA-1852241	REAC	Organelle biogenesis and maintenance	10916	1646		1	1	292	10624	6	8	286	10616	10916	0.08924263597553565
M1	string	0	network_modules	149	TRUE	6.128217344247049e-4	503	24	8	0.3333333333333333	0.015904572564612324	GO:0120031	GO:BP	plasma membrane bounded cell projection assembly	16175	19467		0.8333333333333334	0.8461538461538461	503	15672	8	16	495	15656	16175	0.06711971970756457
M1	string	0	network_modules	149	TRUE	7.223019385652964e-4	514	24	8	0.3333333333333333	0.01556420233463035	GO:0030031	GO:BP	cell projection assembly	16175	6655		0.9166666666666666	0.9230769230769231	514	15661	8	16	506	15645	16175	0.06627148859998229
M1	string	0	network_modules	149	TRUE	0.0019204721475373399	808	24	9	0.375	0.011138613861386138	GO:0033365	GO:BP	protein localization to organelle	16175	8175		1	1	808	15367	9	15	799	15352	16175	0.05751687647207152
M1	string	0	network_modules	150	TRUE	3.2923969863962377e-6	54	16	5	0.3125	0.09259259259259259	REAC:R-HSA-5620924	REAC	Intraflagellar transport	10916	1267		0	0.16666666666666666	54	10862	5	11	49	10851	10916	0.1679494731109182
M1	string	0	network_modules	150	TRUE	6.466622900906119e-5	5	27	3	0.1111111111111111	0.6	GO:0072383	GO:BP	plus-end-directed vesicle transport along microtubule	16175	17377		0	0.25	5	16170	3	24	2	16146	16175	0.25773556882201987
M1	string	0	network_modules	150	TRUE	8.200249860537263e-5	202	16	6	0.375	0.0297029702970297	REAC:R-HSA-6811442	REAC	Intra-Golgi and retrograde Golgi-to-ER traffic	10916	1262		0.2	0.3333333333333333	202	10714	6	10	196	10704	10916	0.10134732060227185
M1	string	0	network_modules	150	TRUE	1.291885136356655e-4	6	27	3	0.1111111111111111	0.5	GO:0072386	GO:BP	plus-end-directed organelle transport along microtubule	16175	17380		0.3333333333333333	0.5	6	16169	3	24	3	16145	16175	0.23515530167234228
M1	string	0	network_modules	150	TRUE	1.6443599122844938e-4	27	27	4	0.14814814814814814	0.14814814814814814	GO:0043507	GO:BP	positive regulation of JUN kinase activity	16175	10744		0.6666666666666666	0.75	27	16148	4	23	23	16125	16175	0.14672382315434088
M1	string	0	network_modules	150	TRUE	4.5790831300738453e-4	60	16	4	0.25	0.06666666666666667	REAC:R-HSA-983189	REAC	Kinesins	10916	1292		0.4	0.5	60	10856	4	12	56	10844	10916	0.1267023802342066
M1	string	0	network_modules	150	TRUE	8.4370384305119e-4	40	27	4	0.14814814814814814	0.1	GO:0043506	GO:BP	regulation of JUN kinase activity	16175	10743		1	1	40	16135	4	23	36	16112	16175	0.11993278861516482
M1	string	0	network_modules	150	TRUE	0.002333052547290484	200	16	5	0.3125	0.025	REAC:R-HSA-5617833	REAC	Cilium Assembly	10916	361		0.6	0.6666666666666666	200	10716	5	11	195	10705	10916	0.08404067062796174
M1	string	0	network_modules	150	TRUE	0.0032029094926381103	193	19	5	0.2631578947368421	0.025906735751295335	KEGG:04814	KEGG	Motor proteins	8484	366		NA	1	193	8291	5	14	188	8277	8484	0.07638937109831594
M1	string	0	network_modules	150	TRUE	0.003415270560442101	99	16	4	0.25	0.04040404040404041	REAC:R-HSA-6811434	REAC	COPI-dependent Golgi-to-ER retrograde traffic	10916	277		0.8	0.8333333333333334	99	10817	4	12	95	10805	10916	0.09737141443533655
M1	string	0	network_modules	150	TRUE	0.00806380968640383	123	16	4	0.25	0.032520325203252036	REAC:R-HSA-2132295	REAC	MHC class II antigen presentation	10916	1371		1	1	123	10793	4	12	119	10781	10916	0.08665577475791379
M1	string	0	network_modules	151	TRUE	7.861093413998957e-5	70	11	4	0.36363636363636365	0.05714285714285714	KEGG:04920	KEGG	Adipocytokine signaling pathway	8484	377		0	0.1	70	8414	4	7	66	8407	8484	0.14155586787869337
M1	string	0	network_modules	151	TRUE	4.480099090075591e-4	108	11	4	0.36363636363636365	0.037037037037037035	KEGG:04931	KEGG	Insulin resistance	8484	388		0.1111111111111111	0.2	108	8376	4	7	104	8369	8484	0.11278195638498147
M1	string	0	network_modules	151	TRUE	5.558476201018622e-4	34	11	3	0.2727272727272727	0.08823529411764706	KEGG:04710	KEGG	Circadian rhythm	8484	345		0.2222222222222222	0.3	34	8450	3	8	31	8442	8484	0.15325340738829454
M1	string	0	network_modules	151	TRUE	9.645992934152215e-4	131	11	4	0.36363636363636365	0.030534351145038167	KEGG:04068	KEGG	FoxO signaling pathway	8484	258		0.3333333333333333	0.4	131	8353	4	7	127	8346	8484	0.10175241063979346
M1	string	0	network_modules	151	TRUE	0.0011515783654437017	137	11	4	0.36363636363636365	0.029197080291970802	KEGG:04910	KEGG	Insulin signaling pathway	8484	367		0.4444444444444444	0.5	137	8347	4	7	133	8340	8484	0.09933290133230704
M1	string	0	network_modules	151	TRUE	0.0013267758480437156	142	11	4	0.36363636363636365	0.028169014084507043	KEGG:04936	KEGG	Alcoholic liver disease	8484	393		0.5555555555555556	0.6	142	8342	4	7	138	8335	8484	0.09743211984277247
M1	string	0	network_modules	151	TRUE	0.0018268471680508937	154	11	4	0.36363636363636365	0.025974025974025976	KEGG:04932	KEGG	Non-alcoholic fatty liver disease	8484	389		0.6666666666666666	0.7	154	8330	4	7	150	8323	8484	0.09324470230173226
M1	string	0	network_modules	151	TRUE	0.0023961248327328774	165	11	4	0.36363636363636365	0.024242424242424242	KEGG:04140	KEGG	Autophagy - animal	8484	277		0.7777777777777778	0.8	165	8319	4	7	161	8312	8484	0.08980418530822137
M1	string	0	network_modules	151	TRUE	0.0026530849710344325	28	16	3	0.1875	0.10714285714285714	REAC:R-HSA-9619483	REAC	Activation of AMPK downstream of NMDARs	10916	73		0	0.3333333333333333	28	10888	3	13	25	10875	10916	0.14008002489691473
M1	string	0	network_modules	151	TRUE	0.002693948972421555	170	11	4	0.36363636363636365	0.023529411764705882	KEGG:04530	KEGG	Tight junction	8484	317		0.8888888888888888	0.9	170	8314	4	7	166	8307	8484	0.08834874234982668
M1	string	0	network_modules	151	TRUE	0.00295656542725716	29	16	3	0.1875	0.10344827586206896	REAC:R-HSA-380972	REAC	Energy dependent regulation of mTOR by LKB1-AMPK	10916	843		0.5	0.6666666666666666	29	10887	3	13	26	10874	10916	0.13758180026894376
M1	string	0	network_modules	151	TRUE	0.00327967094030669	61	11	3	0.2727272727272727	0.04918032786885246	KEGG:04213	KEGG	Longevity regulating pathway - multiple species	8484	290		1	1	61	8423	3	8	58	8415	8484	0.11324148713289527
M1	string	0	network_modules	151	TRUE	0.00853327964827157	41	16	3	0.1875	0.07317073170731707	REAC:R-HSA-165159	REAC	MTOR signalling	10916	1387		1	1	41	10875	3	13	38	10862	10916	0.11508453891527895
M1	string	0	network_modules	151	TRUE	0.008783952978863854	3	23	2	0.08695652173913043	0.6666666666666666	GO:1990044	GO:BP	protein localization to lipid droplet	16175	25059		0	1	3	16172	2	21	1	16151	16175	0.24045145819458102
M1	string	0	network_modules	151	TRUE	0.008783952978863854	3	23	2	0.08695652173913043	0.6666666666666666	GO:1903944	GO:BP	negative regulation of hepatocyte apoptotic process	16175	23407		0	1	3	16172	2	21	1	16151	16175	0.24045145819458102
M1	string	0	network_modules	151	TRUE	0.008783952978863854	3	23	2	0.08695652173913043	0.6666666666666666	GO:1903943	GO:BP	regulation of hepatocyte apoptotic process	16175	23406		0	1	3	16172	2	21	1	16151	16175	0.24045145819458102
M1	string	0	network_modules	153	TRUE	2.279906829271106e-16	510	27	17	0.6296296296296297	0.03333333333333333	GO:0007169	GO:BP	cell surface receptor protein tyrosine kinase signaling pathway	16175	2733		0	0.01694915254237288	510	15665	17	10	493	15655	16175	0.13995549217968825
M1	string	0	network_modules	153	TRUE	1.0026647005068416e-14	790	27	18	0.6666666666666666	0.02278481012658228	GO:0007167	GO:BP	enzyme-linked receptor protein signaling pathway	16175	2731		0.017241379310344827	0.03389830508474576	790	15385	18	9	772	15376	16175	0.11721159871342042
M1	string	0	network_modules	153	TRUE	3.3950982952373176e-14	227	17	12	0.7058823529411765	0.05286343612334802	KEGG:04810	KEGG	Regulation of actin cytoskeleton	8484	365		0	0.07142857142857142	227	8257	12	5	215	8252	8484	0.1885761196624642
M1	string	0	network_modules	153	TRUE	4.710292750332692e-13	94	23	10	0.43478260869565216	0.10638297872340426	REAC:R-HSA-4420097	REAC	VEGFA-VEGFR2 Pathway	10916	2634		0	0.029411764705882353	94	10822	10	13	84	10809	10916	0.21194359594736673
M1	string	0	network_modules	153	TRUE	9.439995353723222e-13	507	23	15	0.6521739130434783	0.029585798816568046	REAC:R-HSA-9006934	REAC	Signaling by Receptor Tyrosine Kinases	10916	2302		0.030303030303030304	0.058823529411764705	507	10409	15	8	492	10401	10916	0.1322583481927705
M1	string	0	network_modules	153	TRUE	1.3450419725712616e-12	104	23	10	0.43478260869565216	0.09615384615384616	REAC:R-HSA-194138	REAC	Signaling by VEGF	10916	2313		0.06060606060606061	0.08823529411764706	104	10812	10	13	94	10799	10916	0.20115635130190718
M1	string	0	network_modules	153	TRUE	1.915520371856749e-12	39	23	8	0.34782608695652173	0.20512820512820512	REAC:R-HSA-9013420	REAC	RHOU GTPase cycle	10916	1874		0.09090909090909091	0.11764705882352941	39	10877	8	15	31	10862	10916	0.26512153171475283
M1	string	0	network_modules	153	TRUE	1.725686551978204e-10	17	23	6	0.2608695652173913	0.35294117647058826	REAC:R-HSA-3928664	REAC	Ephrin signaling	10916	849		0.12121212121212122	0.14705882352941177	17	10899	6	17	11	10882	10916	0.30217524745751934
M1	string	0	network_modules	153	TRUE	2.5983813817540814e-9	202	17	9	0.5294117647058824	0.04455445544554455	KEGG:04510	KEGG	Focal adhesion	8484	313		0.07692307692307693	0.14285714285714285	202	8282	9	8	193	8274	8484	0.14860247165908713
M1	string	0	network_modules	153	TRUE	5.978763255825565e-9	449	23	12	0.5217391304347826	0.026726057906458798	REAC:R-HSA-9012999	REAC	RHO GTPase cycle	10916	1847		0.15151515151515152	0.17647058823529413	449	10467	12	11	437	10456	10916	0.11120117208208842
M1	string	0	network_modules	153	TRUE	1.091838230376062e-8	13	23	5	0.21739130434782608	0.38461538461538464	REAC:R-HSA-8849471	REAC	PTK6 Regulates RHO GTPases, RAS GTPase and MAP kinases	10916	1709		0.18181818181818182	0.23529411764705882	13	10903	5	18	8	10885	10916	0.2880484137086931
M1	string	0	network_modules	153	TRUE	1.091838230376062e-8	13	23	5	0.21739130434782608	0.38461538461538464	REAC:R-HSA-428540	REAC	Activation of RAC1	10916	94		0.18181818181818182	0.23529411764705882	13	10903	5	18	8	10885	10916	0.2880484137086931
M1	string	0	network_modules	153	TRUE	1.9813463515368517e-8	184	23	9	0.391304347826087	0.04891304347826087	REAC:R-HSA-9013149	REAC	RAC1 GTPase cycle	10916	1836		0.24242424242424243	0.2647058823529412	184	10732	9	14	175	10718	10916	0.13365843712208697
M1	string	0	network_modules	153	TRUE	3.156044521980672e-8	37	23	6	0.2608695652173913	0.16216216216216217	REAC:R-HSA-9013424	REAC	RHOV GTPase cycle	10916	1875		0.2727272727272727	0.29411764705882354	37	10879	6	17	31	10862	10916	0.20356444221859699
M1	string	0	network_modules	153	TRUE	7.33644008107084e-8	440	27	11	0.4074074074074074	0.025	GO:0051493	GO:BP	regulation of cytoskeleton organization	16175	13748		0.034482758620689655	0.05084745762711865	440	15735	11	16	429	15719	16175	0.09557071567378606
M1	string	0	network_modules	153	TRUE	1.480427357071969e-7	90	23	7	0.30434782608695654	0.07777777777777778	REAC:R-HSA-2682334	REAC	EPH-Ephrin signaling	10916	818		0.30303030303030304	0.3235294117647059	90	10826	7	16	83	10810	10916	0.15046701474514618
M1	string	0	network_modules	153	TRUE	1.7074224199746617e-7	21	23	5	0.21739130434782608	0.23809523809523808	REAC:R-HSA-5627123	REAC	RHO GTPases activate PAKs	10916	1856		0.3333333333333333	0.35294117647058826	21	10895	5	18	16	10877	10916	0.22594994870933782
M1	string	0	network_modules	153	TRUE	2.426184678086735e-7	136	17	7	0.4117647058823529	0.051470588235294115	KEGG:05135	KEGG	Yersinia infection	8484	432		0.15384615384615385	0.21428571428571427	136	8348	7	10	129	8338	8484	0.14118989469988083
M1	string	0	network_modules	153	TRUE	5.458272901421209e-7	84	17	6	0.35294117647058826	0.07142857142857142	KEGG:04012	KEGG	ErbB signaling pathway	8484	245		0.23076923076923078	0.2857142857142857	84	8400	6	11	78	8389	8484	0.1552480143616031
M1	string	0	network_modules	153	TRUE	6.631200413916864e-7	279	27	9	0.3333333333333333	0.03225806451612903	GO:0031589	GO:BP	cell-substrate adhesion	16175	7233		0.05172413793103448	0.06779661016949153	279	15896	9	18	270	15878	16175	0.09927135772769961
M1	string	0	network_modules	153	TRUE	8.199072478079487e-7	407	27	10	0.37037037037037035	0.02457002457002457	GO:0007015	GO:BP	actin filament organization	16175	2624		0.06896551724137931	0.0847457627118644	407	15768	10	17	397	15751	16175	0.09012852149309998
M1	string	0	network_modules	153	TRUE	1.2548318865805194e-6	748	27	12	0.4444444444444444	0.016042780748663103	GO:0097435	GO:BP	supramolecular fiber organization	16175	18657		0.08620689655172414	0.1016949152542373	748	15427	12	15	736	15412	16175	0.07753124898521226
M1	string	0	network_modules	153	TRUE	1.6098555857184393e-6	11	23	4	0.17391304347826086	0.36363636363636365	REAC:R-HSA-389359	REAC	CD28 dependent Vav1 pathway	10916	268		0.36363636363636365	0.38235294117647056	11	10905	4	19	7	10886	10916	0.2504107349353039
M1	string	0	network_modules	153	TRUE	2.102789282398646e-6	318	27	9	0.3333333333333333	0.02830188679245283	GO:1902903	GO:BP	regulation of supramolecular fiber organization	16175	22602		0.10344827586206896	0.11864406779661017	318	15857	9	18	309	15839	16175	0.09238902200546505
M1	string	0	network_modules	153	TRUE	3.4783085248135826e-6	13	23	4	0.17391304347826086	0.3076923076923077	REAC:R-HSA-418885	REAC	DCC mediated attractive signaling	10916	435		0.3939393939393939	0.4117647058823529	13	10903	4	19	9	10884	10916	0.23012139534049625
M1	string	0	network_modules	153	TRUE	4.9690806741262515e-6	210	17	7	0.4117647058823529	0.03333333333333333	KEGG:05170	KEGG	Human immunodeficiency virus 1 infection	8484	451		0.3076923076923077	0.35714285714285715	210	8274	7	10	203	8264	8484	0.111613730804339
M1	string	0	network_modules	153	TRUE	7.83583203460714e-6	43	23	5	0.21739130434782608	0.11627906976744186	REAC:R-HSA-445355	REAC	Smooth Muscle Contraction	10916	2336		0.42424242424242425	0.4411764705882353	43	10873	5	18	38	10855	10916	0.15658323789861
M1	string	0	network_modules	153	TRUE	8.003695471066536e-6	86	27	6	0.2222222222222222	0.06976744186046512	GO:0034446	GO:BP	substrate adhesion-dependent cell spreading	16175	8640		0.1206896551724138	0.13559322033898305	86	16089	6	21	80	16068	16175	0.12196167048926994
M1	string	0	network_modules	153	TRUE	8.816921745393555e-6	16	23	4	0.17391304347826086	0.25	REAC:R-HSA-399954	REAC	Sema3A PAK dependent Axon repulsion	10916	2189		0.45454545454545453	0.47058823529411764	16	10900	4	19	12	10881	10916	0.20712707146160486
M1	string	0	network_modules	153	TRUE	9.968234171991943e-6	161	27	7	0.25925925925925924	0.043478260869565216	GO:0032271	GO:BP	regulation of protein polymerization	16175	7452		0.13793103448275862	0.15254237288135594	161	16014	7	20	154	15994	16175	0.10269186284276634
M1	string	0	network_modules	153	TRUE	1.1334165196591485e-5	164	27	7	0.25925925925925924	0.042682926829268296	GO:0010810	GO:BP	regulation of cell-substrate adhesion	16175	4422		0.15517241379310345	0.1694915254237288	164	16011	7	20	157	15991	16175	0.10168210186869359
M1	string	0	network_modules	153	TRUE	1.539479875656975e-5	49	23	5	0.21739130434782608	0.10204081632653061	REAC:R-HSA-373752	REAC	Netrin-1 signaling	10916	1586		0.48484848484848486	0.5	49	10867	5	18	44	10849	10916	0.14634623070938624
M1	string	0	network_modules	153	TRUE	1.6068423764980628e-5	274	27	8	0.2962962962962963	0.029197080291970802	GO:0032956	GO:BP	regulation of actin cytoskeleton organization	16175	7940		0.1724137931034483	0.1864406779661017	274	15901	8	19	266	15882	16175	0.08851934619228881
M1	string	0	network_modules	153	TRUE	1.878186972090873e-5	77	17	5	0.29411764705882354	0.06493506493506493	KEGG:05100	KEGG	Bacterial invasion of epithelial cells	8484	423		0.38461538461538464	0.42857142857142855	77	8407	5	12	72	8395	8484	0.1346799399224114
M1	string	0	network_modules	153	TRUE	1.8912409343129357e-5	51	23	5	0.21739130434782608	0.09803921568627451	REAC:R-HSA-9006927	REAC	Signaling by Non-Receptor Tyrosine Kinases	10916	2288		0.5151515151515151	0.5588235294117647	51	10865	5	18	46	10847	10916	0.14333774244183442
M1	string	0	network_modules	153	TRUE	1.8912409343129357e-5	51	23	5	0.21739130434782608	0.09803921568627451	REAC:R-HSA-8848021	REAC	Signaling by PTK6	10916	2295		0.5151515151515151	0.5588235294117647	51	10865	5	18	46	10847	10916	0.14333774244183442
M1	string	0	network_modules	153	TRUE	2.1216171868147574e-5	101	27	6	0.2222222222222222	0.0594059405940594	GO:0007229	GO:BP	integrin-mediated signaling pathway	16175	2779		0.1896551724137931	0.2033898305084746	101	16074	6	21	95	16053	16175	0.11211240885971417
M1	string	0	network_modules	153	TRUE	2.7853712075202702e-5	55	23	5	0.21739130434782608	0.09090909090909091	REAC:R-HSA-9013409	REAC	RHOJ GTPase cycle	10916	1870		0.5757575757575758	0.5882352941176471	55	10861	5	18	50	10843	10916	0.1378146835228477
M1	string	0	network_modules	153	TRUE	3.7175575410769416e-5	53	27	5	0.18518518518518517	0.09433962264150944	GO:1900024	GO:BP	regulation of substrate adhesion-dependent cell spreading	16175	20331		0.20689655172413793	0.22033898305084745	53	16122	5	22	48	16100	16175	0.13015847665579391
M1	string	0	network_modules	153	TRUE	3.9970594531631464e-5	308	27	8	0.2962962962962963	0.025974025974025976	GO:0032970	GO:BP	regulation of actin filament-based process	16175	7953		0.22413793103448276	0.23728813559322035	308	15867	8	19	300	15848	16175	0.08295121237308709
M1	string	0	network_modules	153	TRUE	4.3254746504787215e-5	450	27	9	0.3333333333333333	0.02	GO:0030335	GO:BP	positive regulation of cell migration	16175	6781		0.2413793103448276	0.2542372881355932	450	15725	9	18	441	15707	16175	0.07596164744481015
M1	string	0	network_modules	153	TRUE	5.40806276212877e-5	181	17	6	0.35294117647058826	0.03314917127071823	KEGG:04360	KEGG	Axon guidance	8484	305		0.46153846153846156	0.5	181	8303	6	11	175	8292	8484	0.10283171837503949
M1	string	0	network_modules	153	TRUE	5.578120203254754e-5	632	27	10	0.37037037037037035	0.015822784810126583	GO:0030036	GO:BP	actin cytoskeleton organization	16175	6660		0.25862068965517243	0.2711864406779661	632	15543	10	17	622	15526	16175	0.06991321842938605
M1	string	0	network_modules	153	TRUE	6.289381469711901e-5	470	27	9	0.3333333333333333	0.019148936170212766	GO:2000147	GO:BP	positive regulation of cell motility	16175	25495		0.27586206896551724	0.288135593220339	470	15705	9	18	461	15687	16175	0.0740741725653707
M1	string	0	network_modules	153	TRUE	7.191497172100851e-5	190	17	6	0.35294117647058826	0.031578947368421054	KEGG:04062	KEGG	Chemokine signaling pathway	8484	255		0.5384615384615384	0.5714285714285714	190	8294	6	11	184	8283	8484	0.10009987509759861
M1	string	0	network_modules	153	TRUE	7.360510417096084e-5	215	27	7	0.25925925925925924	0.03255813953488372	GO:0110053	GO:BP	regulation of actin filament organization	16175	19377		0.29310344827586204	0.3050847457627119	215	15960	7	20	208	15940	16175	0.0878229906515715
M1	string	0	network_modules	153	TRUE	7.40245677289331e-5	479	27	9	0.3333333333333333	0.018789144050104383	GO:0040017	GO:BP	positive regulation of locomotion	16175	9905		0.3103448275862069	0.3220338983050847	479	15696	9	18	470	15678	16175	0.0732617953826965
M1	string	0	network_modules	153	TRUE	8.372622866934166e-5	27	23	4	0.17391304347826086	0.14814814814814814	REAC:R-HSA-5218920	REAC	VEGFR2 mediated vascular permeability	10916	2636		0.6060606060606061	0.6176470588235294	27	10889	4	19	23	10870	10916	0.15859481412000134
M1	string	0	network_modules	153	TRUE	1.2106449926025223e-4	135	27	6	0.2222222222222222	0.044444444444444446	GO:0051017	GO:BP	actin filament bundle assembly	16175	13442		0.3275862068965517	0.3389830508474576	135	16040	6	21	129	16019	16175	0.09613019119901363
M1	string	0	network_modules	153	TRUE	1.3355448474631736e-4	114	17	5	0.29411764705882354	0.043859649122807015	KEGG:04670	KEGG	Leukocyte transendothelial migration	8484	343		0.6153846153846154	0.6428571428571429	114	8370	5	12	109	8358	8484	0.10923393160732599
M1	string	0	network_modules	153	TRUE	1.3800975975707935e-4	138	27	6	0.2222222222222222	0.043478260869565216	GO:0061572	GO:BP	actin filament bundle organization	16175	15565		0.3448275862068966	0.3559322033898305	138	16037	6	21	132	16016	16175	0.09500598932537269
M1	string	0	network_modules	153	TRUE	1.4762185541952573e-4	238	27	7	0.25925925925925924	0.029411764705882353	GO:0051258	GO:BP	protein polymerization	16175	13605		0.3620689655172414	0.3728813559322034	238	15937	7	20	231	15917	16175	0.08304895439356283
M1	string	0	network_modules	153	TRUE	1.49275856899087e-4	31	23	4	0.17391304347826086	0.12903225806451613	REAC:R-HSA-389356	REAC	Co-stimulation by CD28	10916	378		0.6363636363636364	0.6470588235294118	31	10885	4	19	27	10866	10916	0.14772042424410556
M1	string	0	network_modules	153	TRUE	1.6232886836998003e-4	708	27	10	0.37037037037037035	0.014124293785310734	GO:0030029	GO:BP	actin filament-based process	16175	6653		0.3793103448275862	0.3898305084745763	708	15467	10	17	698	15450	16175	0.06527729320048042
M1	string	0	network_modules	153	TRUE	1.6516976943681936e-4	119	17	5	0.29411764705882354	0.04201680672268908	KEGG:04660	KEGG	T cell receptor signaling pathway	8484	338		0.6923076923076923	0.7142857142857143	119	8365	5	12	114	8353	8484	0.1067218685198094
M1	string	0	network_modules	153	TRUE	2.023361628309894e-4	155	23	6	0.2608695652173913	0.03870967741935484	REAC:R-HSA-9013148	REAC	CDC42 GTPase cycle	10916	269		0.6666666666666666	0.6764705882352942	155	10761	6	17	149	10744	10916	0.09580281229860767
M1	string	0	network_modules	153	TRUE	2.2582828282020372e-4	7	27	3	0.1111111111111111	0.42857142857142855	GO:0007172	GO:BP	signal complex assembly	16175	2735		0.39655172413793105	0.4067796610169492	7	16168	3	24	4	16144	16175	0.21759669023535055
M1	string	0	network_modules	153	TRUE	2.2658397029871202e-4	150	27	6	0.2222222222222222	0.04	GO:1902905	GO:BP	positive regulation of supramolecular fiber organization	16175	22604		0.41379310344827586	0.423728813559322	150	16025	6	21	144	16004	16175	0.09084416710342562
M1	string	0	network_modules	153	TRUE	2.4702376305987963e-4	35	23	4	0.17391304347826086	0.11428571428571428	REAC:R-HSA-202433	REAC	Generation of second messenger molecules	10916	1044		0.696969696969697	0.7058823529411765	35	10881	4	19	31	10862	10916	0.13875094081242184
M1	string	0	network_modules	153	TRUE	2.8346811066618156e-4	79	27	5	0.18518518518518517	0.06329113924050633	GO:0032273	GO:BP	positive regulation of protein polymerization	16175	7454		0.43103448275862066	0.4406779661016949	79	16096	5	22	74	16074	16175	0.10575299156280804
M1	string	0	network_modules	153	TRUE	2.969354520307499e-4	157	27	6	0.2222222222222222	0.03821656050955414	GO:0051495	GO:BP	positive regulation of cytoskeleton organization	16175	13750		0.4482758620689655	0.4576271186440678	157	16018	6	21	151	15997	16175	0.08863479176509641
M1	string	0	network_modules	153	TRUE	2.99715491982208e-4	88	23	5	0.21739130434782608	0.056818181818181816	REAC:R-HSA-9013404	REAC	RAC2 GTPase cycle	10916	1837		0.7272727272727273	0.7352941176470589	88	10828	5	18	83	10810	10916	0.10756455243686407
M1	string	0	network_modules	153	TRUE	4.052689624692405e-4	781	27	10	0.37037037037037035	0.012804097311139564	GO:0030334	GO:BP	regulation of cell migration	16175	6780		0.46551724137931033	0.4745762711864407	781	15394	10	17	771	15377	16175	0.06143804180611108
M1	string	0	network_modules	153	TRUE	4.6053577109798075e-4	87	27	5	0.18518518518518517	0.05747126436781609	GO:0010811	GO:BP	positive regulation of cell-substrate adhesion	16175	4423		0.4827586206896552	0.4915254237288136	87	16088	5	22	82	16066	16175	0.10052210354255407
M1	string	0	network_modules	153	TRUE	4.668408786507738e-4	793	27	10	0.37037037037037035	0.012610340479192938	GO:0044087	GO:BP	regulation of cellular component biogenesis	16175	10909		0.5	0.5084745762711864	793	15382	10	17	783	15365	16175	0.060854700306280145
M1	string	0	network_modules	153	TRUE	5.082897241961621e-4	68	17	4	0.23529411764705882	0.058823529411764705	KEGG:05211	KEGG	Renal cell carcinoma	8484	462		0.7692307692307693	0.7857142857142857	68	8416	4	13	64	8403	8484	0.11421217152865427
M1	string	0	network_modules	153	TRUE	5.459108832111493e-4	90	27	5	0.18518518518518517	0.05555555555555555	GO:0043149	GO:BP	stress fiber assembly	16175	10553		0.5172413793103449	0.5423728813559322	90	16085	5	22	85	16063	16175	0.09873979644061029
M1	string	0	network_modules	153	TRUE	5.459108832111493e-4	90	27	5	0.18518518518518517	0.05555555555555555	GO:0030038	GO:BP	contractile actin filament bundle assembly	16175	6661		0.5172413793103449	0.5423728813559322	90	16085	5	22	85	16063	16175	0.09873979644061029
M1	string	0	network_modules	153	TRUE	5.462878151589395e-4	36	27	4	0.14814814814814814	0.1111111111111111	GO:1900026	GO:BP	positive regulation of substrate adhesion-dependent cell spreading	16175	20333		0.5517241379310345	0.559322033898305	36	16139	4	23	32	16116	16175	0.12661917381391077
M1	string	0	network_modules	153	TRUE	7.941661928382029e-4	97	27	5	0.18518518518518517	0.05154639175257732	GO:0007173	GO:BP	epidermal growth factor receptor signaling pathway	16175	2736		0.5689655172413793	0.576271186440678	97	16078	5	22	92	16056	16175	0.09490181397970147
M1	string	0	network_modules	153	TRUE	8.994675904216939e-4	318	23	7	0.30434782608695654	0.0220125786163522	REAC:R-HSA-195258	REAC	RHO GTPase Effectors	10916	1846		0.7575757575757576	0.7647058823529411	318	10598	7	16	311	10582	10916	0.07519730735285446
M1	string	0	network_modules	153	TRUE	9.57449174655043e-4	466	27	8	0.2962962962962963	0.017167381974248927	GO:0120035	GO:BP	regulation of plasma membrane bounded cell projection organization	16175	19471		0.5862068965517241	0.5932203389830508	466	15709	8	19	458	15690	16175	0.06538848661168532
M1	string	0	network_modules	153	TRUE	9.722596262375371e-4	192	27	6	0.2222222222222222	0.03125	GO:0007160	GO:BP	cell-matrix adhesion	16175	2724		0.603448275862069	0.6101694915254238	192	15983	6	21	186	15962	16175	0.07942071459462283
M1	string	0	network_modules	153	TRUE	0.0010598877697315923	11	27	3	0.1111111111111111	0.2727272727272727	GO:0048012	GO:BP	hepatocyte growth factor receptor signaling pathway	16175	12468		0.6206896551724138	0.6271186440677966	11	16164	3	24	8	16140	16175	0.17321569325514452
M1	string	0	network_modules	153	TRUE	0.0011805289836733426	116	23	5	0.21739130434782608	0.04310344827586207	REAC:R-HSA-2029482	REAC	Regulation of actin dynamics for phagocytic cup formation	10916	2020		0.7878787878787878	0.7941176470588235	116	10800	5	18	111	10782	10916	0.09265934352285833
M1	string	0	network_modules	153	TRUE	0.0011974211779767208	480	27	8	0.2962962962962963	0.016666666666666666	GO:0031344	GO:BP	regulation of cell projection organization	16175	7135		0.6379310344827587	0.6440677966101694	480	15695	8	19	472	15676	16175	0.06424800779829164
M1	string	0	network_modules	153	TRUE	0.00124754539402432	44	27	4	0.14814814814814814	0.09090909090909091	GO:0048013	GO:BP	ephrin receptor signaling pathway	16175	12469		0.6551724137931034	0.6610169491525424	44	16131	4	23	40	16108	16175	0.11417145944583616
M1	string	0	network_modules	153	TRUE	0.0016252236877341577	112	27	5	0.18518518518518517	0.044642857142857144	GO:0038127	GO:BP	ERBB signaling pathway	16175	9716		0.6724137931034483	0.6779661016949152	112	16063	5	22	107	16041	16175	0.08790237353164837
M1	string	0	network_modules	153	TRUE	0.0016286821190852783	500	27	8	0.2962962962962963	0.016	GO:0001934	GO:BP	positive regulation of protein phosphorylation	16175	548		0.6896551724137931	0.6949152542372882	500	15675	8	19	492	15656	16175	0.06269795944420385
M1	string	0	network_modules	153	TRUE	0.0018512128816373487	346	27	7	0.25925925925925924	0.02023121387283237	GO:0043254	GO:BP	regulation of protein-containing complex assembly	16175	10588		0.7068965517241379	0.711864406779661	346	15829	7	20	339	15809	16175	0.06722618117398899
M1	string	0	network_modules	153	TRUE	0.0019359430284191998	197	17	5	0.29411764705882354	0.025380710659898477	KEGG:05130	KEGG	Pathogenic Escherichia coli infection	8484	427		0.8461538461538461	0.8571428571428571	197	8287	5	12	192	8275	8484	0.08059971456641415
M1	string	0	network_modules	153	TRUE	0.0020764945549741364	59	23	4	0.17391304347826086	0.06779661016949153	REAC:R-HSA-9013406	REAC	RHOQ GTPase cycle	10916	1871		0.8181818181818182	0.8235294117647058	59	10857	4	19	55	10838	10916	0.10560722620308775
M1	string	0	network_modules	153	TRUE	0.0022504820265703846	522	27	8	0.2962962962962963	0.01532567049808429	GO:0042327	GO:BP	positive regulation of phosphorylation	16175	10095		0.7241379310344828	0.7288135593220338	522	15653	8	19	514	15634	16175	0.061090912203361325
M1	string	0	network_modules	153	TRUE	0.0022783369825015156	51	27	4	0.14814814814814814	0.0784313725490196	GO:0048010	GO:BP	vascular endothelial growth factor receptor signaling pathway	16175	12466		0.7413793103448276	0.7457627118644068	51	16124	4	23	47	16101	16175	0.10575447330422888
M1	string	0	network_modules	153	TRUE	0.002878724215523031	64	23	4	0.17391304347826086	0.0625	REAC:R-HSA-373755	REAC	Semaphorin interactions	10916	2193		0.8484848484848485	0.8529411764705882	64	10852	4	19	60	10833	10916	0.10114573230716813
M1	string	0	network_modules	153	TRUE	0.002968892864429106	140	23	5	0.21739130434782608	0.03571428571428571	REAC:R-HSA-2029480	REAC	Fcgamma receptor (FCGR) dependent phagocytosis	10916	939		0.8787878787878788	0.8823529411764706	140	10776	5	18	135	10758	10916	0.08354001252443476
M1	string	0	network_modules	153	TRUE	0.0029934803241665796	20	23	3	0.13043478260869565	0.15	REAC:R-HSA-5621575	REAC	CD209 (DC-SIGN) signaling	10916	265		0.9090909090909091	0.9117647058823529	20	10896	3	20	17	10876	10916	0.13818309942561657
M1	string	0	network_modules	153	TRUE	0.0030452935465325303	744	27	9	0.3333333333333333	0.012096774193548387	GO:0001932	GO:BP	regulation of protein phosphorylation	16175	546		0.7586206896551724	0.7627118644067796	744	15431	9	18	735	15413	16175	0.05608852005976884
M1	string	0	network_modules	153	TRUE	0.00345821527147718	67	23	4	0.17391304347826086	0.05970149253731343	REAC:R-HSA-388841	REAC	Regulation of T cell activation by CD28 family	10916	2007		0.9393939393939394	0.9411764705882353	67	10849	4	19	63	10830	10916	0.0987073217598757
M1	string	0	network_modules	153	TRUE	0.003509025219466342	223	17	5	0.29411764705882354	0.02242152466367713	KEGG:05163	KEGG	Human cytomegalovirus infection	8484	444		0.9230769230769231	0.9285714285714286	223	8261	5	12	218	8249	8484	0.07501627281215081
M1	string	0	network_modules	153	TRUE	0.0038373581464580856	58	27	4	0.14814814814814814	0.06896551724137931	GO:0031113	GO:BP	regulation of microtubule polymerization	16175	7038		0.7758620689655172	0.7796610169491526	58	16117	4	23	54	16094	16175	0.09889309153261358
M1	string	0	network_modules	153	TRUE	0.004012331919264063	564	27	8	0.2962962962962963	0.014184397163120567	GO:0045937	GO:BP	positive regulation of phosphate metabolic process	16175	11731		0.7931034482758621	0.8135593220338984	564	15611	8	19	556	15592	16175	0.058272472091042776
M1	string	0	network_modules	153	TRUE	0.004012331919264063	564	27	8	0.2962962962962963	0.014184397163120567	GO:0010562	GO:BP	positive regulation of phosphorus metabolic process	16175	4215		0.7931034482758621	0.8135593220338984	564	15611	8	19	556	15592	16175	0.058272472091042776
M1	string	0	network_modules	153	TRUE	0.004154474720078779	150	23	5	0.21739130434782608	0.03333333333333333	REAC:R-HSA-1500931	REAC	Cell-Cell communication	10916	328		0.9696969696969697	0.9705882352941176	150	10766	5	18	145	10748	10916	0.0803832026779623
M1	string	0	network_modules	153	TRUE	0.00504812431324834	791	27	9	0.3333333333333333	0.011378002528445006	GO:1901701	GO:BP	cellular response to oxygen-containing compound	16175	21654		0.8275862068965517	0.8305084745762712	791	15384	9	18	782	15366	16175	0.05392875604571665
M1	string	0	network_modules	153	TRUE	0.005100845142457374	792	27	9	0.3333333333333333	0.011363636363636364	GO:0042325	GO:BP	regulation of phosphorylation	16175	10093		0.8448275862068966	0.847457627118644	792	15383	9	18	783	15365	16175	0.053884736171465566
M1	string	0	network_modules	153	TRUE	0.005600343215789051	246	17	5	0.29411764705882354	0.02032520325203252	KEGG:05131	KEGG	Shigellosis	8484	428		1	1	246	8238	5	12	241	8226	8484	0.07079905826086834
M1	string	0	network_modules	153	TRUE	0.006169238979555305	19	27	3	0.1111111111111111	0.15789473684210525	GO:0010968	GO:BP	regulation of microtubule nucleation	16175	4544		0.8620689655172413	0.864406779661017	19	16156	3	24	16	16132	16175	0.13123957709566395
M1	string	0	network_modules	153	TRUE	0.008180410797488108	70	27	4	0.14814814814814814	0.05714285714285714	GO:0048041	GO:BP	focal adhesion assembly	16175	12482		0.8793103448275862	0.8813559322033898	70	16105	4	23	66	16082	16175	0.08958971527672815
M1	string	0	network_modules	153	TRUE	0.008289580436558001	622	27	8	0.2962962962962963	0.012861736334405145	GO:0030155	GO:BP	regulation of cell adhesion	16175	6688		0.896551724137931	0.8983050847457628	622	15553	8	19	614	15534	16175	0.05482996907160314
M1	string	0	network_modules	153	TRUE	0.008360380907766984	4	23	2	0.08695652173913043	0.5	REAC:R-HSA-9032759	REAC	NTRK2 activates RAC1	10916	1554		1	1	4	10912	2	21	2	10891	10916	0.20789291825368691
M1	string	0	network_modules	153	TRUE	0.00844875176401832	21	27	3	0.1111111111111111	0.14285714285714285	GO:1990840	GO:BP	response to lectin	16175	25313		0.9137931034482759	0.9661016949152542	21	16154	3	24	18	16130	16175	0.12470105400611571
M1	string	0	network_modules	153	TRUE	0.00844875176401832	21	27	3	0.1111111111111111	0.14285714285714285	GO:1990858	GO:BP	cellular response to lectin	16175	25318		0.9137931034482759	0.9661016949152542	21	16154	3	24	18	16130	16175	0.12470105400611571
M1	string	0	network_modules	153	TRUE	0.00844875176401832	21	27	3	0.1111111111111111	0.14285714285714285	GO:0010762	GO:BP	regulation of fibroblast migration	16175	4383		0.9137931034482759	0.9661016949152542	21	16154	3	24	18	16130	16175	0.12470105400611571
M1	string	0	network_modules	153	TRUE	0.00844875176401832	21	27	3	0.1111111111111111	0.14285714285714285	GO:0002223	GO:BP	stimulatory C-type lectin receptor signaling pathway	16175	757		0.9137931034482759	0.9661016949152542	21	16154	3	24	18	16130	16175	0.12470105400611571
M1	string	0	network_modules	153	TRUE	0.009323936198562005	632	27	8	0.2962962962962963	0.012658227848101266	GO:0031401	GO:BP	positive regulation of protein modification process	16175	7157		0.9827586206896551	0.9830508474576272	632	15543	8	19	624	15524	16175	0.054281487534961995
M1	string	0	network_modules	153	TRUE	0.009995726876430468	638	27	8	0.2962962962962963	0.012539184952978056	GO:0018193	GO:BP	peptidyl-amino acid modification	16175	5353		1	1	638	15537	8	19	630	15518	16175	0.05395814761725062
M1	string	0	network_modules	156	TRUE	2.981818983660331e-6	18	16	4	0.25	0.2222222222222222	REAC:R-HSA-1369062	REAC	ABC transporters in lipid homeostasis	10916	8		0	0.2	18	10898	4	12	14	10886	10916	0.23451282892810624
M1	string	0	network_modules	156	TRUE	1.2987760991099582e-5	45	11	4	0.36363636363636365	0.08888888888888889	KEGG:02010	KEGG	ABC transporters	8484	199		0	0.5	45	8439	4	7	41	8432	8484	0.1777512075298779
M1	string	0	network_modules	156	TRUE	6.456087096540229e-4	2	16	2	0.125	1	REAC:R-HSA-5679096	REAC	Defective ABCG5 causes sitosterolemia	10916	471		0.25	0.6	2	10914	2	14	0	10900	10916	0.35332655644370065
M1	string	0	network_modules	156	TRUE	6.456087096540229e-4	2	16	2	0.125	1	REAC:R-HSA-5679090	REAC	Defective ABCG8 causes GBD4 and sitosterolemia	10916	472		0.25	0.6	2	10914	2	14	0	10900	10916	0.35332655644370065
M1	string	0	network_modules	156	TRUE	0.0011390525641983994	43	11	3	0.2727272727272727	0.06976744186046512	KEGG:04975	KEGG	Fat digestion and absorption	8484	406		1	1	43	8441	3	8	40	8433	8484	0.1358091166106681
M1	string	0	network_modules	156	TRUE	0.001632464525617017	52	25	4	0.16	0.07692307692307693	GO:0033344	GO:BP	cholesterol efflux	16175	8154		0	0.1111111111111111	52	16123	4	21	48	16102	16175	0.10897036144172943
M1	string	0	network_modules	156	TRUE	0.003276358997535711	2	25	2	0.08	1	GO:0060752	GO:BP	intestinal phytosterol absorption	16175	14920		0.125	0.5555555555555556	2	16173	2	23	0	16150	16175	0.282641522315189
M1	string	0	network_modules	156	TRUE	0.003276358997535711	2	25	2	0.08	1	GO:0045796	GO:BP	negative regulation of intestinal cholesterol absorption	16175	11624		0.125	0.5555555555555556	2	16173	2	23	0	16150	16175	0.282641522315189
M1	string	0	network_modules	156	TRUE	0.003276358997535711	2	25	2	0.08	1	GO:0010949	GO:BP	negative regulation of intestinal phytosterol absorption	16175	4527		0.125	0.5555555555555556	2	16173	2	23	0	16150	16175	0.282641522315189
M1	string	0	network_modules	156	TRUE	0.003276358997535711	2	25	2	0.08	1	GO:1904730	GO:BP	negative regulation of intestinal lipid absorption	16175	24060		0.125	0.5555555555555556	2	16173	2	23	0	16150	16175	0.282641522315189
M1	string	0	network_modules	156	TRUE	0.0037442930207189206	18	25	3	0.12	0.16666666666666666	GO:0098856	GO:BP	intestinal lipid absorption	16175	18913		0.625	0.6666666666666666	18	16157	3	22	15	16135	16175	0.14029636220631622
M1	string	0	network_modules	156	TRUE	0.003997098747466138	103	16	4	0.25	0.038834951456310676	REAC:R-HSA-382556	REAC	ABC-family proteins mediated transport	10916	9		0.75	0.8	103	10813	4	12	99	10801	10916	0.09533442472671759
M1	string	0	network_modules	156	TRUE	0.005741148945869013	36	16	3	0.1875	0.08333333333333333	REAC:R-HSA-9029569	REAC	NR1H3 & NR1H2 regulate gene expression linked to cholesterol transport and efflux	10916	1547		1	1	36	10880	3	13	33	10867	10916	0.12309463408383023
M1	string	0	network_modules	156	TRUE	0.006781313211558385	74	25	4	0.16	0.05405405405405406	GO:0042632	GO:BP	cholesterol homeostasis	16175	10265		0.75	0.7777777777777778	74	16101	4	21	70	16080	16175	0.09061638433209257
M1	string	0	network_modules	156	TRUE	0.00715591305421498	75	25	4	0.16	0.05333333333333334	GO:0055092	GO:BP	sterol homeostasis	16175	14242		0.875	0.8888888888888888	75	16100	4	21	71	16079	16175	0.08997723846322535
M1	string	0	network_modules	156	TRUE	0.009819758219721055	3	25	2	0.08	0.6666666666666666	GO:1904479	GO:BP	negative regulation of intestinal absorption	16175	23854		1	1	3	16172	2	23	1	16149	16175	0.23060434694047444
M1	string	0	network_modules	157	TRUE	9.169659126549938e-4	8	5	2	0.4	0.25	REAC:R-HSA-75158	REAC	TRAIL  signaling	10916	2470		0	0.5	8	10908	2	3	6	10905	10916	0.31583645181620407
M1	string	0	network_modules	157	TRUE	0.0051662213693066195	153	5	3	0.6	0.0196078431372549	REAC:R-HSA-73887	REAC	Death Receptor Signaling	10916	455		1	1	153	10763	3	2	150	10761	10916	0.10670617009736008
M1	string	0	network_modules	158	TRUE	6.015953790672728e-13	210	21	12	0.5714285714285714	0.05714285714285714	KEGG:04015	KEGG	Rap1 signaling pathway	8484	248		0	0.2	210	8274	12	9	198	8265	8484	0.17527130311446973
M1	string	0	network_modules	158	TRUE	8.033415100876712e-12	389	26	13	0.5	0.033419023136246784	GO:0007264	GO:BP	small GTPase-mediated signal transduction	16175	2792		0	0.14285714285714285	389	15786	13	13	376	15773	16175	0.12465483291571011
M1	string	0	network_modules	158	TRUE	1.211689152253981e-11	15	18	6	0.3333333333333333	0.4	REAC:R-HSA-392517	REAC	Rap1 signalling	10916	1940		0	0.25	15	10901	6	12	9	10889	10916	0.3641935855788142
M1	string	0	network_modules	158	TRUE	4.047160247243833e-9	103	26	8	0.3076923076923077	0.07766990291262135	GO:0007265	GO:BP	Ras protein signal transduction	16175	2793		0.16666666666666666	0.2857142857142857	103	16072	8	18	95	16054	16175	0.1519983778495123
M1	string	0	network_modules	158	TRUE	1.3201568312344578e-7	26	18	5	0.2777777777777778	0.19230769230769232	REAC:R-HSA-354192	REAC	Integrin signaling	10916	1217		0.3333333333333333	0.5	26	10890	5	13	21	10877	10916	0.2296060449289502
M1	string	0	network_modules	158	TRUE	9.95408424639124e-7	38	18	5	0.2777777777777778	0.13157894736842105	REAC:R-HSA-76009	REAC	Platelet Aggregation (Plug Formation)	10916	1761		0.6666666666666666	0.75	38	10878	5	13	33	10865	10916	0.1892694649718574
M1	string	0	network_modules	158	TRUE	6.147483066689939e-5	235	21	7	0.3333333333333333	0.029787234042553193	KEGG:04014	KEGG	Ras signaling pathway	8484	247		0.25	0.4	235	8249	7	14	228	8235	8484	0.09277167774947315
M1	string	0	network_modules	158	TRUE	6.884139054339546e-5	147	21	6	0.2857142857142857	0.04081632653061224	KEGG:04072	KEGG	Phospholipase D signaling pathway	8484	261		0.5	0.6	147	8337	6	15	141	8322	8484	0.10245825132670112
M1	string	0	network_modules	158	TRUE	1.619028513706359e-4	93	21	5	0.23809523809523808	0.053763440860215055	KEGG:04520	KEGG	Adherens junction	8484	316		0.75	0.8	93	8391	5	16	88	8375	8484	0.108662791270908
M1	string	0	network_modules	158	TRUE	5.118493639304509e-4	183	26	6	0.23076923076923078	0.03278688524590164	GO:0043087	GO:BP	regulation of GTPase activity	16175	10520		0.3333333333333333	0.42857142857142855	183	15992	6	20	177	15972	16175	0.08325831757587228
M1	string	0	network_modules	158	TRUE	7.592393087502107e-4	259	18	6	0.3333333333333333	0.023166023166023165	REAC:R-HSA-76002	REAC	Platelet activation, signaling and aggregation	10916	1762		1	1	259	10657	6	12	253	10645	10916	0.08267407684081453
M1	string	0	network_modules	158	TRUE	0.0011158129876016666	12	26	3	0.11538461538461539	0.25	GO:0032486	GO:BP	Rap protein signal transduction	16175	7597		0.5	0.5714285714285714	12	16163	3	23	9	16140	16175	0.16894800003492952
M1	string	0	network_modules	158	TRUE	0.002206842587508004	127	26	5	0.19230769230769232	0.03937007874015748	GO:0043547	GO:BP	positive regulation of GTPase activity	16175	10762		0.6666666666666666	0.7142857142857143	127	16048	5	21	122	16027	16175	0.08385689503754593
M1	string	0	network_modules	158	TRUE	0.003450794777497106	2	26	2	0.07692307692307693	1	GO:2000299	GO:BP	negative regulation of Rho-dependent protein serine/threonine kinase activity	16175	25621		0.8333333333333334	0.8571428571428571	2	16173	2	24	0	16149	16175	0.27714423421480233
M1	string	0	network_modules	158	TRUE	0.00487808005922128	19	26	3	0.11538461538461539	0.15789473684210525	GO:2000300	GO:BP	regulation of synaptic vesicle exocytosis	16175	25622		1	1	19	16156	3	23	16	16133	16175	0.13378838606206206
M1	string	0	network_modules	158	TRUE	0.009982495949406596	114	21	4	0.19047619047619047	0.03508771929824561	KEGG:04670	KEGG	Leukocyte transendothelial migration	8484	343		1	1	114	8370	4	17	110	8353	8484	0.07659532353254098
M1	string	0	network_modules	159	TRUE	4.987020168387561e-10	11	16	5	0.3125	0.45454545454545453	REAC:R-HSA-5625970	REAC	RHO GTPases activate KTN1	10916	1855		0	0.1111111111111111	11	10905	5	11	6	10894	10916	0.3761390420009599
M1	string	0	network_modules	159	TRUE	1.0151658624584552e-7	348	26	10	0.38461538461538464	0.028735632183908046	GO:0007018	GO:BP	microtubule-based movement	16175	2626		0	0.07142857142857142	348	15827	10	16	338	15811	16175	0.10041447242220522
M1	string	0	network_modules	159	TRUE	5.6571399995562274e-6	60	16	5	0.3125	0.08333333333333333	REAC:R-HSA-983189	REAC	Kinesins	10916	1292		0.125	0.2222222222222222	60	10856	5	11	55	10845	10916	0.15909005311348254
M1	string	0	network_modules	159	TRUE	8.097350159393802e-6	42	26	5	0.19230769230769232	0.11904761904761904	GO:0008089	GO:BP	anterograde axonal transport	16175	3120		0.07692307692307693	0.14285714285714285	42	16133	5	21	37	16112	16175	0.14957832281080038
M1	string	0	network_modules	159	TRUE	8.266793539345457e-6	5	16	3	0.1875	0.6	REAC:R-HSA-9013425	REAC	RHOT1 GTPase cycle	10916	1872		0.25	0.3333333333333333	5	10911	3	13	2	10898	10916	0.3349130162710582
M1	string	0	network_modules	159	TRUE	9.88657986998834e-6	249	16	7	0.4375	0.028112449799196786	KEGG:05132	KEGG	Salmonella infection	8484	429		0	0.14285714285714285	249	8235	7	9	242	8226	8484	0.10511367719644162
M1	string	0	network_modules	159	TRUE	2.777112118919247e-5	19	26	4	0.15384615384615385	0.21052631578947367	GO:0034643	GO:BP	establishment of mitochondrion localization, microtubule-mediated	16175	8705		0.15384615384615385	0.2857142857142857	19	16156	4	22	15	16134	16175	0.17884318701465213
M1	string	0	network_modules	159	TRUE	2.777112118919247e-5	19	26	4	0.15384615384615385	0.21052631578947367	GO:0047497	GO:BP	mitochondrion transport along microtubule	16175	12459		0.15384615384615385	0.2857142857142857	19	16156	4	22	15	16134	16175	0.17884318701465213
M1	string	0	network_modules	159	TRUE	2.9714350897807613e-5	54	26	5	0.19230769230769232	0.09259259259259259	GO:0098930	GO:BP	axonal transport	16175	18959		0.3076923076923077	0.35714285714285715	54	16121	5	21	49	16100	16175	0.13144870675928744
M1	string	0	network_modules	159	TRUE	4.6170068130234215e-5	8	16	3	0.1875	0.375	REAC:R-HSA-9715370	REAC	Miro GTPase Cycle	10916	1454		0.375	0.4444444444444444	8	10908	3	13	5	10895	10916	0.264419304318248
M1	string	0	network_modules	159	TRUE	5.3361762513523025e-5	193	16	6	0.375	0.031088082901554404	KEGG:04814	KEGG	Motor proteins	8484	366		0.16666666666666666	0.2857142857142857	193	8291	6	10	187	8281	8484	0.10269297009634537
M1	string	0	network_modules	159	TRUE	5.547450245515626e-5	61	26	5	0.19230769230769232	0.08196721311475409	GO:0008088	GO:BP	axo-dendritic transport	16175	3119		0.38461538461538464	0.42857142857142855	61	16114	5	21	56	16093	16175	0.12342037229264001
M1	string	0	network_modules	159	TRUE	7.168652698119461e-5	99	16	5	0.3125	0.050505050505050504	REAC:R-HSA-6811434	REAC	COPI-dependent Golgi-to-ER retrograde traffic	10916	277		0.5	0.5555555555555556	99	10817	5	11	94	10806	10916	0.12263059599370475
M1	string	0	network_modules	159	TRUE	7.572069088463398e-5	24	26	4	0.15384615384615385	0.16666666666666666	GO:0051654	GO:BP	establishment of mitochondrion localization	16175	13867		0.46153846153846156	0.5	24	16151	4	22	20	16129	16175	0.15882928177839048
M1	string	0	network_modules	159	TRUE	1.238228393480966e-4	144	26	6	0.23076923076923078	0.041666666666666664	GO:0010970	GO:BP	transport along microtubule	16175	4546		0.5384615384615384	0.5714285714285714	144	16031	6	20	138	16011	16175	0.09477385088577724
M1	string	0	network_modules	159	TRUE	1.3825075460071362e-4	73	26	5	0.19230769230769232	0.0684931506849315	GO:0072384	GO:BP	organelle transport along microtubule	16175	17378		0.6153846153846154	0.6428571428571429	73	16102	5	21	68	16081	16175	0.11241902134298619
M1	string	0	network_modules	159	TRUE	2.1221567236695164e-4	123	16	5	0.3125	0.04065040650406504	REAC:R-HSA-2132295	REAC	MHC class II antigen presentation	10916	1371		0.625	0.6666666666666666	123	10793	5	11	118	10782	10916	0.10934222998760938
M1	string	0	network_modules	159	TRUE	2.777846662020495e-4	165	26	6	0.23076923076923078	0.03636363636363636	GO:0099111	GO:BP	microtubule-based transport	16175	19044		0.6923076923076923	0.7142857142857143	165	16010	6	20	159	15990	16175	0.0880772224732524
M1	string	0	network_modules	159	TRUE	3.1300720835893305e-4	133	16	5	0.3125	0.03759398496240601	REAC:R-HSA-8856688	REAC	Golgi-to-ER retrograde transport	10916	1084		0.75	0.7777777777777778	133	10783	5	11	128	10772	10916	0.1048801232757713
M1	string	0	network_modules	159	TRUE	3.3921354493906793e-4	265	16	6	0.375	0.022641509433962263	KEGG:05012	KEGG	Parkinson disease	8484	412		0.3333333333333333	0.42857142857142855	265	8219	6	10	259	8209	8484	0.08590117813609437
M1	string	0	network_modules	159	TRUE	3.860757823132506e-4	271	16	6	0.375	0.02214022140221402	KEGG:05020	KEGG	Prion disease	8484	416		0.5	0.5714285714285714	271	8213	6	10	265	8203	8484	0.08480112492852973
M1	string	0	network_modules	159	TRUE	5.45672578679351e-4	185	26	6	0.23076923076923078	0.032432432432432434	GO:0030705	GO:BP	cytoskeleton-dependent intracellular transport	16175	6886		0.7692307692307693	0.7857142857142857	185	15990	6	20	179	15970	16175	0.08276556935352623
M1	string	0	network_modules	159	TRUE	6.399931611168003e-4	40	26	4	0.15384615384615385	0.1	GO:0051646	GO:BP	mitochondrion localization	16175	13859		0.8461538461538461	0.8571428571428571	40	16135	4	22	36	16113	16175	0.12229048362020044
M1	string	0	network_modules	159	TRUE	7.622285354913246e-4	305	16	6	0.375	0.019672131147540985	KEGG:05016	KEGG	Huntington disease	8484	414		0.6666666666666666	0.7142857142857143	305	8179	6	10	299	8169	8484	0.07916512853662637
M1	string	0	network_modules	159	TRUE	0.0010223137195236839	169	16	5	0.3125	0.029585798816568046	REAC:R-HSA-983231	REAC	Factors involved in megakaryocyte development and platelet production	10916	931		0.875	0.8888888888888888	169	10747	5	11	164	10736	10916	0.09217353942559665
M1	string	0	network_modules	159	TRUE	0.001386906105957553	519	26	8	0.3076923076923077	0.015414258188824663	GO:0051640	GO:BP	organelle localization	16175	13853		0.9230769230769231	0.9285714285714286	519	15656	8	18	511	15638	16175	0.06275124428071424
M1	string	0	network_modules	159	TRUE	0.0014490099394394822	13	26	3	0.11538461538461539	0.23076923076923078	GO:0019896	GO:BP	axonal transport of mitochondrion	16175	6066		1	1	13	16162	3	23	10	16139	16175	0.16223747198685623
M1	string	0	network_modules	159	TRUE	0.002055909898723558	363	16	6	0.375	0.01652892561983471	KEGG:05014	KEGG	Amyotrophic lateral sclerosis	8484	413		0.8333333333333334	0.8571428571428571	363	8121	6	10	357	8111	8484	0.071355842469932207
M1	string	0	network_modules	159	TRUE	0.002449130080035636	202	16	5	0.3125	0.024752475247524754	REAC:R-HSA-6811442	REAC	Intra-Golgi and retrograde Golgi-to-ER traffic	10916	1262		1	1	202	10714	5	11	197	10703	10916	0.08357931097079299
M1	string	0	network_modules	159	TRUE	0.0027431223902164184	382	16	6	0.375	0.015706806282722512	KEGG:05010	KEGG	Alzheimer disease	8484	411		1	1	382	8102	6	10	376	8092	8484	0.06917071065391332
M1	string	0	network_modules	160	TRUE	1.4686045364230873e-29	23	21	13	0.6190476190476191	0.5652173913043478	REAC:R-HSA-5620922	REAC	BBSome-mediated cargo-targeting to cilium	10916	199		0	0.25	23	10893	13	8	10	10885	10916	0.5906976633864743
M1	string	0	network_modules	160	TRUE	5.9978281943734276e-24	51	21	13	0.6190476190476191	0.2549019607843137	REAC:R-HSA-5620920	REAC	Cargo trafficking to the periciliary membrane	10916	310		0.3333333333333333	0.5	51	10865	13	8	38	10857	10916	0.3955428582239205
M1	string	0	network_modules	160	TRUE	1.0039861414669236e-15	200	21	13	0.6190476190476191	0.065	REAC:R-HSA-5617833	REAC	Cilium Assembly	10916	361		0.6666666666666666	0.75	200	10716	13	8	187	10708	10916	0.1966548021118414
M1	string	0	network_modules	160	TRUE	1.4651063826127553e-13	292	21	13	0.6190476190476191	0.04452054794520548	REAC:R-HSA-1852241	REAC	Organelle biogenesis and maintenance	10916	1646		1	1	292	10624	13	8	279	10616	10916	0.161162608737006
M1	string	0	network_modules	160	TRUE	2.296561244455375e-11	343	24	12	0.5	0.03498542274052478	GO:0060271	GO:BP	cilium assembly	16175	14488		0	0.0196078431372549	343	15832	12	12	331	15820	16175	0.1281103877808651
M1	string	0	network_modules	160	TRUE	5.320387490690907e-11	368	24	12	0.5	0.03260869565217391	GO:0044782	GO:BP	cilium organization	16175	11155		0.02	0.0392156862745098	368	15807	12	12	356	15795	16175	0.12338047782873865
M1	string	0	network_modules	160	TRUE	1.5531632264064595e-10	18	24	6	0.25	0.3333333333333333	GO:0032402	GO:BP	melanosome transport	16175	7546		0.04	0.0784313725490196	18	16157	6	18	12	16139	16175	0.2877637595977634
M1	string	0	network_modules	160	TRUE	1.5531632264064595e-10	18	24	6	0.25	0.3333333333333333	GO:0051904	GO:BP	pigment granule transport	16175	13987		0.04	0.0784313725490196	18	16157	6	18	12	16139	16175	0.2877637595977634
M1	string	0	network_modules	160	TRUE	2.2678408465380759e-10	19	24	6	0.25	0.3157894736842105	GO:0032401	GO:BP	establishment of melanosome localization	16175	7545		0.08	0.11764705882352941	19	16156	6	18	13	16138	16175	0.2800277678750306
M1	string	0	network_modules	160	TRUE	2.2678408465380759e-10	19	24	6	0.25	0.3157894736842105	GO:0051905	GO:BP	establishment of pigment granule localization	16175	13988		0.08	0.11764705882352941	19	16156	6	18	13	16138	16175	0.2800277678750306
M1	string	0	network_modules	160	TRUE	4.5270258736441186e-10	21	24	6	0.25	0.2857142857142857	GO:0051875	GO:BP	pigment granule localization	16175	13962		0.12	0.1568627450980392	21	16154	6	18	15	16136	16175	0.2662436565334366
M1	string	0	network_modules	160	TRUE	4.5270258736441186e-10	21	24	6	0.25	0.2857142857142857	GO:0032400	GO:BP	melanosome localization	16175	7544		0.12	0.1568627450980392	21	16154	6	18	15	16136	16175	0.2662436565334366
M1	string	0	network_modules	160	TRUE	2.1614976966007626e-9	503	24	12	0.5	0.02385685884691849	GO:0120031	GO:BP	plasma membrane bounded cell projection assembly	16175	19467		0.16	0.17647058823529413	503	15672	12	12	491	15660	16175	0.10413258846079848
M1	string	0	network_modules	160	TRUE	2.7885007468876356e-9	514	24	12	0.5	0.023346303501945526	GO:0030031	GO:BP	cell projection assembly	16175	6655		0.18	0.19607843137254902	514	15661	12	12	502	15649	16175	0.10289901980017067
M1	string	0	network_modules	160	TRUE	9.134669291044652e-9	33	24	6	0.25	0.18181818181818182	GO:0045494	GO:BP	photoreceptor cell maintenance	16175	11413		0.2	0.21568627450980393	33	16142	6	18	27	16124	16175	0.21183409564475608
M1	string	0	network_modules	160	TRUE	4.2894104334676714e-8	42	24	6	0.25	0.14285714285714285	GO:0001895	GO:BP	retina homeostasis	16175	520		0.22	0.23529411764705882	42	16133	6	18	36	16115	16175	0.18740175504380888
M1	string	0	network_modules	160	TRUE	3.2593740411436287e-7	58	24	6	0.25	0.10344827586206896	GO:0033059	GO:BP	cellular pigmentation	16175	8013		0.24	0.2549019607843137	58	16117	6	18	52	16099	16175	0.15891316131789304
M1	string	0	network_modules	160	TRUE	3.6248914317564115e-7	59	24	6	0.25	0.1016949152542373	GO:0061512	GO:BP	protein localization to cilium	16175	15514		0.26	0.27450980392156865	59	16116	6	18	53	16098	16175	0.15752604031419593
M1	string	0	network_modules	160	TRUE	2.55655781412472e-6	81	24	6	0.25	0.07407407407407407	GO:0043473	GO:BP	pigmentation	16175	10719		0.28	0.29411764705882354	81	16094	6	18	75	16076	16175	0.13379136326551133
M1	string	0	network_modules	160	TRUE	1.0473628201665213e-5	16	24	4	0.16666666666666666	0.25	GO:0048854	GO:BP	brain morphogenesis	16175	13098		0.3	0.3137254901960784	16	16159	4	20	12	16139	16175	0.20316386454915059
M1	string	0	network_modules	160	TRUE	1.792116726740919e-5	4	24	3	0.125	0.75	GO:0038108	GO:BP	negative regulation of appetite by leptin-mediated signaling pathway	16175	9702		0.32	0.3333333333333333	4	16171	3	21	1	16150	16175	0.3058452484972161
M1	string	0	network_modules	160	TRUE	8.372345634060319e-5	250	24	7	0.2916666666666667	0.028	GO:0007389	GO:BP	pattern specification process	16175	2889		0.34	0.35294117647058826	250	15925	7	17	243	15908	16175	0.08631395176715487
M1	string	0	network_modules	160	TRUE	8.612430455372087e-5	145	24	6	0.25	0.041379310344827586	GO:0045444	GO:BP	fat cell differentiation	16175	11377		0.36	0.37254901960784315	145	16030	6	18	139	16012	16175	0.09857812144484329
M1	string	0	network_modules	160	TRUE	1.1407345052790111e-4	152	24	6	0.25	0.039473684210526314	GO:0001894	GO:BP	tissue homeostasis	16175	519		0.38	0.4117647058823529	152	16023	6	18	146	16005	16175	0.09612960019116353
M1	string	0	network_modules	160	TRUE	1.1407345052790111e-4	152	24	6	0.25	0.039473684210526314	GO:0060249	GO:BP	anatomical structure homeostasis	16175	14466		0.38	0.4117647058823529	152	16023	6	18	146	16005	16175	0.09612960019116353
M1	string	0	network_modules	160	TRUE	1.5635251887141397e-4	7	24	3	0.125	0.42857142857142855	GO:0021544	GO:BP	subpallium development	16175	6128		0.42	0.47058823529411764	7	16168	3	21	4	16147	16175	0.23087496910088323
M1	string	0	network_modules	160	TRUE	1.5635251887141397e-4	7	24	3	0.125	0.42857142857142855	GO:0060296	GO:BP	regulation of cilium beat frequency involved in ciliary motility	16175	14510		0.42	0.47058823529411764	7	16168	3	21	4	16147	16175	0.23087496910088323
M1	string	0	network_modules	160	TRUE	1.5635251887141397e-4	7	24	3	0.125	0.42857142857142855	GO:0021756	GO:BP	striatum development	16175	6337		0.42	0.47058823529411764	7	16168	3	21	4	16147	16175	0.23087496910088323
M1	string	0	network_modules	160	TRUE	1.8222841321506976e-4	82	24	5	0.20833333333333334	0.06097560975609756	GO:0007368	GO:BP	determination of left/right symmetry	16175	2870		0.48	0.49019607843137253	82	16093	5	19	77	16074	16175	0.11032775239916728
M1	string	0	network_modules	160	TRUE	1.9371948812102466e-4	83	24	5	0.20833333333333334	0.060240963855421686	GO:0060972	GO:BP	left/right pattern formation	16175	15099		0.5	0.5098039215686274	83	16092	5	19	78	16073	16175	0.10963116554598046
M1	string	0	network_modules	160	TRUE	2.499204092417415e-4	8	24	3	0.125	0.375	GO:0032108	GO:BP	negative regulation of response to nutrient levels	16175	7369		0.52	0.5686274509803921	8	16167	3	21	5	16146	16175	0.21586324943197172
M1	string	0	network_modules	160	TRUE	2.499204092417415e-4	8	24	3	0.125	0.375	GO:0032096	GO:BP	negative regulation of response to food	16175	7360		0.52	0.5686274509803921	8	16167	3	21	5	16146	16175	0.21586324943197172
M1	string	0	network_modules	160	TRUE	2.499204092417415e-4	8	24	3	0.125	0.375	GO:0032099	GO:BP	negative regulation of appetite	16175	7363		0.52	0.5686274509803921	8	16167	3	21	5	16146	16175	0.21586324943197172
M1	string	0	network_modules	160	TRUE	2.7531554853923155e-4	89	24	5	0.20833333333333334	0.056179775280898875	GO:0009855	GO:BP	determination of bilateral symmetry	16175	3727		0.58	0.6078431372549019	89	16086	5	19	84	16067	16175	0.10569769826025002
M1	string	0	network_modules	160	TRUE	2.7531554853923155e-4	89	24	5	0.20833333333333334	0.056179775280898875	GO:0009799	GO:BP	specification of symmetry	16175	3683		0.58	0.6078431372549019	89	16086	5	19	84	16067	16175	0.10569769826025002
M1	string	0	network_modules	160	TRUE	2.9121186708716307e-4	178	24	6	0.25	0.033707865168539325	GO:0051650	GO:BP	establishment of vesicle localization	16175	13863		0.62	0.6274509803921569	178	15997	6	18	172	15979	16175	0.0883101054373319
M1	string	0	network_modules	160	TRUE	3.7451554401581413e-4	9	24	3	0.125	0.3333333333333333	GO:0033210	GO:BP	leptin-mediated signaling pathway	16175	8076		0.64	0.6470588235294118	9	16166	3	21	6	16145	16175	0.2034230568890601
M1	string	0	network_modules	160	TRUE	3.776040959492114e-4	186	24	6	0.25	0.03225806451612903	GO:0051648	GO:BP	vesicle localization	16175	13861		0.66	0.6666666666666666	186	15989	6	18	180	15971	16175	0.08623287562655339
M1	string	0	network_modules	160	TRUE	4.6267562207770246e-4	39	24	4	0.16666666666666666	0.10256410256410256	GO:1905515	GO:BP	non-motile cilium assembly	16175	24691		0.68	0.6862745098039216	39	16136	4	20	35	16116	16175	0.12910408307256965
M1	string	0	network_modules	160	TRUE	5.902731907035355e-4	50	8	3	0.375	0.06	KEGG:00270	KEGG	Cysteine and methionine metabolism	8484	30		NA	1	50	8434	3	5	47	8429	8484	0.14814948121020544
M1	string	0	network_modules	160	TRUE	6.277572331977316e-4	42	24	4	0.16666666666666666	0.09523809523809523	GO:0001947	GO:BP	heart looping	16175	558		0.7	0.7058823529411765	42	16133	4	20	38	16113	16175	0.12427888405333369
M1	string	0	network_modules	160	TRUE	7.342234578881337e-4	11	24	3	0.125	0.2727272727272727	GO:0044320	GO:BP	cellular response to leptin stimulus	16175	10955		0.72	0.7254901960784313	11	16164	3	21	8	16143	16175	0.18383162391620309
M1	string	0	network_modules	160	TRUE	9.116016870603157e-4	46	24	4	0.16666666666666666	0.08695652173913043	GO:0061371	GO:BP	determination of heart left/right asymmetry	16175	15443		0.74	0.7647058823529411	46	16129	4	20	42	16109	16175	0.11858829756710812
M1	string	0	network_modules	160	TRUE	9.116016870603157e-4	46	24	4	0.16666666666666666	0.08695652173913043	GO:0003143	GO:BP	embryonic heart tube morphogenesis	16175	1575		0.74	0.7647058823529411	46	16129	4	20	42	16109	16175	0.11858829756710812
M1	string	0	network_modules	160	TRUE	0.0011560001336232584	225	24	6	0.25	0.02666666666666667	GO:0003002	GO:BP	regionalization	16175	1453		0.78	0.7843137254901961	225	15950	6	18	219	15932	16175	0.07770617594822807
M1	string	0	network_modules	160	TRUE	0.001270176640289424	13	24	3	0.125	0.23076923076923078	GO:0032095	GO:BP	regulation of response to food	16175	7359		0.8	0.803921568627451	13	16162	3	21	10	16141	16175	0.1689427654824629
M1	string	0	network_modules	160	TRUE	0.001503393320158339	52	24	4	0.16666666666666666	0.07692307692307693	GO:0035050	GO:BP	embryonic heart tube development	16175	8784		0.82	0.8235294117647058	52	16123	4	20	48	16103	16175	0.11130518282332948
M1	string	0	network_modules	160	TRUE	0.0016150142932310726	14	24	3	0.125	0.21428571428571427	GO:0044321	GO:BP	response to leptin	16175	10956		0.84	0.8431372549019608	14	16161	3	21	11	16140	16175	0.16272131740802678
M1	string	0	network_modules	160	TRUE	0.0020168021160694542	15	24	3	0.125	0.2	GO:0003356	GO:BP	regulation of cilium beat frequency	16175	1776		0.86	0.8627450980392157	15	16160	3	21	12	16139	16175	0.15713029557594074
M1	string	0	network_modules	160	TRUE	0.0022796869295413536	136	24	5	0.20833333333333334	0.03676470588235294	GO:0048562	GO:BP	embryonic organ morphogenesis	16175	12835		0.88	0.8823529411764706	136	16039	5	19	131	16020	16175	0.08440338258793209
M1	string	0	network_modules	160	TRUE	0.0024798009978851004	16	24	3	0.125	0.1875	GO:0032098	GO:BP	regulation of appetite	16175	7362		0.9	0.9019607843137255	16	16159	3	21	13	16138	16175	0.15206964990454408
M1	string	0	network_modules	160	TRUE	0.0032968362412703106	2	24	2	0.08333333333333333	1	GO:0051877	GO:BP	pigment granule aggregation in cell center	16175	13964		0.92	0.9215686274509803	2	16173	2	22	0	16151	16175	0.28847872656338225
M1	string	0	network_modules	160	TRUE	0.004278419411008274	19	24	3	0.125	0.15789473684210525	GO:0032094	GO:BP	response to food	16175	7358		0.94	0.9411764705882353	19	16156	3	21	16	16135	16175	0.1393529077787942
M1	string	0	network_modules	160	TRUE	0.0046246063447353295	157	24	5	0.20833333333333334	0.03184713375796178	GO:0060562	GO:BP	epithelial tube morphogenesis	16175	14746		0.96	0.9607843137254902	157	16018	5	19	152	15999	16175	0.07809702783123294
M1	string	0	network_modules	160	TRUE	0.006779710287488683	22	24	3	0.125	0.13636363636363635	GO:0032107	GO:BP	regulation of response to nutrient levels	16175	7368		0.98	0.9803921568627451	22	16153	3	21	19	16132	16175	0.1293215278126346
M1	string	0	network_modules	160	TRUE	0.007789075887658279	23	24	3	0.125	0.13043478260869565	GO:0051131	GO:BP	chaperone-mediated protein complex assembly	16175	13515		1	1	23	16152	3	21	20	16131	16175	0.12641961913648028
M1	string	0	network_modules	161	TRUE	2.244889395973981e-20	62	19	12	0.631578947368421	0.1935483870967742	KEGG:05321	KEGG	Inflammatory bowel disease	8484	483		0	0.09090909090909091	62	8422	12	7	50	8415	8484	0.3472431823426442
M1	string	0	network_modules	161	TRUE	3.68941851918834e-20	125	27	14	0.5185185185185185	0.112	GO:0046631	GO:BP	alpha-beta T cell activation	16175	12268		0	0.005	125	16050	14	13	111	16037	16175	0.2385157840953108
M1	string	0	network_modules	161	TRUE	4.326602223700289e-18	84	27	12	0.4444444444444444	0.14285714285714285	GO:0046634	GO:BP	regulation of alpha-beta T cell activation	16175	12271		0.005025125628140704	0.01	84	16091	12	15	72	16076	16175	0.24988986463023738
M1	string	0	network_modules	161	TRUE	1.6440328338335027e-17	61	27	11	0.4074074074074074	0.18032786885245902	GO:0002294	GO:BP	CD4-positive, alpha-beta T cell differentiation involved in immune response	16175	826		0.010050251256281407	0.015	61	16114	11	16	50	16098	16175	0.2692714226532809
M1	string	0	network_modules	161	TRUE	1.962252877541138e-17	105	19	12	0.631578947368421	0.11428571428571428	KEGG:04659	KEGG	Th17 cell differentiation	8484	337		0.1	0.18181818181818182	105	8379	12	7	93	8372	8484	0.2653420515049847
M1	string	0	network_modules	161	TRUE	1.9968100528006875e-17	62	27	11	0.4074074074074074	0.1774193548387097	GO:0002287	GO:BP	alpha-beta T cell activation involved in immune response	16175	819		0.01507537688442211	0.025	62	16113	11	16	51	16097	16175	0.2670584284488448
M1	string	0	network_modules	161	TRUE	1.9968100528006875e-17	62	27	11	0.4074074074074074	0.1774193548387097	GO:0002293	GO:BP	alpha-beta T cell differentiation involved in immune response	16175	825		0.01507537688442211	0.025	62	16113	11	16	51	16097	16175	0.2670584284488448
M1	string	0	network_modules	161	TRUE	3.193371713250089e-17	472	19	16	0.8421052631578947	0.03389830508474576	REAC:R-HSA-449147	REAC	Signaling by Interleukins	10916	2261		0	0.14285714285714285	472	10444	16	3	456	10441	10916	0.16400472066689573
M1	string	0	network_modules	161	TRUE	4.190190965533589e-17	162	19	13	0.6842105263157895	0.08024691358024691	KEGG:04630	KEGG	JAK-STAT signaling pathway	8484	332		0.2	0.2727272727272727	162	8322	13	6	149	8316	8484	0.23024481268686992
M1	string	0	network_modules	161	TRUE	4.2043389717057214e-17	66	27	11	0.4074074074074074	0.16666666666666666	GO:0002292	GO:BP	T cell differentiation involved in immune response	16175	824		0.02512562814070352	0.03	66	16109	11	16	55	16093	16175	0.2587127770972429
M1	string	0	network_modules	161	TRUE	1.1765843362080276e-16	72	27	11	0.4074074074074074	0.1527777777777778	GO:0043367	GO:BP	CD4-positive, alpha-beta T cell differentiation	16175	10644		0.03015075376884422	0.035	72	16103	11	16	61	16087	16175	0.24751691537525342
M1	string	0	network_modules	161	TRUE	1.860047724784208e-16	57	19	10	0.5263157894736842	0.17543859649122806	REAC:R-HSA-447115	REAC	Interleukin-12 family signaling	10916	1235		0.16666666666666666	0.2857142857142857	57	10859	10	9	47	10850	10916	0.30190524682725645
M1	string	0	network_modules	161	TRUE	3.902539042438054e-16	89	19	11	0.5789473684210527	0.12359550561797752	KEGG:04658	KEGG	Th1 and Th2 cell differentiation	8484	336		0.3	0.36363636363636365	89	8395	11	8	78	8387	8484	0.2643359733277991
M1	string	0	network_modules	161	TRUE	8.208081586554503e-16	85	27	11	0.4074074074074074	0.12941176470588237	GO:0046632	GO:BP	alpha-beta T cell differentiation	16175	12269		0.035175879396984924	0.04	85	16090	11	16	74	16074	16175	0.2274416325311096
M1	string	0	network_modules	161	TRUE	1.2279741201777808e-15	88	27	11	0.4074074074074074	0.125	GO:0035710	GO:BP	CD4-positive, alpha-beta T cell activation	16175	9184		0.04020100502512563	0.045	88	16087	11	16	77	16071	16175	0.22344890998616276
M1	string	0	network_modules	161	TRUE	2.3457237184006503e-15	59	27	10	0.37037037037037035	0.1694915254237288	GO:0042093	GO:BP	T-helper cell differentiation	16175	9964		0.04522613065326633	0.05	59	16116	10	17	49	16099	16175	0.24874252441645847
M1	string	0	network_modules	161	TRUE	5.374790745127421e-15	100	27	11	0.4074074074074074	0.11	GO:0002286	GO:BP	T cell activation involved in immune response	16175	818		0.05025125628140704	0.055	100	16075	11	16	89	16059	16175	0.20930486614827923
M1	string	0	network_modules	161	TRUE	2.4053692306811035e-14	44	27	9	0.3333333333333333	0.20454545454545456	GO:0043370	GO:BP	regulation of CD4-positive, alpha-beta T cell differentiation	16175	10647		0.05527638190954774	0.06	44	16131	9	18	35	16113	16175	0.2595552732555414
M1	string	0	network_modules	161	TRUE	9.832009239582397e-14	129	27	11	0.4074074074074074	0.08527131782945736	GO:0045580	GO:BP	regulation of T cell differentiation	16175	11431		0.06030150753768844	0.065	129	16046	11	16	118	16030	16175	0.18362489300415233
M1	string	0	network_modules	161	TRUE	1.710361681421969e-13	30	27	8	0.2962962962962963	0.26666666666666666	GO:0042088	GO:BP	T-helper 1 type immune response	16175	9962		0.06532663316582915	0.07	30	16145	8	19	22	16126	16175	0.27982485786445094
M1	string	0	network_modules	161	TRUE	1.7863189824381281e-13	54	27	9	0.3333333333333333	0.16666666666666666	GO:0046637	GO:BP	regulation of alpha-beta T cell differentiation	16175	12274		0.07035175879396985	0.075	54	16121	9	18	45	16103	16175	0.23392739885940483
M1	string	0	network_modules	161	TRUE	2.883412187768335e-13	284	27	13	0.48148148148148145	0.045774647887323945	GO:0050863	GO:BP	regulation of T cell activation	16175	13311		0.07537688442211055	0.08	284	15891	13	14	271	15877	16175	0.14443698346512227
M1	string	0	network_modules	161	TRUE	3.012857605679416e-13	57	27	9	0.3333333333333333	0.15789473684210525	GO:2000514	GO:BP	regulation of CD4-positive, alpha-beta T cell activation	16175	25817		0.08040201005025126	0.085	57	16118	9	18	48	16100	16175	0.22758141646654648
M1	string	0	network_modules	161	TRUE	3.0313302769664487e-13	206	27	12	0.4444444444444444	0.05825242718446602	GO:0030217	GO:BP	T cell differentiation	16175	6725		0.08542713567839195	0.09	206	15969	12	15	194	15954	16175	0.15742915802207394
M1	string	0	network_modules	161	TRUE	4.0445608877135746e-13	33	27	8	0.2962962962962963	0.24242424242424243	GO:0045622	GO:BP	regulation of T-helper cell differentiation	16175	11473		0.09045226130653267	0.095	33	16142	8	19	25	16123	16175	0.2666592481281647
M1	string	0	network_modules	161	TRUE	6.263479917057658e-13	152	27	11	0.4074074074074074	0.07236842105263158	GO:0045619	GO:BP	regulation of lymphocyte differentiation	16175	11470		0.09547738693467336	0.1	152	16023	11	16	141	16007	16175	0.16868143281464346
M1	string	0	network_modules	161	TRUE	6.631026049321648e-13	403	27	14	0.5185185185185185	0.034739454094292806	GO:0001819	GO:BP	positive regulation of cytokine production	16175	476		0.10050251256281408	0.105	403	15772	14	13	389	15759	16175	0.1294938512624835
M1	string	0	network_modules	161	TRUE	7.352176218373544e-13	406	27	14	0.5185185185185185	0.034482758620689655	GO:0042110	GO:BP	T cell activation	16175	9970		0.10552763819095477	0.11	406	15769	14	13	392	15756	16175	0.12897832854977684
M1	string	0	network_modules	161	TRUE	9.674600137673855e-13	158	27	11	0.4074074074074074	0.06962025316455696	GO:0002285	GO:BP	lymphocyte activation involved in immune response	16175	817		0.11055276381909548	0.115	158	16017	11	16	147	16001	16175	0.16532438359594898
M1	string	0	network_modules	161	TRUE	1.139727468299016e-12	419	27	14	0.5185185185185185	0.03341288782816229	GO:0019221	GO:BP	cytokine-mediated signaling pathway	16175	5598		0.11557788944723618	0.12	419	15756	14	13	405	15743	16175	0.12680718398959215
M1	string	0	network_modules	161	TRUE	1.6588894287144262e-12	555	27	15	0.5555555555555556	0.02702702702702703	GO:0071345	GO:BP	cellular response to cytokine stimulus	16175	16597		0.12060301507537688	0.125	555	15620	15	12	540	15608	16175	0.11709013808196818
M1	string	0	network_modules	161	TRUE	2.3772465006006933e-12	334	27	13	0.48148148148148145	0.038922155688622756	GO:0002250	GO:BP	adaptive immune response	16175	782		0.12562814070351758	0.13	334	15841	13	14	321	15827	16175	0.13250894975227517
M1	string	0	network_modules	161	TRUE	8.631994639605924e-12	369	27	13	0.48148148148148145	0.03523035230352303	GO:0051249	GO:BP	regulation of lymphocyte activation	16175	13596		0.1306532663316583	0.135	369	15806	13	14	356	15792	16175	0.12561501161060956
M1	string	0	network_modules	161	TRUE	9.574419243347331e-12	625	27	15	0.5555555555555556	0.024	GO:0034097	GO:BP	response to cytokine	16175	8408		0.135678391959799	0.145	625	15550	15	12	610	15538	16175	0.10966834792478596
M1	string	0	network_modules	161	TRUE	9.574419243347331e-12	625	27	15	0.5555555555555556	0.024	GO:1901652	GO:BP	response to peptide	16175	21619		0.135678391959799	0.145	625	15550	15	12	610	15538	16175	0.10966834792478596
M1	string	0	network_modules	161	TRUE	2.5005296656980665e-11	297	27	12	0.4444444444444444	0.04040404040404041	GO:0030098	GO:BP	lymphocyte differentiation	16175	6676		0.1457286432160804	0.15	297	15878	12	15	285	15863	16175	0.12977309290642314
M1	string	0	network_modules	161	TRUE	3.151717183118859e-11	216	27	11	0.4074074074074074	0.05092592592592592	GO:0002366	GO:BP	leukocyte activation involved in immune response	16175	898		0.1507537688442211	0.155	216	15959	11	16	205	15943	16175	0.14037579862919156
M1	string	0	network_modules	161	TRUE	3.6840240498580266e-11	29	27	7	0.25925925925925924	0.2413793103448276	GO:0072539	GO:BP	T-helper 17 cell differentiation	16175	17437		0.15577889447236182	0.16	29	16146	7	20	22	16126	16175	0.248860423759654
M1	string	0	network_modules	161	TRUE	4.0594197555693413e-11	221	27	11	0.4074074074074074	0.049773755656108594	GO:0002263	GO:BP	cell activation involved in immune response	16175	795		0.16080402010050251	0.165	221	15954	11	16	210	15938	16175	0.13869161398121782
M1	string	0	network_modules	161	TRUE	4.714871815876954e-11	421	27	13	0.48148148148148145	0.030878859857482184	GO:0002694	GO:BP	regulation of leukocyte activation	16175	1212		0.1658291457286432	0.17	421	15754	13	14	408	15740	16175	0.11697001071539055
M1	string	0	network_modules	161	TRUE	5.7288579671830436e-11	228	27	11	0.4074074074074074	0.04824561403508772	GO:1902105	GO:BP	regulation of leukocyte differentiation	16175	22019		0.1708542713567839	0.175	228	15947	11	16	217	15931	16175	0.13642583300620004
M1	string	0	network_modules	161	TRUE	7.245728184714391e-11	60	27	8	0.2962962962962963	0.13333333333333333	GO:0032729	GO:BP	positive regulation of type II interferon production	16175	7774		0.17587939698492464	0.18	60	16115	8	19	52	16096	16175	0.1968026088563286
M1	string	0	network_modules	161	TRUE	7.806821262465204e-11	569	27	14	0.5185185185185185	0.02460456942003515	GO:0046649	GO:BP	lymphocyte activation	16175	12286		0.18090452261306533	0.185	569	15606	14	13	555	15593	16175	0.10727988535745953
M1	string	0	network_modules	161	TRUE	1.0159648967242697e-10	334	27	12	0.4444444444444444	0.03592814371257485	GO:0009615	GO:BP	response to virus	16175	3541		0.18592964824120603	0.19	334	15841	12	15	322	15826	16175	0.12185922198010798
M1	string	0	network_modules	161	TRUE	1.8298783566545905e-10	468	27	13	0.48148148148148145	0.027777777777777776	GO:0050865	GO:BP	regulation of cell activation	16175	13313		0.19095477386934673	0.195	468	15707	13	14	455	15693	16175	0.11039816301587378
M1	string	0	network_modules	161	TRUE	2.243275256552661e-10	357	27	12	0.4444444444444444	0.03361344537815126	GO:1903131	GO:BP	mononuclear cell differentiation	16175	22787		0.19597989949748743	0.2	357	15818	12	15	345	15803	16175	0.11755833124974703
M1	string	0	network_modules	161	TRUE	2.344316489017692e-10	291	19	11	0.5789473684210527	0.037800687285223365	KEGG:04060	KEGG	Cytokine-cytokine receptor interaction	8484	253		0.4	0.45454545454545453	291	8193	11	8	280	8185	8484	0.1417788761746796
M1	string	0	network_modules	161	TRUE	2.4091329986818966e-10	37	27	7	0.25925925925925924	0.1891891891891892	GO:0072538	GO:BP	T-helper 17 type immune response	16175	17436		0.20100502512562815	0.205	37	16138	7	20	30	16118	16175	0.2199512902202457
M1	string	0	network_modules	161	TRUE	3.4092716548710776e-10	18	27	6	0.2222222222222222	0.3333333333333333	GO:0072540	GO:BP	T-helper 17 cell lineage commitment	16175	17438		0.20603015075376885	0.21	18	16157	6	21	12	16136	16175	0.27117982734165513
M1	string	0	network_modules	161	TRUE	3.4314634221627296e-10	634	27	14	0.5185185185185185	0.022082018927444796	GO:0001817	GO:BP	regulation of cytokine production	16175	474		0.21105527638190955	0.215	634	15541	14	13	620	15528	16175	0.10099741567648145
M1	string	0	network_modules	161	TRUE	3.600383969916953e-10	9	19	5	0.2631578947368421	0.5555555555555556	REAC:R-HSA-9020933	REAC	Interleukin-23 signaling	10916	1244		0.3333333333333333	0.42857142857142855	9	10907	5	14	4	10893	10916	0.381651133643446
M1	string	0	network_modules	161	TRUE	3.739084279571357e-10	638	27	14	0.5185185185185185	0.0219435736677116	GO:0001816	GO:BP	cytokine production	16175	473		0.21608040201005024	0.22	638	15537	14	13	624	15524	16175	0.1006413204224833
M1	string	0	network_modules	161	TRUE	4.681392546526755e-10	276	27	11	0.4074074074074074	0.03985507246376811	GO:0002460	GO:BP	adaptive immune response based on somatic recombination of immune receptors built from immunoglobulin superfamily domains	16175	983		0.22110552763819097	0.225	276	15899	11	16	265	15883	16175	0.12324658824471059
M1	string	0	network_modules	161	TRUE	4.977232556474314e-10	19	27	6	0.2222222222222222	0.3157894736842105	GO:2000319	GO:BP	regulation of T-helper 17 cell differentiation	16175	25641		0.22613065326633167	0.23	19	16156	6	21	13	16135	16175	0.2638814266034348
M1	string	0	network_modules	161	TRUE	7.102413532140148e-10	20	27	6	0.2222222222222222	0.3	GO:0002295	GO:BP	T-helper cell lineage commitment	16175	827		0.23115577889447236	0.24	20	16155	6	21	14	16134	16175	0.2571358226229504
M1	string	0	network_modules	161	TRUE	7.102413532140148e-10	20	27	6	0.2222222222222222	0.3	GO:0002825	GO:BP	regulation of T-helper 1 type immune response	16175	1335		0.23115577889447236	0.24	20	16155	6	21	14	16134	16175	0.2571358226229504
M1	string	0	network_modules	161	TRUE	7.179285270058848e-10	287	27	11	0.4074074074074074	0.03832752613240418	GO:1903037	GO:BP	regulation of leukocyte cell-cell adhesion	16175	22717		0.24120603015075376	0.245	287	15888	11	16	276	15872	16175	0.12069283672435697
M1	string	0	network_modules	161	TRUE	7.634722679408244e-10	8	27	5	0.18518518518518517	0.625	GO:2000328	GO:BP	regulation of T-helper 17 cell lineage commitment	16175	25647		0.24623115577889448	0.25	8	16167	5	22	3	16145	16175	0.3396658368382056
M1	string	0	network_modules	161	TRUE	1.2965939589975283e-9	699	27	14	0.5185185185185185	0.020028612303290415	GO:0045321	GO:BP	leukocyte activation	16175	11356		0.25125628140703515	0.255	699	15476	14	13	685	15463	16175	0.09558066112646194
M1	string	0	network_modules	161	TRUE	1.535345422212837e-9	142	27	9	0.3333333333333333	0.06338028169014084	GO:0007259	GO:BP	cell surface receptor signaling pathway via JAK-STAT	16175	2789		0.2562814070351759	0.26	142	16033	9	18	133	16015	16175	0.1422665079469228
M1	string	0	network_modules	161	TRUE	1.6076499075013675e-9	309	27	11	0.4074074074074074	0.03559870550161812	GO:1903706	GO:BP	regulation of hemopoiesis	16175	23220		0.2613065326633166	0.265	309	15866	11	16	298	15850	16175	0.11599133200804106
M1	string	0	network_modules	161	TRUE	1.7158648494112188e-9	9	27	5	0.18518518518518517	0.5555555555555556	GO:0035722	GO:BP	interleukin-12-mediated signaling pathway	16175	9192		0.2663316582914573	0.27	9	16166	5	22	4	16144	16175	0.32014272539374267
M1	string	0	network_modules	161	TRUE	1.8435872669831903e-9	23	27	6	0.2222222222222222	0.2608695652173913	GO:0043373	GO:BP	CD4-positive, alpha-beta T cell lineage commitment	16175	10650		0.271356783919598	0.28	23	16152	6	21	17	16131	16175	0.23960139352370766
M1	string	0	network_modules	161	TRUE	1.8435872669831903e-9	23	27	6	0.2222222222222222	0.2608695652173913	GO:0002363	GO:BP	alpha-beta T cell lineage commitment	16175	895		0.271356783919598	0.28	23	16152	6	21	17	16131	16175	0.23960139352370766
M1	string	0	network_modules	161	TRUE	1.9422768292535144e-9	111	19	8	0.42105263157894735	0.07207207207207207	REAC:R-HSA-6785807	REAC	Interleukin-4 and Interleukin-13 signaling	10916	1252		0.5	0.5714285714285714	111	10805	8	11	103	10794	10916	0.17101424317144248
M1	string	0	network_modules	161	TRUE	2.12720071794961e-9	90	27	8	0.2962962962962963	0.08888888888888889	GO:0032649	GO:BP	regulation of type II interferon production	16175	7696		0.2814070351758794	0.29	90	16085	8	19	82	16066	16175	0.15981887888411356
M1	string	0	network_modules	161	TRUE	2.12720071794961e-9	90	27	8	0.2962962962962963	0.08888888888888889	GO:0032609	GO:BP	type II interferon production	16175	7657		0.2814070351758794	0.29	90	16085	8	19	82	16066	16175	0.15981887888411356
M1	string	0	network_modules	161	TRUE	2.259576231476519e-9	434	27	12	0.4444444444444444	0.027649769585253458	GO:0002521	GO:BP	leukocyte differentiation	16175	1043		0.2914572864321608	0.295	434	15741	12	15	422	15726	16175	0.10567681052999618
M1	string	0	network_modules	161	TRUE	2.3801465097921095e-9	149	27	9	0.3333333333333333	0.06040268456375839	GO:0097696	GO:BP	cell surface receptor signaling pathway via STAT	16175	18727		0.2964824120603015	0.3	149	16026	9	18	140	16008	16175	0.13872957444392944
M1	string	0	network_modules	161	TRUE	2.4553784441431106e-9	24	27	6	0.2222222222222222	0.25	GO:0002360	GO:BP	T cell lineage commitment	16175	892		0.3015075376884422	0.31	24	16151	6	21	18	16130	16175	0.23449817233414474
M1	string	0	network_modules	161	TRUE	2.4553784441431106e-9	24	27	6	0.2222222222222222	0.25	GO:0043369	GO:BP	CD4-positive or CD8-positive, alpha-beta T cell lineage commitment	16175	10646		0.3015075376884422	0.31	24	16151	6	21	18	16130	16175	0.23449817233414474
M1	string	0	network_modules	161	TRUE	2.6933763637397964e-9	324	27	11	0.4074074074074074	0.033950617283950615	GO:0007159	GO:BP	leukocyte cell-cell adhesion	16175	2723		0.31155778894472363	0.315	324	15851	11	16	313	15835	16175	0.11305746121641067
M1	string	0	network_modules	161	TRUE	3.213381002091008e-9	154	27	9	0.3333333333333333	0.05844155844155844	GO:0002819	GO:BP	regulation of adaptive immune response	16175	1329		0.3165829145728643	0.32	154	16021	9	18	145	16003	16175	0.13635001713894232
M1	string	0	network_modules	161	TRUE	3.5448889842541094e-9	53	27	7	0.25925925925925924	0.1320754716981132	GO:0046635	GO:BP	positive regulation of alpha-beta T cell activation	16175	12272		0.32160804020100503	0.325	53	16122	7	20	46	16102	16175	0.1831596689398548
M1	string	0	network_modules	161	TRUE	3.753200837965995e-9	756	27	14	0.5185185185185185	0.018518518518518517	GO:0050776	GO:BP	regulation of immune response	16175	13250		0.32663316582914576	0.33	756	15419	14	13	742	15406	16175	0.09139387075127836
M1	string	0	network_modules	161	TRUE	4.190638115204667e-9	26	27	6	0.2222222222222222	0.23076923076923078	GO:2000316	GO:BP	regulation of T-helper 17 type immune response	16175	25638		0.3316582914572864	0.335	26	16149	6	21	20	16128	16175	0.22518629746427682
M1	string	0	network_modules	161	TRUE	6.053856257076176e-9	57	27	7	0.25925925925925924	0.12280701754385964	GO:0002711	GO:BP	positive regulation of T cell mediated immunity	16175	1229		0.33668341708542715	0.34	57	16118	7	20	50	16098	16175	0.17646739759145427
M1	string	0	network_modules	161	TRUE	6.277244767619935e-9	11	27	5	0.18518518518518517	0.45454545454545453	GO:0070671	GO:BP	response to interleukin-12	16175	16252		0.3417085427135678	0.35	11	16164	5	22	6	16142	16175	0.28940395892662013
M1	string	0	network_modules	161	TRUE	6.277244767619935e-9	11	27	5	0.18518518518518517	0.45454545454545453	GO:0071349	GO:BP	cellular response to interleukin-12	16175	16601		0.3417085427135678	0.35	11	16164	5	22	6	16142	16175	0.28940395892662013
M1	string	0	network_modules	161	TRUE	7.46482493567326e-9	169	27	9	0.3333333333333333	0.05325443786982249	GO:0050670	GO:BP	regulation of lymphocyte proliferation	16175	13204		0.35175879396984927	0.355	169	16006	9	18	160	15988	16175	0.12984644424689523
M1	string	0	network_modules	161	TRUE	8.303218197614863e-9	171	27	9	0.3333333333333333	0.05263157894736842	GO:0032944	GO:BP	regulation of mononuclear cell proliferation	16175	7929		0.35678391959798994	0.36	171	16004	9	18	162	15986	16175	0.1290435048493319
M1	string	0	network_modules	161	TRUE	1.3327278634905121e-8	31	27	6	0.2222222222222222	0.1935483870967742	GO:0043368	GO:BP	positive T cell selection	16175	10645		0.36180904522613067	0.365	31	16144	6	21	25	16123	16175	0.20597100245779212
M1	string	0	network_modules	161	TRUE	1.744697543704665e-8	13	27	5	0.18518518518518517	0.38461538461538464	GO:0002827	GO:BP	positive regulation of T-helper 1 type immune response	16175	1337		0.36683417085427134	0.37	13	16162	5	22	8	16140	16175	0.26605097838535824
M1	string	0	network_modules	161	TRUE	1.7946079636397462e-8	386	27	11	0.4074074074074074	0.02849740932642487	GO:0022407	GO:BP	regulation of cell-cell adhesion	16175	6598		0.37185929648241206	0.375	386	15789	11	16	375	15773	16175	0.10275675299387388
M1	string	0	network_modules	161	TRUE	1.815418176470074e-8	276	27	10	0.37037037037037035	0.036231884057971016	GO:0002697	GO:BP	regulation of immune effector process	16175	1215		0.3768844221105528	0.38	276	15899	10	17	266	15882	16175	0.11155257473607172
M1	string	0	network_modules	161	TRUE	2.1486553719364054e-8	190	27	9	0.3333333333333333	0.04736842105263158	GO:0070663	GO:BP	regulation of leukocyte proliferation	16175	16244		0.38190954773869346	0.385	190	15985	9	18	181	15967	16175	0.12204834908578781
M1	string	0	network_modules	161	TRUE	2.679029757644078e-8	536	27	12	0.4444444444444444	0.022388059701492536	GO:0002252	GO:BP	immune effector process	16175	784		0.3869346733668342	0.39	536	15639	12	15	524	15624	16175	0.0939606250853149
M1	string	0	network_modules	161	TRUE	2.7144038917084723e-8	195	27	9	0.3333333333333333	0.046153846153846156	GO:0050870	GO:BP	positive regulation of T cell activation	16175	13318		0.39195979899497485	0.395	195	15980	9	18	186	15962	16175	0.12037649089228436
M1	string	0	network_modules	161	TRUE	3.770010316312792e-8	128	27	8	0.2962962962962963	0.0625	GO:0042129	GO:BP	regulation of T cell proliferation	16175	9983		0.3969849246231156	0.4	128	16047	8	19	120	16028	16175	0.13308659653695032
M1	string	0	network_modules	161	TRUE	3.791313069641586e-8	47	19	6	0.3157894736842105	0.1276595744680851	REAC:R-HSA-9020591	REAC	Interleukin-12 signaling	10916	1236		0.6666666666666666	0.7142857142857143	47	10869	6	13	41	10856	10916	0.19864547963840767
M1	string	0	network_modules	161	TRUE	4.179993126800234e-8	37	27	6	0.2222222222222222	0.16216216216216217	GO:0045058	GO:BP	T cell selection	16175	11256		0.4020100502512563	0.405	37	16138	6	21	31	16117	16175	0.18824997217173223
M1	string	0	network_modules	161	TRUE	4.845949811049984e-8	208	27	9	0.3333333333333333	0.04326923076923077	GO:0046651	GO:BP	lymphocyte proliferation	16175	12287		0.40703517587939697	0.41	208	15967	9	18	199	15949	16175	0.11630978374265193
M1	string	0	network_modules	161	TRUE	5.509740617746568e-8	211	27	9	0.3333333333333333	0.04265402843601896	GO:0032943	GO:BP	mononuclear cell proliferation	16175	7928		0.4120603015075377	0.415	211	15964	9	18	202	15946	16175	0.11542398771374952
M1	string	0	network_modules	161	TRUE	6.519187215553631e-8	215	27	9	0.3333333333333333	0.04186046511627907	GO:1903039	GO:BP	positive regulation of leukocyte cell-cell adhesion	16175	22719		0.41708542713567837	0.42	215	15960	9	18	206	15942	16175	0.11427126608983568
M1	string	0	network_modules	161	TRUE	7.094632719214741e-8	80	27	7	0.25925925925925924	0.0875	GO:0002709	GO:BP	regulation of T cell mediated immunity	16175	1227		0.4221105527638191	0.425	80	16095	7	20	73	16075	16175	0.1482332001358625
M1	string	0	network_modules	161	TRUE	7.337937907569359e-8	139	27	8	0.2962962962962963	0.05755395683453238	GO:0002822	GO:BP	regulation of adaptive immune response based on somatic recombination of immune receptors built from immunoglobulin superfamily domains	16175	1332		0.4271356783919598	0.43	139	16036	8	19	131	16017	16175	0.12745458032508789
M1	string	0	network_modules	161	TRUE	7.774485877715913e-8	140	27	8	0.2962962962962963	0.05714285714285714	GO:0042098	GO:BP	T cell proliferation	16175	9965		0.4321608040201005	0.435	140	16035	8	19	132	16016	16175	0.12697523832548518
M1	string	0	network_modules	161	TRUE	1.1922148984607475e-7	86	27	7	0.25925925925925924	0.08139534883720931	GO:0045582	GO:BP	positive regulation of T cell differentiation	16175	11433		0.4371859296482412	0.44	86	16089	7	20	79	16069	16175	0.14278687549902355
M1	string	0	network_modules	161	TRUE	1.4394438245664244e-7	6	27	4	0.14814814814814814	0.6666666666666666	GO:2000330	GO:BP	positive regulation of T-helper 17 cell lineage commitment	16175	25649		0.44221105527638194	0.445	6	16169	4	23	2	16146	16175	0.3138029663033647
M1	string	0	network_modules	161	TRUE	1.4991960004521752e-7	236	27	9	0.3333333333333333	0.038135593220338986	GO:0070661	GO:BP	leukocyte proliferation	16175	16242		0.4472361809045226	0.45	236	15939	9	18	227	15921	16175	0.10869781288761066
M1	string	0	network_modules	161	TRUE	1.5238505514110985e-7	89	27	7	0.25925925925925924	0.07865168539325842	GO:0002824	GO:BP	positive regulation of adaptive immune response based on somatic recombination of immune receptors built from immunoglobulin superfamily domains	16175	1334		0.45226130653266333	0.455	89	16086	7	20	82	16066	16175	0.14027029024786433
M1	string	0	network_modules	161	TRUE	1.7861803906580663e-7	91	27	7	0.25925925925925924	0.07692307692307693	GO:0031341	GO:BP	regulation of cell killing	16175	7132		0.457286432160804	0.46	91	16084	7	20	84	16064	16175	0.13866132103814027
M1	string	0	network_modules	161	TRUE	1.9311784255502912e-7	92	27	7	0.25925925925925924	0.07608695652173914	GO:0002708	GO:BP	positive regulation of lymphocyte mediated immunity	16175	1226		0.4623115577889447	0.465	92	16083	7	20	85	16063	16175	0.13787633920629772
M1	string	0	network_modules	161	TRUE	2.0201193695033124e-7	638	27	12	0.4444444444444444	0.018808777429467086	GO:0030097	GO:BP	hemopoiesis	16175	6675		0.46733668341708545	0.47	638	15537	12	15	626	15522	16175	0.08508026282073908
M1	string	0	network_modules	161	TRUE	2.4169334820385686e-7	249	27	9	0.3333333333333333	0.03614457831325301	GO:0051251	GO:BP	positive regulation of lymphocyte activation	16175	13598		0.4723618090452261	0.475	249	15926	9	18	240	15908	16175	0.10559852644091994
M1	string	0	network_modules	161	TRUE	2.616075120522181e-7	96	27	7	0.25925925925925924	0.07291666666666667	GO:0002821	GO:BP	positive regulation of adaptive immune response	16175	1331		0.47738693467336685	0.48	96	16079	7	20	89	16059	16175	0.13485849310445158
M1	string	0	network_modules	161	TRUE	3.02984414211105e-7	98	27	7	0.25925925925925924	0.07142857142857142	GO:0002456	GO:BP	T cell mediated immunity	16175	979		0.4824120603015075	0.485	98	16077	7	20	91	16057	16175	0.13341844111913106
M1	string	0	network_modules	161	TRUE	3.201440549181162e-7	257	27	9	0.3333333333333333	0.03501945525291829	GO:0022409	GO:BP	positive regulation of cell-cell adhesion	16175	6600		0.48743718592964824	0.49	257	15918	9	18	248	15900	16175	0.10380635819408204
M1	string	0	network_modules	161	TRUE	3.2568346821557197e-7	99	27	7	0.25925925925925924	0.0707070707070707	GO:0045621	GO:BP	positive regulation of lymphocyte differentiation	16175	11472		0.49246231155778897	0.495	99	16076	7	20	92	16056	16175	0.1327146161555527
M1	string	0	network_modules	161	TRUE	4.5565503355851465e-7	54	27	6	0.2222222222222222	0.1111111111111111	GO:0042531	GO:BP	positive regulation of tyrosine phosphorylation of STAT protein	16175	10227		0.49748743718592964	0.5	54	16121	6	21	48	16100	16175	0.15516273522046828
M1	string	0	network_modules	161	TRUE	4.6222185461934834e-7	104	27	7	0.25925925925925924	0.0673076923076923	GO:0050671	GO:BP	positive regulation of lymphocyte proliferation	16175	13205		0.5025125628140703	0.505	104	16071	7	20	97	16051	16175	0.12934706262344256
M1	string	0	network_modules	161	TRUE	4.9469970514384355e-07	105	27	7	0.25925925925925924	0.06666666666666667	GO:0032946	GO:BP	positive regulation of mononuclear cell proliferation	16175	7931		0.507537688442211	0.51	105	16070	7	20	98	16050	16175	0.12870217697367772
M1	string	0	network_modules	161	TRUE	5.835521832634561e-7	275	27	9	0.3333333333333333	0.03272727272727273	GO:0002696	GO:BP	positive regulation of leukocyte activation	16175	1214		0.5125628140703518	0.515	275	15900	9	18	266	15882	16175	0.10005636652191502
M1	string	0	network_modules	161	TRUE	6.702126402954201e-7	8	27	4	0.14814814814814814	0.5	GO:0010455	GO:BP	positive regulation of cell fate commitment	16175	4151		0.5175879396984925	0.52	8	16167	4	23	4	16144	16175	0.2715507484927268
M1	string	0	network_modules	161	TRUE	6.878912177309665e-7	110	27	7	0.25925925925925924	0.06363636363636363	GO:0002705	GO:BP	positive regulation of leukocyte mediated immunity	16175	1223		0.5226130653266332	0.525	110	16065	7	20	103	16045	16175	0.12560887722469305
M1	string	0	network_modules	161	TRUE	9.333713642348414e-7	290	27	9	0.3333333333333333	0.03103448275862069	GO:0050867	GO:BP	positive regulation of cell activation	16175	13315		0.5276381909547738	0.53	290	15885	9	18	281	15867	16175	0.09719456544729184
M1	string	0	network_modules	161	TRUE	9.740286550112312e-7	192	27	8	0.2962962962962963	0.041666666666666664	GO:0002699	GO:BP	positive regulation of immune effector process	16175	1217		0.5326633165829145	0.535	192	15983	8	19	184	15964	16175	0.10738819023453366
M1	string	0	network_modules	161	TRUE	1.0243111652134996e-6	12	19	4	0.21052631578947367	0.3333333333333333	REAC:R-HSA-8984722	REAC	Interleukin-35 Signalling	10916	1248		0.8333333333333334	0.8571428571428571	12	10904	4	15	8	10889	10916	0.26389794242083753
M1	string	0	network_modules	161	TRUE	1.0771520954498838e-6	27	27	5	0.18518518518518517	0.18518518518518517	GO:0043372	GO:BP	positive regulation of CD4-positive, alpha-beta T cell differentiation	16175	10649		0.5376884422110553	0.54	27	16148	5	22	22	16126	16175	0.18382278736502172
M1	string	0	network_modules	161	TRUE	1.1753595597769344e-6	571	27	11	0.4074074074074074	0.01926444833625219	GO:0060284	GO:BP	regulation of cell development	16175	14500		0.542713567839196	0.545	571	15604	11	16	560	15588	16175	0.08245129250919592
M1	string	0	network_modules	161	TRUE	1.1867510054717618e-6	63	27	6	0.2222222222222222	0.09523809523809523	GO:0031343	GO:BP	positive regulation of cell killing	16175	7134		0.5477386934673367	0.555	63	16112	6	21	57	16091	16175	0.14332761983592937
M1	string	0	network_modules	161	TRUE	1.1867510054717618e-6	63	27	6	0.2222222222222222	0.09523809523809523	GO:0042509	GO:BP	regulation of tyrosine phosphorylation of STAT protein	16175	10226		0.5477386934673367	0.555	63	16112	6	21	57	16091	16175	0.14332761983592937
M1	string	0	network_modules	161	TRUE	1.1991361096035007e-6	119	27	7	0.25925925925925924	0.058823529411764705	GO:0070665	GO:BP	positive regulation of leukocyte proliferation	16175	16246		0.5577889447236181	0.56	119	16056	7	20	112	16036	16175	0.12053318906507904
M1	string	0	network_modules	161	TRUE	1.205010060652219e-6	9	27	4	0.14814814814814814	0.4444444444444444	GO:0043382	GO:BP	positive regulation of memory T cell differentiation	16175	10659		0.5628140703517588	0.575	9	16166	4	23	5	16143	16175	0.25592121801151496
M1	string	0	network_modules	161	TRUE	1.205010060652219e-6	9	27	4	0.14814814814814814	0.4444444444444444	GO:0051135	GO:BP	positive regulation of NK T cell activation	16175	13519		0.5628140703517588	0.575	9	16166	4	23	5	16143	16175	0.25592121801151496
M1	string	0	network_modules	161	TRUE	1.205010060652219e-6	9	27	4	0.14814814814814814	0.4444444444444444	GO:2000321	GO:BP	positive regulation of T-helper 17 cell differentiation	16175	25643		0.5628140703517588	0.575	9	16166	4	23	5	16143	16175	0.25592121801151496
M1	string	0	network_modules	161	TRUE	1.4394737029897218e-6	65	27	6	0.2222222222222222	0.09230769230769231	GO:0007260	GO:BP	tyrosine phosphorylation of STAT protein	16175	2790		0.5778894472361809	0.58	65	16110	6	21	59	16089	16175	0.14103419156200636
M1	string	0	network_modules	161	TRUE	1.5809137435972973e-6	29	27	5	0.18518518518518517	0.1724137931034483	GO:0010453	GO:BP	regulation of cell fate commitment	16175	4149		0.5829145728643216	0.585	29	16146	5	22	24	16124	16175	0.1772623135461679
M1	string	0	network_modules	161	TRUE	2.006064875401066e-6	10	27	4	0.14814814814814814	0.4	GO:0090715	GO:BP	immunological memory formation process	16175	18426		0.5879396984924623	0.6	10	16165	4	23	6	16142	16175	0.24269399150603854
M1	string	0	network_modules	161	TRUE	2.006064875401066e-6	10	27	4	0.14814814814814814	0.4	GO:0043380	GO:BP	regulation of memory T cell differentiation	16175	10657		0.5879396984924623	0.6	10	16165	4	23	6	16142	16175	0.24269399150603854
M1	string	0	network_modules	161	TRUE	2.006064875401066e-6	10	27	4	0.14814814814814814	0.4	GO:0043379	GO:BP	memory T cell differentiation	16175	10656		0.5879396984924623	0.6	10	16165	4	23	6	16142	16175	0.24269399150603854
M1	string	0	network_modules	161	TRUE	2.256794005976895e-6	31	27	5	0.18518518518518517	0.16129032258064516	GO:0002230	GO:BP	positive regulation of defense response to virus by host	16175	763		0.6030150753768844	0.605	31	16144	5	22	26	16122	16175	0.17134386304051183
M1	string	0	network_modules	161	TRUE	2.8948229298431593e-6	622	27	11	0.4074074074074074	0.017684887459807074	GO:0030155	GO:BP	regulation of cell adhesion	16175	6688		0.6080402010050251	0.61	622	15553	11	16	611	15537	16175	0.0784576998248449
M1	string	0	network_modules	161	TRUE	3.0669063010601725e-6	136	27	7	0.25925925925925924	0.051470588235294115	GO:0002706	GO:BP	regulation of lymphocyte mediated immunity	16175	1224		0.6130653266331658	0.615	136	16039	7	20	129	16019	16175	0.11233754391013405
M1	string	0	network_modules	161	TRUE	3.1451991896465596e-6	33	27	5	0.18518518518518517	0.15151515151515152	GO:2000516	GO:BP	positive regulation of CD4-positive, alpha-beta T cell activation	16175	25819		0.6180904522613065	0.62	33	16142	5	22	28	16120	16175	0.16596871271493147
M1	string	0	network_modules	161	TRUE	3.148800664334475e-6	11	27	4	0.14814814814814814	0.36363636363636365	GO:0051133	GO:BP	regulation of NK T cell activation	16175	13517		0.6231155778894473	0.625	11	16164	4	23	7	16141	16175	0.23130982609088233
M1	string	0	network_modules	161	TRUE	3.573621003710757e-6	139	27	7	0.25925925925925924	0.050359712230215826	GO:1902107	GO:BP	positive regulation of leukocyte differentiation	16175	22021		0.628140703517588	0.635	139	16036	7	20	132	16016	16175	0.111046883867884
M1	string	0	network_modules	161	TRUE	3.573621003710757e-6	139	27	7	0.25925925925925924	0.050359712230215826	GO:1903708	GO:BP	positive regulation of hemopoiesis	16175	23222		0.628140703517588	0.635	139	16036	7	20	132	16016	16175	0.111046883867884
M1	string	0	network_modules	161	TRUE	3.6832917105377877e-6	34	27	5	0.18518518518518517	0.14705882352941177	GO:0001916	GO:BP	positive regulation of T cell mediated cytotoxicity	16175	533		0.6381909547738693	0.64	34	16141	5	22	29	16119	16175	0.16345964870227397
M1	string	0	network_modules	161	TRUE	3.7966959569387456e-6	228	27	8	0.2962962962962963	0.03508771929824561	GO:0051607	GO:BP	defense response to virus	16175	13823		0.6432160804020101	0.645	228	15947	8	19	220	15928	16175	0.09788533066511487
M1	string	0	network_modules	161	TRUE	4.076930475863111e-6	77	27	6	0.2222222222222222	0.07792207792207792	GO:0042102	GO:BP	positive regulation of T cell proliferation	16175	9967		0.6482412060301508	0.65	77	16098	6	21	71	16077	16175	0.1291868873452868
M1	string	0	network_modules	161	TRUE	4.292298698341759e-6	35	27	5	0.18518518518518517	0.14285714285714285	GO:0032620	GO:BP	interleukin-17 production	16175	7667		0.6532663316582915	0.66	35	16140	5	22	30	16118	16175	0.16105817481231416
M1	string	0	network_modules	161	TRUE	4.292298698341759e-6	35	27	5	0.18518518518518517	0.14285714285714285	GO:0032660	GO:BP	regulation of interleukin-17 production	16175	7706		0.6532663316582915	0.66	35	16140	5	22	30	16118	16175	0.16105817481231416
M1	string	0	network_modules	161	TRUE	4.717826602073541e-6	12	27	4	0.14814814814814814	0.3333333333333333	GO:0051132	GO:BP	NK T cell activation	16175	13516		0.6633165829145728	0.665	12	16163	4	23	8	16140	16175	0.22137630094004898
M1	string	0	network_modules	161	TRUE	4.899553061673878e-6	654	27	11	0.4074074074074074	0.016819571865443424	GO:0031347	GO:BP	regulation of defense response	16175	7138		0.6683417085427136	0.67	654	15521	11	16	643	15505	16175	0.07618230899660182
M1	string	0	network_modules	161	TRUE	5.7503796976806236e-6	37	27	5	0.18518518518518517	0.13513513513513514	GO:0046638	GO:BP	positive regulation of alpha-beta T cell differentiation	16175	12275		0.6733668341708543	0.675	37	16138	5	22	32	16116	16175	0.15654865412321875
M1	string	0	network_modules	161	TRUE	6.806884213911963e-6	13	27	4	0.14814814814814814	0.3076923076923077	GO:0090713	GO:BP	immunological memory process	16175	18424		0.678391959798995	0.68	13	16162	4	23	9	16139	16175	0.21260884218517978
M1	string	0	network_modules	161	TRUE	8.499256247469432e-6	373	27	9	0.3333333333333333	0.024128686327077747	GO:0045785	GO:BP	positive regulation of cell adhesion	16175	11617		0.6834170854271356	0.685	373	15802	9	18	364	15784	16175	0.08452796595802259
M1	string	0	network_modules	161	TRUE	8.650969686351786e-6	40	27	5	0.18518518518518517	0.125	GO:0050691	GO:BP	regulation of defense response to virus by host	16175	13221		0.6884422110552764	0.69	40	16135	5	22	35	16113	16175	0.1504249743405702
M1	string	0	network_modules	161	TRUE	1.1158546964395035e-5	42	27	5	0.18518518518518517	0.11904761904761904	GO:0001914	GO:BP	regulation of T cell mediated cytotoxicity	16175	531		0.6934673366834171	0.695	42	16133	5	22	37	16111	16175	0.14670949194142402
M1	string	0	network_modules	161	TRUE	1.2965404124992802e-5	15	27	4	0.14814814814814814	0.26666666666666666	GO:0032816	GO:BP	positive regulation of natural killer cell activation	16175	7840		0.6984924623115578	0.7	15	16160	4	23	11	16137	16175	0.1977742018216588
M1	string	0	network_modules	161	TRUE	1.340030628178188e-5	168	27	7	0.25925925925925924	0.041666666666666664	GO:0001906	GO:BP	cell killing	16175	524		0.7035175879396985	0.705	168	16007	7	20	161	15987	16175	0.10037711916829181
M1	string	0	network_modules	161	TRUE	1.5971802144867426e-5	45	27	5	0.18518518518518517	0.1111111111111111	GO:0032653	GO:BP	regulation of interleukin-10 production	16175	7700		0.7085427135678392	0.72	45	16130	5	22	40	16108	16175	0.141604028580816
M1	string	0	network_modules	161	TRUE	1.5971802144867426e-5	45	27	5	0.18518518518518517	0.1111111111111111	GO:0001913	GO:BP	T cell mediated cytotoxicity	16175	530		0.7085427135678392	0.72	45	16130	5	22	40	16108	16175	0.141604028580816
M1	string	0	network_modules	161	TRUE	1.5971802144867426e-5	45	27	5	0.18518518518518517	0.1111111111111111	GO:0032613	GO:BP	interleukin-10 production	16175	7661		0.7085427135678392	0.72	45	16130	5	22	40	16108	16175	0.141604028580816
M1	string	0	network_modules	161	TRUE	1.7267534579890326e-5	16	27	4	0.14814814814814814	0.25	GO:2000318	GO:BP	positive regulation of T-helper 17 type immune response	16175	25640		0.7236180904522613	0.725	16	16159	4	23	12	16136	16175	0.1914195543332221
M1	string	0	network_modules	161	TRUE	1.7788177476636997e-5	175	27	7	0.25925925925925924	0.04	GO:0045165	GO:BP	cell fate commitment	16175	11307		0.7286432160804021	0.73	175	16000	7	20	168	15980	16175	0.09819954376612548
M1	string	0	network_modules	161	TRUE	1.904870160917249e-5	745	27	11	0.4074074074074074	0.01476510067114094	GO:0098609	GO:BP	cell-cell adhesion	16175	18805		0.7336683417085427	0.735	745	15430	11	16	734	15414	16175	0.07049075594456312
M1	string	0	network_modules	161	TRUE	1.9245763555919917e-5	177	27	7	0.25925925925925924	0.03954802259887006	GO:0002703	GO:BP	regulation of leukocyte mediated immunity	16175	1221		0.7386934673366834	0.74	177	15998	7	20	170	15978	16175	0.09760067156855044
M1	string	0	network_modules	161	TRUE	2.4815342702639913e-5	49	27	5	0.18518518518518517	0.10204081632653061	GO:0045670	GO:BP	regulation of osteoclast differentiation	16175	11521		0.7437185929648241	0.745	49	16126	5	22	44	16104	16175	0.13553407072612547
M1	string	0	network_modules	161	TRUE	2.8966194775706126e-5	18	27	4	0.14814814814814814	0.2222222222222222	GO:0045624	GO:BP	positive regulation of T-helper cell differentiation	16175	11475		0.7487437185929648	0.75	18	16157	4	23	14	16134	16175	0.18033160839357362
M1	string	0	network_modules	161	TRUE	4.0922506061505464e-5	54	27	5	0.18518518518518517	0.09259259259259259	GO:0050688	GO:BP	regulation of defense response to virus	16175	13219		0.7537688442211056	0.755	54	16121	5	22	49	16099	16175	0.12890784734082275
M1	string	0	network_modules	161	TRUE	4.409036502082307e-5	451	27	9	0.3333333333333333	0.019955654101995565	GO:0002831	GO:BP	regulation of response to biotic stimulus	16175	1341		0.7587939698492462	0.76	451	15724	9	18	442	15706	16175	0.07586444367198246
M1	string	0	network_modules	161	TRUE	4.575882539086218e-5	20	27	4	0.14814814814814814	0.2	GO:0045672	GO:BP	positive regulation of osteoclast differentiation	16175	11523		0.7638190954773869	0.77	20	16155	4	23	16	16132	16175	0.17094429985999895
M1	string	0	network_modules	161	TRUE	4.575882539086218e-5	20	27	4	0.14814814814814814	0.2	GO:0042104	GO:BP	positive regulation of activated T cell proliferation	16175	9969		0.7638190954773869	0.77	20	16155	4	23	16	16132	16175	0.17094429985999895
M1	string	0	network_modules	161	TRUE	4.929663927327982e-5	34	19	4	0.21052631578947367	0.11764705882352941	KEGG:05330	KEGG	Allograft rejection	8484	486		0.5	0.5454545454545454	34	8450	4	15	30	8435	8484	0.1548658642321423
M1	string	0	network_modules	161	TRUE	5.174688546811898e-5	627	27	10	0.37037037037037035	0.01594896331738437	GO:0050778	GO:BP	positive regulation of immune response	16175	13252		0.7738693467336684	0.775	627	15548	10	17	617	15531	16175	0.07024562050703081
M1	string	0	network_modules	161	TRUE	5.3996391586593286e-5	57	27	5	0.18518518518518517	0.08771929824561403	GO:0001912	GO:BP	positive regulation of leukocyte mediated cytotoxicity	16175	529		0.7788944723618091	0.78	57	16118	5	22	52	16096	16175	0.1253533787163621
M1	string	0	network_modules	161	TRUE	1.0117403483115526e-4	131	27	6	0.2222222222222222	0.04580152671755725	GO:0050731	GO:BP	positive regulation of peptidyl-tyrosine phosphorylation	16175	13230		0.7839195979899497	0.785	131	16044	6	21	125	16023	16175	0.09768744771878148
M1	string	0	network_modules	161	TRUE	1.1007440011432598e-4	228	27	7	0.25925925925925924	0.03070175438596491	GO:0001818	GO:BP	negative regulation of cytokine production	16175	475		0.7889447236180904	0.79	228	15947	7	20	221	15927	16175	0.08503849655141982
M1	string	0	network_modules	161	TRUE	1.18795296253026e-4	25	27	4	0.14814814814814814	0.16	GO:0032814	GO:BP	regulation of natural killer cell activation	16175	7838		0.7939698492462312	0.795	25	16150	4	23	21	16127	16175	0.1525991333033486
M1	string	0	network_modules	161	TRUE	1.573667210583068e-4	104	19	5	0.2631578947368421	0.04807692307692308	KEGG:04625	KEGG	C-type lectin receptor signaling pathway	8484	330		0.6	0.6363636363636364	104	8380	5	14	99	8366	8484	0.10802521542365263
M1	string	0	network_modules	161	TRUE	2.0376393371154076e-4	74	27	5	0.18518518518518517	0.06756756756756757	GO:0030316	GO:BP	osteoclast differentiation	16175	6767		0.7989949748743719	0.8	74	16101	5	22	69	16079	16175	0.10943767225715023
M1	string	0	network_modules	161	TRUE	2.2203052848341457e-4	29	27	4	0.14814814814814814	0.13793103448275862	GO:0046640	GO:BP	regulation of alpha-beta T cell proliferation	16175	12277		0.8040201005025126	0.805	29	16146	4	23	25	16123	16175	0.1414632584394248
M1	string	0	network_modules	161	TRUE	2.5589754139873557e-4	30	27	4	0.14814814814814814	0.13333333333333333	GO:0046633	GO:BP	alpha-beta T cell proliferation	16175	12270		0.8090452261306532	0.81	30	16145	4	23	26	16122	16175	0.13903110793187473
M1	string	0	network_modules	161	TRUE	2.658289283291275e-4	78	27	5	0.18518518518518517	0.0641025641025641	GO:0001910	GO:BP	regulation of leukocyte mediated cytotoxicity	16175	527		0.8140703517587939	0.815	78	16097	5	22	73	16075	16175	0.10646192292229702
M1	string	0	network_modules	161	TRUE	2.9347394841988575e-4	31	27	4	0.14814814814814814	0.12903225806451613	GO:0032733	GO:BP	positive regulation of interleukin-10 production	16175	7778		0.8190954773869347	0.82	31	16144	4	23	27	16121	16175	0.13671672362323156
M1	string	0	network_modules	161	TRUE	3.3974774108426595e-4	269	27	7	0.25925925925925924	0.026022304832713755	GO:0002449	GO:BP	lymphocyte mediated immunity	16175	972		0.8241206030150754	0.825	269	15906	7	20	262	15886	16175	0.07758044481996311
M1	string	0	network_modules	161	TRUE	3.609231249281484e-4	8	27	3	0.1111111111111111	0.375	GO:0032819	GO:BP	positive regulation of natural killer cell proliferation	16175	7843		0.8291457286432161	0.83	8	16167	3	24	5	16143	16175	0.20343566014724798
M1	string	0	network_modules	161	TRUE	3.8079256754729597e-4	33	27	4	0.14814814814814814	0.12121212121212122	GO:0046006	GO:BP	regulation of activated T cell proliferation	16175	11797		0.8341708542713567	0.835	33	16142	4	23	29	16119	16175	0.13240520091052038
M1	string	0	network_modules	161	TRUE	3.984175565570283e-4	165	27	6	0.2222222222222222	0.03636363636363636	GO:0002573	GO:BP	myeloid leukocyte differentiation	16175	1094		0.8391959798994975	0.84	165	16010	6	21	159	15989	16175	0.08627970380325602
M1	string	0	network_modules	161	TRUE	4.3107380432553236e-4	34	27	4	0.14814814814814814	0.11764705882352941	GO:0050798	GO:BP	activated T cell proliferation	16175	13265		0.8442211055276382	0.85	34	16141	4	23	30	16118	16175	0.13039237732191603
M1	string	0	network_modules	161	TRUE	4.3107380432553236e-4	34	27	4	0.14814814814814814	0.11764705882352941	GO:0032735	GO:BP	positive regulation of interleukin-12 production	16175	7780		0.8442211055276382	0.85	34	16141	4	23	30	16118	16175	0.13039237732191603
M1	string	0	network_modules	161	TRUE	4.791250549794294e-4	283	27	7	0.25925925925925924	0.024734982332155476	GO:0010720	GO:BP	positive regulation of cell development	16175	4346		0.8542713567839196	0.855	283	15892	7	20	276	15872	16175	0.0754005237538936
M1	string	0	network_modules	161	TRUE	5.161687151373765e-4	89	27	5	0.18518518518518517	0.056179775280898875	GO:0002761	GO:BP	regulation of myeloid leukocyte differentiation	16175	1272		0.8592964824120602	0.86	89	16086	5	22	84	16064	16175	0.09932405313322634
M1	string	0	network_modules	161	TRUE	5.637772722924664e-4	175	27	6	0.2222222222222222	0.03428571428571429	GO:0050730	GO:BP	regulation of peptidyl-tyrosine phosphorylation	16175	13229		0.864321608040201	0.865	175	16000	6	21	169	15979	16175	0.083560118693157
M1	string	0	network_modules	161	TRUE	7.716862327132514e-4	10	27	3	0.1111111111111111	0.3	GO:0032817	GO:BP	regulation of natural killer cell proliferation	16175	7841		0.8693467336683417	0.87	10	16165	3	24	7	16141	16175	0.1817662356064549
M1	string	0	network_modules	161	TRUE	0.0010361842585209233	72	19	4	0.21052631578947367	0.05555555555555555	KEGG:05140	KEGG	Leishmaniasis	8484	433		0.7	0.7272727272727273	72	8412	4	15	68	8397	8484	0.10434819171944792
M1	string	0	network_modules	161	TRUE	0.0010598877697315923	11	27	3	0.1111111111111111	0.2727272727272727	GO:0032736	GO:BP	positive regulation of interleukin-13 production	16175	7781		0.8743718592964824	0.88	11	16164	3	24	8	16140	16175	0.17321569325514452
M1	string	0	network_modules	161	TRUE	0.0010598877697315923	11	27	3	0.1111111111111111	0.2727272727272727	GO:0032700	GO:BP	negative regulation of interleukin-17 production	16175	7745		0.8743718592964824	0.88	11	16164	3	24	8	16140	16175	0.17321569325514452
M1	string	0	network_modules	161	TRUE	0.0012361104837578013	106	27	5	0.18518518518518517	0.04716981132075472	GO:0001909	GO:BP	leukocyte mediated cytotoxicity	16175	526		0.8844221105527639	0.885	106	16069	5	22	101	16047	16175	0.09052705007191572
M1	string	0	network_modules	161	TRUE	0.0012848780166313494	76	19	4	0.21052631578947367	0.05263157894736842	KEGG:05133	KEGG	Pertussis	8484	430		0.8	0.8181818181818182	76	8408	4	15	72	8393	8484	0.10135216151111155
M1	string	0	network_modules	161	TRUE	0.0013676989151832945	45	27	4	0.14814814814814814	0.08888888888888889	GO:0002763	GO:BP	positive regulation of myeloid leukocyte differentiation	16175	1274		0.8894472361809045	0.89	45	16130	4	23	41	16107	16175	0.11285126480608967
M1	string	0	network_modules	161	TRUE	0.0014116110841080967	12	27	3	0.1111111111111111	0.25	GO:0001787	GO:BP	natural killer cell proliferation	16175	449		0.8944723618090452	0.9	12	16163	3	24	9	16139	16175	0.16575368276393845
M1	string	0	network_modules	161	TRUE	0.0014116110841080967	12	27	3	0.1111111111111111	0.25	GO:0034393	GO:BP	positive regulation of smooth muscle cell apoptotic process	16175	8614		0.8944723618090452	0.9	12	16163	3	24	9	16139	16175	0.16575368276393845
M1	string	0	network_modules	161	TRUE	0.0014618531525402286	334	27	7	0.25925925925925924	0.020958083832335328	GO:0002443	GO:BP	leukocyte mediated immunity	16175	966		0.9045226130653267	0.905	334	15841	7	20	327	15821	16175	0.06861058311927207
M1	string	0	network_modules	161	TRUE	0.0015512598306263402	686	27	9	0.3333333333333333	0.013119533527696793	GO:0008284	GO:BP	positive regulation of cell population proliferation	16175	3151		0.9095477386934674	0.91	686	15489	9	18	677	15471	16175	0.05902961136691785
M1	string	0	network_modules	161	TRUE	0.0018335985758691034	214	27	6	0.2222222222222222	0.028037383177570093	GO:0018108	GO:BP	peptidyl-tyrosine phosphorylation	16175	5327		0.914572864321608	0.915	214	15961	6	21	208	15940	16175	0.07479272889112247
M1	string	0	network_modules	161	TRUE	0.0018841247042432113	215	27	6	0.2222222222222222	0.027906976744186046	GO:0018212	GO:BP	peptidyl-tyrosine modification	16175	5371		0.9195979899497487	0.92	215	15960	6	21	209	15939	16175	0.07459885293243941
M1	string	0	network_modules	161	TRUE	0.0021020360648803292	50	27	4	0.14814814814814814	0.08	GO:0032615	GO:BP	interleukin-12 production	16175	7663		0.9246231155778895	0.93	50	16125	4	23	46	16102	16175	0.10684901008545478
M1	string	0	network_modules	161	TRUE	0.0021020360648803292	50	27	4	0.14814814814814814	0.08	GO:0032655	GO:BP	regulation of interleukin-12 production	16175	7702		0.9246231155778895	0.93	50	16125	4	23	46	16102	16175	0.10684901008545478
M1	string	0	network_modules	161	TRUE	0.0023303796758297516	14	27	3	0.1111111111111111	0.21428571428571427	GO:0032725	GO:BP	positive regulation of granulocyte macrophage colony-stimulating factor production	16175	7770		0.9346733668341709	0.94	14	16161	3	24	11	16137	16175	0.15329565532848902
M1	string	0	network_modules	161	TRUE	0.0023303796758297516	14	27	3	0.1111111111111111	0.21428571428571427	GO:0045063	GO:BP	T-helper 1 cell differentiation	16175	11261		0.9346733668341709	0.94	14	16161	3	24	11	16137	16175	0.15329565532848902
M1	string	0	network_modules	161	TRUE	0.0023472919737963773	721	27	9	0.3333333333333333	0.012482662968099861	GO:0045087	GO:BP	innate immune response	16175	11270		0.9447236180904522	0.945	721	15454	9	18	712	15436	16175	0.05721544753680726
M1	string	0	network_modules	161	TRUE	0.002474147253048524	76	19	4	0.21052631578947367	0.05263157894736842	REAC:R-HSA-909733	REAC	Interferon alpha/beta signaling	10916	1228		1	1	76	10840	4	15	72	10825	10916	0.10222721180717641
M1	string	0	network_modules	161	TRUE	0.002909733243755928	15	27	3	0.1111111111111111	0.2	GO:0032693	GO:BP	negative regulation of interleukin-10 production	16175	7739		0.949748743718593	0.955	15	16160	3	24	12	16136	16175	0.14801920198550775
M1	string	0	network_modules	161	TRUE	0.002909733243755928	15	27	3	0.1111111111111111	0.2	GO:0010661	GO:BP	positive regulation of muscle cell apoptotic process	16175	4306		0.949748743718593	0.955	15	16160	3	24	12	16136	16175	0.14801920198550775
M1	string	0	network_modules	161	TRUE	0.0035772253304888753	16	27	3	0.1111111111111111	0.1875	GO:0032604	GO:BP	granulocyte macrophage colony-stimulating factor production	16175	7652		0.9597989949748744	0.975	16	16159	3	24	13	16135	16175	0.14324299225971948
M1	string	0	network_modules	161	TRUE	0.0035772253304888753	16	27	3	0.1111111111111111	0.1875	GO:0032656	GO:BP	regulation of interleukin-13 production	16175	7703		0.9597989949748744	0.975	16	16159	3	24	13	16135	16175	0.14324299225971948
M1	string	0	network_modules	161	TRUE	0.0035772253304888753	16	27	3	0.1111111111111111	0.1875	GO:0032645	GO:BP	regulation of granulocyte macrophage colony-stimulating factor production	16175	7692		0.9597989949748744	0.975	16	16159	3	24	13	16135	16175	0.14324299225971948
M1	string	0	network_modules	161	TRUE	0.0035772253304888753	16	27	3	0.1111111111111111	0.1875	GO:0032616	GO:BP	interleukin-13 production	16175	7664		0.9597989949748744	0.975	16	16159	3	24	13	16135	16175	0.14324299225971948
M1	string	0	network_modules	161	TRUE	0.004006059275109083	36	19	3	0.15789473684210525	0.08333333333333333	KEGG:05143	KEGG	African trypanosomiasis	8484	435		0.9	0.9090909090909091	36	8448	3	16	33	8432	8484	0.1119882490174578
M1	string	0	network_modules	161	TRUE	0.004338940416778568	17	27	3	0.1111111111111111	0.17647058823529413	GO:0071353	GO:BP	cellular response to interleukin-4	16175	16605		0.9798994974874372	0.98	17	16158	3	24	14	16134	16175	0.13889239510379298
M1	string	0	network_modules	161	TRUE	0.005200935261179129	18	27	3	0.1111111111111111	0.16666666666666666	GO:0070670	GO:BP	response to interleukin-4	16175	16251		0.9849246231155779	0.99	18	16157	3	24	15	16133	16175	0.13490749891953285
M1	string	0	network_modules	161	TRUE	0.005200935261179129	18	27	3	0.1111111111111111	0.16666666666666666	GO:0046641	GO:BP	positive regulation of alpha-beta T cell proliferation	16175	12278		0.9849246231155779	0.99	18	16157	3	24	15	16133	16175	0.13490749891953285
M1	string	0	network_modules	161	TRUE	0.0052618759277906135	795	27	9	0.3333333333333333	0.011320754716981131	GO:0051241	GO:BP	negative regulation of multicellular organismal process	16175	13591		0.9949748743718593	0.995	795	15380	9	18	786	15362	16175	0.05375313410618446
M1	string	0	network_modules	161	TRUE	0.005512092242167408	40	19	3	0.15789473684210525	0.075	KEGG:04940	KEGG	Type I diabetes mellitus	8484	394		1	1	40	8444	3	16	37	8428	8484	0.10594046592213915
M1	string	0	network_modules	161	TRUE	0.009701188872905664	161	27	5	0.18518518518518517	0.031055900621118012	GO:0045637	GO:BP	regulation of myeloid cell differentiation	16175	11488		1	1	161	16014	5	22	156	15992	16175	0.072179897496567
M1	string	0	network_modules	162	TRUE	4.370248231574883e-10	74	22	8	0.36363636363636365	0.10810810810810811	KEGG:01230	KEGG	Biosynthesis of amino acids	8484	188		0	0.25	74	8410	8	14	66	8396	8484	0.19461882214248621
M1	string	0	network_modules	162	TRUE	1.7024853840234126e-9	48	27	7	0.25925925925925924	0.14583333333333334	GO:0097237	GO:BP	cellular response to toxic substance	16175	18553		0	0.013157894736842105	48	16127	7	20	41	16107	16175	0.19266550252678283
M1	string	0	network_modules	162	TRUE	1.4308946759215192e-8	67	22	7	0.3181818181818182	0.1044776119402985	KEGG:00010	KEGG	Glycolysis / Gluconeogenesis	8484	2		0.3333333333333333	0.5	67	8417	7	15	60	8402	8484	0.1787391325664997
M1	string	0	network_modules	162	TRUE	1.614114842986474e-8	115	22	8	0.36363636363636365	0.06956521739130435	KEGG:01200	KEGG	Carbon metabolism	8484	184		0.6666666666666666	0.75	115	8369	8	14	107	8355	8484	0.15436856545849564
M1	string	0	network_modules	162	TRUE	3.3046570121895406e-8	36	24	6	0.25	0.16666666666666666	REAC:R-HSA-3299685	REAC	Detoxification of Reactive Oxygen Species	10916	735		0	0.1111111111111111	36	10880	6	18	30	10862	10916	0.20198655396133935
M1	string	0	network_modules	162	TRUE	1.2593591027966814e-7	44	27	6	0.2222222222222222	0.13636363636363635	GO:1990748	GO:BP	cellular detoxification	16175	25271		0.013333333333333334	0.02631578947368421	44	16131	6	21	38	16110	16175	0.17232498496971826
M1	string	0	network_modules	162	TRUE	2.616075120522181e-7	96	27	7	0.25925925925925924	0.07291666666666667	GO:0006090	GO:BP	pyruvate metabolic process	16175	1953		0.02666666666666667	0.039473684210526314	96	16079	7	20	89	16059	16175	0.13485849310445158
M1	string	0	network_modules	162	TRUE	2.8164855611809983e-7	97	27	7	0.25925925925925924	0.07216494845360824	GO:0009636	GO:BP	response to toxic substance	16175	3554		0.04	0.05263157894736842	97	16078	7	20	90	16058	16175	0.1341329743027865
M1	string	0	network_modules	162	TRUE	3.4156083687160597e-7	372	27	10	0.37037037037037035	0.026881720430107527	GO:0006091	GO:BP	generation of precursor metabolites and energy	16175	1954		0.05333333333333334	0.06578947368421052	372	15803	10	17	362	15786	16175	0.09475895552912013
M1	string	0	network_modules	162	TRUE	4.202556964979965e-7	265	27	9	0.3333333333333333	0.033962264150943396	GO:0006979	GO:BP	response to oxidative stress	16175	2604		0.06666666666666667	0.07894736842105263	265	15910	9	18	256	15892	16175	0.10209384626720708
M1	string	0	network_modules	162	TRUE	4.5100954606185326e-7	23	27	5	0.18518518518518517	0.21739130434782608	GO:0098869	GO:BP	cellular oxidant detoxification	16175	18920		0.08	0.09210526315789473	23	16152	5	22	18	16130	16175	0.19941065691702325
M1	string	0	network_modules	162	TRUE	1.7352902661401543e-6	67	27	6	0.2222222222222222	0.08955223880597014	GO:0098754	GO:BP	detoxification	16175	18873		0.09333333333333334	0.10526315789473684	67	16108	6	21	61	16087	16175	0.13884315776489975
M1	string	0	network_modules	162	TRUE	1.8962334704657792e-6	127	27	7	0.25925925925925924	0.05511811023622047	GO:0000302	GO:BP	response to reactive oxygen species	16175	88		0.10666666666666667	0.11842105263157894	127	16048	7	20	120	16028	16175	0.11647506132201062
M1	string	0	network_modules	162	TRUE	2.316552557625891e-6	33	24	5	0.20833333333333334	0.15151515151515152	REAC:R-HSA-70263	REAC	Gluconeogenesis	10916	1052		0.125	0.2222222222222222	33	10883	5	19	28	10864	10916	0.17554751030776036
M1	string	0	network_modules	162	TRUE	2.7016315012232283e-6	72	27	6	0.2222222222222222	0.08333333333333333	GO:0006096	GO:BP	glycolytic process	16175	1956		0.12	0.14473684210526316	72	16103	6	21	66	16082	16175	0.13376639383614625
M1	string	0	network_modules	162	TRUE	2.7016315012232283e-6	72	27	6	0.2222222222222222	0.08333333333333333	GO:0046032	GO:BP	ADP catabolic process	16175	11809		0.12	0.14473684210526316	72	16103	6	21	66	16082	16175	0.13376639383614625
M1	string	0	network_modules	162	TRUE	3.1961526371887393e-6	74	27	6	0.2222222222222222	0.08108108108108109	GO:0009181	GO:BP	purine ribonucleoside diphosphate catabolic process	16175	3347		0.14666666666666667	0.18421052631578946	74	16101	6	21	68	16080	16175	0.13187963060697852
M1	string	0	network_modules	162	TRUE	3.1961526371887393e-6	74	27	6	0.2222222222222222	0.08108108108108109	GO:0046031	GO:BP	ADP metabolic process	16175	11808		0.14666666666666667	0.18421052631578946	74	16101	6	21	68	16080	16175	0.13187963060697852
M1	string	0	network_modules	162	TRUE	3.1961526371887393e-6	74	27	6	0.2222222222222222	0.08108108108108109	GO:0009137	GO:BP	purine nucleoside diphosphate catabolic process	16175	3304		0.14666666666666667	0.18421052631578946	74	16101	6	21	68	16080	16175	0.13187963060697852
M1	string	0	network_modules	162	TRUE	3.3973498427578876e-6	138	27	7	0.25925925925925924	0.050724637681159424	GO:0019362	GO:BP	pyridine nucleotide metabolic process	16175	5724		0.18666666666666668	0.21052631578947367	138	16037	7	20	131	16017	16175	0.11147251323495547
M1	string	0	network_modules	162	TRUE	3.3973498427578876e-6	138	27	7	0.25925925925925924	0.050724637681159424	GO:0046496	GO:BP	nicotinamide nucleotide metabolic process	16175	12199		0.18666666666666668	0.21052631578947367	138	16037	7	20	131	16017	16175	0.11147251323495547
M1	string	0	network_modules	162	TRUE	3.7634462080237006e-6	76	27	6	0.2222222222222222	0.07894736842105263	GO:0009179	GO:BP	purine ribonucleoside diphosphate metabolic process	16175	3345		0.21333333333333335	0.23684210526315788	76	16099	6	21	70	16078	16175	0.13006695209019387
M1	string	0	network_modules	162	TRUE	3.7634462080237006e-6	76	27	6	0.2222222222222222	0.07894736842105263	GO:0019364	GO:BP	pyridine nucleotide catabolic process	16175	5726		0.21333333333333335	0.23684210526315788	76	16099	6	21	70	16078	16175	0.13006695209019387
M1	string	0	network_modules	162	TRUE	4.076930475863111e-6	77	27	6	0.2222222222222222	0.07792207792207792	GO:0009191	GO:BP	ribonucleoside diphosphate catabolic process	16175	3357		0.24	0.2631578947368421	77	16098	6	21	71	16077	16175	0.1291868873452868
M1	string	0	network_modules	162	TRUE	4.076930475863111e-6	77	27	6	0.2222222222222222	0.07792207792207792	GO:0009135	GO:BP	purine nucleoside diphosphate metabolic process	16175	3302		0.24	0.2631578947368421	77	16098	6	21	71	16077	16175	0.1291868873452868
M1	string	0	network_modules	162	TRUE	4.358731716099324e-6	143	27	7	0.25925925925925924	0.04895104895104895	GO:0072524	GO:BP	pyridine-containing compound metabolic process	16175	17426		0.26666666666666666	0.27631578947368424	143	16032	7	20	136	16012	16175	0.10938839820994371
M1	string	0	network_modules	162	TRUE	4.769029740738181e-6	79	27	6	0.2222222222222222	0.0759493670886076	GO:0072526	GO:BP	pyridine-containing compound catabolic process	16175	17428		0.28	0.2894736842105263	79	16096	6	21	73	16075	16175	0.12747652714138644
M1	string	0	network_modules	162	TRUE	5.987669006268639e-6	82	27	6	0.2222222222222222	0.07317073170731707	GO:0009134	GO:BP	nucleoside diphosphate catabolic process	16175	3301		0.29333333333333333	0.3026315789473684	82	16093	6	21	76	16072	16175	0.125027786855837
M1	string	0	network_modules	162	TRUE	7.453615890981367e-6	85	27	6	0.2222222222222222	0.07058823529411765	GO:0009185	GO:BP	ribonucleoside diphosphate metabolic process	16175	3351		0.30666666666666664	0.3157894736842105	85	16090	6	21	79	16069	16175	0.12270814718718494
M1	string	0	network_modules	162	TRUE	1.0551857883259708e-5	90	27	6	0.2222222222222222	0.06666666666666667	GO:0009154	GO:BP	purine ribonucleotide catabolic process	16175	3321		0.32	0.32894736842105265	90	16085	6	21	84	16064	16175	0.11909949058844471
M1	string	0	network_modules	162	TRUE	1.1980863056456062e-5	388	27	9	0.3333333333333333	0.023195876288659795	GO:0009117	GO:BP	nucleotide metabolic process	16175	3286		0.3333333333333333	0.34210526315789475	388	15787	9	18	379	15769	16175	0.08266948167294916
M1	string	0	network_modules	162	TRUE	1.2057875094580407e-5	92	27	6	0.2222222222222222	0.06521739130434782	GO:0009261	GO:BP	ribonucleotide catabolic process	16175	3426		0.3466666666666667	0.35526315789473684	92	16083	6	21	86	16062	16175	0.1177379100187171
M1	string	0	network_modules	162	TRUE	1.2612449961805361e-5	43	27	5	0.18518518518518517	0.11627906976744186	GO:0042743	GO:BP	hydrogen peroxide metabolic process	16175	10336		0.36	0.3684210526315789	43	16132	5	22	38	16110	16175	0.14494893054179894
M1	string	0	network_modules	162	TRUE	1.287506579275619e-5	93	27	6	0.2222222222222222	0.06451612903225806	GO:0009132	GO:BP	nucleoside diphosphate metabolic process	16175	3299		0.37333333333333335	0.3815789473684211	93	16082	6	21	87	16061	16175	0.11707340469438085
M1	string	0	network_modules	162	TRUE	1.7788177476636997e-5	175	27	7	0.25925925925925924	0.04	GO:0072593	GO:BP	reactive oxygen species metabolic process	16175	17457		0.38666666666666666	0.39473684210526316	175	16000	7	20	168	15980	16175	0.09819954376612548
M1	string	0	network_modules	162	TRUE	1.880041214126952e-5	99	27	6	0.2222222222222222	0.06060606060606061	GO:0006195	GO:BP	purine nucleotide catabolic process	16175	2024		0.4	0.40789473684210525	99	16076	6	21	93	16055	16175	0.11329697634518232
M1	string	0	network_modules	162	TRUE	2.424213366881889e-5	183	27	7	0.25925925925925924	0.03825136612021858	GO:0034599	GO:BP	cellular response to oxidative stress	16175	8684		0.41333333333333333	0.42105263157894735	183	15992	7	20	176	15972	16175	0.09586191540360112
M1	string	0	network_modules	162	TRUE	2.517340473062023e-5	184	27	7	0.25925925925925924	0.03804347826086957	GO:0046034	GO:BP	ATP metabolic process	16175	11811		0.4266666666666667	0.4342105263157895	184	15991	7	20	177	15971	16175	0.09558021701085032
M1	string	0	network_modules	162	TRUE	2.6134862946779227e-5	185	27	7	0.25925925925925924	0.03783783783783784	GO:0046434	GO:BP	organophosphate catabolic process	16175	12142		0.44	0.4473684210526316	185	15990	7	20	178	15970	16175	0.09530074812408314
M1	string	0	network_modules	162	TRUE	3.0052455237025695e-5	107	27	6	0.2222222222222222	0.056074766355140186	GO:0034614	GO:BP	cellular response to reactive oxygen species	16175	8691		0.4533333333333333	0.4605263157894737	107	16068	6	21	101	16047	16175	0.1087569474060319
M1	string	0	network_modules	162	TRUE	4.176667550226477e-5	198	27	7	0.25925925925925924	0.03535353535353535	GO:0009205	GO:BP	purine ribonucleoside triphosphate metabolic process	16175	3371		0.4666666666666667	0.47368421052631576	198	15977	7	20	191	15957	16175	0.09185767458313482
M1	string	0	network_modules	162	TRUE	4.6326299150405866e-5	201	27	7	0.25925925925925924	0.03482587064676617	GO:0009144	GO:BP	purine nucleoside triphosphate metabolic process	16175	3311		0.48	0.4868421052631579	201	15974	7	20	194	15954	16175	0.09110969276929025
M1	string	0	network_modules	162	TRUE	4.884754237615008e-5	116	27	6	0.2222222222222222	0.05172413793103448	GO:0072523	GO:BP	purine-containing compound catabolic process	16175	17425		0.49333333333333335	0.5	116	16059	6	21	110	16038	16175	0.104212386021723
M1	string	0	network_modules	162	TRUE	5.1301132501641395e-5	204	27	7	0.25925925925925924	0.03431372549019608	GO:0009199	GO:BP	ribonucleoside triphosphate metabolic process	16175	3365		0.5066666666666667	0.5131578947368421	204	15971	7	20	197	15951	16175	0.09037781936626715
M1	string	0	network_modules	162	TRUE	5.143043874924265e-5	117	27	6	0.2222222222222222	0.05128205128205128	GO:0009166	GO:BP	nucleotide catabolic process	16175	3332		0.52	0.5263157894736842	117	16058	6	21	111	16037	16175	0.10373947707458869
M1	string	0	network_modules	162	TRUE	5.646128674501929e-5	21	27	4	0.14814814814814814	0.19047619047619047	GO:0032148	GO:BP	activation of protein kinase B activity	16175	7382		0.5333333333333333	0.5394736842105263	21	16154	4	23	17	16131	16175	0.16675951241866255
M1	string	0	network_modules	162	TRUE	6.941050563914202e-5	123	27	6	0.2222222222222222	0.04878048780487805	GO:0016052	GO:BP	carbohydrate catabolic process	16175	5084		0.5466666666666666	0.5526315789473685	123	16052	6	21	117	16031	16175	0.10102191569223994
M1	string	0	network_modules	162	TRUE	7.360510417096084e-5	215	27	7	0.25925925925925924	0.03255813953488372	GO:0009141	GO:BP	nucleoside triphosphate metabolic process	16175	3308		0.56	0.5657894736842105	215	15960	7	20	208	15940	16175	0.0878229906515715
M1	string	0	network_modules	162	TRUE	7.374531965278015e-5	211	24	7	0.2916666666666667	0.03317535545023697	REAC:R-HSA-9711123	REAC	Cellular response to chemical stress	10916	333		0.25	0.3333333333333333	211	10705	7	17	204	10688	10916	0.09285126031182539
M1	string	0	network_modules	162	TRUE	9.669591918564048e-5	68	24	5	0.20833333333333334	0.07352941176470588	REAC:R-HSA-70171	REAC	Glycolysis	10916	1074		0.375	0.4444444444444444	68	10848	5	19	63	10829	10916	0.12057598776792902
M1	string	0	network_modules	162	TRUE	1.0363083176005246e-4	226	27	7	0.25925925925925924	0.030973451327433628	GO:0062197	GO:BP	cellular response to chemical stress	16175	15861		0.5733333333333334	0.5789473684210527	226	15949	7	20	219	15929	16175	0.08545166429013397
M1	string	0	network_modules	162	TRUE	1.05143884248474e-4	349	27	8	0.2962962962962963	0.022922636103151862	GO:0006163	GO:BP	purine nucleotide metabolic process	16175	1998		0.5866666666666667	0.5921052631578947	349	15826	8	19	341	15807	16175	0.0773140549541842
M1	string	0	network_modules	162	TRUE	1.1448258815321243e-4	504	27	9	0.3333333333333333	0.017857142857142856	GO:0032787	GO:BP	monocarboxylic acid metabolic process	16175	7822		0.6	0.6052631578947368	504	15671	9	18	495	15653	16175	0.07111487778807946
M1	string	0	network_modules	162	TRUE	1.4407454797151772e-4	139	27	6	0.2222222222222222	0.04316546762589928	GO:1901292	GO:BP	nucleoside phosphate catabolic process	16175	21367		0.6133333333333333	0.618421052631579	139	16036	6	21	133	16015	16175	0.09463918741068011
M1	string	0	network_modules	162	TRUE	1.5200302604351186e-4	521	27	9	0.3333333333333333	0.01727447216890595	GO:0006753	GO:BP	nucleoside phosphate metabolic process	16175	2450		0.6266666666666667	0.631578947368421	521	15654	9	18	512	15636	16175	0.06973959069284298
M1	string	0	network_modules	162	TRUE	2.516242159424935e-4	742	27	10	0.37037037037037035	0.013477088948787063	GO:0019752	GO:BP	carboxylic acid metabolic process	16175	6036		0.64	0.6447368421052632	742	15433	10	17	732	15416	16175	0.0634235434861339
M1	string	0	network_modules	162	TRUE	2.7259848924359457e-4	558	27	9	0.3333333333333333	0.016129032258064516	GO:0055086	GO:BP	nucleobase-containing small molecule metabolic process	16175	14237		0.6533333333333333	0.6578947368421053	558	15617	9	18	549	15599	16175	0.06695504479261294
M1	string	0	network_modules	162	TRUE	3.146980075762969e-4	86	24	5	0.20833333333333334	0.05813953488372093	REAC:R-HSA-70326	REAC	Glucose metabolism	10916	1053		0.5	0.5555555555555556	86	10830	5	19	81	10811	10916	0.10643114846977553
M1	string	0	network_modules	162	TRUE	3.1484595897940523e-4	266	27	7	0.25925925925925924	0.02631578947368421	GO:0009150	GO:BP	purine ribonucleotide metabolic process	16175	3317		0.6666666666666666	0.6710526315789473	266	15909	7	20	259	15889	16175	0.07806897797526344
M1	string	0	network_modules	162	TRUE	3.1844855906513385e-4	761	27	10	0.37037037037037035	0.013140604467805518	GO:0043436	GO:BP	oxoacid metabolic process	16175	10693		0.68	0.6842105263157895	761	15414	10	17	751	15397	16175	0.06243852940053025
M1	string	0	network_modules	162	TRUE	3.4258076741337513e-4	767	27	10	0.37037037037037035	0.01303780964797914	GO:0006082	GO:BP	organic acid metabolic process	16175	1947		0.6933333333333334	0.6973684210526315	767	15408	10	17	757	15391	16175	0.062134571721499554
M1	string	0	network_modules	162	TRUE	3.8079256754729597e-4	33	27	4	0.14814814814814814	0.12121212121212122	GO:1902175	GO:BP	regulation of oxidative stress-induced intrinsic apoptotic signaling pathway	16175	22078		0.7066666666666667	0.7105263157894737	33	16142	4	23	29	16119	16175	0.13240520091052038
M1	string	0	network_modules	162	TRUE	4.043924232552496e-4	276	27	7	0.25925925925925924	0.025362318840579712	GO:0009259	GO:BP	ribonucleotide metabolic process	16175	3424		0.72	0.7236842105263158	276	15899	7	20	269	15879	16175	0.07647053421015512
M1	string	0	network_modules	162	TRUE	4.684051032435227e-4	109	22	5	0.22727272727272727	0.045871559633027525	KEGG:04066	KEGG	HIF-1 signaling pathway	8484	257		1	1	109	8375	5	17	104	8358	8484	0.09708346758914024
M1	string	0	network_modules	162	TRUE	4.791250549794294e-4	283	27	7	0.25925925925925924	0.024734982332155476	GO:0019693	GO:BP	ribose phosphate metabolic process	16175	6010		0.7333333333333333	0.7368421052631579	283	15892	7	20	276	15872	16175	0.0754005237538936
M1	string	0	network_modules	162	TRUE	5.793597875926563e-4	610	27	9	0.3333333333333333	0.014754098360655738	GO:0043066	GO:BP	negative regulation of apoptotic process	16175	10512		0.7466666666666667	0.75	610	15565	9	18	601	15547	16175	0.06345448585550756
M1	string	0	network_modules	162	TRUE	7.601683434997892e-4	630	27	9	0.3333333333333333	0.014285714285714285	GO:0043069	GO:BP	negative regulation of programmed cell death	16175	10515		0.76	0.7631578947368421	630	15545	9	18	621	15527	16175	0.06221797381292932
M1	string	0	network_modules	162	TRUE	7.601985557147086e-4	39	27	4	0.14814814814814814	0.10256410256410256	GO:0045454	GO:BP	cell redox homeostasis	16175	11384		0.7733333333333333	0.7763157894736842	39	16136	4	23	35	16113	16175	0.12150843840102382
M1	string	0	network_modules	162	TRUE	0.001005058821068173	469	27	8	0.2962962962962963	0.017057569296375266	GO:0072521	GO:BP	purine-containing compound metabolic process	16175	17423		0.7866666666666666	0.7894736842105263	469	15706	8	19	461	15687	16175	0.0651400455491542
M1	string	0	network_modules	162	TRUE	0.0010971629168306468	196	27	6	0.2222222222222222	0.030612244897959183	GO:1901136	GO:BP	carbohydrate derivative catabolic process	16175	21244		0.8	0.8026315789473685	196	15979	6	21	190	15958	16175	0.07852353677564758
M1	string	0	network_modules	162	TRUE	0.0013676989151832945	45	27	4	0.14814814814814814	0.08888888888888889	GO:0008631	GO:BP	intrinsic apoptotic signaling pathway in response to oxidative stress	16175	3219		0.8133333333333334	0.8157894736842105	45	16130	4	23	41	16107	16175	0.11285126480608967
M1	string	0	network_modules	162	TRUE	0.0014299037347152072	2	24	2	0.08333333333333333	1	REAC:R-HSA-9636667	REAC	Manipulation of host energy metabolism	10916	1391		0.625	0.6666666666666666	2	10914	2	22	0	10892	10916	0.2883840379923303
M1	string	0	network_modules	162	TRUE	0.0020818706000104658	126	24	5	0.20833333333333334	0.03968253968253968	REAC:R-HSA-114608	REAC	Platelet degranulation 	10916	1764		0.75	0.7777777777777778	126	10790	5	19	121	10771	10916	0.0864816133429679
M1	string	0	network_modules	162	TRUE	0.0025184726951162505	131	24	5	0.20833333333333334	0.03816793893129771	REAC:R-HSA-76005	REAC	Response to elevated platelet cytosolic Ca2+	10916	2090		0.875	0.8888888888888888	131	10785	5	19	126	10766	10916	0.08463734430757461
M1	string	0	network_modules	162	TRUE	0.003095266328634395	55	27	4	0.14814814814814814	0.07272727272727272	GO:0006801	GO:BP	superoxide metabolic process	16175	2486		0.8266666666666667	0.8289473684210527	55	16120	4	23	51	16097	16175	0.10167519789021678
M1	string	0	network_modules	162	TRUE	0.004192715654658986	2	27	2	0.07407407407407407	1	GO:1903384	GO:BP	negative regulation of hydrogen peroxide-induced neuron intrinsic apoptotic signaling pathway	16175	22963		0.84	0.881578947368421	2	16173	2	25	0	16148	16175	0.27195509076604235
M1	string	0	network_modules	162	TRUE	0.004192715654658986	2	27	2	0.07407407407407407	1	GO:1903383	GO:BP	regulation of hydrogen peroxide-induced neuron intrinsic apoptotic signaling pathway	16175	22962		0.84	0.881578947368421	2	16173	2	25	0	16148	16175	0.27195509076604235
M1	string	0	network_modules	162	TRUE	0.004192715654658986	2	27	2	0.07407407407407407	1	GO:0046166	GO:BP	glyceraldehyde-3-phosphate biosynthetic process	16175	11936		0.84	0.881578947368421	2	16173	2	25	0	16148	16175	0.27195509076604235
M1	string	0	network_modules	162	TRUE	0.004192715654658986	2	27	2	0.07407407407407407	1	GO:0036482	GO:BP	neuron intrinsic apoptotic signaling pathway in response to hydrogen peroxide	16175	9618		0.84	0.881578947368421	2	16173	2	25	0	16148	16175	0.27195509076604235
M1	string	0	network_modules	162	TRUE	0.004338940416778568	17	27	3	0.1111111111111111	0.17647058823529413	GO:0019430	GO:BP	removal of superoxide radicals	16175	5782		0.8933333333333333	0.8947368421052632	17	16158	3	24	14	16134	16175	0.13889239510379298
M1	string	0	network_modules	162	TRUE	0.004398785169219106	137	27	5	0.18518518518518517	0.0364963503649635	GO:2001242	GO:BP	regulation of intrinsic apoptotic signaling pathway	16175	26431		0.9066666666666666	0.9078947368421053	137	16038	5	22	132	16016	16175	0.07885071303094891
M1	string	0	network_modules	162	TRUE	0.005200935261179129	18	27	3	0.1111111111111111	0.16666666666666666	GO:0000303	GO:BP	response to superoxide	16175	89		0.92	0.9473684210526315	18	16157	3	24	15	16133	16175	0.13490749891953285
M1	string	0	network_modules	162	TRUE	0.005200935261179129	18	27	3	0.1111111111111111	0.16666666666666666	GO:0071450	GO:BP	cellular response to oxygen radical	16175	16684		0.92	0.9473684210526315	18	16157	3	24	15	16133	16175	0.13490749891953285
M1	string	0	network_modules	162	TRUE	0.005200935261179129	18	27	3	0.1111111111111111	0.16666666666666666	GO:0071451	GO:BP	cellular response to superoxide	16175	16685		0.92	0.9473684210526315	18	16157	3	24	15	16133	16175	0.13490749891953285
M1	string	0	network_modules	162	TRUE	0.006169238979555305	19	27	3	0.1111111111111111	0.15789473684210525	GO:0000305	GO:BP	response to oxygen radical	16175	91		0.96	0.9605263157894737	19	16156	3	24	16	16132	16175	0.13123957709566395
M1	string	0	network_modules	162	TRUE	0.007833473043229074	275	27	6	0.2222222222222222	0.02181818181818182	GO:2001233	GO:BP	regulation of apoptotic signaling pathway	16175	26422		0.9733333333333334	0.9736842105263158	275	15900	6	21	269	15879	16175	0.06491170357963542
M1	string	0	network_modules	162	TRUE	0.008388411054511404	623	27	8	0.2962962962962963	0.012841091492776886	GO:0019725	GO:BP	cellular homeostasis	16175	6020		0.9866666666666667	0.9868421052631579	623	15552	8	19	615	15533	16175	0.054774571287303536
M1	string	0	network_modules	162	TRUE	0.008658927596264373	71	27	4	0.14814814814814814	0.056338028169014086	GO:0032147	GO:BP	activation of protein kinase activity	16175	7381		1	1	71	16104	4	23	67	16081	16175	0.088921085621162
M1	string	0	network_modules	162	TRUE	0.00890756188995954	288	24	6	0.25	0.020833333333333332	REAC:R-HSA-71387	REAC	Metabolism of carbohydrates	10916	1422		1	1	288	10628	6	18	282	10610	10916	0.06549340458054048
M1	string	0	network_modules	163	TRUE	2.3530556087524552e-11	30	21	7	0.3333333333333333	0.23333333333333334	KEGG:00020	KEGG	Citrate cycle (TCA cycle)	8484	3		0	0.07142857142857142	30	8454	7	14	23	8440	8484	0.27676007395281876
M1	string	0	network_modules	163	TRUE	1.8581683680217517e-10	115	21	9	0.42857142857142855	0.0782608695652174	KEGG:01200	KEGG	Carbon metabolism	8484	184		0.07692307692307693	0.14285714285714285	115	8369	9	12	106	8357	8484	0.17878364934932658
M1	string	0	network_modules	163	TRUE	3.655056052626538e-10	43	21	7	0.3333333333333333	0.16279069767441862	KEGG:00071	KEGG	Fatty acid degradation	8484	11		0.15384615384615385	0.21428571428571427	43	8441	7	14	36	8427	8484	0.2302721938070195
M1	string	0	network_modules	163	TRUE	8.29110399303392e-10	48	21	7	0.3333333333333333	0.14583333333333334	KEGG:00280	KEGG	Valine, leucine and isoleucine degradation	8484	31		0.23076923076923078	0.2857142857142857	48	8436	7	14	41	8422	8484	0.21762228630974015
M1	string	0	network_modules	163	TRUE	1.93588162781825e-9	22	25	6	0.24	0.2727272727272727	REAC:R-HSA-71403	REAC	Citric acid cycle (TCA cycle)	10916	364		0	0.3333333333333333	22	10894	6	19	16	10875	10916	0.25423977701580963
M1	string	0	network_modules	163	TRUE	2.2971864075339425e-9	26	25	6	0.24	0.23076923076923078	GO:0006099	GO:BP	tricarboxylic acid cycle	16175	1959		0	0.047619047619047616	26	16149	6	19	20	16130	16175	0.23413226956106464
M1	string	0	network_modules	163	TRUE	2.1034082243004118e-7	271	25	9	0.36	0.033210332103321034	GO:0044248	GO:BP	cellular catabolic process	16175	10939		0.05	0.09523809523809523	271	15904	9	16	262	15888	16175	0.10521929061828304
M1	string	0	network_modules	163	TRUE	3.407742283561801e-7	742	25	12	0.48	0.016172506738544475	GO:0019752	GO:BP	carboxylic acid metabolic process	16175	6036		0.1	0.14285714285714285	742	15433	12	13	730	15420	16175	0.08164271439906406
M1	string	0	network_modules	163	TRUE	4.5586177525429235e-7	761	25	12	0.48	0.01576872536136662	GO:0043436	GO:BP	oxoacid metabolic process	16175	10693		0.15	0.19047619047619047	761	15414	12	13	749	15401	16175	0.08044848346808957
M1	string	0	network_modules	163	TRUE	4.989351848873727e-7	767	25	12	0.48	0.01564537157757497	GO:0006082	GO:BP	organic acid metabolic process	16175	1947		0.2	0.23809523809523808	767	15408	12	13	755	15395	16175	0.08008013526541931
M1	string	0	network_modules	163	TRUE	5.837418210374299e-7	31	21	5	0.23809523809523808	0.16129032258064516	KEGG:00410	KEGG	beta-Alanine metabolism	8484	55		0.3076923076923077	0.35714285714285715	31	8453	5	16	26	8437	8484	0.19355124920129413
M1	string	0	network_modules	163	TRUE	6.90752647973022e-7	32	21	5	0.23809523809523808	0.15625	KEGG:00640	KEGG	Propanoate metabolism	8484	109		0.38461538461538464	0.42857142857142855	32	8452	5	16	27	8436	8484	0.1904184929459029
M1	string	0	network_modules	163	TRUE	2.2287889151050675e-6	40	21	5	0.23809523809523808	0.125	KEGG:00380	KEGG	Tryptophan metabolism	8484	48		0.46153846153846156	0.5	40	8444	5	16	35	8428	8484	0.16971043991148343
M1	string	0	network_modules	163	TRUE	2.295946357643688e-5	63	21	5	0.23809523809523808	0.07936507936507936	KEGG:00310	KEGG	Lysine degradation	8484	34		0.5384615384615384	0.5714285714285714	63	8421	5	16	58	8405	8484	0.13384008204602516
M1	string	0	network_modules	163	TRUE	6.390779650095114e-5	65	25	5	0.2	0.07692307692307693	GO:0006635	GO:BP	fatty acid beta-oxidation	16175	2346		0.25	0.2857142857142857	65	16110	5	20	60	16090	16175	0.12188171447502291
M1	string	0	network_modules	163	TRUE	6.973338870219454e-5	33	21	4	0.19047619047619047	0.12121212121212122	KEGG:01210	KEGG	2-Oxocarboxylic acid metabolism	8484	185		0.6153846153846154	0.6428571428571429	33	8451	4	17	29	8434	8484	0.14931979018134914
M1	string	0	network_modules	163	TRUE	9.290279180855125e-5	6	25	3	0.12	0.5	GO:1901289	GO:BP	succinyl-CoA catabolic process	16175	21364		0.3	0.3333333333333333	6	16169	3	22	3	16147	16175	0.2444260585285185
M1	string	0	network_modules	163	TRUE	1.98803863229933e-4	162	25	6	0.24	0.037037037037037035	GO:0009060	GO:BP	aerobic respiration	16175	3236		0.35	0.38095238095238093	162	16013	6	19	156	15994	16175	0.09087257232742335
M1	string	0	network_modules	163	TRUE	2.971975234598398e-4	47	21	4	0.19047619047619047	0.0851063829787234	KEGG:00620	KEGG	Pyruvate metabolism	8484	99		0.6923076923076923	0.7142857142857143	47	8437	4	17	43	8420	8484	0.12411591319582183
M1	string	0	network_modules	163	TRUE	3.2369482945789806e-4	48	21	4	0.19047619047619047	0.08333333333333333	KEGG:00330	KEGG	Arginine and proline metabolism	8484	36		0.7692307692307693	0.7857142857142857	48	8436	4	17	44	8419	8484	0.1227452319905297
M1	string	0	network_modules	163	TRUE	3.5027584102540816e-4	91	25	5	0.2	0.054945054945054944	GO:0019395	GO:BP	fatty acid oxidation	16175	5752		0.4	0.42857142857142855	91	16084	5	20	86	16064	16175	0.10224652340061922
M1	string	0	network_modules	163	TRUE	3.8899871601792674e-4	9	25	3	0.12	0.3333333333333333	GO:0006104	GO:BP	succinyl-CoA metabolic process	16175	1963		0.45	0.47619047619047616	9	16166	3	22	6	16144	16175	0.19928211379297658
M1	string	0	network_modules	163	TRUE	4.121644981635442e-4	94	25	5	0.2	0.05319148936170213	GO:0009062	GO:BP	fatty acid catabolic process	16175	3238		0.5	0.5238095238095238	94	16081	5	20	89	16061	16175	0.1005150804596989
M1	string	0	network_modules	163	TRUE	4.5801946200360843e-4	96	25	5	0.2	0.052083333333333336	GO:0034440	GO:BP	lipid oxidation	16175	8634		0.55	0.5714285714285714	96	16079	5	20	91	16059	16175	0.0994053874932114
M1	string	0	network_modules	163	TRUE	4.792050697839249e-4	188	25	6	0.24	0.031914893617021274	GO:0045333	GO:BP	cellular respiration	16175	11360		0.6	0.6190476190476191	188	15987	6	19	182	15968	16175	0.08383362005060714
M1	string	0	network_modules	163	TRUE	8.060578687687195e-4	177	25	6	0.24	0.03389830508474576	REAC:R-HSA-1428517	REAC	Aerobic respiration and respiratory electron transport	10916	127		0.5	0.6666666666666666	177	10739	6	19	171	10720	10916	0.08489118454460193
M1	string	0	network_modules	163	TRUE	8.249737595239441e-4	108	25	5	0.2	0.046296296296296294	GO:0072329	GO:BP	monocarboxylic acid catabolic process	16175	17352		0.65	0.6666666666666666	108	16067	5	20	103	16047	16175	0.09339687551685401
M1	string	0	network_modules	163	TRUE	9.440343650335493e-4	211	25	6	0.24	0.02843601895734597	GO:0046395	GO:BP	carboxylic acid catabolic process	16175	12121		0.7	0.7619047619047619	211	15964	6	19	205	15945	16175	0.07869661245832116
M1	string	0	network_modules	163	TRUE	9.440343650335493e-4	211	25	6	0.24	0.02843601895734597	GO:0016054	GO:BP	organic acid catabolic process	16175	5086		0.7	0.7619047619047619	211	15964	6	19	205	15945	16175	0.07869661245832116
M1	string	0	network_modules	163	TRUE	0.0012568410884362456	22	21	3	0.14285714285714285	0.13636363636363635	KEGG:00340	KEGG	Histidine metabolism	8484	40		0.8461538461538461	0.8571428571428571	22	8462	3	18	19	8444	8484	0.13738729960676443
M1	string	0	network_modules	163	TRUE	0.00129164292245363	142	21	5	0.23809523809523808	0.035211267605633804	KEGG:04936	KEGG	Alcoholic liver disease	8484	393		0.9230769230769231	0.9285714285714286	142	8342	5	16	137	8326	8484	0.08595354635031185
M1	string	0	network_modules	163	TRUE	0.001545142725779614	372	25	7	0.28	0.01881720430107527	GO:0006091	GO:BP	generation of precursor metabolites and energy	16175	1954		0.8	0.8095238095238095	372	15803	7	18	365	15785	16175	0.06745630142939509
M1	string	0	network_modules	163	TRUE	0.0026590451169698896	252	25	6	0.24	0.023809523809523808	GO:0015980	GO:BP	energy derivation by oxidation of organic compounds	16175	5060		0.85	0.8571428571428571	252	15923	6	19	246	15904	16175	0.07129804934749209
M1	string	0	network_modules	163	TRUE	0.003271541317618007	30	21	3	0.14285714285714285	0.1	KEGG:00053	KEGG	Ascorbate and aldarate metabolism	8484	8		1	1	30	8454	3	18	27	8436	8484	0.11691579964697348
M1	string	0	network_modules	163	TRUE	0.006301495356422438	163	25	5	0.2	0.03067484662576687	GO:0030258	GO:BP	lipid modification	16175	6747		0.9	0.9047619047619048	163	16012	5	20	158	15992	16175	0.0748149447314419
M1	string	0	network_modules	163	TRUE	0.006781313211558385	74	25	4	0.16	0.05405405405405406	GO:0043648	GO:BP	dicarboxylic acid metabolic process	16175	10828		0.95	0.9523809523809523	74	16101	4	21	70	16080	16175	0.09061638433209257
M1	string	0	network_modules	163	TRUE	0.007278651976749593	300	25	6	0.24	0.02	GO:0044282	GO:BP	small molecule catabolic process	16175	10949		1	1	300	15875	6	19	294	15856	16175	0.06457907620086795
M1	string	0	network_modules	163	TRUE	0.008826688848238597	158	25	5	0.2	0.03164556962025317	REAC:R-HSA-9609507	REAC	Protein localization	10916	1815		1	1	158	10758	5	20	153	10738	10916	0.07442343836719434
M1	string	0	network_modules	165	TRUE	6.202069279487166e-37	43	24	18	0.75	0.4186046511627907	KEGG:03022	KEGG	Basal transcription factors	8484	213		0	0.3333333333333333	43	8441	18	6	25	8435	8484	0.5587355951807033
M1	string	0	network_modules	165	TRUE	9.265568377313828e-30	64	27	16	0.5925925925925926	0.25	GO:0051123	GO:BP	RNA polymerase II preinitiation complex assembly	16175	13507		0	0.058823529411764705	64	16111	16	11	48	16100	16175	0.3834089867098597
M1	string	0	network_modules	165	TRUE	2.1273090043499693e-29	67	27	16	0.5925925925925926	0.23880597014925373	GO:0070897	GO:BP	transcription preinitiation complex assembly	16175	16360		0.0625	0.11764705882352941	67	16108	16	11	51	16097	16175	0.37464371391689877
M1	string	0	network_modules	165	TRUE	2.0334856611238676e-28	46	25	15	0.6	0.32608695652173914	REAC:R-HSA-73779	REAC	RNA Polymerase II Transcription Pre-Initiation And Promoter Opening	10916	1894		0	0.3333333333333333	46	10870	15	10	31	10860	10916	0.44065252173786223
M1	string	0	network_modules	165	TRUE	2.0334856611238676e-28	46	25	15	0.6	0.32608695652173914	REAC:R-HSA-76042	REAC	RNA Polymerase II Transcription Initiation And Promoter Clearance	10916	1893		0	0.3333333333333333	46	10870	15	10	31	10860	10916	0.44065252173786223
M1	string	0	network_modules	165	TRUE	2.0334856611238676e-28	46	25	15	0.6	0.32608695652173914	REAC:R-HSA-75953	REAC	RNA Polymerase II Transcription Initiation	10916	1892		0	0.3333333333333333	46	10870	15	10	31	10860	10916	0.44065252173786223
M1	string	0	network_modules	165	TRUE	2.0334856611238676e-28	46	25	15	0.6	0.32608695652173914	REAC:R-HSA-73776	REAC	RNA Polymerase II Promoter Escape	10916	1889		0	0.3333333333333333	46	10870	15	10	31	10860	10916	0.44065252173786223
M1	string	0	network_modules	165	TRUE	2.0334856611238676e-28	46	25	15	0.6	0.32608695652173914	REAC:R-HSA-167161	REAC	HIV Transcription Initiation	10916	1105		0	0.3333333333333333	46	10870	15	10	31	10860	10916	0.44065252173786223
M1	string	0	network_modules	165	TRUE	2.0334856611238676e-28	46	25	15	0.6	0.32608695652173914	REAC:R-HSA-167162	REAC	RNA Polymerase II HIV Promoter Escape	10916	1887		0	0.3333333333333333	46	10870	15	10	31	10860	10916	0.44065252173786223
M1	string	0	network_modules	165	TRUE	3.0482226442865397e-28	55	27	15	0.5555555555555556	0.2727272727272727	GO:0060261	GO:BP	positive regulation of transcription initiation by RNA polymerase II	16175	14478		0.125	0.17647058823529413	55	16120	15	12	40	16108	16175	0.38785030798460607
M1	string	0	network_modules	165	TRUE	1.7993973255825765e-27	61	27	15	0.5555555555555556	0.2459016393442623	GO:2000144	GO:BP	positive regulation of DNA-templated transcription initiation	16175	25492		0.1875	0.23529411764705882	61	16114	15	12	46	16102	16175	0.36810316028172735
M1	string	0	network_modules	165	TRUE	6.821893789197434e-27	66	27	15	0.5555555555555556	0.22727272727272727	GO:0060260	GO:BP	regulation of transcription initiation by RNA polymerase II	16175	14477		0.25	0.29411764705882354	66	16109	15	12	51	16097	16175	0.35374191068865224
M1	string	0	network_modules	165	TRUE	9.141451313034346e-27	173	27	18	0.6666666666666666	0.10404624277456648	GO:0006352	GO:BP	DNA-templated transcription initiation	16175	2129		0.3125	0.35294117647058826	173	16002	18	9	155	15993	16175	0.2607602297308203
M1	string	0	network_modules	165	TRUE	2.9248797974787853e-26	72	27	15	0.5555555555555556	0.20833333333333334	GO:2000142	GO:BP	regulation of DNA-templated transcription initiation	16175	25490		0.375	0.4117647058823529	72	16103	15	12	57	16091	16175	0.33851733260653916
M1	string	0	network_modules	165	TRUE	2.2082993070548423e-25	69	25	15	0.6	0.21739130434782608	REAC:R-HSA-167172	REAC	Transcription of the HIV genome	10916	2540		0.35294117647058826	0.3888888888888889	69	10847	15	10	54	10837	10916	0.3588987752768631
M1	string	0	network_modules	165	TRUE	4.450955632847249e-25	40	27	13	0.48148148148148145	0.325	GO:0042789	GO:BP	mRNA transcription by RNA polymerase II	16175	10367		0.4375	0.47058823529411764	40	16135	13	14	27	16121	16175	0.3943624601438133
M1	string	0	network_modules	165	TRUE	2.560565886687139e-24	80	25	15	0.6	0.1875	REAC:R-HSA-674695	REAC	RNA Polymerase II Pre-transcription Events	10916	1888		0.4117647058823529	0.4444444444444444	80	10836	15	10	65	10826	10916	0.3329155368520214
M1	string	0	network_modules	165	TRUE	2.6895587844092316e-24	45	27	13	0.48148148148148145	0.28888888888888886	GO:0009299	GO:BP	mRNA transcription	16175	3446		0.5	0.5294117647058824	45	16130	13	14	32	16116	16175	0.37162613877862655
M1	string	0	network_modules	165	TRUE	1.1022255773559326e-23	143	27	16	0.5925925925925926	0.11188811188811189	GO:0006367	GO:BP	transcription initiation at RNA polymerase II promoter	16175	2142		0.5625	0.5882352941176471	143	16032	16	11	127	16021	16175	0.25499587479650376
M1	string	0	network_modules	165	TRUE	6.762021381364402e-22	183	27	16	0.5925925925925926	0.08743169398907104	GO:0065004	GO:BP	protein-DNA complex assembly	16175	15888		0.625	0.6470588235294118	183	15992	16	11	167	15981	16175	0.22473689540876562
M1	string	0	network_modules	165	TRUE	4.784848552367423e-21	206	27	16	0.5925925925925926	0.07766990291262135	GO:0071824	GO:BP	protein-DNA complex organization	16175	16927		0.6875	0.7058823529411765	206	15969	16	11	190	15958	16175	0.21145363332163258
M1	string	0	network_modules	165	TRUE	7.945402962261571e-21	132	25	15	0.6	0.11363636363636363	REAC:R-HSA-162599	REAC	Late Phase of HIV Life Cycle	10916	1304		0.47058823529411764	0.5	132	10784	15	10	117	10774	10916	0.2577103523691145
M1	string	0	network_modules	165	TRUE	3.470918001412478e-20	145	25	15	0.6	0.10344827586206896	REAC:R-HSA-162587	REAC	HIV Life Cycle	10916	1103		0.5294117647058824	0.5555555555555556	145	10771	15	10	130	10761	10916	0.2455365346965094
M1	string	0	network_modules	165	TRUE	7.5669963908716015e-19	92	25	13	0.52	0.14130434782608695	REAC:R-HSA-6804756	REAC	Regulation of TP53 Activity through Phosphorylation	10916	2016		0.5882352941176471	0.6111111111111112	92	10824	13	12	79	10812	10916	0.26811345964878686
M1	string	0	network_modules	165	TRUE	3.09529508078094e-17	225	25	15	0.6	0.06666666666666667	REAC:R-HSA-162906	REAC	HIV Infection	10916	1102		0.6470588235294118	0.6666666666666666	225	10691	15	10	210	10681	10916	0.19537489840834624
M1	string	0	network_modules	165	TRUE	1.3849234838648483e-15	160	25	13	0.52	0.08125	REAC:R-HSA-5633007	REAC	Regulation of TP53 Activity	10916	2012		0.7058823529411765	0.7222222222222222	160	10756	13	12	147	10744	10916	0.20146526932290176
M1	string	0	network_modules	165	TRUE	5.444096214873425e-11	359	25	13	0.52	0.036211699164345405	REAC:R-HSA-3700989	REAC	Transcriptional Regulation by TP53	10916	2546		0.7647058823529411	0.7777777777777778	359	10557	13	12	346	10545	10916	0.1308613624174587
M1	string	0	network_modules	165	TRUE	9.37815677053432e-10	73	25	8	0.32	0.1095890410958904	REAC:R-HSA-6807505	REAC	RNA polymerase II transcribes snRNA genes	10916	1904		0.8235294117647058	0.8333333333333334	73	10843	8	17	65	10826	10916	0.18417950887276396
M1	string	0	network_modules	165	TRUE	3.480727883366478e-9	590	27	13	0.48148148148148145	0.022033898305084745	GO:0016071	GO:BP	mRNA metabolic process	16175	5098		0.75	0.7647058823529411	590	15585	13	14	577	15571	16175	0.09706277650252201
M1	string	0	network_modules	165	TRUE	3.110472009820973e-4	9	25	3	0.12	0.3333333333333333	REAC:R-HSA-381183	REAC	ATF6 (ATF6-alpha) activates chaperone genes	10916	36		0.8823529411764706	0.8888888888888888	9	10907	3	22	6	10885	10916	0.19893573576338952
M1	string	0	network_modules	165	TRUE	6.091397345837422e-4	11	25	3	0.12	0.2727272727272727	REAC:R-HSA-381033	REAC	ATF6 (ATF6-alpha) activates chaperones	10916	37		0.9411764705882353	0.9444444444444444	11	10905	3	22	8	10883	10916	0.17968397710091152
M1	string	0	network_modules	165	TRUE	0.0015100910667893753	207	27	6	0.2222222222222222	0.028985507246376812	GO:0006282	GO:BP	regulation of DNA repair	16175	2096		0.8125	0.8235294117647058	207	15968	6	21	201	15947	16175	0.07618759391925067
M1	string	0	network_modules	165	TRUE	0.0020518058865444497	16	25	3	0.12	0.1875	REAC:R-HSA-9614657	REAC	FOXO-mediated transcription of cell death genes	10916	925		1	1	16	10900	3	22	13	10878	10916	0.14844661905822454
M1	string	0	network_modules	165	TRUE	0.002307739262435894	69	24	4	0.16666666666666666	0.057971014492753624	KEGG:04612	KEGG	Antigen processing and presentation	8484	322		0.5	0.6666666666666666	69	8415	4	20	65	8395	8484	0.094013694166422
M1	string	0	network_modules	165	TRUE	0.0023847206259414162	141	24	5	0.20833333333333334	0.03546099290780142	KEGG:05017	KEGG	Spinocerebellar ataxia	8484	415		1	1	141	8343	5	19	136	8324	8484	0.07987370479197226
M1	string	0	network_modules	165	TRUE	0.002909733243755928	15	27	3	0.1111111111111111	0.2	GO:0045346	GO:BP	regulation of MHC class II biosynthetic process	16175	11369		0.875	0.8823529411764706	15	16160	3	24	12	16136	16175	0.14801920198550775
M1	string	0	network_modules	165	TRUE	0.0035772253304888753	16	27	3	0.1111111111111111	0.1875	GO:0045342	GO:BP	MHC class II biosynthetic process	16175	11365		0.9375	0.9411764705882353	16	16159	3	24	13	16135	16175	0.14324299225971948
M1	string	0	network_modules	165	TRUE	0.008698254698956834	437	27	7	0.25925925925925924	0.016018306636155607	GO:0080135	GO:BP	regulation of cellular response to stress	16175	17817		1	1	437	15738	7	20	430	15718	16175	0.058572337594367085
M1	string	0	network_modules	166	TRUE	5.180719696132539e-11	449	14	11	0.7857142857142857	0.024498886414253896	REAC:R-HSA-9012999	REAC	RHO GTPase cycle	10916	1847		0	0.1	449	10467	11	3	438	10464	10916	0.1343546519295873
M1	string	0	network_modules	166	TRUE	5.113655406655597e-10	74	14	7	0.5	0.0945945945945946	REAC:R-HSA-9013408	REAC	RHOG GTPase cycle	10916	1868		0.1111111111111111	0.2	74	10842	7	7	67	10835	10916	0.21539986108162784
M1	string	0	network_modules	166	TRUE	1.2511726798154207e-6	389	22	9	0.4090909090909091	0.02313624678663239	GO:0007264	GO:BP	small GTPase-mediated signal transduction	16175	2792		0	0.3333333333333333	389	15786	9	13	380	15773	16175	0.09275250925705175
M1	string	0	network_modules	166	TRUE	5.046146605937602e-6	149	14	6	0.42857142857142855	0.040268456375838924	REAC:R-HSA-8980692	REAC	RHOA GTPase cycle	10916	1859		0.2222222222222222	0.3	149	10767	6	8	143	10759	10916	0.12814455455647691
M1	string	0	network_modules	166	TRUE	6.396058823296883e-6	155	14	6	0.42857142857142855	0.03870967741935484	REAC:R-HSA-9013148	REAC	CDC42 GTPase cycle	10916	269		0.3333333333333333	0.4	155	10761	6	8	149	10753	10916	0.12550839767764221
M1	string	0	network_modules	166	TRUE	1.04400040026151e-5	77	7	4	0.5714285714285714	0.05194805194805195	KEGG:05100	KEGG	Bacterial invasion of epithelial cells	8484	423		0	0.5	77	8407	4	3	73	8404	8484	0.17040073303374817
M1	string	0	network_modules	166	TRUE	2.326990181037939e-4	59	14	4	0.2857142857142857	0.06779661016949153	REAC:R-HSA-193648	REAC	NRAGE signals death through JNK	10916	1548		0.4444444444444444	0.5	59	10857	4	10	55	10847	10916	0.13700334004544462
M1	string	0	network_modules	166	TRUE	4.650174502264584e-4	70	14	4	0.2857142857142857	0.05714285714285714	REAC:R-HSA-9013026	REAC	RHOB GTPase cycle	10916	1860		0.5555555555555556	0.6	70	10846	4	10	66	10836	10916	0.12539037017329582
M1	string	0	network_modules	166	TRUE	6.478146693083312e-4	76	14	4	0.2857142857142857	0.05263157894736842	REAC:R-HSA-204998	REAC	Cell death signalling via NRAGE, NRIF and NADE	10916	323		0.6666666666666666	0.7	76	10840	4	10	72	10830	10916	0.12013541561209035
M1	string	0	network_modules	166	TRUE	7.172547509345342e-4	184	14	5	0.35714285714285715	0.02717391304347826	REAC:R-HSA-9013149	REAC	RAC1 GTPase cycle	10916	1836		0.7777777777777778	0.8	184	10732	5	9	179	10723	10916	0.09472626189341671
M1	string	0	network_modules	166	TRUE	7.962426160528568e-4	80	14	4	0.2857142857142857	0.05	REAC:R-HSA-416482	REAC	G alpha (12/13) signalling events	10916	986		0.8888888888888888	0.9	80	10836	4	10	76	10826	10916	0.11696117474094567
M1	string	0	network_modules	166	TRUE	8.696524569644464e-4	242	22	6	0.2727272727272727	0.024793388429752067	GO:0051056	GO:BP	regulation of small GTPase mediated signal transduction	16175	13466		0.5	0.6666666666666666	242	15933	6	16	236	15917	16175	0.07836065493274838
M1	string	0	network_modules	166	TRUE	0.0017226694444896678	97	14	4	0.2857142857142857	0.041237113402061855	REAC:R-HSA-193704	REAC	p75 NTR receptor-mediated signalling	10916	2721		1	1	97	10819	4	10	93	10809	10916	0.10570740970686049
M1	string	0	network_modules	166	TRUE	0.0023864290536104726	2	22	2	0.09090909090909091	1	GO:1904694	GO:BP	negative regulation of vascular associated smooth muscle contraction	16175	24031		1	1	2	16173	2	20	0	16153	16175	0.30132485807762605
M1	string	0	network_modules	166	TRUE	0.0065312840960437026	136	7	3	0.42857142857142855	0.022058823529411766	KEGG:05135	KEGG	Yersinia infection	8484	432		1	1	136	8348	3	4	133	8344	8484	0.09439202396791643
M1	string	0	network_modules	167	TRUE	1.881120119220727e-21	365	20	18	0.9	0.049315068493150684	KEGG:04080	KEGG	Neuroactive ligand-receptor interaction	8484	263		NA	1	365	8119	18	2	347	8117	8484	0.20530509140744474
M1	string	0	network_modules	167	TRUE	5.470687461229784e-20	195	21	15	0.7142857142857143	0.07692307692307693	REAC:R-HSA-375276	REAC	Peptide ligand-binding receptors	10916	1726		0	0.16666666666666666	195	10721	15	6	180	10715	10916	0.2308325785028601
M1	string	0	network_modules	167	TRUE	1.5629176234577084e-16	328	21	15	0.7142857142857143	0.04573170731707317	REAC:R-HSA-373076	REAC	Class A/1 (Rhodopsin-like receptors)	10916	365		0.2	0.3333333333333333	328	10588	15	6	313	10582	10916	0.1759636280965582
M1	string	0	network_modules	167	TRUE	4.0670033056148765e-16	460	21	16	0.7619047619047619	0.034782608695652174	REAC:R-HSA-500792	REAC	GPCR ligand binding	10916	1019		0.4	0.5	460	10456	16	5	444	10451	10916	0.1572854133252493
M1	string	0	network_modules	167	TRUE	4.1286912498874354e-11	774	25	15	0.6	0.01937984496124031	GO:0007186	GO:BP	G protein-coupled receptor signaling pathway	16175	2744		0	0.04	774	15401	15	10	759	15391	16175	0.10177447941320782
M1	string	0	network_modules	167	TRUE	2.784276460342519e-10	8	21	5	0.23809523809523808	0.625	REAC:R-HSA-389397	REAC	Orexin and neuropeptides FF and QRFP bind to their respective receptors	10916	1645		0.6	0.6666666666666666	8	10908	5	16	3	10892	10916	0.3850825744424474
M1	string	0	network_modules	167	TRUE	6.164453350594718e-10	46	25	7	0.28	0.15217391304347827	GO:0007631	GO:BP	feeding behavior	16175	3087		0.041666666666666664	0.08	46	16129	7	18	39	16111	16175	0.20477165628529434
M1	string	0	network_modules	167	TRUE	1.2149714822782145e-8	69	25	7	0.28	0.10144927536231885	GO:0007218	GO:BP	neuropeptide signaling pathway	16175	2772		0.08333333333333333	0.12	69	16106	7	18	62	16088	16175	0.16645628853446298
M1	string	0	network_modules	167	TRUE	2.630311465346269e-8	213	21	9	0.42857142857142855	0.04225352112676056	REAC:R-HSA-416476	REAC	G alpha (q) signalling events	10916	988		0.8	0.8333333333333334	213	10703	9	12	204	10691	10916	0.1298382694554827
M1	string	0	network_modules	167	TRUE	9.817356889153422e-6	583	25	10	0.4	0.017152658662092625	GO:0032940	GO:BP	secretion by cell	16175	7926		0.125	0.16	583	15592	10	15	573	15577	16175	0.0768232341464739
M1	string	0	network_modules	167	TRUE	1.861853022027406e-5	4	25	3	0.12	0.75	GO:2000851	GO:BP	positive regulation of glucocorticoid secretion	16175	26102		0.16666666666666666	0.32	4	16171	3	22	1	16149	16175	0.29965044535356145
M1	string	0	network_modules	167	TRUE	1.861853022027406e-5	4	25	3	0.12	0.75	GO:0043400	GO:BP	cortisol secretion	16175	10669		0.16666666666666666	0.32	4	16171	3	22	1	16149	16175	0.29965044535356145
M1	string	0	network_modules	167	TRUE	1.861853022027406e-5	4	25	3	0.12	0.75	GO:0051462	GO:BP	regulation of cortisol secretion	16175	13723		0.16666666666666666	0.32	4	16171	3	22	1	16149	16175	0.29965044535356145
M1	string	0	network_modules	167	TRUE	1.861853022027406e-5	4	25	3	0.12	0.75	GO:0051464	GO:BP	positive regulation of cortisol secretion	16175	13725		0.16666666666666666	0.32	4	16171	3	22	1	16149	16175	0.29965044535356145
M1	string	0	network_modules	167	TRUE	1.896660815861832e-5	312	21	8	0.38095238095238093	0.02564102564102564	REAC:R-HSA-418594	REAC	G alpha (i) signalling events	10916	987		1	1	312	10604	8	13	304	10591	10916	0.09284252046379696
M1	string	0	network_modules	167	TRUE	2.613002672349063e-5	646	25	10	0.4	0.015479876160990712	GO:0140352	GO:BP	export from cell	16175	19748		0.3333333333333333	0.36	646	15529	10	15	636	15514	16175	0.07234642966725312
M1	string	0	network_modules	167	TRUE	2.730660864587421e-5	649	25	10	0.4	0.015408320493066256	GO:0046903	GO:BP	secretion	16175	12430		0.375	0.4	649	15526	10	15	639	15511	16175	0.0721488147517457
M1	string	0	network_modules	167	TRUE	4.649883605893815e-5	5	25	3	0.12	0.6	GO:2000848	GO:BP	positive regulation of corticosteroid hormone secretion	16175	26099		0.4166666666666667	0.44	5	16170	3	22	2	16148	16175	0.26788542285229483
M1	string	0	network_modules	167	TRUE	6.596724747445044e-5	24	25	4	0.16	0.16666666666666666	GO:0140353	GO:BP	lipid export from cell	16175	19749		0.4583333333333333	0.48	24	16151	4	21	20	16130	16175	0.16203037324710862
M1	string	0	network_modules	167	TRUE	9.290279180855125e-5	6	25	3	0.12	0.5	GO:0035933	GO:BP	glucocorticoid secretion	16175	9353		0.5	0.56	6	16169	3	22	3	16147	16175	0.2444260585285185
M1	string	0	network_modules	167	TRUE	9.290279180855125e-5	6	25	3	0.12	0.5	GO:2000849	GO:BP	regulation of glucocorticoid secretion	16175	26100		0.5	0.56	6	16169	3	22	3	16147	16175	0.2444260585285185
M1	string	0	network_modules	167	TRUE	1.2013108497455599e-4	255	25	7	0.28	0.027450980392156862	GO:0007610	GO:BP	behavior	16175	3067		0.5833333333333334	0.6	255	15920	7	18	248	15902	16175	0.08345966495284962
M1	string	0	network_modules	167	TRUE	2.595973150559093e-4	8	25	3	0.12	0.375	GO:2000833	GO:BP	positive regulation of steroid hormone secretion	16175	26084		0.625	0.64	8	16167	3	22	5	16145	16175	0.2114734655362776
M1	string	0	network_modules	167	TRUE	3.8899871601792674e-4	9	25	3	0.12	0.3333333333333333	GO:0035930	GO:BP	corticosteroid hormone secretion	16175	9350		0.6666666666666666	0.72	9	16166	3	22	6	16144	16175	0.19928211379297658
M1	string	0	network_modules	167	TRUE	3.8899871601792674e-4	9	25	3	0.12	0.3333333333333333	GO:2000846	GO:BP	regulation of corticosteroid hormone secretion	16175	26097		0.6666666666666666	0.72	9	16166	3	22	6	16144	16175	0.19928211379297658
M1	string	0	network_modules	167	TRUE	0.0013190517910497343	13	25	3	0.12	0.23076923076923078	GO:2000831	GO:BP	regulation of steroid hormone secretion	16175	26082		0.75	0.76	13	16162	3	22	10	16140	16175	0.16548991892696704
M1	string	0	network_modules	167	TRUE	0.0016770806674558068	14	25	3	0.12	0.21428571428571427	GO:0035929	GO:BP	steroid hormone secretion	16175	9349		0.7916666666666666	0.8	14	16161	3	22	11	16139	16175	0.15939229457778828
M1	string	0	network_modules	167	TRUE	0.003276358997535711	2	25	2	0.08	1	GO:1902606	GO:BP	regulation of large conductance calcium-activated potassium channel activity	16175	22378		0.8333333333333334	0.88	2	16173	2	23	0	16150	16175	0.282641522315189
M1	string	0	network_modules	167	TRUE	0.003276358997535711	2	25	2	0.08	1	GO:1902608	GO:BP	positive regulation of large conductance calcium-activated potassium channel activity	16175	22380		0.8333333333333334	0.88	2	16173	2	23	0	16150	16175	0.282641522315189
M1	string	0	network_modules	167	TRUE	0.008085042301513865	23	25	3	0.12	0.13043478260869565	GO:0044060	GO:BP	regulation of endocrine process	16175	10895		0.9166666666666666	0.92	23	16152	3	22	20	16130	16175	0.12380987150270771
M1	string	0	network_modules	167	TRUE	0.008949572090753772	311	25	6	0.24	0.01929260450160772	GO:0023061	GO:BP	signal release	16175	6645		0.9583333333333334	0.96	311	15864	6	19	305	15845	16175	0.06325386190282478
M1	string	0	network_modules	167	TRUE	0.009734269564140235	81	25	4	0.16	0.04938271604938271	GO:0046887	GO:BP	positive regulation of hormone secretion	16175	12422		1	1	81	16094	4	21	77	16073	16175	0.08639001850379645
M1	string	0	network_modules	168	TRUE	5.115754554055161e-5	140	23	6	0.2608695652173913	0.04285714285714286	GO:0007189	GO:BP	adenylate cyclase-activating G protein-coupled receptor signaling pathway	16175	2747		0	0.2	140	16035	6	17	134	16018	16175	0.10274628910287421
M1	string	0	network_modules	168	TRUE	3.740726613060708e-4	63	17	4	0.23529411764705882	0.06349206349206349	KEGG:00561	KEGG	Glycerolipid metabolism	8484	85		0	0.25	63	8421	4	13	59	8408	8484	0.11893023790550872
M1	string	0	network_modules	168	TRUE	6.877705191786521e-4	217	23	6	0.2608695652173913	0.027649769585253458	GO:0007188	GO:BP	adenylate cyclase-modulating G protein-coupled receptor signaling pathway	16175	2746		0.25	0.4	217	15958	6	17	211	15941	16175	0.08116524141634344
M1	string	0	network_modules	168	TRUE	0.0010038187281704125	156	17	5	0.29411764705882354	0.03205128205128205	REAC:R-HSA-418555	REAC	G alpha (s) signalling events	10916	989		0	0.5	156	10760	5	12	151	10748	10916	0.09311408378610798
M1	string	0	network_modules	168	TRUE	0.0016459062926228692	56	23	4	0.17391304347826086	0.07142857142857142	GO:0007187	GO:BP	G protein-coupled receptor signaling pathway, coupled to cyclic nucleotide second messenger	16175	2745		0.5	0.6	56	16119	4	19	52	16100	16175	0.10950433668683521
M1	string	0	network_modules	168	TRUE	0.0029936675907090344	195	17	5	0.29411764705882354	0.02564102564102564	REAC:R-HSA-375276	REAC	Peptide ligand-binding receptors	10916	1726		1	1	195	10721	5	12	190	10709	10916	0.08236983974523653
M1	string	0	network_modules	168	TRUE	0.004270000937332811	20	23	3	0.13043478260869565	0.15	GO:0006670	GO:BP	sphingosine metabolic process	16175	2379		0.75	0.8	20	16155	3	20	17	16135	16175	0.13873415606930908
M1	string	0	network_modules	168	TRUE	0.0048037981049403235	43	17	3	0.17647058823529413	0.06976744186046512	KEGG:04975	KEGG	Fat digestion and absorption	8484	406		0.3333333333333333	0.5	43	8441	3	14	40	8427	8484	0.10815475456485528
M1	string	0	network_modules	168	TRUE	0.0057575537717758475	22	23	3	0.13043478260869565	0.13636363636363635	GO:0046519	GO:BP	sphingoid metabolic process	16175	12217		1	1	22	16153	3	20	19	16133	16175	0.13215941380754104
M1	string	0	network_modules	168	TRUE	0.007563496494545329	50	17	3	0.17647058823529413	0.06	KEGG:00565	KEGG	Ether lipid metabolism	8484	89		0.6666666666666666	0.75	50	8434	3	14	47	8420	8484	0.09985719743066389
M1	string	0	network_modules	168	TRUE	0.00952434429351182	54	17	3	0.17647058823529413	0.05555555555555555	KEGG:00600	KEGG	Sphingolipid metabolism	8484	95		1	1	54	8430	3	14	51	8416	8484	0.095844777415138
M1	string	0	network_modules	169	TRUE	3.7043313842064663e-13	12	14	6	0.42857142857142855	0.5	REAC:R-HSA-375281	REAC	Hormone ligand-binding receptors	10916	1131		0	0.125	12	10904	6	8	6	10896	10916	0.462273194933608
M1	string	0	network_modules	169	TRUE	1.866203683531493e-8	8	14	4	0.2857142857142857	0.5	KEGG:04122	KEGG	Sulfur relay system	8484	271		0	0.25	8	8476	4	10	4	8466	8484	0.37720615886932185
M1	string	0	network_modules	169	TRUE	2.9088754178139407e-8	5	24	4	0.16666666666666666	0.8	GO:0034227	GO:BP	tRNA thio-modification	16175	8510		0	0.08333333333333333	5	16170	4	20	1	16150	16175	0.3647982104044354
M1	string	0	network_modules	169	TRUE	6.647678258738615e-6	156	14	6	0.42857142857142855	0.038461538461538464	REAC:R-HSA-418555	REAC	G alpha (s) signalling events	10916	989		0.14285714285714285	0.25	156	10760	6	8	150	10752	10916	0.12508363436668582
M1	string	0	network_modules	169	TRUE	1.3682729925989265e-5	17	24	4	0.16666666666666666	0.23529411764705882	GO:0002098	GO:BP	tRNA wobble uridine modification	16175	681		0.09090909090909091	0.16666666666666666	17	16158	4	20	13	16138	16175	0.19703044763732533
M1	string	0	network_modules	169	TRUE	1.792116726740919e-5	4	24	3	0.125	0.75	GO:0002143	GO:BP	tRNA wobble position uridine thiolation	16175	711		0.18181818181818182	0.25	4	16171	3	21	1	16150	16175	0.3058452484972161
M1	string	0	network_modules	169	TRUE	2.7771520057808218e-5	20	24	4	0.16666666666666666	0.2	GO:0002097	GO:BP	tRNA wobble base modification	16175	680		0.2727272727272727	0.3333333333333333	20	16155	4	20	16	16135	16175	0.18146651247757528
M1	string	0	network_modules	169	TRUE	4.4778686690239045e-5	223	14	6	0.42857142857142855	0.026905829596412557	KEGG:04024	KEGG	cAMP signaling pathway	8484	252		0.3333333333333333	0.5	223	8261	6	8	217	8253	8484	0.10223270648237236
M1	string	0	network_modules	169	TRUE	5.246732180395515e-5	41	14	4	0.2857142857142857	0.0975609756097561	REAC:R-HSA-6782315	REAC	tRNA modification in the nucleus and cytosol	10916	2742		0.2857142857142857	0.375	41	10875	4	10	37	10865	10916	0.1651782369208893
M1	string	0	network_modules	169	TRUE	1.1540396568951454e-4	12	14	3	0.21428571428571427	0.25	REAC:R-HSA-209822	REAC	Glycoprotein hormones	10916	1075		0.42857142857142855	0.5	12	10904	3	11	9	10893	10916	0.23054219769374462
M1	string	0	network_modules	169	TRUE	1.9065245855680278e-4	14	14	3	0.21428571428571427	0.21428571428571427	REAC:R-HSA-209952	REAC	Peptide hormone biosynthesis	10916	1724		0.5714285714285714	0.625	14	10902	3	11	11	10891	10916	0.21327672510941637
M1	string	0	network_modules	169	TRUE	2.7531554853923155e-4	89	24	5	0.20833333333333334	0.056179775280898875	GO:0006400	GO:BP	tRNA modification	16175	2161		0.36363636363636365	0.4166666666666667	89	16086	5	19	84	16067	16175	0.10569769826025002
M1	string	0	network_modules	169	TRUE	5.416721292458652e-4	328	14	6	0.42857142857142855	0.018292682926829267	REAC:R-HSA-373076	REAC	Class A/1 (Rhodopsin-like receptors)	10916	365		0.7142857142857143	0.75	328	10588	6	8	322	10580	10916	0.08365363593045343
M1	string	0	network_modules	169	TRUE	7.858829247927455e-4	365	14	6	0.42857142857142855	0.01643835616438356	KEGG:04080	KEGG	Neuroactive ligand-receptor interaction	8484	263		0.6666666666666666	0.75	365	8119	6	8	359	8111	8484	0.07725118568109317
M1	string	0	network_modules	169	TRUE	0.0012261795236475942	120	24	5	0.20833333333333334	0.041666666666666664	GO:0008033	GO:BP	tRNA processing	16175	3098		0.45454545454545453	0.5	120	16055	5	19	115	16036	16175	0.09025383298770676
M1	string	0	network_modules	169	TRUE	0.0021885017105569586	103	14	4	0.2857142857142857	0.038834951456310676	REAC:R-HSA-72306	REAC	tRNA processing	10916	2743		0.8571428571428571	0.875	103	10813	4	10	99	10803	10916	0.10240707950118615
M1	string	0	network_modules	169	TRUE	0.0032968362412703106	2	24	2	0.08333333333333333	1	GO:0032447	GO:BP	protein urmylation	16175	7569		0.5454545454545454	0.5833333333333334	2	16173	2	22	0	16151	16175	0.28847872656338225
M1	string	0	network_modules	169	TRUE	0.0036063909603417355	18	24	3	0.125	0.16666666666666666	GO:0022602	GO:BP	ovulation cycle process	16175	6610		0.6363636363636364	0.6666666666666666	18	16157	3	21	15	16136	16175	0.1432385527576149
M1	string	0	network_modules	169	TRUE	0.003835297922073842	460	14	6	0.42857142857142855	0.013043478260869565	REAC:R-HSA-500792	REAC	GPCR ligand binding	10916	1019		1	1	460	10456	6	8	454	10448	10916	0.06892634000660738
M1	string	0	network_modules	169	TRUE	0.004100512275522749	51	14	3	0.21428571428571427	0.058823529411764705	KEGG:04913	KEGG	Ovarian steroidogenesis	8484	370		1	1	51	8433	3	11	48	8422	8484	0.10954251909639494
M1	string	0	network_modules	169	TRUE	0.004342352791560077	155	24	5	0.20833333333333334	0.03225806451612903	GO:0009451	GO:BP	RNA modification	16175	3498		0.7272727272727273	0.75	155	16020	5	19	150	16001	16175	0.07864328412093827
M1	string	0	network_modules	169	TRUE	0.006779710287488683	22	24	3	0.125	0.13636363636363635	GO:0042698	GO:BP	ovulation cycle	16175	10308		0.8181818181818182	0.8333333333333334	22	16153	3	21	19	16132	16175	0.1293215278126346
M1	string	0	network_modules	169	TRUE	0.007789075887658279	23	24	3	0.125	0.13043478260869565	GO:0001541	GO:BP	ovarian follicle development	16175	332		0.9090909090909091	0.9166666666666666	23	16152	3	21	20	16131	16175	0.12641961913648028
M1	string	0	network_modules	169	TRUE	0.009881539404908083	3	24	2	0.08333333333333333	0.6666666666666666	GO:0042699	GO:BP	follicle-stimulating hormone signaling pathway	16175	10309		1	1	3	16172	2	22	1	16150	16175	0.23537416597204877
M1	string	0	network_modules	170	TRUE	1.869686851658906e-17	53	17	10	0.5882352941176471	0.18867924528301888	REAC:R-HSA-9662361	REAC	Sensory processing of sound by outer hair cells of the cochlea	10916	2203		0	0.3333333333333333	53	10863	10	7	43	10856	10916	0.3314617352332283
M1	string	0	network_modules	170	TRUE	2.0076527778548664e-16	66	17	10	0.5882352941176471	0.15151515151515152	REAC:R-HSA-9662360	REAC	Sensory processing of sound by inner hair cells of the cochlea	10916	2202		0.5	0.6666666666666666	66	10850	10	7	56	10843	10916	0.2966005227226319
M1	string	0	network_modules	170	TRUE	6.804234045375492e-16	74	17	10	0.5882352941176471	0.13513513513513514	REAC:R-HSA-9659379	REAC	Sensory processing of sound	10916	2201		1	1	74	10842	10	7	64	10835	10916	0.279860203913125
M1	string	0	network_modules	170	TRUE	1.1715892500629609e-15	101	24	11	0.4583333333333333	0.10891089108910891	GO:0007605	GO:BP	sensory perception of sound	16175	3064		0	0.030303030303030304	101	16074	11	13	90	16061	16175	0.2212338601515209
M1	string	0	network_modules	170	TRUE	2.2738360670132967e-15	107	24	11	0.4583333333333333	0.102803738317757	GO:0050954	GO:BP	sensory perception of mechanical stimulus	16175	13396		0.03125	0.06060606060606061	107	16068	11	13	96	16055	16175	0.2148052923107909
M1	string	0	network_modules	170	TRUE	8.717991818213654e-8	6	24	4	0.16666666666666666	0.6666666666666666	GO:1904970	GO:BP	brush border assembly	16175	24257		0.0625	0.09090909090909091	6	16169	4	20	2	16149	16175	0.33290021664463487
M1	string	0	network_modules	170	TRUE	1.0956254959282587e-7	529	24	11	0.4583333333333333	0.020793950850661626	GO:0007600	GO:BP	sensory perception	16175	3059		0.09375	0.12121212121212122	529	15646	11	13	518	15633	16175	0.09224682897676914
M1	string	0	network_modules	170	TRUE	1.8653516105412284e-7	22	24	5	0.20833333333333334	0.22727272727272727	GO:0042490	GO:BP	mechanoreceptor differentiation	16175	10219		0.125	0.15151515151515152	22	16153	5	19	17	16134	16175	0.21648429683442197
M1	string	0	network_modules	170	TRUE	2.0321853621671478e-7	7	24	4	0.16666666666666666	0.5714285714285714	GO:0050957	GO:BP	equilibrioception	16175	13399		0.15625	0.18181818181818182	7	16168	4	20	3	16148	16175	0.30810065773348627
M1	string	0	network_modules	170	TRUE	5.9086619355283905e-6	42	24	5	0.20833333333333334	0.11904761904761904	GO:0001895	GO:BP	retina homeostasis	16175	520		0.1875	0.21212121212121213	42	16133	5	19	37	16114	16175	0.15584031954857128
M1	string	0	network_modules	170	TRUE	7.863001877529722e-6	15	24	4	0.16666666666666666	0.26666666666666666	GO:0050885	GO:BP	neuromuscular process controlling balance	16175	13329		0.21875	0.24242424242424243	15	16160	4	20	11	16140	16175	0.20989854079427026
M1	string	0	network_modules	170	TRUE	9.44479305848203e-6	806	24	11	0.4583333333333333	0.013647642679900745	GO:0050877	GO:BP	nervous system process	16175	13322		0.25	0.2727272727272727	806	15369	11	13	795	15356	16175	0.07236948740697624
M1	string	0	network_modules	170	TRUE	1.7574672977911386e-5	18	24	4	0.16666666666666666	0.2222222222222222	GO:0032528	GO:BP	microvillus organization	16175	7622		0.28125	0.30303030303030304	18	16157	4	20	14	16137	16175	0.19141362170433107
M1	string	0	network_modules	170	TRUE	1.792116726740919e-5	4	24	3	0.125	0.75	GO:0032532	GO:BP	regulation of microvillus length	16175	7626		0.3125	0.36363636363636365	4	16171	3	21	1	16150	16175	0.3058452484972161
M1	string	0	network_modules	170	TRUE	1.792116726740919e-5	4	24	3	0.125	0.75	GO:0032536	GO:BP	regulation of cell projection size	16175	7630		0.3125	0.36363636363636365	4	16171	3	21	1	16150	16175	0.3058452484972161
M1	string	0	network_modules	170	TRUE	2.2239223453534354e-5	19	24	4	0.16666666666666666	0.21052631578947367	GO:0060113	GO:BP	inner ear receptor cell differentiation	16175	14359		0.375	0.3939393939393939	19	16156	4	20	15	16136	16175	0.186244527810873
M1	string	0	network_modules	170	TRUE	4.4073906133118575e-5	62	24	5	0.20833333333333334	0.08064516129032258	GO:0048839	GO:BP	inner ear development	16175	13083		0.40625	0.42424242424242425	62	16113	5	19	57	16094	16175	0.12757336549407955
M1	string	0	network_modules	170	TRUE	5.060628635801422e-5	23	24	4	0.16666666666666666	0.17391304347826086	GO:0035315	GO:BP	hair cell differentiation	16175	8965		0.4375	0.45454545454545453	23	16152	4	20	19	16132	16175	0.1690443734677201
M1	string	0	network_modules	170	TRUE	6.691364987201554e-5	139	24	6	0.25	0.04316546762589928	GO:0050953	GO:BP	sensory perception of light stimulus	16175	13395		0.46875	0.48484848484848486	139	16036	6	18	133	16018	16175	0.10081931025983734
M1	string	0	network_modules	170	TRUE	9.436578599033047e-5	72	24	5	0.20833333333333334	0.06944444444444445	GO:0043583	GO:BP	ear development	16175	10787		0.5	0.5151515151515151	72	16103	5	19	67	16084	16175	0.11806182271098369
M1	string	0	network_modules	170	TRUE	1.77271620720148e-4	279	24	7	0.2916666666666667	0.025089605734767026	GO:0007423	GO:BP	sensory organ development	16175	2918		0.53125	0.5454545454545454	279	15896	7	17	272	15879	16175	0.08124871333409975
M1	string	0	network_modules	170	TRUE	2.3155350559415187e-4	33	24	4	0.16666666666666666	0.12121212121212122	GO:0045494	GO:BP	photoreceptor cell maintenance	16175	11413		0.5625	0.5757575757575758	33	16142	4	20	29	16122	16175	0.14064174805694146
M1	string	0	network_modules	170	TRUE	2.95702699034101e-4	35	24	4	0.16666666666666666	0.11428571428571428	GO:0042472	GO:BP	inner ear morphogenesis	16175	10205		0.59375	0.6060606060606061	35	16140	4	20	31	16120	16175	0.13647019038274022
M1	string	0	network_modules	170	TRUE	3.7451554401581413e-4	9	24	3	0.125	0.3333333333333333	GO:0032530	GO:BP	regulation of microvillus organization	16175	7624		0.625	0.6363636363636364	9	16166	3	21	6	16145	16175	0.2034230568890601
M1	string	0	network_modules	170	TRUE	5.685335597441884e-4	41	24	4	0.16666666666666666	0.0975609756097561	GO:0042471	GO:BP	ear morphogenesis	16175	10204		0.65625	0.6666666666666666	41	16134	4	20	37	16114	16175	0.12582884770433553
M1	string	0	network_modules	170	TRUE	0.0011762436886734971	119	24	5	0.20833333333333334	0.04201680672268908	GO:0090596	GO:BP	sensory organ morphogenesis	16175	18358		0.6875	0.696969696969697	119	16056	5	19	114	16037	16175	0.09065732277126501
M1	string	0	network_modules	170	TRUE	0.001270176640289424	13	24	3	0.125	0.23076923076923078	GO:0060122	GO:BP	inner ear receptor cell stereocilium organization	16175	14368		0.71875	0.7272727272727273	13	16162	3	21	10	16141	16175	0.1689427654824629
M1	string	0	network_modules	170	TRUE	0.0016150142932310726	14	24	3	0.125	0.21428571428571427	GO:0042491	GO:BP	inner ear auditory receptor cell differentiation	16175	10220		0.75	0.7575757575757576	14	16161	3	21	11	16140	16175	0.16272131740802678
M1	string	0	network_modules	170	TRUE	0.0016170891087751973	193	9	4	0.4444444444444444	0.02072538860103627	KEGG:04814	KEGG	Motor proteins	8484	366		NA	1	193	8291	4	5	189	8286	8484	0.09216566560703329
M1	string	0	network_modules	170	TRUE	0.0020168021160694542	15	24	3	0.125	0.2	GO:0060119	GO:BP	inner ear receptor cell development	16175	14365		0.78125	0.7878787878787878	15	16160	3	21	12	16139	16175	0.15713029557594074
M1	string	0	network_modules	170	TRUE	0.0032968362412703106	2	24	2	0.08333333333333333	1	GO:0090675	GO:BP	intermicrovillar adhesion	16175	18405		0.8125	0.8181818181818182	2	16173	2	22	0	16151	16175	0.28847872656338225
M1	string	0	network_modules	170	TRUE	0.0036063909603417355	18	24	3	0.125	0.16666666666666666	GO:0030050	GO:BP	vesicle transport along actin filament	16175	6669		0.84375	0.8484848484848485	18	16157	3	21	15	16136	16175	0.1432385527576149
M1	string	0	network_modules	170	TRUE	0.003944586604494704	152	24	5	0.20833333333333334	0.03289473684210526	GO:0060249	GO:BP	anatomical structure homeostasis	16175	14466		0.875	0.9090909090909091	152	16023	5	19	147	16004	16175	0.07948224485517424
M1	string	0	network_modules	170	TRUE	0.003944586604494704	152	24	5	0.20833333333333334	0.03289473684210526	GO:0001894	GO:BP	tissue homeostasis	16175	519		0.875	0.9090909090909091	152	16023	5	19	147	16004	16175	0.07948224485517424
M1	string	0	network_modules	170	TRUE	0.00502853374470541	20	24	3	0.125	0.15	GO:0099515	GO:BP	actin filament-based transport	16175	19105		0.9375	0.9393939393939394	20	16155	3	21	17	16134	16175	0.13576080024891163
M1	string	0	network_modules	170	TRUE	0.005601029017068555	72	24	4	0.16666666666666666	0.05555555555555555	GO:0050905	GO:BP	neuromuscular process	16175	13347		0.96875	0.9696969696969697	72	16103	4	20	68	16083	16175	0.09393393432165546
M1	string	0	network_modules	170	TRUE	0.009881539404908083	3	24	2	0.08333333333333333	0.6666666666666666	GO:0009258	GO:BP	10-formyltetrahydrofolate catabolic process	16175	3423		1	1	3	16172	2	22	1	16150	16175	0.23537416597204877
M1	string	0	network_modules	171	TRUE	6.465917782354697e-4	397	21	7	0.3333333333333333	0.017632241813602016	GO:0008380	GO:BP	RNA splicing	16175	3186		NA	1	397	15778	7	14	390	15764	16175	0.07195399116237557
M1	string	0	network_modules	171	TRUE	0.003704804602453574	202	9	4	0.4444444444444444	0.019801980198019802	REAC:R-HSA-72163	REAC	mRNA Splicing - Major Pathway	10916	2707		0	0.5	202	10714	4	5	198	10709	10916	0.0907880177077085
M1	string	0	network_modules	171	TRUE	0.004238904221897938	209	9	4	0.4444444444444444	0.019138755980861243	REAC:R-HSA-72172	REAC	mRNA Splicing	10916	2706		1	1	209	10707	4	5	205	10702	10916	0.08914944898364399
M1	string	0	network_modules	172	TRUE	2.854394113873875e-8	94	21	7	0.3333333333333333	0.07446808510638298	GO:0006493	GO:BP	protein O-linked glycosylation	16175	2225		0	0.09090909090909091	94	16081	7	14	87	16067	16175	0.15535805805352615
M1	string	0	network_modules	172	TRUE	3.1638565458538568e-6	183	21	7	0.3333333333333333	0.03825136612021858	GO:0043413	GO:BP	macromolecule glycosylation	16175	10680		0.1	0.2727272727272727	183	15992	7	14	176	15978	16175	0.10977899179594887
M1	string	0	network_modules	172	TRUE	3.1638565458538568e-6	183	21	7	0.3333333333333333	0.03825136612021858	GO:0006486	GO:BP	protein glycosylation	16175	2220		0.1	0.2727272727272727	183	15992	7	14	176	15978	16175	0.10977899179594887
M1	string	0	network_modules	172	TRUE	6.7414105487063095e-6	204	21	7	0.3333333333333333	0.03431372549019608	GO:0070085	GO:BP	glycosylation	16175	15903		0.3	0.36363636363636365	204	15971	7	14	197	15957	16175	0.10362404289012861
M1	string	0	network_modules	172	TRUE	1.5294102485521784e-5	36	14	4	0.2857142857142857	0.1111111111111111	KEGG:00512	KEGG	Mucin type O-glycan biosynthesis	8484	65		0	0.3333333333333333	36	8448	4	10	32	8438	8484	0.1760469203274353
M1	string	0	network_modules	172	TRUE	3.3451447263879486e-5	108	13	5	0.38461538461538464	0.046296296296296294	REAC:R-HSA-5173105	REAC	O-linked glycosylation	10916	1631		0	0.5	108	10808	5	8	103	10800	10916	0.13073336440124197
M1	string	0	network_modules	172	TRUE	4.114085545383556e-5	265	21	7	0.3333333333333333	0.026415094339622643	GO:0009101	GO:BP	glycoprotein biosynthetic process	16175	3273		0.4	0.45454545454545453	265	15910	7	14	258	15896	16175	0.0900215864103721
M1	string	0	network_modules	172	TRUE	1.3446629211225246e-4	315	21	7	0.3333333333333333	0.022222222222222223	GO:0009100	GO:BP	glycoprotein metabolic process	16175	3272		0.5	0.5454545454545454	315	15860	7	14	308	15846	16175	0.08189198313567567
M1	string	0	network_modules	172	TRUE	2.0807115847856108e-4	62	13	4	0.3076923076923077	0.06451612903225806	REAC:R-HSA-913709	REAC	O-linked glycosylation of mucins	10916	1632		1	1	62	10854	4	9	58	10845	10916	0.1387702801164181
M1	string	0	network_modules	172	TRUE	2.7371017130311593e-4	40	21	4	0.19047619047619047	0.1	GO:0016266	GO:BP	O-glycan processing	16175	5194		0.6	0.6363636363636364	40	16135	4	17	36	16118	16175	0.1364786591376327
M1	string	0	network_modules	172	TRUE	3.583586870258076e-4	23	14	3	0.21428571428571427	0.13043478260869565	KEGG:00515	KEGG	Mannose type O-glycan biosynthesis	8484	68		0.5	0.6666666666666666	23	8461	3	11	20	8450	8484	0.16542913543916385
M1	string	0	network_modules	172	TRUE	0.0018641168156595608	17	21	3	0.14285714285714285	0.17647058823529413	GO:0035269	GO:BP	protein O-linked mannosylation	16175	8933		0.7	0.8181818181818182	17	16158	3	18	14	16140	16175	0.15779406522265696
M1	string	0	network_modules	172	TRUE	0.0018641168156595608	17	21	3	0.14285714285714285	0.17647058823529413	GO:0035268	GO:BP	protein mannosylation	16175	8932		0.7	0.8181818181818182	17	16158	3	18	14	16140	16175	0.15779406522265696
M1	string	0	network_modules	172	TRUE	0.0022350730008551182	18	21	3	0.14285714285714285	0.16666666666666666	GO:0097502	GO:BP	mannosylation	16175	18684		0.9	0.9090909090909091	18	16157	3	18	15	16139	16175	0.1532861548213182
M1	string	0	network_modules	172	TRUE	0.003205257762086875	47	14	3	0.21428571428571427	0.06382978723404255	KEGG:00514	KEGG	Other types of O-glycan biosynthesis	8484	67		1	1	47	8437	3	11	44	8426	8484	0.11433992956382405
M1	string	0	network_modules	172	TRUE	0.0036463711675750153	514	21	7	0.3333333333333333	0.013618677042801557	GO:1901137	GO:BP	carbohydrate derivative biosynthetic process	16175	21245		1	1	514	15661	7	14	507	15647	16175	0.06198554466558811
M1	string	0	network_modules	173	TRUE	1.2991511466685919e-5	46	26	5	0.19230769230769232	0.10869565217391304	GO:0048709	GO:BP	oligodendrocyte differentiation	16175	12966		0	0.1	46	16129	5	21	41	16108	16175	0.14275842465361757
M1	string	0	network_modules	173	TRUE	1.9924500721055276e-4	156	26	6	0.23076923076923078	0.038461538461538464	GO:0042063	GO:BP	gliogenesis	16175	9949		0.1111111111111111	0.2	156	16019	6	20	150	15999	16175	0.09078528003437471
M1	string	0	network_modules	173	TRUE	4.49360383431527e-4	179	26	6	0.23076923076923078	0.0335195530726257	GO:0043009	GO:BP	chordate embryonic development	16175	10479		0.2222222222222222	0.3	179	15996	6	20	173	15976	16175	0.08426776310936315
M1	string	0	network_modules	173	TRUE	7.214526780594662e-4	194	26	6	0.23076923076923078	0.030927835051546393	GO:0009792	GO:BP	embryo development ending in birth or egg hatching	16175	3679		0.3333333333333333	0.4	194	15981	6	20	188	15961	16175	0.08064061254421043
M1	string	0	network_modules	173	TRUE	0.0015991993309985506	119	26	5	0.19230769230769232	0.04201680672268908	GO:0010001	GO:BP	glial cell differentiation	16175	3822		0.4444444444444444	0.5	119	16056	5	21	114	16035	16175	0.08684041109767138
M1	string	0	network_modules	173	TRUE	0.0018712357345051357	52	26	4	0.15384615384615385	0.07692307692307693	GO:0001701	GO:BP	in utero embryonic development	16175	393		0.5555555555555556	0.6	52	16123	4	22	48	16101	16175	0.106769895579598
M1	string	0	network_modules	173	TRUE	0.002850310373695999	103	7	3	0.42857142857142855	0.02912621359223301	KEGG:04137	KEGG	Mitophagy - animal	8484	274		NA	1	103	8381	3	4	100	8377	8484	0.10927102908979812
M1	string	0	network_modules	173	TRUE	0.003126603805652688	791	26	9	0.34615384615384615	0.011378002528445006	GO:0000122	GO:BP	negative regulation of transcription by RNA polymerase II	16175	48		0.6666666666666666	0.7	791	15384	9	17	782	15367	16175	0.05530430162266251
M1	string	0	network_modules	173	TRUE	0.003450794777497106	2	26	2	0.07692307692307693	1	GO:0021529	GO:BP	spinal cord oligodendrocyte cell differentiation	16175	6113		0.7777777777777778	0.8	2	16173	2	24	0	16149	16175	0.27714423421480233
M1	string	0	network_modules	173	TRUE	0.0037628687032901405	593	26	8	0.3076923076923077	0.013490725126475547	GO:0007417	GO:BP	central nervous system development	16175	2912		0.8888888888888888	0.9	593	15582	8	18	585	15564	16175	0.057867915039327145
M1	string	0	network_modules	173	TRUE	0.006479580224185338	283	26	6	0.23076923076923078	0.02120141342756184	GO:0001501	GO:BP	skeletal system development	16175	318		1	1	283	15892	6	20	277	15872	16175	0.06526971570501314
M1	string	0	network_modules	173	TRUE	0.009510853417146718	10	10	2	0.2	0.2	REAC:R-HSA-9832991	REAC	Formation of the posterior neural plate	10916	972		NA	1	10	10906	2	8	8	10898	10916	0.19926645883000182
M1	string	0	network_modules	174	TRUE	6.901420007193798e-12	64	17	8	0.47058823529411764	0.125	REAC:R-HSA-373755	REAC	Semaphorin interactions	10916	2193		0	0.125	64	10852	8	9	56	10843	10916	0.2404064311278447
M1	string	0	network_modules	174	TRUE	2.461077959533569e-10	42	24	7	0.2916666666666667	0.16666666666666666	GO:0071526	GO:BP	semaphorin-plexin signaling pathway	16175	16747		0	0.019230769230769232	42	16133	7	17	35	16116	16175	0.21896319053904645
M1	string	0	network_modules	174	TRUE	4.745000121476603e-10	181	16	9	0.5625	0.049723756906077346	KEGG:04360	KEGG	Axon guidance	8484	305		NA	1	181	8303	9	7	172	8296	8484	0.1627959894349594
M1	string	0	network_modules	174	TRUE	1.5651559925235098e-9	99	24	8	0.3333333333333333	0.08080808080808081	GO:0050770	GO:BP	regulation of axonogenesis	16175	13244		0.0196078431372549	0.038461538461538464	99	16076	8	16	91	16060	16175	0.16172377087395579
M1	string	0	network_modules	174	TRUE	1.8349264775825127e-8	19	17	5	0.29411764705882354	0.2631578947368421	REAC:R-HSA-416700	REAC	Other semaphorin interactions	10916	1652		0.14285714285714285	0.25	19	10897	5	12	14	10885	10916	0.2770178243011048
M1	string	0	network_modules	174	TRUE	6.284696415744652e-8	449	17	10	0.5882352941176471	0.022271714922048998	REAC:R-HSA-9012999	REAC	RHO GTPase cycle	10916	1847		0.2857142857142857	0.375	449	10467	10	7	439	10460	10916	0.10880014744921207
M1	string	0	network_modules	174	TRUE	9.889985542006288e-8	165	24	8	0.3333333333333333	0.048484848484848485	GO:0007411	GO:BP	axon guidance	16175	2906		0.0392156862745098	0.07692307692307693	165	16010	8	16	157	15994	16175	0.12396328540598334
M1	string	0	network_modules	174	TRUE	9.889985542006288e-8	165	24	8	0.3333333333333333	0.048484848484848485	GO:0097485	GO:BP	neuron projection guidance	16175	18673		0.0392156862745098	0.07692307692307693	165	16010	8	16	157	15994	16175	0.12396328540598334
M1	string	0	network_modules	174	TRUE	1.0141707750959296e-7	379	24	10	0.4166666666666667	0.026385224274406333	GO:0048667	GO:BP	cell morphogenesis involved in neuron differentiation	16175	12925		0.0784313725490196	0.09615384615384616	379	15796	10	14	369	15782	16175	0.1002096837806219
M1	string	0	network_modules	174	TRUE	2.7082595406518356e-7	761	24	12	0.5	0.01576872536136662	GO:0048666	GO:BP	neuron development	16175	12924		0.09803921568627451	0.11538461538461539	761	15414	12	12	749	15402	16175	0.08246173355306276
M1	string	0	network_modules	174	TRUE	3.1771346949935783e-7	295	24	9	0.375	0.030508474576271188	GO:0010975	GO:BP	regulation of neuron projection development	16175	4551		0.11764705882352941	0.1346153846153846	295	15880	9	15	286	15865	16175	0.10277618862126223
M1	string	0	network_modules	174	TRUE	3.373445780826375e-7	297	24	9	0.375	0.030303030303030304	GO:0007409	GO:BP	axonogenesis	16175	2905		0.13725490196078433	0.15384615384615385	297	15878	9	15	288	15863	16175	0.1024005045702381
M1	string	0	network_modules	174	TRUE	4.465082589245766e-7	441	24	10	0.4166666666666667	0.022675736961451247	GO:0048812	GO:BP	neuron projection morphogenesis	16175	13058		0.1568627450980392	0.17307692307692307	441	15734	10	14	431	15720	16175	0.09217431616698199
M1	string	0	network_modules	174	TRUE	6.184792266132513e-7	456	24	10	0.4166666666666667	0.021929824561403508	GO:0120039	GO:BP	plasma membrane bounded cell projection morphogenesis	16175	19473		0.17647058823529413	0.19230769230769232	456	15719	10	14	446	15705	16175	0.09047287953338341
M1	string	0	network_modules	174	TRUE	6.733384635163485e-7	460	24	10	0.4166666666666667	0.021739130434782608	GO:0048858	GO:BP	cell projection morphogenesis	16175	13102		0.19607843137254902	0.21153846153846154	460	15715	10	14	450	15701	16175	0.09003277410335282
M1	string	0	network_modules	174	TRUE	1.0870230452689431e-6	339	24	9	0.375	0.02654867256637168	GO:0061564	GO:BP	axon development	16175	15561		0.21568627450980393	0.23076923076923078	339	15836	9	15	330	15821	16175	0.0952756809724119
M1	string	0	network_modules	174	TRUE	1.6842260690047422e-6	684	24	11	0.4583333333333333	0.01608187134502924	GO:0031175	GO:BP	neuron projection development	16175	7086		0.23529411764705882	0.25	684	15491	11	13	673	15478	16175	0.07969363215861586
M1	string	0	network_modules	174	TRUE	9.483859176394381e-6	46	24	5	0.20833333333333334	0.10869565217391304	GO:0050772	GO:BP	positive regulation of axonogenesis	16175	13246		0.2549019607843137	0.2692307692307692	46	16129	5	19	41	16110	16175	0.14875003278863108
M1	string	0	network_modules	174	TRUE	1.3987375042074025e-5	24	17	4	0.23529411764705882	0.16666666666666666	REAC:R-HSA-400685	REAC	Sema4D in semaphorin signaling	10916	2190		0.42857142857142855	0.5	24	10892	4	13	20	10879	10916	0.1965482278409663
M1	string	0	network_modules	174	TRUE	1.7608172421515096e-5	466	24	9	0.375	0.019313304721030045	GO:0120035	GO:BP	regulation of plasma membrane bounded cell projection organization	16175	19471		0.27450980392156865	0.28846153846153844	466	15709	9	15	457	15694	16175	0.07978066057651696
M1	string	0	network_modules	174	TRUE	1.9139073705580868e-5	651	24	10	0.4166666666666667	0.015360983102918587	GO:0000902	GO:BP	cell morphogenesis	16175	240		0.29411764705882354	0.3076923076923077	651	15524	10	14	641	15510	16175	0.07382948780438338
M1	string	0	network_modules	174	TRUE	2.2761929089184603e-5	480	24	9	0.375	0.01875	GO:0031344	GO:BP	regulation of cell projection organization	16175	7135		0.3137254901960784	0.3269230769230769	480	15695	9	15	471	15680	16175	0.07844701247726756
M1	string	0	network_modules	174	TRUE	2.7771520057808218e-5	20	24	4	0.16666666666666666	0.2	GO:0048843	GO:BP	negative regulation of axon extension involved in axon guidance	16175	13087		0.3333333333333333	0.34615384615384615	20	16155	4	20	16	16135	16175	0.18146651247757528
M1	string	0	network_modules	174	TRUE	2.9137780173951446e-5	121	24	6	0.25	0.049586776859504134	GO:0008361	GO:BP	regulation of cell size	16175	3180		0.35294117647058826	0.36538461538461536	121	16054	6	18	115	16036	16175	0.10849562573180378
M1	string	0	network_modules	174	TRUE	3.47743880354021e-5	220	24	7	0.2916666666666667	0.031818181818181815	GO:0050767	GO:BP	regulation of neurogenesis	16175	13241		0.37254901960784315	0.38461538461538464	220	15955	7	17	213	15938	16175	0.09254169644108584
M1	string	0	network_modules	174	TRUE	5.828615162144252e-5	8	17	3	0.17647058823529413	0.375	REAC:R-HSA-416550	REAC	Sema4D mediated inhibition of cell attachment and migration	10916	2192		0.5714285714285714	0.625	8	10908	3	14	5	10894	10916	0.2564732578983867
M1	string	0	network_modules	174	TRUE	6.066744668659922e-5	24	24	4	0.16666666666666666	0.16666666666666666	GO:0048841	GO:BP	regulation of axon extension involved in axon guidance	16175	13085		0.39215686274509803	0.40384615384615385	24	16151	4	20	20	16131	16175	0.1654283532495408
M1	string	0	network_modules	174	TRUE	8.842155803284432e-5	252	24	7	0.2916666666666667	0.027777777777777776	GO:0031346	GO:BP	positive regulation of cell projection organization	16175	7137		0.4117647058823529	0.4230769230769231	252	15923	7	17	245	15906	16175	0.08593766495757636
M1	string	0	network_modules	174	TRUE	1.1861565547862e-4	153	24	6	0.25	0.0392156862745098	GO:0051962	GO:BP	positive regulation of nervous system development	16175	14031		0.43137254901960786	0.4423076923076923	153	16022	6	18	147	16004	16175	0.09579330544840318
M1	string	0	network_modules	174	TRUE	1.2111798030807824e-4	407	24	8	0.3333333333333333	0.019656019656019656	GO:0007015	GO:BP	actin filament organization	16175	2624		0.45098039215686275	0.46153846153846156	407	15768	8	16	399	15752	16175	0.07585016391176069
M1	string	0	network_modules	174	TRUE	1.2800000180229117e-4	266	24	7	0.2916666666666667	0.02631578947368421	GO:0051960	GO:BP	regulation of nervous system development	16175	14029		0.47058823529411764	0.4807692307692308	266	15909	7	17	259	15892	16175	0.08342003266703434
M1	string	0	network_modules	174	TRUE	1.3493286859527135e-4	29	24	4	0.16666666666666666	0.13793103448275862	GO:0048846	GO:BP	axon extension involved in axon guidance	16175	13090		0.49019607843137253	0.5192307692307693	29	16146	4	20	25	16126	16175	0.15023472075636082
M1	string	0	network_modules	174	TRUE	1.3493286859527135e-4	29	24	4	0.16666666666666666	0.13793103448275862	GO:1902284	GO:BP	neuron projection extension involved in neuron projection guidance	16175	22177		0.49019607843137253	0.5192307692307693	29	16146	4	20	25	16126	16175	0.15023472075636082
M1	string	0	network_modules	174	TRUE	1.595292300258891e-4	43	17	4	0.23529411764705882	0.09302325581395349	REAC:R-HSA-9696270	REAC	RND2 GTPase cycle	10916	1906		0.7142857142857143	0.75	43	10873	4	13	39	10860	10916	0.145869511196952
M1	string	0	network_modules	174	TRUE	2.0368800490149402e-4	32	24	4	0.16666666666666666	0.125	GO:0030517	GO:BP	negative regulation of axon extension	16175	6832		0.5294117647058824	0.5384615384615384	32	16143	4	20	28	16123	16175	0.1428715804112155
M1	string	0	network_modules	174	TRUE	3.469648021737895e-4	52	17	4	0.23529411764705882	0.07692307692307693	REAC:R-HSA-9013405	REAC	RHOD GTPase cycle	10916	1866		0.8571428571428571	0.875	52	10864	4	13	48	10851	10916	0.13222891762083436
M1	string	0	network_modules	174	TRUE	3.7225067479315904e-4	37	24	4	0.16666666666666666	0.10810810810810811	GO:0090497	GO:BP	mesenchymal cell migration	16175	18319		0.5490196078431373	0.5769230769230769	37	16138	4	20	33	16118	16175	0.13263902154438909
M1	string	0	network_modules	174	TRUE	3.7225067479315904e-4	37	24	4	0.16666666666666666	0.10810810810810811	GO:0001755	GO:BP	neural crest cell migration	16175	424		0.5490196078431373	0.5769230769230769	37	16138	4	20	33	16118	16175	0.13263902154438909
M1	string	0	network_modules	174	TRUE	3.7451554401581413e-4	9	24	3	0.125	0.3333333333333333	GO:1902287	GO:BP	semaphorin-plexin signaling pathway involved in axon guidance	16175	22180		0.5882352941176471	0.6153846153846154	9	16166	3	21	6	16145	16175	0.2034230568890601
M1	string	0	network_modules	174	TRUE	3.7451554401581413e-4	9	24	3	0.125	0.3333333333333333	GO:1902285	GO:BP	semaphorin-plexin signaling pathway involved in neuron projection guidance	16175	22178		0.5882352941176471	0.6153846153846154	9	16166	3	21	6	16145	16175	0.2034230568890601
M1	string	0	network_modules	174	TRUE	6.914575069080787e-4	43	24	4	0.16666666666666666	0.09302325581395349	GO:0050771	GO:BP	negative regulation of axonogenesis	16175	13245		0.6274509803921569	0.6346153846153846	43	16132	4	20	39	16112	16175	0.12278280302522317
M1	string	0	network_modules	174	TRUE	0.0011729108839143418	20	17	3	0.17647058823529413	0.15	REAC:R-HSA-416572	REAC	Sema4D induced cell migration and growth-cone collapse	10916	2191		1	1	20	10896	3	14	17	10882	10916	0.1612819991646386
M1	string	0	network_modules	174	TRUE	0.001281440419746232	50	24	4	0.16666666666666666	0.08	GO:0050922	GO:BP	negative regulation of chemotaxis	16175	13364		0.6470588235294118	0.6538461538461539	50	16125	4	20	46	16105	16175	0.11358828228005226
M1	string	0	network_modules	174	TRUE	0.00138278452369886	232	24	6	0.25	0.02586206896551724	GO:0007162	GO:BP	negative regulation of cell adhesion	16175	2726		0.6666666666666666	0.6730769230769231	232	15943	6	18	226	15925	16175	0.07640139806246976
M1	string	0	network_modules	174	TRUE	0.0013891227548571822	51	24	4	0.16666666666666666	0.0784313725490196	GO:0014032	GO:BP	neural crest cell development	16175	4602		0.6862745098039216	0.6923076923076923	51	16124	4	20	47	16104	16175	0.11243013684192836
M1	string	0	network_modules	174	TRUE	0.001624509615523333	53	24	4	0.16666666666666666	0.07547169811320754	GO:0048864	GO:BP	stem cell development	16175	13107		0.7058823529411765	0.7115384615384616	53	16122	4	20	49	16102	16175	0.11021185061745167
M1	string	0	network_modules	174	TRUE	0.0016245168312150153	127	24	5	0.20833333333333334	0.03937007874015748	GO:0050769	GO:BP	positive regulation of neurogenesis	16175	13243		0.7254901960784313	0.7307692307692307	127	16048	5	19	122	16029	16175	0.0875613890073999
M1	string	0	network_modules	174	TRUE	0.0017552687447024715	129	24	5	0.20833333333333334	0.03875968992248062	GO:0007266	GO:BP	Rho protein signal transduction	16175	2794		0.7450980392156863	0.75	129	16046	5	19	124	16027	16175	0.08683179454546669
M1	string	0	network_modules	174	TRUE	0.0017689640633952973	242	24	6	0.25	0.024793388429752067	GO:0051056	GO:BP	regulation of small GTPase mediated signal transduction	16175	13466		0.7647058823529411	0.7692307692307693	242	15933	6	18	236	15915	16175	0.07463336202964838
M1	string	0	network_modules	174	TRUE	0.0018941928348206048	131	24	5	0.20833333333333334	0.03816793893129771	GO:0031345	GO:BP	negative regulation of cell projection organization	16175	7136		0.7843137254901961	0.7884615384615384	131	16044	5	19	126	16025	16175	0.08611859800660884
M1	string	0	network_modules	174	TRUE	0.0023421019681164187	58	24	4	0.16666666666666666	0.06896551724137931	GO:0014033	GO:BP	neural crest cell differentiation	16175	4603		0.803921568627451	0.8269230769230769	58	16117	4	20	54	16097	16175	0.1051712811966921
M1	string	0	network_modules	174	TRUE	0.0023421019681164187	58	24	4	0.16666666666666666	0.06896551724137931	GO:0048640	GO:BP	negative regulation of developmental growth	16175	12898		0.803921568627451	0.8269230769230769	58	16117	4	20	54	16097	16175	0.1051712811966921
M1	string	0	network_modules	174	TRUE	0.0025099494621158825	59	24	4	0.16666666666666666	0.06779661016949153	GO:0030516	GO:BP	regulation of axon extension	16175	6831		0.8431372549019608	0.8461538461538461	59	16116	4	20	55	16096	16175	0.10423989308450525
M1	string	0	network_modules	174	TRUE	0.0025104412391885097	257	24	6	0.25	0.023346303501945526	GO:0032535	GO:BP	regulation of cellular component size	16175	7629		0.8627450980392157	0.8653846153846154	257	15918	6	18	251	15900	16175	0.07217083574998757
M1	string	0	network_modules	174	TRUE	0.00338703424912493	631	24	8	0.3333333333333333	0.012678288431061807	GO:0022603	GO:BP	regulation of anatomical structure morphogenesis	16175	6611		0.8823529411764706	0.8846153846153846	631	15544	8	16	623	15528	16175	0.058597301010358156
M1	string	0	network_modules	174	TRUE	0.0034273553414178723	632	24	8	0.3333333333333333	0.012658227848101266	GO:0030036	GO:BP	actin cytoskeleton organization	16175	6660		0.9019607843137255	0.9038461538461539	632	15543	8	16	624	15527	16175	0.058540508230119616
M1	string	0	network_modules	174	TRUE	0.003711647367798777	65	24	4	0.16666666666666666	0.06153846153846154	GO:0061387	GO:BP	regulation of extent of cell growth	16175	15458		0.9215686274509803	0.9230769230769231	65	16110	4	20	61	16090	16175	0.0991048251410368
M1	string	0	network_modules	174	TRUE	0.007331217501827521	77	24	4	0.16666666666666666	0.05194805194805195	GO:0048675	GO:BP	axon extension	16175	12933		0.9411764705882353	0.9423076923076923	77	16098	4	20	73	16078	16175	0.09067393186170822
M1	string	0	network_modules	174	TRUE	0.007973613978353665	708	24	8	0.3333333333333333	0.011299435028248588	GO:0030029	GO:BP	actin filament-based process	16175	6653		0.9607843137254902	0.9615384615384616	708	15467	8	16	700	15451	16175	0.05455973091477812
M1	string	0	network_modules	174	TRUE	0.008542609148804024	80	24	4	0.16666666666666666	0.05	GO:0050768	GO:BP	negative regulation of neurogenesis	16175	13242		0.9803921568627451	0.9807692307692307	80	16095	4	20	76	16075	16175	0.08886392631018665
M1	string	0	network_modules	174	TRUE	0.009881539404908083	3	24	2	0.08333333333333333	0.6666666666666666	GO:1905704	GO:BP	positive regulation of inhibitory synapse assembly	16175	24844		1	1	3	16172	2	22	1	16150	16175	0.23537416597204877
M1	string	0	network_modules	175	TRUE	2.1263392147336427e-9	128	17	8	0.47058823529411764	0.0625	REAC:R-HSA-6809371	REAC	Formation of the cornified envelope	10916	969		0	0.25	128	10788	8	9	120	10779	10916	0.16834553888344983
M1	string	0	network_modules	175	TRUE	1.38385231765368e-7	215	17	8	0.47058823529411764	0.037209302325581395	REAC:R-HSA-6805567	REAC	Keratinization	10916	1288		0.3333333333333333	0.5	215	10701	8	9	207	10692	10916	0.12815517306036728
M1	string	0	network_modules	175	TRUE	1.7124072246267938e-4	11	17	3	0.17647058823529413	0.2727272727272727	REAC:R-HSA-351906	REAC	Apoptotic cleavage of cell adhesion  proteins	10916	160		0.6666666666666666	0.75	11	10905	3	14	8	10891	10916	0.21840912037724391
M1	string	0	network_modules	175	TRUE	3.4797539645855895e-4	745	22	9	0.4090909090909091	0.012080536912751677	GO:0098609	GO:BP	cell-cell adhesion	16175	18805		NA	1	745	15430	9	13	736	15417	16175	0.06391650996990116
M1	string	0	network_modules	175	TRUE	0.007864527029876016	37	17	3	0.17647058823529413	0.08108108108108109	REAC:R-HSA-111465	REAC	Apoptotic cleavage of cellular proteins	10916	161		1	1	37	10879	3	14	34	10865	10916	0.11761125331052884
M1	string	0	network_modules	176	TRUE	1.3574531990275234e-6	12	20	4	0.2	0.3333333333333333	REAC:R-HSA-8866907	REAC	Activation of the TFAP2 (AP-2) family of transcription factors	10916	104		0	0.2	12	10904	4	16	8	10888	10916	0.25715663631504615
M1	string	0	network_modules	176	TRUE	1.9633773492431098e-4	38	20	4	0.2	0.10526315789473684	REAC:R-HSA-8864260	REAC	Transcriptional regulation by the AP-2 (TFAP2) family of transcription factors	10916	2556		0.25	0.4	38	10878	4	16	34	10862	10916	0.14294958974127753
M1	string	0	network_modules	176	TRUE	0.001624509615523333	53	24	4	0.16666666666666666	0.07547169811320754	GO:0140527	GO:BP	reciprocal homologous recombination	16175	19808		0	0.6666666666666666	53	16122	4	20	49	16102	16175	0.11021185061745167
M1	string	0	network_modules	176	TRUE	0.001624509615523333	53	24	4	0.16666666666666666	0.07547169811320754	GO:0007131	GO:BP	reciprocal meiotic recombination	16175	2702		0	0.6666666666666666	53	16122	4	20	49	16102	16175	0.11021185061745167
M1	string	0	network_modules	176	TRUE	0.0023116972571021674	154	20	5	0.25	0.032467532467532464	REAC:R-HSA-1474165	REAC	Reproduction	10916	2064		0.5	0.6	154	10762	5	15	149	10747	10916	0.08569427910123935
M1	string	0	network_modules	176	TRUE	0.0028722542402923744	61	24	4	0.16666666666666666	0.06557377049180328	GO:0035825	GO:BP	homologous recombination	16175	9273		1	1	61	16114	4	20	57	16094	16175	0.10244540040200391
M1	string	0	network_modules	176	TRUE	0.005338479828561265	86	20	4	0.2	0.046511627906976744	REAC:R-HSA-912446	REAC	Meiotic recombination	10916	1411		0.75	0.8	86	10830	4	16	82	10814	10916	0.09310175028300605
M1	string	0	network_modules	176	TRUE	0.006450603655071502	4	20	2	0.1	0.5	REAC:R-HSA-8866906	REAC	TFAP2 (AP-2) family regulates transcription of other transcription factors	10916	2426		1	1	4	10912	2	18	2	10894	10916	0.22303266570648034
M1	string	0	network_modules	177	TRUE	2.6155555550926135e-29	55	26	16	0.6153846153846154	0.2909090909090909	REAC:R-HSA-75893	REAC	TNF signaling	10916	2446		0	0.010638297872340425	55	10861	16	10	39	10851	10916	0.42120761254676653
M1	string	0	network_modules	177	TRUE	4.47822860956742e-28	46	26	15	0.5769230769230769	0.32608695652173914	REAC:R-HSA-5357905	REAC	Regulation of TNFR1 signaling	10916	2011		0.010752688172043012	0.02127659574468085	46	10870	15	11	31	10859	10916	0.43199293201636785
M1	string	0	network_modules	177	TRUE	1.904551843965076e-26	252	26	19	0.7307692307692307	0.07539682539682539	GO:0043122	GO:BP	regulation of canonical NF-kappaB signal transduction	16175	10541		0	0.01020408163265306	252	15923	19	7	233	15916	16175	0.2317216639491326
M1	string	0	network_modules	177	TRUE	7.301043371203387e-26	153	26	18	0.6923076923076923	0.11764705882352941	REAC:R-HSA-73887	REAC	Death Receptor Signaling	10916	455		0.021505376344086023	0.031914893617021274	153	10763	18	8	135	10755	10916	0.281929352948231
M1	string	0	network_modules	177	TRUE	1.4963128377708377e-25	280	26	19	0.7307692307692307	0.06785714285714285	GO:0007249	GO:BP	canonical NF-kappaB signal transduction	16175	2783		0.010309278350515464	0.02040816326530612	280	15895	19	7	261	15888	16175	0.21949145678155887
M1	string	0	network_modules	177	TRUE	3.8494181687946505e-25	33	26	13	0.5	0.3939393939393939	REAC:R-HSA-5357956	REAC	TNFR1-induced NF-kappa-B signaling pathway	10916	2447		0.03225806451612903	0.0425531914893617	33	10883	13	13	20	10870	10916	0.44232470048313255
M1	string	0	network_modules	177	TRUE	2.7386185168838943e-24	25	26	12	0.46153846153846156	0.48	REAC:R-HSA-5357786	REAC	TNFR1-induced proapoptotic signaling	10916	2448		0.043010752688172046	0.05319148936170213	25	10891	12	14	13	10877	10916	0.4694397743560365
M1	string	0	network_modules	177	TRUE	3.546893712799554e-24	192	26	17	0.6538461538461539	0.08854166666666667	GO:0043123	GO:BP	positive regulation of canonical NF-kappaB signal transduction	16175	10542		0.020618556701030927	0.030612244897959183	192	15983	17	9	175	15974	16175	0.23784671824341844
M1	string	0	network_modules	177	TRUE	4.23670611405605e-23	84	26	14	0.5384615384615384	0.16666666666666666	GO:0033209	GO:BP	tumor necrosis factor-mediated signaling pathway	16175	8075		0.030927835051546393	0.04081632653061224	84	16091	14	12	70	16079	16175	0.2976958533657704
M1	string	0	network_modules	177	TRUE	9.975874819536695e-23	113	26	16	0.6153846153846154	0.1415929203539823	KEGG:04668	KEGG	TNF signaling pathway	8484	342		0	0.023255813953488372	113	8371	16	10	97	8361	8484	0.2911851945084248
M1	string	0	network_modules	177	TRUE	1.8796311643839608e-22	180	26	16	0.6153846153846154	0.08888888888888889	GO:0034612	GO:BP	response to tumor necrosis factor	16175	8690		0.041237113402061855	0.05102040816326531	180	15995	16	10	164	15985	16175	0.23112715880844395
M1	string	0	network_modules	177	TRUE	3.3843338446953697e-22	103	26	15	0.5769230769230769	0.14563106796116504	REAC:R-HSA-168164	REAC	Toll Like Receptor 3 (TLR3) Cascade	10916	2515		0.053763440860215055	0.06382978723404255	103	10813	15	11	88	10802	10916	0.28681427315785646
M1	string	0	network_modules	177	TRUE	6.2268344782649355e-22	107	26	15	0.5769230769230769	0.14018691588785046	REAC:R-HSA-937061	REAC	TRIF (TICAM1)-mediated TLR4 signaling 	10916	2471		0.06451612903225806	0.0851063829787234	107	10809	15	11	92	10798	10916	0.28127252112892004
M1	string	0	network_modules	177	TRUE	6.2268344782649355e-22	107	26	15	0.5769230769230769	0.14018691588785046	REAC:R-HSA-166166	REAC	MyD88-independent TLR4 cascade 	10916	1501		0.06451612903225806	0.0851063829787234	107	10809	15	11	92	10798	10916	0.28127252112892004
M1	string	0	network_modules	177	TRUE	3.437186282024117e-21	182	26	17	0.6538461538461539	0.09340659340659341	KEGG:04621	KEGG	NOD-like receptor signaling pathway	8484	326		0.023809523809523808	0.046511627906976744	182	8302	17	9	165	8293	8484	0.24199934005502555
M1	string	0	network_modules	177	TRUE	6.242151063138996e-21	164	26	15	0.5769230769230769	0.09146341463414634	GO:0071356	GO:BP	cellular response to tumor necrosis factor	16175	16608		0.05154639175257732	0.061224489795918366	164	16011	15	11	149	16000	16175	0.22700977316175533
M1	string	0	network_modules	177	TRUE	6.098434582355279e-20	143	26	15	0.5769230769230769	0.1048951048951049	REAC:R-HSA-166016	REAC	Toll Like Receptor 4 (TLR4) Cascade	10916	2516		0.08602150537634409	0.09574468085106383	143	10773	15	11	128	10762	10916	0.24229404006805258
M1	string	0	network_modules	177	TRUE	5.16083502786029e-19	164	26	15	0.5769230769230769	0.09146341463414634	REAC:R-HSA-168898	REAC	Toll-like Receptor Cascades	10916	2522		0.0967741935483871	0.10638297872340426	164	10752	15	11	149	10741	10916	0.22569823786691698
M1	string	0	network_modules	177	TRUE	7.739726444137298e-19	625	26	19	0.7307692307692307	0.0304	GO:0034097	GO:BP	response to cytokine	16175	8408		0.061855670103092786	0.08163265306122448	625	15550	19	7	606	15543	16175	0.14409211284251242
M1	string	0	network_modules	177	TRUE	7.739726444137298e-19	625	26	19	0.7307692307692307	0.0304	GO:1901652	GO:BP	response to peptide	16175	21619		0.061855670103092786	0.08163265306122448	625	15550	19	7	606	15543	16175	0.14409211284251242
M1	string	0	network_modules	177	TRUE	1.1699426091636938e-18	198	26	16	0.6153846153846154	0.08080808080808081	KEGG:05169	KEGG	Epstein-Barr virus infection	8484	450		0.047619047619047616	0.06976744186046512	198	8286	16	10	182	8276	8484	0.21742240793927858
M1	string	0	network_modules	177	TRUE	2.7077537292271016e-18	419	26	17	0.6538461538461539	0.0405727923627685	GO:0019221	GO:BP	cytokine-mediated signaling pathway	16175	5598		0.08247422680412371	0.09183673469387756	419	15756	17	9	402	15747	16175	0.15861624597638474
M1	string	0	network_modules	177	TRUE	2.5138026099673493e-17	71	26	12	0.46153846153846156	0.16901408450704225	KEGG:04622	KEGG	RIG-I-like receptor signaling pathway	8484	327		0.07142857142857142	0.09302325581395349	71	8413	12	14	59	8399	8484	0.27580986996970164
M1	string	0	network_modules	177	TRUE	2.9240251396854216e-17	102	26	13	0.5	0.12745098039215685	KEGG:04064	KEGG	NF-kappa B signaling pathway	8484	256		0.09523809523809523	0.11627906976744186	102	8382	13	13	89	8369	8484	0.2482442858438127
M1	string	0	network_modules	177	TRUE	4.0769689907957246e-17	82	26	12	0.46153846153846156	0.14634146341463414	REAC:R-HSA-168928	REAC	DDX58/IFIH1-mediated induction of interferon-alpha/beta	10916	436		0.10752688172043011	0.11702127659574468	82	10834	12	14	70	10820	10916	0.2569308012902597
M1	string	0	network_modules	177	TRUE	6.506551970091943e-17	36	26	10	0.38461538461538464	0.2777777777777778	REAC:R-HSA-168638	REAC	NOD1/2 Signaling Pathway	10916	1529		0.11827956989247312	0.1276595744680851	36	10880	10	16	26	10864	10916	0.32498047540010083
M1	string	0	network_modules	177	TRUE	1.064626793221681e-16	654	26	18	0.6923076923076923	0.027522935779816515	GO:0031347	GO:BP	regulation of defense response	16175	7138		0.09278350515463918	0.10204081632653061	654	15521	18	8	636	15513	16175	0.13279254633554877
M1	string	0	network_modules	177	TRUE	1.7228506929784577e-16	158	26	14	0.5384615384615384	0.08860759493670886	KEGG:05160	KEGG	Hepatitis C	8484	441		0.11904761904761904	0.13953488372093023	158	8326	14	12	144	8314	8484	0.21319399931446892
M1	string	0	network_modules	177	TRUE	2.528817241512418e-16	214	26	15	0.5769230769230769	0.07009345794392523	KEGG:05417	KEGG	Lipid and atherosclerosis	8484	494		0.14285714285714285	0.16279069767441862	214	8270	15	11	199	8259	8484	0.19507254405252858
M1	string	0	network_modules	177	TRUE	3.246219654909894e-16	555	26	17	0.6538461538461539	0.03063063063063063	GO:0071345	GO:BP	cellular response to cytokine stimulus	16175	16597		0.10309278350515463	0.11224489795918367	555	15620	17	9	538	15611	16175	0.1365640052651055
M1	string	0	network_modules	177	TRUE	6.897775551518788e-16	92	26	12	0.46153846153846156	0.13043478260869565	KEGG:04657	KEGG	IL-17 signaling pathway	8484	335		0.16666666666666666	0.18604651162790697	92	8392	12	14	80	8378	8484	0.24127321965890572
M1	string	0	network_modules	177	TRUE	1.024911972602148e-15	594	26	17	0.6538461538461539	0.02861952861952862	GO:0006954	GO:BP	inflammatory response	16175	2585		0.1134020618556701	0.12244897959183673	594	15581	17	9	577	15572	16175	0.13165545629185862
M1	string	0	network_modules	177	TRUE	1.3043015829973084e-15	135	26	13	0.5	0.0962962962962963	KEGG:04210	KEGG	Apoptosis	8484	287		0.19047619047619047	0.20930232558139536	135	8349	13	13	122	8336	8484	0.21448326970588405
M1	string	0	network_modules	177	TRUE	1.7514510953588632e-15	138	26	13	0.5	0.09420289855072464	KEGG:05162	KEGG	Measles	8484	443		0.21428571428571427	0.23255813953488372	138	8346	13	13	125	8333	8484	0.21202225650439266
M1	string	0	network_modules	177	TRUE	2.523587743381328e-15	249	26	15	0.5769230769230769	0.060240963855421686	KEGG:05132	KEGG	Salmonella infection	8484	429		0.23809523809523808	0.2558139534883721	249	8235	15	11	234	8224	8484	0.17987243319060744
M1	string	0	network_modules	177	TRUE	2.567819178450366e-15	142	26	13	0.5	0.09154929577464789	KEGG:04936	KEGG	Alcoholic liver disease	8484	393		0.2619047619047619	0.27906976744186046	142	8342	13	13	129	8329	8484	0.20886103478660567
M1	string	0	network_modules	177	TRUE	7.298991680163633e-15	55	26	10	0.38461538461538464	0.18181818181818182	REAC:R-HSA-168643	REAC	Nucleotide-binding domain, leucine rich repeat containing receptor (NLR) signaling pathways	10916	1628		0.12903225806451613	0.13829787234042554	55	10861	10	16	45	10845	10916	0.2619508393639705
M1	string	0	network_modules	177	TRUE	7.663269735154888e-15	19	26	8	0.3076923076923077	0.42105263157894735	REAC:R-HSA-168927	REAC	TICAM1, RIP1-mediated IKK complex recruitment	10916	2440		0.13978494623655913	0.14893617021276595	19	10897	8	18	11	10879	10916	0.3586401581998001
M1	string	0	network_modules	177	TRUE	1.0021002255111993e-14	210	26	14	0.5384615384615384	0.06666666666666667	KEGG:05170	KEGG	Human immunodeficiency virus 1 infection	8484	451		0.2857142857142857	0.3023255813953488	210	8274	14	12	196	8262	8484	0.18331724242889114
M1	string	0	network_modules	177	TRUE	1.1814694916676336e-14	423	26	15	0.5769230769230769	0.03546099290780142	GO:0031349	GO:BP	positive regulation of defense response	16175	7140		0.12371134020618557	0.1326530612244898	423	15752	15	11	408	15741	16175	0.1384814670653329
M1	string	0	network_modules	177	TRUE	3.227895649257401e-14	22	26	8	0.3076923076923077	0.36363636363636365	REAC:R-HSA-937041	REAC	IKK complex recruitment mediated by RIP1	10916	1145		0.15053763440860216	0.1595744680851064	22	10894	8	18	14	10876	10916	0.3330380694235718
M1	string	0	network_modules	177	TRUE	9.342395918162772e-14	246	26	14	0.5384615384615384	0.056910569105691054	KEGG:05131	KEGG	Shigellosis	8484	428		0.30952380952380953	0.32558139534883723	246	8238	14	12	232	8226	8484	0.16834106330171414
M1	string	0	network_modules	177	TRUE	1.965301670369948e-13	197	26	13	0.5	0.06598984771573604	KEGG:05130	KEGG	Pathogenic Escherichia coli infection	8484	427		0.3333333333333333	0.3488372093023256	197	8287	13	13	184	8274	8484	0.17552524060499483
M1	string	0	network_modules	177	TRUE	3.5106791729676114e-13	531	26	15	0.5769230769230769	0.02824858757062147	GO:0032103	GO:BP	positive regulation of response to external stimulus	16175	7367		0.13402061855670103	0.14285714285714285	531	15644	15	11	516	15633	16175	0.1225212525077353
M1	string	0	network_modules	177	TRUE	3.57489841257574e-13	108	26	11	0.4230769230769231	0.10185185185185185	KEGG:05145	KEGG	Toxoplasmosis	8484	437		0.35714285714285715	0.37209302325581395	108	8376	11	15	97	8361	8484	0.20294325760047194
M1	string	0	network_modules	177	TRUE	1.0040536624819283e-12	721	26	16	0.6153846153846154	0.022191400832177532	GO:0045087	GO:BP	innate immune response	16175	11270		0.14432989690721648	0.15306122448979592	721	15454	16	10	705	15444	16175	0.11098425456480591
M1	string	0	network_modules	177	TRUE	1.2149030078168854e-12	82	26	10	0.38461538461538464	0.12195121951219512	KEGG:04623	KEGG	Cytosolic DNA-sensing pathway	8484	328		0.38095238095238093	0.3953488372093023	82	8402	10	16	72	8386	8484	0.21248522636917497
M1	string	0	network_modules	177	TRUE	2.1149692582549036e-12	756	26	16	0.6153846153846154	0.021164021164021163	GO:0050776	GO:BP	regulation of immune response	16175	13250		0.15463917525773196	0.16326530612244897	756	15419	16	10	740	15409	16175	0.10809634157670382
M1	string	0	network_modules	177	TRUE	6.80789347402285e-12	194	26	12	0.46153846153846156	0.061855670103092786	KEGG:05167	KEGG	Kaposi sarcoma-associated herpesvirus infection	8484	448		0.40476190476190477	0.4186046511627907	194	8290	12	14	182	8276	8484	0.1627103458361731
M1	string	0	network_modules	177	TRUE	1.732121926124589e-11	44	26	8	0.3076923076923077	0.18181818181818182	REAC:R-HSA-445989	REAC	TAK1-dependent IKK and NF-kappa-B activation  	10916	2417		0.16129032258064516	0.1702127659574468	44	10872	8	18	36	10854	10916	0.2341773962341999
M1	string	0	network_modules	177	TRUE	1.7353363599681952e-11	106	26	10	0.38461538461538464	0.09433962264150944	KEGG:04620	KEGG	Toll-like receptor signaling pathway	8484	325		0.42857142857142855	0.4418604651162791	106	8378	10	16	96	8362	8484	0.1857440396954716
M1	string	0	network_modules	177	TRUE	2.565683085121119e-11	158	26	11	0.4230769230769231	0.06962025316455696	KEGG:04217	KEGG	Necroptosis	8484	294		0.4523809523809524	0.46511627906976744	158	8326	11	15	147	8311	8484	0.1658729187117562
M1	string	0	network_modules	177	TRUE	4.741655132227603e-11	167	26	11	0.4230769230769231	0.0658682634730539	KEGG:05164	KEGG	Influenza A	8484	445		0.47619047619047616	0.4883720930232558	167	8317	11	15	156	8302	8484	0.1610052591342369
M1	string	0	network_modules	177	TRUE	1.303282794761869e-10	472	26	14	0.5384615384615384	0.029661016949152543	REAC:R-HSA-449147	REAC	Signaling by Interleukins	10916	2261		0.17204301075268819	0.18085106382978725	472	10444	14	12	458	10432	10916	0.1189684997813484
M1	string	0	network_modules	177	TRUE	1.3082525616243873e-10	627	26	14	0.5384615384615384	0.022328548644338118	GO:0050778	GO:BP	positive regulation of immune response	16175	13252		0.16494845360824742	0.17346938775510204	627	15548	14	12	613	15536	16175	0.10387110063218447
M1	string	0	network_modules	177	TRUE	1.4997549760600667e-10	31	26	7	0.2692307692307692	0.22580645161290322	REAC:R-HSA-5675482	REAC	Regulation of necroptotic cell death	10916	2045		0.1827956989247312	0.20212765957446807	31	10885	7	19	24	10866	10916	0.24460232708059898
M1	string	0	network_modules	177	TRUE	1.4997549760600667e-10	31	26	7	0.2692307692307692	0.22580645161290322	REAC:R-HSA-5213460	REAC	RIPK1-mediated regulated necrosis	10916	1877		0.1827956989247312	0.20212765957446807	31	10885	7	19	24	10866	10916	0.24460232708059898
M1	string	0	network_modules	177	TRUE	1.5230722744052157e-10	634	26	14	0.5384615384615384	0.022082018927444796	GO:0001817	GO:BP	regulation of cytokine production	16175	474		0.17525773195876287	0.1836734693877551	634	15541	14	12	620	15529	16175	0.1032298685400497
M1	string	0	network_modules	177	TRUE	1.6600076337721571e-10	638	26	14	0.5384615384615384	0.0219435736677116	GO:0001816	GO:BP	cytokine production	16175	473		0.18556701030927836	0.19387755102040816	638	15537	14	12	624	15525	16175	0.10286802314820097
M1	string	0	network_modules	177	TRUE	1.8351081681262376e-10	58	26	8	0.3076923076923077	0.13793103448275862	REAC:R-HSA-5218859	REAC	Regulated Necrosis	10916	1959		0.20430107526881722	0.2127659574468085	58	10858	8	18	50	10840	10916	0.20323522418478998
M1	string	0	network_modules	177	TRUE	2.157907821399647e-10	32	26	7	0.2692307692307692	0.21875	KEGG:04215	KEGG	Apoptosis - multiple species	8484	292		0.5	0.5116279069767442	32	8452	7	19	25	8433	8484	0.24010220827022505
M1	string	0	network_modules	177	TRUE	2.395457746807389e-10	92	26	9	0.34615384615384615	0.09782608695652174	KEGG:05222	KEGG	Small cell lung cancer	8484	473		0.5238095238095238	0.5348837209302325	92	8392	9	17	83	8375	8484	0.17950362536061903
M1	string	0	network_modules	177	TRUE	2.64930741599197e-10	124	26	9	0.34615384615384615	0.07258064516129033	GO:0051092	GO:BP	positive regulation of NF-kappaB transcription factor activity	16175	13487		0.1958762886597938	0.20408163265306123	124	16051	9	17	115	16034	16175	0.1557181161848829
M1	string	0	network_modules	177	TRUE	2.857677909774633e-10	386	26	12	0.46153846153846156	0.031088082901554404	GO:0045088	GO:BP	regulation of innate immune response	16175	11271		0.20618556701030927	0.21428571428571427	386	15789	12	14	374	15775	16175	0.11506371711694477
M1	string	0	network_modules	177	TRUE	5.879097377559177e-10	18	26	6	0.23076923076923078	0.3333333333333333	REAC:R-HSA-9758274	REAC	Regulation of NF-kappa B signaling	10916	1992		0.21505376344086022	0.22340425531914893	18	10898	6	20	12	10878	10916	0.2759244139865422
M1	string	0	network_modules	177	TRUE	6.138950766706097e-10	208	26	10	0.38461538461538464	0.04807692307692308	GO:0051091	GO:BP	positive regulation of DNA-binding transcription factor activity	16175	13486		0.21649484536082475	0.22448979591836735	208	15967	10	16	198	15951	16175	0.13239538351192298
M1	string	0	network_modules	177	TRUE	6.932774687092498e-10	416	26	12	0.46153846153846156	0.028846153846153848	GO:0002757	GO:BP	immune response-activating signaling pathway	16175	1268		0.2268041237113402	0.23469387755102042	416	15759	12	14	404	15745	16175	0.11047247145707359
M1	string	0	network_modules	177	TRUE	1.1336449552635506e-9	223	26	11	0.4230769230769231	0.04932735426008968	KEGG:05163	KEGG	Human cytomegalovirus infection	8484	444		0.5476190476190477	0.5581395348837209	223	8261	11	15	212	8246	8484	0.13751428794130546
M1	string	0	network_modules	177	TRUE	1.2191836493703663e-9	319	26	11	0.4230769230769231	0.034482758620689655	GO:0045089	GO:BP	positive regulation of innate immune response	16175	11272		0.23711340206185566	0.24489795918367346	319	15856	11	15	308	15841	16175	0.1164001583085594
M1	string	0	network_modules	177	TRUE	1.2401642683347971e-9	437	26	12	0.46153846153846156	0.02745995423340961	GO:0002764	GO:BP	immune response-regulating signaling pathway	16175	1275		0.24742268041237114	0.25510204081632654	437	15738	12	14	425	15724	16175	0.10753600225991052
M1	string	0	network_modules	177	TRUE	1.277252429480957e-9	162	26	10	0.38461538461538464	0.06172839506172839	KEGG:05161	KEGG	Hepatitis B	8484	442		0.5714285714285714	0.5813953488372093	162	8322	10	16	152	8306	8484	0.1480791830464413
M1	string	0	network_modules	177	TRUE	1.421532276810891e-9	149	26	9	0.34615384615384615	0.06040268456375839	GO:0002753	GO:BP	cytoplasmic pattern recognition receptor signaling pathway	16175	1264		0.25773195876288657	0.2653061224489796	149	16026	9	17	140	16009	16175	0.14151670901620814
M1	string	0	network_modules	177	TRUE	1.4733858905783327e-9	227	26	10	0.38461538461538464	0.04405286343612335	GO:0002221	GO:BP	pattern recognition receptor signaling pathway	16175	755		0.26804123711340205	0.2755102040816326	227	15948	10	16	217	15932	16175	0.12640833179329458
M1	string	0	network_modules	177	TRUE	1.5205458738670937e-9	120	26	9	0.34615384615384615	0.075	REAC:R-HSA-9705671	REAC	SARS-CoV-2 activates/modulates innate and adaptive immune responses	10916	2123		0.22580645161290322	0.23404255319148937	120	10796	9	17	111	10779	10916	0.15706066408663447
M1	string	0	network_modules	177	TRUE	1.7104122896528174e-9	21	26	6	0.23076923076923078	0.2857142857142857	REAC:R-HSA-1606322	REAC	ZBP1(DAI) mediated induction of type I IFNs	10916	2680		0.23655913978494625	0.24468085106382978	21	10895	6	20	15	10875	10916	0.25518507891389625
M1	string	0	network_modules	177	TRUE	1.798524755296435e-9	451	26	12	0.46153846153846156	0.026607538802660754	GO:0002831	GO:BP	regulation of response to biotic stimulus	16175	1341		0.27835051546391754	0.2857142857142857	451	15724	12	14	439	15710	16175	0.10568993816246577
M1	string	0	network_modules	177	TRUE	2.0108751948100874e-9	334	26	11	0.4230769230769231	0.03293413173652695	GO:0009615	GO:BP	response to virus	16175	3541		0.28865979381443296	0.29591836734693877	334	15841	11	15	323	15826	16175	0.11354854175003824
M1	string	0	network_modules	177	TRUE	2.3635720532240413e-9	339	26	11	0.4230769230769231	0.032448377581120944	GO:0002833	GO:BP	positive regulation of response to biotic stimulus	16175	1343		0.29896907216494845	0.30612244897959184	339	15836	11	15	328	15821	16175	0.11263925535980965
M1	string	0	network_modules	177	TRUE	2.860077135448794e-9	345	26	11	0.4230769230769231	0.03188405797101449	GO:0051090	GO:BP	regulation of DNA-binding transcription factor activity	16175	13485		0.30927835051546393	0.3163265306122449	345	15830	11	15	334	15815	16175	0.11157362731767048
M1	string	0	network_modules	177	TRUE	2.9081858543221978e-9	243	26	10	0.38461538461538464	0.0411522633744856	GO:0002758	GO:BP	innate immune response-activating signaling pathway	16175	1269		0.31958762886597936	0.32653061224489793	243	15932	10	16	233	15916	16175	0.12191093394166727
M1	string	0	network_modules	177	TRUE	3.3101500551225507e-9	475	26	12	0.46153846153846156	0.02526315789473684	GO:0002253	GO:BP	activation of immune response	16175	785		0.32989690721649484	0.336734693877551	475	15700	12	14	463	15686	16175	0.1027113168419913
M1	string	0	network_modules	177	TRUE	3.732124659615229e-9	330	26	12	0.46153846153846156	0.03636363636363636	KEGG:05165	KEGG	Human papillomavirus infection	8484	446		0.5952380952380952	0.6046511627906976	330	8154	12	14	318	8140	8484	0.12119467254547904
M1	string	0	network_modules	177	TRUE	6.389655137887166e-9	263	26	10	0.38461538461538464	0.03802281368821293	GO:0002218	GO:BP	activation of innate immune response	16175	753		0.3402061855670103	0.3469387755102041	263	15912	10	16	253	15896	16175	0.11686522792081239
M1	string	0	network_modules	177	TRUE	6.809843261943421e-9	208	26	10	0.38461538461538464	0.04807692307692308	REAC:R-HSA-5357801	REAC	Programmed Cell Death	10916	1803		0.24731182795698925	0.2553191489361702	208	10708	10	16	198	10692	10916	0.13065018067418976
M1	string	0	network_modules	177	TRUE	8.517144700692879e-9	136	26	9	0.34615384615384615	0.0661764705882353	KEGG:05135	KEGG	Yersinia infection	8484	432		0.6190476190476191	0.627906976744186	136	8348	9	17	127	8331	8484	0.14573688607604401
M1	string	0	network_modules	177	TRUE	1.1019284223380745e-8	95	26	8	0.3076923076923077	0.08421052631578947	REAC:R-HSA-168142	REAC	Toll Like Receptor 10 (TLR10) Cascade	10916	2513		0.25806451612903225	0.2872340425531915	95	10821	8	18	87	10803	10916	0.15728839351386006
M1	string	0	network_modules	177	TRUE	1.1019284223380745e-8	95	26	8	0.3076923076923077	0.08421052631578947	REAC:R-HSA-975871	REAC	MyD88 cascade initiated on plasma membrane	10916	1497		0.25806451612903225	0.2872340425531915	95	10821	8	18	87	10803	10916	0.15728839351386006
M1	string	0	network_modules	177	TRUE	1.1019284223380745e-8	95	26	8	0.3076923076923077	0.08421052631578947	REAC:R-HSA-168176	REAC	Toll Like Receptor 5 (TLR5) Cascade	10916	2517		0.25806451612903225	0.2872340425531915	95	10821	8	18	87	10803	10916	0.15728839351386006
M1	string	0	network_modules	177	TRUE	1.2275377151720378e-8	151	26	9	0.34615384615384615	0.059602649006622516	REAC:R-HSA-446652	REAC	Interleukin-1 family signaling	10916	1231		0.2903225806451613	0.2978723404255319	151	10765	9	17	142	10748	10916	0.13902678456464365
M1	string	0	network_modules	177	TRUE	1.5382950070181587e-8	403	26	11	0.4230769230769231	0.02729528535980149	GO:0001819	GO:BP	positive regulation of cytokine production	16175	476		0.35051546391752575	0.35714285714285715	403	15772	11	15	392	15757	16175	0.10249955326214455
M1	string	0	network_modules	177	TRUE	1.815953282086899e-8	101	26	8	0.3076923076923077	0.07920792079207921	REAC:R-HSA-975138	REAC	TRAF6 mediated induction of NFkB and MAP kinases upon TLR7/8 or 9 activation	10916	2468		0.3010752688172043	0.30851063829787234	101	10815	8	18	93	10797	10916	0.15230673296703748
M1	string	0	network_modules	177	TRUE	1.845265664514286e-8	30	26	6	0.23076923076923078	0.2	REAC:R-HSA-933541	REAC	TRAF6 mediated IRF7 activation	10916	2465		0.3118279569892473	0.3191489361702128	30	10886	6	20	24	10866	10916	0.21282187256702056
M1	string	0	network_modules	177	TRUE	1.9675948847739376e-8	102	26	8	0.3076923076923077	0.0784313725490196	REAC:R-HSA-975155	REAC	MyD88 dependent cascade initiated on endosome	10916	1500		0.3225806451612903	0.32978723404255317	102	10814	8	18	94	10796	10916	0.15151877548614115
M1	string	0	network_modules	177	TRUE	2.1301390718862915e-8	103	26	8	0.3076923076923077	0.07766990291262135	REAC:R-HSA-168181	REAC	Toll Like Receptor 7/8 (TLR7/8) Cascade	10916	2518		0.3333333333333333	0.3404255319148936	103	10813	8	18	95	10795	10916	0.1507421255343442
M1	string	0	network_modules	177	TRUE	2.1305060333825677e-8	13	26	5	0.19230769230769232	0.38461538461538464	REAC:R-HSA-933543	REAC	NF-kB activation through FADD/RIP-1 pathway mediated by caspase-8 and -10	10916	1515		0.34408602150537637	0.35106382978723405	13	10903	5	21	8	10882	10916	0.270763673933344
M1	string	0	network_modules	177	TRUE	2.2778385558705355e-8	299	26	10	0.38461538461538464	0.033444816053511704	GO:0050727	GO:BP	regulation of inflammatory response	16175	13226		0.36082474226804123	0.3673469387755102	299	15876	10	16	289	15860	16175	0.10906550203115367
M1	string	0	network_modules	177	TRUE	2.6899433620195258e-8	106	26	8	0.3076923076923077	0.07547169811320754	REAC:R-HSA-168138	REAC	Toll Like Receptor 9 (TLR9) Cascade	10916	2519		0.3548387096774194	0.3617021276595745	106	10810	8	18	98	10792	10916	0.14847734997370793
M1	string	0	network_modules	177	TRUE	3.3088036400907e-8	14	26	5	0.19230769230769232	0.35714285714285715	REAC:R-HSA-975144	REAC	IRAK1 recruits IKK complex upon TLR7/8 or 9 stimulation	10916	1155		0.3655913978494624	0.3829787234042553	14	10902	5	21	9	10881	10916	0.26080130013077835
M1	string	0	network_modules	177	TRUE	3.3088036400907e-8	14	26	5	0.19230769230769232	0.35714285714285715	REAC:R-HSA-937039	REAC	IRAK1 recruits IKK complex	10916	1154		0.3655913978494624	0.3829787234042553	14	10902	5	21	9	10881	10916	0.26080130013077835
M1	string	0	network_modules	177	TRUE	4.2037209247347774e-8	112	26	8	0.3076923076923077	0.07142857142857142	REAC:R-HSA-166058	REAC	MyD88:MAL(TIRAP) cascade initiated on plasma membrane	10916	1502		0.3870967741935484	0.40425531914893614	112	10804	8	18	104	10786	10916	0.1442191250909372
M1	string	0	network_modules	177	TRUE	4.2037209247347774e-8	112	26	8	0.3076923076923077	0.07142857142857142	REAC:R-HSA-168188	REAC	Toll Like Receptor TLR6:TLR2 Cascade	10916	2521		0.3870967741935484	0.40425531914893614	112	10804	8	18	104	10786	10916	0.1442191250909372
M1	string	0	network_modules	177	TRUE	4.286827514760426e-8	231	26	10	0.38461538461538464	0.04329004329004329	KEGG:05171	KEGG	Coronavirus disease - COVID-19	8484	452		0.6428571428571429	0.6511627906976745	231	8253	10	16	221	8237	8484	0.12175341072854666
M1	string	0	network_modules	177	TRUE	4.5173242536520914e-8	113	26	8	0.3076923076923077	0.07079646017699115	REAC:R-HSA-9020702	REAC	Interleukin-1 signaling	10916	1233		0.40860215053763443	0.4148936170212766	113	10803	8	18	105	10785	10916	0.14354199014469796
M1	string	0	network_modules	177	TRUE	4.8718418370087125e-8	176	26	9	0.34615384615384615	0.05113636363636364	REAC:R-HSA-109581	REAC	Apoptosis	10916	158		0.41935483870967744	0.425531914893617	176	10740	9	17	167	10723	10916	0.12803601798944877
M1	string	0	network_modules	177	TRUE	5.2060781122582064e-8	115	26	8	0.3076923076923077	0.06956521739130435	REAC:R-HSA-181438	REAC	Toll Like Receptor 2 (TLR2) Cascade	10916	2514		0.43010752688172044	0.44680851063829785	115	10801	8	18	107	10783	10916	0.14221381301569708
M1	string	0	network_modules	177	TRUE	5.2060781122582064e-8	115	26	8	0.3076923076923077	0.06956521739130435	REAC:R-HSA-168179	REAC	Toll Like Receptor TLR1:TLR2 Cascade	10916	2520		0.43010752688172044	0.44680851063829785	115	10801	8	18	107	10783	10916	0.14221381301569708
M1	string	0	network_modules	177	TRUE	7.131379973496059e-8	70	26	7	0.2692307692307692	0.1	KEGG:04920	KEGG	Adipocytokine signaling pathway	8484	377		0.6666666666666666	0.6744186046511628	70	8414	7	19	63	8395	8484	0.15995961619674073
M1	string	0	network_modules	177	TRUE	1.3337775739681846e-7	197	26	9	0.34615384615384615	0.04568527918781726	REAC:R-HSA-9705683	REAC	SARS-CoV-2-host interactions	10916	2128		0.45161290322580644	0.4574468085106383	197	10719	9	17	188	10702	10916	0.12043187070413161
M1	string	0	network_modules	177	TRUE	2.665127867425666e-7	102	26	7	0.2692307692307692	0.06862745098039216	GO:0038061	GO:BP	non-canonical NF-kappaB signal transduction	16175	9680		0.3711340206185567	0.37755102040816324	102	16073	7	19	95	16054	16175	0.13327265305100686
M1	string	0	network_modules	177	TRUE	2.896865842874947e-7	7	26	4	0.15384615384615385	0.5714285714285714	REAC:R-HSA-9693928	REAC	Defective RIPK1-mediated regulated necrosis	10916	613		0.46236559139784944	0.46808510638297873	7	10909	4	22	3	10887	10916	0.29571095031683997
M1	string	0	network_modules	177	TRUE	5.602047678741054e-7	301	26	10	0.38461538461538464	0.03322259136212625	KEGG:04010	KEGG	MAPK signaling pathway	8484	243		0.6904761904761905	0.6976744186046512	301	8183	10	16	291	8167	8484	0.10464287011562738
M1	string	0	network_modules	177	TRUE	6.622988948059682e-7	97	26	7	0.2692307692307692	0.07216494845360824	REAC:R-HSA-5607764	REAC	CLEC7A (Dectin-1) signaling	10916	275		0.4731182795698925	0.4787234042553192	97	10819	7	19	90	10800	10916	0.13555190493148148
M1	string	0	network_modules	177	TRUE	8.04098731279046e-7	302	26	9	0.34615384615384615	0.029801324503311258	GO:0030522	GO:BP	intracellular receptor signaling pathway	16175	6836		0.38144329896907214	0.3877551020408163	302	15873	9	17	293	15856	16175	0.09707647621223461
M1	string	0	network_modules	177	TRUE	8.627300947806353e-7	25	26	5	0.19230769230769232	0.2	REAC:R-HSA-5357769	REAC	Caspase activation via extrinsic apoptotic signalling pathway	10916	315		0.4838709677419355	0.5	25	10891	5	21	20	10870	10916	0.19423429923601793
M1	string	0	network_modules	177	TRUE	8.627300947806353e-7	25	26	5	0.19230769230769232	0.2	REAC:R-HSA-933542	REAC	TRAF6 mediated NF-kB activation	10916	2467		0.4838709677419355	0.5	25	10891	5	21	20	10870	10916	0.19423429923601793
M1	string	0	network_modules	177	TRUE	1.0969782266985627e-6	66	26	6	0.23076923076923078	0.09090909090909091	GO:0032481	GO:BP	positive regulation of type I interferon production	16175	7592		0.3917525773195876	0.3979591836734694	66	16109	6	20	60	16089	16175	0.14268623075339917
M1	string	0	network_modules	177	TRUE	1.519447028422723e-6	10	26	4	0.15384615384615385	0.4	GO:0060546	GO:BP	negative regulation of necroptotic process	16175	14735		0.4020618556701031	0.40816326530612246	10	16165	4	22	6	16143	16175	0.24734787636028013
M1	string	0	network_modules	177	TRUE	1.6488995431703696e-6	132	26	7	0.2692307692307692	0.05303030303030303	GO:0001959	GO:BP	regulation of cytokine-mediated signaling pathway	16175	568		0.41237113402061853	0.41836734693877553	132	16043	7	19	125	16024	16175	0.11643549755708726
M1	string	0	network_modules	177	TRUE	1.729722506833986e-6	10	26	4	0.15384615384615385	0.4	REAC:R-HSA-69416	REAC	Dimerization of procaspase-8	10916	745		0.5053763440860215	0.5319148936170213	10	10906	4	22	6	10884	10916	0.24699968208156156
M1	string	0	network_modules	177	TRUE	1.729722506833986e-6	10	26	4	0.15384615384615385	0.4	REAC:R-HSA-5218900	REAC	CASP8 activity is inhibited	10916	263		0.5053763440860215	0.5319148936170213	10	10906	4	22	6	10884	10916	0.24699968208156156
M1	string	0	network_modules	177	TRUE	1.729722506833986e-6	10	26	4	0.15384615384615385	0.4	REAC:R-HSA-3371378	REAC	Regulation by c-FLIP	10916	1962		0.5053763440860215	0.5319148936170213	10	10906	4	22	6	10884	10916	0.24699968208156156
M1	string	0	network_modules	177	TRUE	1.8684713616505473e-6	632	26	11	0.4230769230769231	0.01740506329113924	GO:0031401	GO:BP	positive regulation of protein modification process	16175	7157		0.422680412371134	0.42857142857142855	632	15543	11	15	621	15528	16175	0.07951851269138317
M1	string	0	network_modules	177	TRUE	2.0045558213823655e-6	63	26	6	0.23076923076923078	0.09523809523809523	REAC:R-HSA-450294	REAC	MAP kinase activation	10916	1345		0.5376344086021505	0.5425531914893617	63	10853	6	20	57	10833	10916	0.14513411948294538
M1	string	0	network_modules	177	TRUE	2.208438743719113e-6	64	26	6	0.23076923076923078	0.09375	REAC:R-HSA-1834949	REAC	Cytosolic sensors of pathogen-associated DNA 	10916	428		0.5483870967741935	0.5531914893617021	64	10852	6	20	58	10832	10916	0.1439437983887986
M1	string	0	network_modules	177	TRUE	2.385103679300842e-6	11	26	4	0.15384615384615385	0.36363636363636365	GO:0062099	GO:BP	negative regulation of programmed necrotic cell death	16175	15820		0.4329896907216495	0.4387755102040816	11	16164	4	22	7	16142	16175	0.2357490841402948
M1	string	0	network_modules	177	TRUE	2.403913131895169e-6	228	26	8	0.3076923076923077	0.03508771929824561	GO:0051607	GO:BP	defense response to virus	16175	13823		0.44329896907216493	0.4489795918367347	228	15947	8	18	220	15929	16175	0.09993142284638064
M1	string	0	network_modules	177	TRUE	2.891200640254682e-6	143	26	7	0.2692307692307692	0.04895104895104895	GO:0060759	GO:BP	regulation of response to cytokine stimulus	16175	14927		0.4536082474226804	0.45918367346938777	143	16032	7	19	136	16013	16175	0.11161447461864626
M1	string	0	network_modules	177	TRUE	3.946206415161963e-6	3	26	3	0.11538461538461539	1	REAC:R-HSA-5603027	REAC	IKBKG deficiency causes anhidrotic ectodermal dysplasia with immunodeficiency (EDA-ID) (via TLR)	10916	1144		0.5591397849462365	0.574468085106383	3	10913	3	23	0	10890	10916	0.33932496709510673
M1	string	0	network_modules	177	TRUE	3.946206415161963e-6	3	26	3	0.11538461538461539	1	REAC:R-HSA-5602636	REAC	IKBKB deficiency causes SCID	10916	1143		0.5591397849462365	0.574468085106383	3	10913	3	23	0	10890	10916	0.33932496709510673
M1	string	0	network_modules	177	TRUE	4.064060628636206e-6	12	26	4	0.15384615384615385	0.3333333333333333	REAC:R-HSA-9013973	REAC	TICAM1-dependent activation of IRF3/IRF7	10916	2442		0.5806451612903226	0.5957446808510638	12	10904	4	22	8	10882	10916	0.22522934804080968
M1	string	0	network_modules	177	TRUE	4.064060628636206e-6	12	26	4	0.15384615384615385	0.3333333333333333	REAC:R-HSA-264870	REAC	Caspase-mediated cleavage of cytoskeletal proteins	10916	316		0.5806451612903226	0.5957446808510638	12	10904	4	22	8	10882	10916	0.22522934804080968
M1	string	0	network_modules	177	TRUE	4.172331826048218e-6	71	26	6	0.23076923076923078	0.08450704225352113	REAC:R-HSA-448424	REAC	Interleukin-17 signaling	10916	1238		0.6021505376344086	0.6063829787234043	71	10845	6	20	65	10825	10916	0.13631819960110889
M1	string	0	network_modules	177	TRUE	4.2749187974237924e-6	292	26	9	0.34615384615384615	0.030821917808219176	REAC:R-HSA-9694516	REAC	SARS-CoV-2 Infection	10916	2122		0.6129032258064516	0.6170212765957447	292	10624	9	17	283	10607	10916	0.09672557486236033
M1	string	0	network_modules	177	TRUE	5.174773738506289e-6	85	26	6	0.23076923076923078	0.07058823529411765	GO:0002220	GO:BP	innate immune response activating cell surface receptor signaling pathway	16175	754		0.4639175257731959	0.46938775510204084	85	16090	6	20	79	16070	16175	0.1251539523519772
M1	string	0	network_modules	177	TRUE	5.997000247172755e-6	201	26	8	0.3076923076923077	0.03980099502487562	KEGG:05203	KEGG	Viral carcinogenesis	8484	455		0.7142857142857143	0.7209302325581395	201	8283	8	18	193	8265	8484	0.10353351825419854
M1	string	0	network_modules	177	TRUE	6.202200988325058e-6	132	26	7	0.2692307692307692	0.05303030303030303	KEGG:04380	KEGG	Osteoclast differentiation	8484	309		0.7380952380952381	0.7441860465116279	132	8352	7	19	125	8333	8484	0.11364332677004546
M1	string	0	network_modules	177	TRUE	6.942992303773003e-6	37	26	5	0.19230769230769232	0.13513513513513514	REAC:R-HSA-111465	REAC	Apoptotic cleavage of cellular proteins	10916	161		0.6236559139784946	0.6276595744680851	37	10879	5	21	32	10858	10916	0.15882345748350066
M1	string	0	network_modules	177	TRUE	7.087164204209293e-6	136	26	7	0.2692307692307692	0.051470588235294115	REAC:R-HSA-5621481	REAC	C-type lectin receptors (CLRs)	10916	261		0.6344086021505376	0.6382978723404256	136	10780	7	19	129	10761	10916	0.11311106166117242
M1	string	0	network_modules	177	TRUE	7.851166534038905e-6	265	26	8	0.3076923076923077	0.03018867924528302	GO:0002429	GO:BP	immune response-activating cell surface receptor signaling pathway	16175	952		0.4742268041237113	0.47959183673469385	265	15910	8	18	257	15892	16175	0.09207760655629586
M1	string	0	network_modules	177	TRUE	9.663994205658252e-6	170	26	7	0.2692307692307692	0.041176470588235294	GO:0097191	GO:BP	extrinsic apoptotic signaling pathway	16175	18535		0.4845360824742268	0.4897959183673469	170	16005	7	19	163	15986	16175	0.10179748819169938
M1	string	0	network_modules	177	TRUE	1.115281096169364e-5	15	26	4	0.15384615384615385	0.26666666666666666	REAC:R-HSA-140534	REAC	Caspase activation via Death Receptors in the presence of ligand	10916	313		0.6451612903225806	0.648936170212766	15	10901	4	22	11	10879	10916	0.20111646530644461
M1	string	0	network_modules	177	TRUE	1.4656654728188742e-5	287	26	8	0.3076923076923077	0.027874564459930314	GO:0002768	GO:BP	immune response-regulating cell surface receptor signaling pathway	16175	1279		0.4948453608247423	0.5	287	15888	8	18	279	15870	16175	0.08812599070862573
M1	string	0	network_modules	177	TRUE	1.48464277429561e-5	16	26	4	0.15384615384615385	0.25	REAC:R-HSA-936964	REAC	Activation of IRF3, IRF7 mediated by TBK1, IKKε (IKBKE)	10916	85		0.6559139784946236	0.6595744680851063	16	10900	4	22	12	10878	10916	0.1946221088946285
M1	string	0	network_modules	177	TRUE	1.4935247793336792e-5	459	26	10	0.38461538461538464	0.02178649237472767	REAC:R-HSA-9679506	REAC	SARS-CoV Infections	10916	2112		0.6666666666666666	0.6702127659574468	459	10457	10	16	449	10441	10916	0.08340112484049038
M1	string	0	network_modules	177	TRUE	1.788185170933388e-5	154	26	7	0.2692307692307692	0.045454545454545456	KEGG:04932	KEGG	Non-alcoholic fatty liver disease	8484	389		0.7619047619047619	0.7674418604651163	154	8330	7	19	147	8311	8484	0.10427517877367337
M1	string	0	network_modules	177	TRUE	1.8014089994876406e-5	49	26	5	0.19230769230769232	0.10204081632653061	GO:0010803	GO:BP	regulation of tumor necrosis factor-mediated signaling pathway	16175	4417		0.5051546391752577	0.5204081632653061	49	16126	5	21	44	16105	16175	0.13819669746205515
M1	string	0	network_modules	177	TRUE	1.8014089994876406e-5	49	26	5	0.19230769230769232	0.10204081632653061	GO:0140374	GO:BP	antiviral innate immune response	16175	19754		0.5051546391752577	0.5204081632653061	49	16126	5	21	44	16105	16175	0.13819669746205515
M1	string	0	network_modules	177	TRUE	1.9383242235159076e-5	17	26	4	0.15384615384615385	0.23529411764705882	REAC:R-HSA-1810476	REAC	RIP-mediated NFkB activation via ZBP1	10916	1876		0.6774193548387096	0.6808510638297872	17	10899	4	22	13	10877	10916	0.18870632552317113
M1	string	0	network_modules	177	TRUE	2.2942987380584014e-5	443	26	9	0.34615384615384615	0.020316027088036117	GO:0009617	GO:BP	response to bacterium	16175	3543		0.5257731958762887	0.5306122448979592	443	15732	9	17	434	15715	16175	0.07836753256844882
M1	string	0	network_modules	177	TRUE	2.4677283789796836e-5	110	26	6	0.23076923076923078	0.05454545454545454	GO:0032479	GO:BP	regulation of type I interferon production	16175	7590		0.5360824742268041	0.5510204081632653	110	16065	6	20	104	16045	16175	0.10934743450192236
M1	string	0	network_modules	177	TRUE	2.4677283789796836e-5	110	26	6	0.23076923076923078	0.05454545454545454	GO:0032606	GO:BP	type I interferon production	16175	7654		0.5360824742268041	0.5510204081632653	110	16065	6	20	104	16045	16175	0.10934743450192236
M1	string	0	network_modules	177	TRUE	2.699226511147817e-5	53	26	5	0.19230769230769232	0.09433962264150944	GO:0034142	GO:BP	toll-like receptor 4 signaling pathway	16175	8450		0.5567010309278351	0.5612244897959183	53	16122	5	21	48	16101	16175	0.13272228663375712
M1	string	0	network_modules	177	TRUE	2.938610928477159e-5	98	26	6	0.23076923076923078	0.061224489795918366	REAC:R-HSA-202424	REAC	Downstream TCR signaling	10916	789		0.6881720430107527	0.6914893617021277	98	10818	6	20	92	10798	10916	0.11489332442613832
M1	string	0	network_modules	177	TRUE	2.9831828625906158e-5	101	26	6	0.23076923076923078	0.0594059405940594	KEGG:05142	KEGG	Chagas disease	8484	434		0.7857142857142857	0.7906976744186046	101	8383	6	20	95	8363	8484	0.11188409054346406
M1	string	0	network_modules	177	TRUE	3.224623847415405e-5	115	26	6	0.23076923076923078	0.05217391304347826	GO:1903322	GO:BP	positive regulation of protein modification by small protein conjugation or removal	16175	22906		0.5670103092783505	0.5714285714285714	115	16060	6	20	109	16040	16175	0.1068129211676545
M1	string	0	network_modules	177	TRUE	3.317375754585319e-5	100	26	6	0.23076923076923078	0.06	REAC:R-HSA-5668541	REAC	TNFR2 non-canonical NF-kB pathway	10916	2450		0.6989247311827957	0.7021276595744681	100	10816	6	20	94	10796	10916	0.1136551379184565
M1	string	0	network_modules	177	TRUE	3.360414688695807e-5	463	26	9	0.34615384615384615	0.019438444924406047	GO:0097190	GO:BP	apoptotic signaling pathway	16175	18534		0.5773195876288659	0.5816326530612245	463	15712	9	17	454	15695	16175	0.07640748296904055
M1	string	0	network_modules	177	TRUE	3.396894625883835e-5	116	26	6	0.23076923076923078	0.05172413793103448	GO:1901875	GO:BP	positive regulation of post-translational protein modification	16175	21819		0.5876288659793815	0.5918367346938775	116	16059	6	20	110	16039	16175	0.10632543679618128
M1	string	0	network_modules	177	TRUE	3.65163659786837e-5	206	26	7	0.2692307692307692	0.03398058252427184	GO:1903320	GO:BP	regulation of protein modification by small protein conjugation or removal	16175	22904		0.5979381443298969	0.6020408163265306	206	15969	7	19	199	15950	16175	0.09178351606584075
M1	string	0	network_modules	177	TRUE	3.6583490396303845e-5	51	26	5	0.19230769230769232	0.09803921568627451	REAC:R-HSA-75153	REAC	Apoptotic execution phase	10916	162		0.7096774193548387	0.7127659574468085	51	10865	5	21	46	10844	10916	0.13444717049012836
M1	string	0	network_modules	177	TRUE	4.034032385757568e-5	209	26	7	0.2692307692307692	0.03349282296650718	GO:1901873	GO:BP	regulation of post-translational protein modification	16175	21817		0.6082474226804123	0.6122448979591837	209	15966	7	19	202	15947	16175	0.0910650654805093
M1	string	0	network_modules	177	TRUE	4.278857789887143e-5	21	26	4	0.15384615384615385	0.19047619047619047	GO:0060544	GO:BP	regulation of necroptotic process	16175	14733		0.6185567010309279	0.6224489795918368	21	16154	4	22	17	16132	16175	0.16998655088032633
M1	string	0	network_modules	177	TRUE	4.6784792173307784e-5	59	26	5	0.19230769230769232	0.0847457627118644	GO:0002224	GO:BP	toll-like receptor signaling pathway	16175	758		0.6288659793814433	0.6326530612244898	59	16116	5	21	54	16095	16175	0.12556932031896215
M1	string	0	network_modules	177	TRUE	5.098265422779775e-5	60	26	5	0.19230769230769232	0.08333333333333333	GO:0140895	GO:BP	cell surface toll-like receptor signaling pathway	16175	19927		0.6391752577319587	0.6428571428571429	60	16115	5	21	55	16094	16175	0.12448157001807318
M1	string	0	network_modules	177	TRUE	5.909600640447342e-5	22	26	4	0.15384615384615385	0.18181818181818182	REAC:R-HSA-450321	REAC	JNK (c-Jun kinases) phosphorylation and  activation mediated by activated human TAK1	10916	1279		0.7204301075268817	0.723404255319149	22	10894	4	22	18	10872	10916	0.16542114075799433
M1	string	0	network_modules	177	TRUE	6.316933502089829e-5	23	26	4	0.15384615384615385	0.17391304347826086	GO:0062098	GO:BP	regulation of programmed necrotic cell death	16175	15819		0.6494845360824743	0.6530612244897959	23	16152	4	22	19	16130	16175	0.16230616549573473
M1	string	0	network_modules	177	TRUE	7.011800397377074e-5	382	26	9	0.34615384615384615	0.02356020942408377	KEGG:05010	KEGG	Alzheimer disease	8484	411		0.8095238095238095	0.813953488372093	382	8102	9	17	373	8085	8484	0.08051498375549498
M1	string	0	network_modules	177	TRUE	7.086604658391261e-5	64	26	5	0.19230769230769232	0.078125	GO:0070534	GO:BP	protein K63-linked ubiquitination	16175	16168		0.6597938144329897	0.6632653061224489	64	16111	5	21	59	16090	16175	0.12038566303220273
M1	string	0	network_modules	177	TRUE	7.142187012693157e-5	23	26	4	0.15384615384615385	0.17391304347826086	REAC:R-HSA-450302	REAC	activated TAK1 mediates p38 MAPK activation	10916	2685		0.7311827956989247	0.7340425531914894	23	10893	4	22	19	10871	10916	0.16169487404338867
M1	string	0	network_modules	177	TRUE	7.855046940624929e-5	6	26	3	0.11538461538461539	0.5	REAC:R-HSA-111459	REAC	Activation of caspases through apoptosome-mediated cleavage	10916	100		0.7419354838709677	0.7446808510638298	6	10910	3	23	3	10887	10916	0.23939903601547216
M1	string	0	network_modules	177	TRUE	8.947153163396906e-5	67	26	5	0.19230769230769232	0.07462686567164178	GO:0002752	GO:BP	cell surface pattern recognition receptor signaling pathway	16175	1263		0.6701030927835051	0.673469387755102	67	16108	5	21	62	16087	16175	0.11755468103652063
M1	string	0	network_modules	177	TRUE	9.849033451728124e-5	120	26	6	0.23076923076923078	0.05	REAC:R-HSA-202403	REAC	TCR signaling	10916	2422		0.7526881720430108	0.7553191489361702	120	10796	6	20	114	10776	10916	0.10298994978205196
M1	string	0	network_modules	177	TRUE	1.2194184433331892e-4	70	26	5	0.19230769230769232	0.07142857142857142	KEGG:05120	KEGG	Epithelial cell signaling in Helicobacter pylori infection	8484	426		0.8333333333333334	0.8372093023255814	70	8414	5	21	65	8393	8484	0.11281198613096986
M1	string	0	network_modules	177	TRUE	1.3040676799600225e-4	248	26	7	0.2692307692307692	0.028225806451612902	GO:0000209	GO:BP	protein polyubiquitination	16175	59		0.6804123711340206	0.6836734693877551	248	15927	7	19	241	15908	16175	0.08291352764938106
M1	string	0	network_modules	177	TRUE	1.3724605652272112e-4	7	26	3	0.11538461538461539	0.42857142857142855	REAC:R-HSA-111463	REAC	SMAC (DIABLO) binds to IAPs 	10916	2149		0.7634408602150538	0.7978723404255319	7	10909	3	23	4	10886	10916	0.22147377783952463
M1	string	0	network_modules	177	TRUE	1.3724605652272112e-4	7	26	3	0.11538461538461539	0.42857142857142855	REAC:R-HSA-111464	REAC	SMAC(DIABLO)-mediated dissociation of IAP:caspase complexes 	10916	2150		0.7634408602150538	0.7978723404255319	7	10909	3	23	4	10886	10916	0.22147377783952463
M1	string	0	network_modules	177	TRUE	1.3724605652272112e-4	7	26	3	0.11538461538461539	0.42857142857142855	REAC:R-HSA-5603029	REAC	IkBA variant leads to EDA-ID	10916	1167		0.7634408602150538	0.7978723404255319	7	10909	3	23	4	10886	10916	0.22147377783952463
M1	string	0	network_modules	177	TRUE	1.3724605652272112e-4	7	26	3	0.11538461538461539	0.42857142857142855	REAC:R-HSA-111469	REAC	SMAC, XIAP-regulated apoptotic response	10916	2151		0.7634408602150538	0.7978723404255319	7	10909	3	23	4	10886	10916	0.22147377783952463
M1	string	0	network_modules	177	TRUE	1.4038655314256002e-4	72	26	5	0.19230769230769232	0.06944444444444445	KEGG:01524	KEGG	Platinum drug resistance	8484	198		0.8571428571428571	0.8604651162790697	72	8412	5	21	67	8391	8484	0.1111048566085111
M1	string	0	network_modules	177	TRUE	2.0659836150964435e-4	136	26	6	0.23076923076923078	0.04411764705882353	REAC:R-HSA-2871837	REAC	FCERI mediated NF-kB activation	10916	896		0.8064516129032258	0.8085106382978723	136	10780	6	20	130	10760	10916	0.09616830479892205
M1	string	0	network_modules	177	TRUE	2.5402734830103356e-4	32	26	4	0.15384615384615385	0.125	GO:2000116	GO:BP	regulation of cysteine-type endopeptidase activity	16175	25465		0.6907216494845361	0.7040816326530612	32	16143	4	22	28	16121	16175	0.1371376530721699
M1	string	0	network_modules	177	TRUE	2.5402734830103356e-4	32	26	4	0.15384615384615385	0.125	GO:0070266	GO:BP	necroptotic process	16175	16027		0.6907216494845361	0.7040816326530612	32	16143	4	22	28	16121	16175	0.1371376530721699
M1	string	0	network_modules	177	TRUE	3.090239617674576e-4	168	26	6	0.23076923076923078	0.03571428571428571	GO:0031396	GO:BP	regulation of protein ubiquitination	16175	7152		0.711340206185567	0.7142857142857143	168	16007	6	20	162	15987	16175	0.0872220505148058
M1	string	0	network_modules	177	TRUE	3.26526079141441e-4	147	26	6	0.23076923076923078	0.04081632653061224	REAC:R-HSA-1169410	REAC	Antiviral mechanism by IFN-stimulated genes	10916	157		0.8172043010752689	0.8191489361702128	147	10769	6	20	141	10749	10916	0.09212025823506813
M1	string	0	network_modules	177	TRUE	4.142171109397769e-4	35	26	4	0.15384615384615385	0.11428571428571428	REAC:R-HSA-936440	REAC	Negative regulators of DDX58/IFIH1 signaling	10916	1581		0.8279569892473119	0.8297872340425532	35	10881	4	22	31	10859	10916	0.1301990189144637
M1	string	0	network_modules	177	TRUE	4.938520171545708e-4	94	26	5	0.19230769230769232	0.05319148936170213	GO:0031398	GO:BP	positive regulation of protein ubiquitination	16175	7154		0.7216494845360825	0.7244897959183674	94	16081	5	21	89	16060	16175	0.09844820641075007
M1	string	0	network_modules	177	TRUE	5.180448131563308e-4	38	26	4	0.15384615384615385	0.10526315789473684	GO:0097300	GO:BP	programmed necrotic cell death	16175	18585		0.7319587628865979	0.7346938775510204	38	16137	4	22	34	16115	16175	0.12556209384511519
M1	string	0	network_modules	177	TRUE	5.813115974887598e-4	187	26	6	0.23076923076923078	0.03208556149732621	GO:0032496	GO:BP	response to lipopolysaccharide	16175	7607		0.7422680412371134	0.7448979591836735	187	15988	6	20	181	15968	16175	0.08228052021361933
M1	string	0	network_modules	177	TRUE	6.464942300600358e-4	39	26	4	0.15384615384615385	0.10256410256410256	REAC:R-HSA-5689896	REAC	Ovarian tumor domain proteases	10916	1653		0.8387096774193549	0.8404255319148937	39	10877	4	22	35	10855	10916	0.12306414928441647
M1	string	0	network_modules	177	TRUE	7.171679904798358e-4	40	26	4	0.15384615384615385	0.1	REAC:R-HSA-9692916	REAC	SARS-CoV-1 activates/modulates innate immune responses	10916	2115		0.8494623655913979	0.851063829787234	40	10876	4	22	36	10854	10916	0.12144761602385662
M1	string	0	network_modules	177	TRUE	7.799510176556597e-4	103	26	5	0.19230769230769232	0.04854368932038835	GO:0039531	GO:BP	regulation of cytoplasmic pattern recognition receptor signaling pathway	16175	9804		0.7525773195876289	0.7653061224489796	103	16072	5	21	98	16051	16175	0.09379442521975911
M1	string	0	network_modules	177	TRUE	7.799510176556597e-4	103	26	5	0.19230769230769232	0.04854368932038835	GO:0052547	GO:BP	regulation of peptidase activity	16175	14133		0.7525773195876289	0.7653061224489796	103	16072	5	21	98	16051	16175	0.09379442521975911
M1	string	0	network_modules	177	TRUE	8.406865907369919e-4	95	26	5	0.19230769230769232	0.05263157894736842	REAC:R-HSA-9692914	REAC	SARS-CoV-1-host interactions	10916	2119		0.8602150537634409	0.8617021276595744	95	10821	5	21	90	10800	10916	0.09658839692200204
M1	string	0	network_modules	177	TRUE	8.55894142112098e-4	12	26	3	0.11538461538461539	0.25	REAC:R-HSA-4755510	REAC	SUMOylation of immune response proteins	10916	2174		0.8709677419354839	0.8723404255319149	12	10904	3	23	9	10881	10916	0.16851677276830831
M1	string	0	network_modules	177	TRUE	8.634991250047068e-4	104	26	5	0.19230769230769232	0.04807692307692308	KEGG:04625	KEGG	C-type lectin receptor signaling pathway	8484	330		0.8809523809523809	0.8837209302325582	104	8380	5	21	99	8359	8484	0.09072068247284021
M1	string	0	network_modules	177	TRUE	9.41280728670477e-4	203	26	6	0.23076923076923078	0.029556650246305417	GO:0002237	GO:BP	response to molecule of bacterial origin	16175	770		0.7731958762886598	0.7755102040816326	203	15972	6	20	197	15952	16175	0.07865440235483764
M1	string	0	network_modules	177	TRUE	0.0011109041324813631	13	26	3	0.11538461538461539	0.23076923076923078	REAC:R-HSA-111461	REAC	Cytochrome c-mediated apoptotic response	10916	424		0.8817204301075269	0.8829787234042553	13	10903	3	23	10	10880	10916	0.16178331684266212
M1	string	0	network_modules	177	TRUE	0.0011158129876016666	12	26	3	0.11538461538461539	0.25	GO:0035666	GO:BP	TRIF-dependent toll-like receptor signaling pathway	16175	9146		0.7835051546391752	0.7857142857142857	12	16163	3	23	9	16140	16175	0.16894800003492952
M1	string	0	network_modules	177	TRUE	0.0011352271440796713	182	26	6	0.23076923076923078	0.03296703296703297	REAC:R-HSA-2454202	REAC	Fc epsilon receptor (FCERI) signaling	10916	938		0.8924731182795699	0.8936170212765957	182	10734	6	20	176	10714	10916	0.08170135358108567
M1	string	0	network_modules	177	TRUE	0.0014490099394394822	13	26	3	0.11538461538461539	0.23076923076923078	GO:0070424	GO:BP	regulation of nucleotide-binding domain, leucine rich repeat containing receptor signaling pathway	16175	16110		0.7938144329896907	0.8061224489795918	13	16162	3	23	10	16139	16175	0.16223747198685623
M1	string	0	network_modules	177	TRUE	0.0014490099394394822	13	26	3	0.11538461538461539	0.23076923076923078	GO:1902916	GO:BP	positive regulation of protein polyubiquitination	16175	22613		0.7938144329896907	0.8061224489795918	13	16162	3	23	10	16139	16175	0.16223747198685623
M1	string	0	network_modules	177	TRUE	0.0014586790636469237	298	26	7	0.2692307692307692	0.02348993288590604	REAC:R-HSA-5688426	REAC	Deubiquitination	10916	736		0.9032258064516129	0.9042553191489362	298	10618	7	19	291	10599	10916	0.07254358151346553
M1	string	0	network_modules	177	TRUE	0.001595292008116632	50	26	4	0.15384615384615385	0.08	GO:0043124	GO:BP	negative regulation of canonical NF-kappaB signal transduction	16175	10543		0.8144329896907216	0.8163265306122449	50	16125	4	22	46	16103	16175	0.10896697702314259
M1	string	0	network_modules	177	TRUE	0.0017617665732461262	15	26	3	0.11538461538461539	0.2	REAC:R-HSA-918233	REAC	TRAF3-dependent IRF activation pathway	10916	2464		0.9139784946236559	0.9148936170212766	15	10901	3	23	12	10878	10916	0.15038421648994627
M1	string	0	network_modules	177	TRUE	0.0019888318229125722	749	26	9	0.34615384615384615	0.012016021361815754	GO:0070647	GO:BP	protein modification by small protein conjugation or removal	16175	16231		0.8247422680412371	0.826530612244898	749	15426	9	17	740	15409	16175	0.05725210604024839
M1	string	0	network_modules	177	TRUE	0.0021261314090347187	375	26	7	0.2692307692307692	0.018666666666666668	GO:0030162	GO:BP	regulation of proteolysis	16175	6690		0.8350515463917526	0.8367346938775511	375	15800	7	19	368	15781	16175	0.06560421851286806
M1	string	0	network_modules	177	TRUE	0.002164901991439167	16	26	3	0.11538461538461539	0.1875	REAC:R-HSA-5676594	REAC	TNF receptor superfamily (TNFSF) members mediating non-canonical NF-kB pathway	10916	2445		0.9247311827956989	0.9361702127659575	16	10900	3	23	13	10877	10916	0.14549856698069571
M1	string	0	network_modules	177	TRUE	0.002164901991439167	16	26	3	0.11538461538461539	0.1875	REAC:R-HSA-5684264	REAC	MAP3K8 (TPL2)-dependent MAPK1/3 activation	10916	1347		0.9247311827956989	0.9361702127659575	16	10900	3	23	13	10877	10916	0.14549856698069571
M1	string	0	network_modules	177	TRUE	0.0024262532153276487	54	26	4	0.15384615384615385	0.07407407407407407	REAC:R-HSA-109606	REAC	Intrinsic Pathway for Apoptosis	10916	1268		0.946236559139785	0.9468085106382979	54	10862	4	22	50	10840	10916	0.10369960442288996
M1	string	0	network_modules	177	TRUE	0.0025333990433526045	385	26	7	0.2692307692307692	0.01818181818181818	GO:0043065	GO:BP	positive regulation of apoptotic process	16175	10511		0.845360824742268	0.8469387755102041	385	15790	7	19	378	15771	16175	0.06460437002153883
M1	string	0	network_modules	177	TRUE	0.002828155079357112	16	26	3	0.11538461538461539	0.1875	GO:0002756	GO:BP	MyD88-independent toll-like receptor signaling pathway	16175	1267		0.8556701030927835	0.8571428571428571	16	16159	3	23	13	16136	16175	0.14601571742775804
M1	string	0	network_modules	177	TRUE	0.0033204011798961177	401	26	7	0.2692307692307692	0.017456359102244388	GO:0043068	GO:BP	positive regulation of programmed cell death	16175	10514		0.865979381443299	0.8673469387755102	401	15774	7	19	394	15755	16175	0.0630792170533254
M1	string	0	network_modules	177	TRUE	0.0033627878579465826	798	26	9	0.34615384615384615	0.011278195488721804	GO:0043687	GO:BP	post-translational protein modification	16175	10838		0.8762886597938144	0.8775510204081632	798	15377	9	17	789	15360	16175	0.05499355422998049
M1	string	0	network_modules	177	TRUE	0.0034719036355104847	221	26	6	0.23076923076923078	0.027149321266968326	REAC:R-HSA-5689880	REAC	Ub-specific processing proteases	10916	2617		0.956989247311828	0.9574468085106383	221	10695	6	20	215	10675	10916	0.07303831820016249
M1	string	0	network_modules	177	TRUE	0.003623390436482676	590	26	8	0.3076923076923077	0.013559322033898305	GO:0016567	GO:BP	protein ubiquitination	16175	5254		0.8865979381443299	0.8877551020408163	590	15585	8	18	582	15567	16175	0.05804896314180632
M1	string	0	network_modules	177	TRUE	0.0036332825162157466	140	26	5	0.19230769230769232	0.03571428571428571	KEGG:04120	KEGG	Ubiquitin mediated proteolysis	8484	270		0.9047619047619048	0.9069767441860465	140	8344	5	21	135	8323	8484	0.07651315754586989
M1	string	0	network_modules	177	TRUE	0.0037283258174364156	19	26	3	0.11538461538461539	0.15789473684210525	REAC:R-HSA-111471	REAC	Apoptotic factor-mediated response	10916	163		0.967741935483871	0.9680851063829787	19	10897	3	23	16	10874	10916	0.13321486586563272
M1	string	0	network_modules	177	TRUE	0.003826626813814414	142	26	5	0.19230769230769232	0.035211267605633804	GO:0071222	GO:BP	cellular response to lipopolysaccharide	16175	16484		0.8969072164948454	0.8979591836734694	142	16033	5	21	137	16012	16175	0.07894244901231015
M1	string	0	network_modules	177	TRUE	0.00406816380900819	63	26	4	0.15384615384615385	0.06349206349206349	GO:0008625	GO:BP	extrinsic apoptotic signaling pathway via death domain receptors	16175	3214		0.9072164948453608	0.9081632653061225	63	16112	4	22	59	16090	16175	0.09659691299209111
M1	string	0	network_modules	177	TRUE	0.004386395754231182	146	26	5	0.19230769230769232	0.03424657534246575	GO:0062207	GO:BP	regulation of pattern recognition receptor signaling pathway	16175	15863		0.9175257731958762	0.9183673469387755	146	16029	5	21	141	16008	16175	0.0777583323728572
M1	string	0	network_modules	177	TRUE	0.004907513414524612	76	26	4	0.15384615384615385	0.05263157894736842	KEGG:05133	KEGG	Pertussis	8484	430		0.9285714285714286	0.9534883720930233	76	8408	4	22	72	8386	8484	0.08525760107967441
M1	string	0	network_modules	177	TRUE	0.004907513414524612	76	26	4	0.15384615384615385	0.05263157894736842	KEGG:05212	KEGG	Pancreatic cancer	8484	463		0.9285714285714286	0.9534883720930233	76	8408	4	22	72	8386	8484	0.08525760107967441
M1	string	0	network_modules	177	TRUE	0.005344777022423571	152	26	5	0.19230769230769232	0.03289473684210526	GO:0071219	GO:BP	cellular response to molecule of bacterial origin	16175	16481		0.9278350515463918	0.9285714285714286	152	16023	5	21	147	16002	16175	0.076068177606968
M1	string	0	network_modules	177	TRUE	0.00562692498908163	140	26	5	0.19230769230769232	0.03571428571428571	REAC:R-HSA-9678108	REAC	SARS-CoV-1 Infection	10916	2114		0.978494623655914	0.9787234042553191	140	10776	5	21	135	10755	10916	0.07794091816051123
M1	string	0	network_modules	177	TRUE	0.006295300390119207	30	26	3	0.11538461538461539	0.1	KEGG:01523	KEGG	Antifolate resistance	8484	197		0.9761904761904762	0.9767441860465116	30	8454	3	23	27	8431	8484	0.1044701198349285
M1	string	0	network_modules	177	TRUE	0.0066811333727300375	21	26	3	0.11538461538461539	0.14285714285714285	GO:0034138	GO:BP	toll-like receptor 3 signaling pathway	16175	8446		0.9381443298969072	0.9387755102040817	21	16154	3	23	18	16131	16175	0.12712823401015022
M1	string	0	network_modules	177	TRUE	0.007727800711620386	22	26	3	0.11538461538461539	0.13636363636363635	GO:0035872	GO:BP	nucleotide-binding domain, leucine rich repeat containing receptor signaling pathway	16175	9301		0.9484536082474226	0.9591836734693877	22	16153	3	23	19	16130	16175	0.12414189032667687
M1	string	0	network_modules	177	TRUE	0.007727800711620386	22	26	3	0.11538461538461539	0.13636363636363635	GO:1902914	GO:BP	regulation of protein polyubiquitination	16175	22611		0.9484536082474226	0.9591836734693877	22	16153	3	23	19	16130	16175	0.12414189032667687
M1	string	0	network_modules	177	TRUE	0.008877495418110313	23	26	3	0.11538461538461539	0.13043478260869565	GO:0032727	GO:BP	positive regulation of interferon-alpha production	16175	7772		0.9690721649484536	0.9693877551020408	23	16152	3	23	20	16129	16175	0.12135109035153473
M1	string	0	network_modules	177	TRUE	0.00898881231571881	667	26	8	0.3076923076923077	0.01199400299850075	GO:0032446	GO:BP	protein modification by small protein conjugation	16175	7568		0.979381443298969	0.9795918367346939	667	15508	8	18	659	15490	16175	0.05377031275736267
M1	string	0	network_modules	177	TRUE	0.009013894896779968	75	26	4	0.15384615384615385	0.05333333333333334	REAC:R-HSA-9833482	REAC	PKR-mediated signaling	10916	1692		0.989247311827957	0.9893617021276596	75	10841	4	22	71	10819	10916	0.0869392559450189
M1	string	0	network_modules	177	TRUE	0.009090424753541715	89	26	4	0.15384615384615385	0.0449438202247191	KEGG:05235	KEGG	PD-L1 expression and PD-1 checkpoint pathway in cancer	8484	480		1	1	89	8395	4	22	85	8373	8484	0.07801236901269273
M1	string	0	network_modules	177	TRUE	0.009102464204842906	77	26	4	0.15384615384615385	0.05194805194805195	GO:0052548	GO:BP	regulation of endopeptidase activity	16175	14134		0.9896907216494846	0.9897959183673469	77	16098	4	22	73	16076	16175	0.08690862364672917
M1	string	0	network_modules	177	TRUE	0.009326831797577347	263	26	6	0.23076923076923078	0.022813688212927757	REAC:R-HSA-913531	REAC	Interferon Signaling	10916	1227		1	1	263	10653	6	20	257	10633	10916	0.06585864628347139
M1	string	0	network_modules	177	TRUE	0.009779182334754498	172	26	5	0.19230769230769232	0.029069767441860465	GO:0071216	GO:BP	cellular response to biotic stimulus	16175	16478		1	1	172	16003	5	21	167	15982	16175	0.07106994745709616
M1	string	0	network_modules	178	TRUE	1.5863054696666952e-49	57	26	23	0.8846153846153846	0.40350877192982454	REAC:R-HSA-6799198	REAC	Complex I biogenesis	10916	391		0	0.3333333333333333	57	10859	23	3	34	10856	10916	0.5961935353781893
M1	string	0	network_modules	178	TRUE	1.5795845749524585e-42	103	26	23	0.8846153846153846	0.22330097087378642	REAC:R-HSA-611105	REAC	Respiratory electron transport	10916	2081		0.5	0.6666666666666666	103	10813	23	3	80	10810	10916	0.442325299013299
M1	string	0	network_modules	178	TRUE	3.2197053105517644e-42	61	26	20	0.7692307692307693	0.32786885245901637	GO:0032981	GO:BP	mitochondrial respiratory chain complex I assembly	16175	7963		0	0.044444444444444446	61	16114	20	6	41	16108	16175	0.5010877388567508
M1	string	0	network_modules	178	TRUE	3.2197053105517644e-42	61	26	20	0.7692307692307693	0.32786885245901637	GO:0010257	GO:BP	NADH dehydrogenase complex assembly	16175	4030		0	0.044444444444444446	61	16114	20	6	41	16108	16175	0.5010877388567508
M1	string	0	network_modules	178	TRUE	1.4616320857116214e-38	65	26	19	0.7307692307692307	0.2923076923076923	GO:0042776	GO:BP	proton motive force-driven mitochondrial ATP synthesis	16175	10361		0.045454545454545456	0.06666666666666667	65	16110	19	7	46	16103	16175	0.4609344268789438
M1	string	0	network_modules	178	TRUE	1.3880866878195891e-37	97	26	20	0.7692307692307693	0.20618556701030927	GO:0033108	GO:BP	mitochondrial respiratory chain complex assembly	16175	8042		0.06818181818181818	0.08888888888888889	97	16078	20	6	77	16072	16175	0.3966558795274751
M1	string	0	network_modules	178	TRUE	1.3928167491735142e-37	72	26	19	0.7307692307692307	0.2638888888888889	GO:0015986	GO:BP	proton motive force-driven ATP synthesis	16175	5062		0.09090909090909091	0.1111111111111111	72	16103	19	7	53	16096	16175	0.4377894171252412
M1	string	0	network_modules	178	TRUE	1.2689283916012408e-36	177	26	23	0.8846153846153846	0.12994350282485875	REAC:R-HSA-1428517	REAC	Aerobic respiration and respiratory electron transport	10916	127		1	1	177	10739	23	3	154	10736	10916	0.335960213486348
M1	string	0	network_modules	178	TRUE	1.824606788234894e-36	109	26	20	0.7692307692307693	0.1834862385321101	GO:0097250	GO:BP	mitochondrial respirasome assembly	16175	18559		0.11363636363636363	0.13333333333333333	109	16066	20	6	89	16060	16175	0.37396098315252496
M1	string	0	network_modules	178	TRUE	1.6860284774047493e-35	90	26	19	0.7307692307692307	0.2111111111111111	GO:0006754	GO:BP	ATP biosynthetic process	16175	2451		0.13636363636363635	0.15555555555555556	90	16085	19	7	71	16078	16175	0.39118951099156535
M1	string	0	network_modules	178	TRUE	2.683364603104815e-35	92	26	19	0.7307692307692307	0.20652173913043478	GO:0009145	GO:BP	purine nucleoside triphosphate biosynthetic process	16175	3312		0.1590909090909091	0.2	92	16083	19	7	73	16076	16175	0.3868721709763068
M1	string	0	network_modules	178	TRUE	2.683364603104815e-35	92	26	19	0.7307692307692307	0.20652173913043478	GO:0009206	GO:BP	purine ribonucleoside triphosphate biosynthetic process	16175	3372		0.1590909090909091	0.2	92	16083	19	7	73	16076	16175	0.3868721709763068
M1	string	0	network_modules	178	TRUE	5.091334398572165e-35	127	26	20	0.7692307692307693	0.15748031496062992	GO:0006119	GO:BP	oxidative phosphorylation	16175	1977		0.20454545454545456	0.2222222222222222	127	16048	20	6	107	16042	16175	0.3461360277059303
M1	string	0	network_modules	178	TRUE	8.174614283916656e-35	97	26	19	0.7307692307692307	0.1958762886597938	GO:0009201	GO:BP	ribonucleoside triphosphate biosynthetic process	16175	3367		0.22727272727272727	0.24444444444444444	97	16078	19	7	78	16071	16175	0.37666725460191347
M1	string	0	network_modules	178	TRUE	2.868376604445593e-34	103	26	19	0.7307692307692307	0.18446601941747573	GO:0009142	GO:BP	nucleoside triphosphate biosynthetic process	16175	3309		0.25	0.26666666666666666	103	16072	19	7	84	16065	16175	0.36541287082527407
M1	string	0	network_modules	178	TRUE	6.901299136087644e-33	46	26	16	0.6153846153846154	0.34782608695652173	GO:0006120	GO:BP	mitochondrial electron transport, NADH to ubiquinone	16175	1978		0.2727272727272727	0.28888888888888886	46	16129	16	10	30	16119	16175	0.46154119936834676
M1	string	0	network_modules	178	TRUE	9.339404657897208e-33	162	26	20	0.7692307692307693	0.12345679012345678	GO:0009060	GO:BP	aerobic respiration	16175	3236		0.29545454545454547	0.3111111111111111	162	16013	20	6	142	16007	16175	0.3059350574476308
M1	string	0	network_modules	178	TRUE	2.537452490883133e-32	128	26	19	0.7307692307692307	0.1484375	GO:0009152	GO:BP	purine ribonucleotide biosynthetic process	16175	3319		0.3181818181818182	0.3333333333333333	128	16047	19	7	109	16040	16175	0.3273466459330692
M1	string	0	network_modules	178	TRUE	1.012897345746727e-31	137	26	19	0.7307692307692307	0.1386861313868613	GO:0009260	GO:BP	ribonucleotide biosynthetic process	16175	3425		0.3409090909090909	0.35555555555555557	137	16038	19	7	118	16031	16175	0.3162568885669209
M1	string	0	network_modules	178	TRUE	2.1643949814505797e-31	188	26	20	0.7692307692307693	0.10638297872340426	GO:0045333	GO:BP	cellular respiration	16175	11360		0.36363636363636365	0.37777777777777777	188	15987	20	6	168	15981	16175	0.28362220258968945
M1	string	0	network_modules	178	TRUE	2.416297027915152e-31	143	26	19	0.7307692307692307	0.13286713286713286	GO:0046390	GO:BP	ribose phosphate biosynthetic process	16175	12117		0.38636363636363635	0.4	143	16032	19	7	124	16025	16175	0.30944995110397816
M1	string	0	network_modules	178	TRUE	2.1076130975851946e-30	232	25	22	0.88	0.09482758620689655	KEGG:04714	KEGG	Thermogenesis	8484	349		0	0.09090909090909091	232	8252	22	3	210	8249	8484	0.2842238980284561
M1	string	0	network_modules	178	TRUE	2.5890304930216817e-30	88	26	17	0.6538461538461539	0.19318181818181818	GO:0042773	GO:BP	ATP synthesis coupled electron transport	16175	10358		0.4090909090909091	0.4444444444444444	88	16087	17	9	71	16078	16175	0.35369268325168823
M1	string	0	network_modules	178	TRUE	2.5890304930216817e-30	88	26	17	0.6538461538461539	0.19318181818181818	GO:0042775	GO:BP	mitochondrial ATP synthesis coupled electron transport	16175	10360		0.4090909090909091	0.4444444444444444	88	16087	17	9	71	16078	16175	0.35369268325168823
M1	string	0	network_modules	178	TRUE	3.823166126909612e-30	164	26	19	0.7307692307692307	0.11585365853658537	GO:0006164	GO:BP	purine nucleotide biosynthetic process	16175	1999		0.45454545454545453	0.4666666666666667	164	16011	19	7	145	16004	16175	0.28862862995278055
M1	string	0	network_modules	178	TRUE	2.317125975081478e-29	99	26	17	0.6538461538461539	0.1717171717171717	GO:0022904	GO:BP	respiratory electron transport chain	16175	6631		0.4772727272727273	0.4888888888888889	99	16076	17	9	82	16067	16175	0.3332288622126452
M1	string	0	network_modules	178	TRUE	3.813713791255604e-29	184	26	19	0.7307692307692307	0.10326086956521739	GO:0046034	GO:BP	ATP metabolic process	16175	11811		0.5	0.5111111111111111	184	15991	19	7	165	15984	16175	0.27219367150905616
M1	string	0	network_modules	178	TRUE	4.7298476791908765e-29	186	26	19	0.7307692307692307	0.10215053763440861	GO:0009165	GO:BP	nucleotide biosynthetic process	16175	3331		0.5227272727272727	0.5333333333333333	186	15989	19	7	167	15982	16175	0.27069670631644177
M1	string	0	network_modules	178	TRUE	9.702292489038028e-29	107	26	17	0.6538461538461539	0.1588785046728972	GO:0022900	GO:BP	electron transport chain	16175	6630		0.5454545454545454	0.5555555555555556	107	16068	17	9	90	16059	16175	0.3203647030521622
M1	string	0	network_modules	178	TRUE	9.748495165619812e-29	252	26	20	0.7692307692307693	0.07936507936507936	GO:0015980	GO:BP	energy derivation by oxidation of organic compounds	16175	5060		0.5681818181818182	0.5777777777777777	252	15923	20	6	232	15917	16175	0.24418321440205631
M1	string	0	network_modules	178	TRUE	1.6385084855878745e-28	198	26	19	0.7307692307692307	0.09595959595959595	GO:0009205	GO:BP	purine ribonucleoside triphosphate metabolic process	16175	3371		0.5909090909090909	0.6	198	15977	19	7	179	15970	16175	0.26219336735553844
M1	string	0	network_modules	178	TRUE	1.6963303389117238e-28	134	25	19	0.76	0.1417910447761194	KEGG:00190	KEGG	Oxidative phosphorylation	8484	18		0.1	0.18181818181818182	134	8350	19	6	115	8344	8484	0.3244953121465244
M1	string	0	network_modules	178	TRUE	2.20781822010516e-28	201	26	19	0.7307692307692307	0.0945273631840796	GO:0009144	GO:BP	purine nucleoside triphosphate metabolic process	16175	3311		0.6136363636363636	0.6222222222222222	201	15974	19	7	182	15967	16175	0.26018660101225377
M1	string	0	network_modules	178	TRUE	2.844724220369423e-28	82	26	16	0.6153846153846154	0.1951219512195122	GO:0019646	GO:BP	aerobic electron transport chain	16175	5967		0.6363636363636364	0.6444444444444445	82	16093	16	10	66	16083	16175	0.34481551875572386
M1	string	0	network_modules	178	TRUE	2.9611343221110016e-28	204	26	19	0.7307692307692307	0.09313725490196079	GO:0009199	GO:BP	ribonucleoside triphosphate metabolic process	16175	3365		0.6590909090909091	0.6666666666666666	204	15971	19	7	185	15964	16175	0.2582239447856298
M1	string	0	network_modules	178	TRUE	8.36811856717965e-28	215	26	19	0.7307692307692307	0.08837209302325581	GO:0009141	GO:BP	nucleoside triphosphate metabolic process	16175	3308		0.6818181818181818	0.6888888888888889	215	15960	19	7	196	15953	16175	0.25137988587194193
M1	string	0	network_modules	178	TRUE	1.1586200874769762e-27	364	26	21	0.8076923076923077	0.057692307692307696	GO:0007005	GO:BP	mitochondrion organization	16175	2617		0.7045454545454546	0.7111111111111111	364	15811	21	5	343	15806	16175	0.21242307141294087
M1	string	0	network_modules	178	TRUE	1.267272670311309e-27	148	25	19	0.76	0.12837837837837837	KEGG:04723	KEGG	Retrograde endocannabinoid signaling	8484	353		0.2	0.2727272727272727	148	8336	19	6	129	8330	8484	0.30834030722554334
M1	string	0	network_modules	178	TRUE	1.3174971830016303e-27	220	26	19	0.7307692307692307	0.08636363636363636	GO:0072522	GO:BP	purine-containing compound biosynthetic process	16175	17424		0.7272727272727273	0.7333333333333333	220	15955	19	7	201	15948	16175	0.24843873031615715
M1	string	0	network_modules	178	TRUE	3.5136271139095356e-26	260	26	19	0.7307692307692307	0.07307692307692308	GO:1901293	GO:BP	nucleoside phosphate biosynthetic process	16175	21368		0.75	0.7555555555555555	260	15915	19	7	241	15908	16175	0.22802838953650248
M1	string	0	network_modules	178	TRUE	5.491448489237659e-26	266	26	19	0.7307692307692307	0.07142857142857142	GO:0009150	GO:BP	purine ribonucleotide metabolic process	16175	3317		0.7727272727272727	0.7777777777777778	266	15909	19	7	247	15902	16175	0.22536744916621032
M1	string	0	network_modules	178	TRUE	1.129782873733463e-25	276	26	19	0.7307692307692307	0.06884057971014493	GO:0009259	GO:BP	ribonucleotide metabolic process	16175	3424		0.7954545454545454	0.8	276	15899	19	7	257	15892	16175	0.22112506002459356
M1	string	0	network_modules	178	TRUE	1.8422927483320978e-25	283	26	19	0.7307692307692307	0.06713780918727916	GO:0019693	GO:BP	ribose phosphate metabolic process	16175	6010		0.8181818181818182	0.8222222222222222	283	15892	19	7	264	15885	16175	0.2182888196370432
M1	string	0	network_modules	178	TRUE	2.907130957529999e-25	372	26	20	0.7692307692307693	0.053763440860215055	GO:0006091	GO:BP	generation of precursor metabolites and energy	16175	1954		0.8409090909090909	0.8444444444444444	372	15803	20	6	352	15797	16175	0.19975191790442334
M1	string	0	network_modules	178	TRUE	6.2833841637302195e-25	202	25	19	0.76	0.09405940594059406	KEGG:05415	KEGG	Diabetic cardiomyopathy	8484	492		0.3	0.36363636363636365	202	8282	19	6	183	8276	8484	0.26251737245723616
M1	string	0	network_modules	178	TRUE	3.697232534204251e-24	221	25	19	0.76	0.08597285067873303	KEGG:05208	KEGG	Chemical carcinogenesis - reactive oxygen species	8484	460		0.4	0.45454545454545453	221	8263	19	6	202	8257	8484	0.2505031464541231
M1	string	0	network_modules	178	TRUE	1.0833501487023913e-23	349	26	19	0.7307692307692307	0.054441260744985676	GO:0006163	GO:BP	purine nucleotide metabolic process	16175	1998		0.8636363636363636	0.8666666666666667	349	15826	19	7	330	15819	16175	0.195850246752677
M1	string	0	network_modules	178	TRUE	6.420662627545948e-23	154	25	17	0.68	0.11038961038961038	KEGG:04932	KEGG	Non-alcoholic fatty liver disease	8484	389		0.5	0.5454545454545454	154	8330	17	8	137	8322	8484	0.26951731576926224
M1	string	0	network_modules	178	TRUE	8.392794477272816e-23	388	26	19	0.7307692307692307	0.04896907216494845	GO:0009117	GO:BP	nucleotide metabolic process	16175	3286		0.8863636363636364	0.8888888888888888	388	15787	19	7	369	15780	16175	0.18534364974881146
M1	string	0	network_modules	178	TRUE	1.2933691018267776e-22	265	25	19	0.76	0.07169811320754717	KEGG:05012	KEGG	Parkinson disease	8484	412		0.6	0.6363636363636364	265	8219	19	6	246	8213	8484	0.22775403118215087
M1	string	0	network_modules	178	TRUE	2.0006372251555688e-22	271	25	19	0.76	0.07011070110701106	KEGG:05020	KEGG	Prion disease	8484	416		0.7	0.7272727272727273	271	8213	19	6	252	8207	8484	0.22508227021513225
M1	string	0	network_modules	178	TRUE	1.986670500554203e-21	305	25	19	0.76	0.06229508196721312	KEGG:05016	KEGG	Huntington disease	8484	414		0.8	0.8181818181818182	305	8179	19	6	286	8173	8484	0.21143635908018127
M1	string	0	network_modules	178	TRUE	3.2181280270157297e-21	469	26	19	0.7307692307692307	0.04051172707889126	GO:0072521	GO:BP	purine-containing compound metabolic process	16175	17423		0.9090909090909091	0.9111111111111111	469	15706	19	7	450	15699	16175	0.16781706456422113
M1	string	0	network_modules	178	TRUE	1.726585777294626e-20	512	26	19	0.7307692307692307	0.037109375	GO:0090407	GO:BP	organophosphate biosynthetic process	16175	18274		0.9318181818181818	0.9333333333333333	512	15663	19	7	493	15656	16175	0.16022658918957883
M1	string	0	network_modules	178	TRUE	1.860237448153363e-20	514	26	19	0.7307692307692307	0.03696498054474708	GO:1901137	GO:BP	carbohydrate derivative biosynthetic process	16175	21245		0.9545454545454546	0.9555555555555556	514	15661	19	7	495	15654	16175	0.15989648639865092
M1	string	0	network_modules	178	TRUE	2.4092723748624676e-20	521	26	19	0.7307692307692307	0.036468330134357005	GO:0006753	GO:BP	nucleoside phosphate metabolic process	16175	2450		0.9772727272727273	0.9777777777777777	521	15654	19	7	502	15647	16175	0.15875584742532484
M1	string	0	network_modules	178	TRUE	5.72124913806803e-20	363	25	19	0.76	0.05234159779614325	KEGG:05014	KEGG	Amyotrophic lateral sclerosis	8484	413		0.9	0.9090909090909091	363	8121	19	6	344	8115	8484	0.19266445002943453
M1	string	0	network_modules	178	TRUE	8.930419230810252e-20	558	26	19	0.7307692307692307	0.034050179211469536	GO:0055086	GO:BP	nucleobase-containing small molecule metabolic process	16175	14237		1	1	558	15617	19	7	539	15610	16175	0.1530808591421648
M1	string	0	network_modules	178	TRUE	1.5247912868659696e-19	382	25	19	0.76	0.049738219895287955	KEGG:05010	KEGG	Alzheimer disease	8484	411		1	1	382	8102	19	6	363	8096	8484	0.1874449056043894
M1	string	0	network_modules	179	TRUE	1.1350636708510479e-9	367	23	11	0.4782608695652174	0.02997275204359673	GO:0005975	GO:BP	carbohydrate metabolic process	16175	1850		0	0.0136986301369863	367	15808	11	12	356	15796	16175	0.11544633189619088
M1	string	0	network_modules	179	TRUE	1.0080650574108159e-8	115	21	8	0.38095238095238093	0.06956521739130435	KEGG:01200	KEGG	Carbon metabolism	8484	184		0	0.14285714285714285	115	8369	8	13	107	8356	8484	0.15826999006584805
M1	string	0	network_modules	179	TRUE	5.0336631113710336e-8	521	23	11	0.4782608695652174	0.02111324376199616	GO:0006753	GO:BP	nucleoside phosphate metabolic process	16175	2450		0.013888888888888888	0.0273972602739726	521	15654	11	12	510	15642	16175	0.09533397964835004
M1	string	0	network_modules	179	TRUE	5.846832815173333e-8	163	23	8	0.34782608695652173	0.049079754601226995	GO:0005996	GO:BP	monosaccharide metabolic process	16175	1871		0.027777777777777776	0.0410958904109589	163	16012	8	15	155	15997	16175	0.1276063496878929
M1	string	0	network_modules	179	TRUE	7.378777108581077e-8	388	23	10	0.43478260869565216	0.02577319587628866	GO:0009117	GO:BP	nucleotide metabolic process	16175	3286		0.041666666666666664	0.0547945205479452	388	15787	10	13	378	15774	16175	0.10131051148363815
M1	string	0	network_modules	179	TRUE	1.05069557030856e-7	558	23	11	0.4782608695652174	0.01971326164874552	GO:0055086	GO:BP	nucleobase-containing small molecule metabolic process	16175	14237		0.05555555555555555	0.0684931506849315	558	15617	11	12	547	15605	16175	0.09175514430592302
M1	string	0	network_modules	179	TRUE	3.853415439354411e-7	288	21	9	0.42857142857142855	0.03125	REAC:R-HSA-71387	REAC	Metabolism of carbohydrates	10916	1422		0	0.25	288	10628	9	12	279	10616	10916	0.11017087477827077
M1	string	0	network_modules	179	TRUE	4.155807529597501e-7	123	23	7	0.30434782608695654	0.056910569105691054	GO:0016052	GO:BP	carbohydrate catabolic process	16175	5084		0.06944444444444445	0.0821917808219178	123	16052	7	16	116	16036	16175	0.12890184560098347
M1	string	0	network_modules	179	TRUE	4.820226809158564e-7	65	23	6	0.2608695652173913	0.09230769230769231	GO:0046364	GO:BP	monosaccharide biosynthetic process	16175	12095		0.08333333333333333	0.0958904109589041	65	16110	6	17	59	16093	16175	0.15320463247104454
M1	string	0	network_modules	179	TRUE	9.357068053851705e-7	138	23	7	0.30434782608695654	0.050724637681159424	GO:0046496	GO:BP	nicotinamide nucleotide metabolic process	16175	12199		0.09722222222222222	0.1232876712328767	138	16037	7	16	131	16021	16175	0.12137124711495721
M1	string	0	network_modules	179	TRUE	9.357068053851705e-7	138	23	7	0.30434782608695654	0.050724637681159424	GO:0019362	GO:BP	pyridine nucleotide metabolic process	16175	5724		0.09722222222222222	0.1232876712328767	138	16037	7	16	131	16021	16175	0.12137124711495721
M1	string	0	network_modules	179	TRUE	9.844698114106879e-7	139	23	7	0.30434782608695654	0.050359712230215826	GO:1901292	GO:BP	nucleoside phosphate catabolic process	16175	21367		0.125	0.136986301369863	139	16036	7	16	132	16020	16175	0.12091236722653022
M1	string	0	network_modules	179	TRUE	1.12820974363879e-6	74	21	6	0.2857142857142857	0.08108108108108109	KEGG:01230	KEGG	Biosynthesis of amino acids	8484	188		0.16666666666666666	0.2857142857142857	74	8410	6	15	68	8395	8484	0.14838892255055933
M1	string	0	network_modules	179	TRUE	1.1444672762835888e-6	33	21	5	0.23809523809523808	0.15151515151515152	REAC:R-HSA-70263	REAC	Gluconeogenesis	10916	1052		0.3333333333333333	0.5	33	10883	5	16	28	10867	10916	0.18798770979694032
M1	string	0	network_modules	179	TRUE	1.2017984674595905e-6	143	23	7	0.30434782608695654	0.04895104895104895	GO:0072524	GO:BP	pyridine-containing compound metabolic process	16175	17426		0.1388888888888889	0.1506849315068493	143	16032	7	16	136	16016	16175	0.11912447218753557
M1	string	0	network_modules	179	TRUE	1.603836695784339e-6	149	23	7	0.30434782608695654	0.04697986577181208	GO:0019318	GO:BP	hexose metabolic process	16175	5681		0.1527777777777778	0.1643835616438356	149	16026	7	16	142	16010	16175	0.11657667252990515
M1	string	0	network_modules	179	TRUE	7.272077933304434e-6	185	23	7	0.30434782608695654	0.03783783783783784	GO:0046434	GO:BP	organophosphate catabolic process	16175	12142		0.16666666666666666	0.1780821917808219	185	15990	7	16	178	15974	16175	0.10394887269278816
M1	string	0	network_modules	179	TRUE	8.468567905203938e-6	16	23	4	0.17391304347826086	0.25	GO:0061718	GO:BP	glucose catabolic process to pyruvate	16175	15628		0.18055555555555555	0.2191780821917808	16	16159	4	19	12	16140	16175	0.20757868218122585
M1	string	0	network_modules	179	TRUE	8.468567905203938e-6	16	23	4	0.17391304347826086	0.25	GO:0061621	GO:BP	canonical glycolysis	16175	15590		0.18055555555555555	0.2191780821917808	16	16159	4	19	12	16140	16175	0.20757868218122585
M1	string	0	network_modules	179	TRUE	8.468567905203938e-6	16	23	4	0.17391304347826086	0.25	GO:0006735	GO:BP	NADH regeneration	16175	2436		0.18055555555555555	0.2191780821917808	16	16159	4	19	12	16140	16175	0.20757868218122585
M1	string	0	network_modules	179	TRUE	1.1063870258999345e-5	17	23	4	0.17391304347826086	0.23529411764705882	GO:0061620	GO:BP	glycolytic process through glucose-6-phosphate	16175	15589		0.2222222222222222	0.2465753424657534	17	16158	4	19	13	16139	16175	0.2013151332267259
M1	string	0	network_modules	179	TRUE	1.1063870258999345e-5	17	23	4	0.17391304347826086	0.23529411764705882	GO:0061615	GO:BP	glycolytic process through fructose-6-phosphate	16175	15586		0.2222222222222222	0.2465753424657534	17	16158	4	19	13	16139	16175	0.2013151332267259
M1	string	0	network_modules	179	TRUE	1.7413339954247723e-5	117	23	6	0.2608695652173913	0.05128205128205128	GO:0009166	GO:BP	nucleotide catabolic process	16175	3332		0.25	0.2602739726027397	117	16058	6	17	111	16041	16175	0.1129451537685503
M1	string	0	network_modules	179	TRUE	1.7984440559514626e-5	19	23	4	0.17391304347826086	0.21052631578947367	GO:0006007	GO:BP	glucose catabolic process	16175	1882		0.2638888888888889	0.2876712328767123	19	16156	4	19	15	16137	16175	0.19030061956360644
M1	string	0	network_modules	179	TRUE	1.7984440559514626e-5	19	23	4	0.17391304347826086	0.21052631578947367	GO:0019677	GO:BP	NAD catabolic process	16175	5995		0.2638888888888889	0.2876712328767123	19	16156	4	19	15	16137	16175	0.19030061956360644
M1	string	0	network_modules	179	TRUE	2.0614931210270857e-5	215	23	7	0.30434782608695654	0.03255813953488372	GO:0009141	GO:BP	nucleoside triphosphate metabolic process	16175	3308		0.2916666666666667	0.3013698630136986	215	15960	7	16	208	15944	16175	0.09590373089849877
M1	string	0	network_modules	179	TRUE	3.1347729566405854e-5	67	21	5	0.23809523809523808	0.07462686567164178	KEGG:00010	KEGG	Glycolysis / Gluconeogenesis	8484	2		0.3333333333333333	0.42857142857142855	67	8417	5	16	62	8401	8484	0.12954887778784227
M1	string	0	network_modules	179	TRUE	3.682525279010062e-5	63	23	5	0.21739130434782608	0.07936507936507936	GO:0019319	GO:BP	hexose biosynthetic process	16175	5682		0.3055555555555556	0.3150684931506849	63	16112	5	18	58	16094	16175	0.12934231182836123
M1	string	0	network_modules	179	TRUE	3.988897825434128e-5	372	23	8	0.34782608695652173	0.021505376344086023	GO:0006091	GO:BP	generation of precursor metabolites and energy	16175	1954		0.3194444444444444	0.3287671232876712	372	15803	8	15	364	15788	16175	0.08177240694199384
M1	string	0	network_modules	179	TRUE	4.815672687545428e-5	68	21	5	0.23809523809523808	0.07352941176470588	REAC:R-HSA-70171	REAC	Glycolysis	10916	1074		0.6666666666666666	0.75	68	10848	5	16	63	10832	10916	0.12937997160757578
M1	string	0	network_modules	179	TRUE	5.3793301826130676e-5	31	21	4	0.19047619047619047	0.12903225806451613	KEGG:00030	KEGG	Pentose phosphate pathway	8484	4		0.5	0.5714285714285714	31	8453	4	17	27	8436	8484	0.15423767218906545
M1	string	0	network_modules	179	TRUE	6.848027200616729e-5	147	23	6	0.2608695652173913	0.04081632653061224	GO:0016051	GO:BP	carbohydrate biosynthetic process	16175	5083		0.3333333333333333	0.3424657534246575	147	16028	6	17	141	16011	16175	0.10011991645588136
M1	string	0	network_modules	179	TRUE	7.269321227840943e-5	72	23	5	0.21739130434782608	0.06944444444444445	GO:0046032	GO:BP	ADP catabolic process	16175	11809		0.3472222222222222	0.3698630136986301	72	16103	5	18	67	16085	16175	0.12070705112843226
M1	string	0	network_modules	179	TRUE	7.269321227840943e-5	72	23	5	0.21739130434782608	0.06944444444444445	GO:0006096	GO:BP	glycolytic process	16175	1956		0.3472222222222222	0.3698630136986301	72	16103	5	18	67	16085	16175	0.12070705112843226
M1	string	0	network_modules	179	TRUE	7.58917467893925e-5	6	23	3	0.13043478260869565	0.5	GO:0009130	GO:BP	pyrimidine nucleoside monophosphate biosynthetic process	16175	3297		0.375	0.3835616438356164	6	16169	3	20	3	16149	16175	0.2548792144510706
M1	string	0	network_modules	179	TRUE	8.082063823243384e-5	27	23	4	0.17391304347826086	0.14814814814814814	GO:0006734	GO:BP	NADH metabolic process	16175	2435		0.3888888888888889	0.3972602739726027	27	16148	4	19	23	16129	16175	0.15921992031033882
M1	string	0	network_modules	179	TRUE	8.35377728829416e-5	74	23	5	0.21739130434782608	0.06756756756756757	GO:0046031	GO:BP	ADP metabolic process	16175	11808		0.4027777777777778	0.4383561643835616	74	16101	5	18	69	16083	16175	0.11900295498209838
M1	string	0	network_modules	179	TRUE	8.35377728829416e-5	74	23	5	0.21739130434782608	0.06756756756756757	GO:0009181	GO:BP	purine ribonucleoside diphosphate catabolic process	16175	3347		0.4027777777777778	0.4383561643835616	74	16101	5	18	69	16083	16175	0.11900295498209838
M1	string	0	network_modules	179	TRUE	8.35377728829416e-5	74	23	5	0.21739130434782608	0.06756756756756757	GO:0009137	GO:BP	purine nucleoside diphosphate catabolic process	16175	3304		0.4027777777777778	0.4383561643835616	74	16101	5	18	69	16083	16175	0.11900295498209838
M1	string	0	network_modules	179	TRUE	9.562991584752548e-5	76	23	5	0.21739130434782608	0.06578947368421052	GO:0009179	GO:BP	purine ribonucleoside diphosphate metabolic process	16175	3345		0.4444444444444444	0.4657534246575342	76	16099	5	18	71	16081	16175	0.11736575125159006
M1	string	0	network_modules	179	TRUE	9.562991584752548e-5	76	23	5	0.21739130434782608	0.06578947368421052	GO:0019364	GO:BP	pyridine nucleotide catabolic process	16175	5726		0.4444444444444444	0.4657534246575342	76	16099	5	18	71	16081	16175	0.11736575125159006
M1	string	0	network_modules	179	TRUE	1.0217583453441076e-4	77	23	5	0.21739130434782608	0.06493506493506493	GO:0009191	GO:BP	ribonucleoside diphosphate catabolic process	16175	3357		0.4722222222222222	0.4931506849315068	77	16098	5	18	72	16080	16175	0.11657087319569777
M1	string	0	network_modules	179	TRUE	1.0217583453441076e-4	77	23	5	0.21739130434782608	0.06493506493506493	GO:0009135	GO:BP	purine nucleoside diphosphate metabolic process	16175	3302		0.4722222222222222	0.4931506849315068	77	16098	5	18	72	16080	16175	0.11657087319569777
M1	string	0	network_modules	179	TRUE	1.1633426723428414e-4	79	23	5	0.21739130434782608	0.06329113924050633	GO:0072526	GO:BP	pyridine-containing compound catabolic process	16175	17428		0.5	0.5068493150684932	79	16096	5	18	74	16078	16175	0.11502605496635013
M1	string	0	network_modules	179	TRUE	1.3268737583468042e-4	7	23	3	0.13043478260869565	0.42857142857142855	GO:0009129	GO:BP	pyrimidine nucleoside monophosphate metabolic process	16175	3296		0.5138888888888888	0.5205479452054794	7	16168	3	20	4	16148	16175	0.23586742795786067
M1	string	0	network_modules	179	TRUE	1.3619371398775689e-4	283	23	7	0.30434782608695654	0.024734982332155476	GO:0019693	GO:BP	ribose phosphate metabolic process	16175	6010		0.5277777777777778	0.5342465753424658	283	15892	7	16	276	15876	16175	0.08256005458759609
M1	string	0	network_modules	179	TRUE	1.4044923691677885e-4	82	23	5	0.21739130434782608	0.06097560975609756	GO:0009134	GO:BP	nucleoside diphosphate catabolic process	16175	3301		0.5416666666666666	0.547945205479452	82	16093	5	18	77	16075	16175	0.11281428958151433
M1	string	0	network_modules	179	TRUE	1.573752337945435e-4	86	21	5	0.23809523809523808	0.05813953488372093	REAC:R-HSA-70326	REAC	Glucose metabolism	10916	1053		1	1	86	10830	5	16	81	10814	10916	0.11432291620966685
M1	string	0	network_modules	179	TRUE	1.6837296540226287e-4	85	23	5	0.21739130434782608	0.058823529411764705	GO:0009185	GO:BP	ribonucleoside diphosphate metabolic process	16175	3351		0.5555555555555556	0.5616438356164384	85	16090	5	18	80	16072	16175	0.11071909332317335
M1	string	0	network_modules	179	TRUE	2.1216741037279478e-4	34	23	4	0.17391304347826086	0.11764705882352941	GO:0019320	GO:BP	hexose catabolic process	16175	5683		0.5694444444444444	0.5753424657534246	34	16141	4	19	30	16122	16175	0.14156028527037076
M1	string	0	network_modules	179	TRUE	2.2454865484413208e-4	90	23	5	0.21739130434782608	0.05555555555555555	GO:0009154	GO:BP	purine ribonucleotide catabolic process	16175	3321		0.5833333333333334	0.589041095890411	90	16085	5	18	85	16067	16175	0.10745952463331157
M1	string	0	network_modules	179	TRUE	2.50792215802276e-4	92	23	5	0.21739130434782608	0.05434782608695652	GO:0009261	GO:BP	ribonucleotide catabolic process	16175	3426		0.5972222222222222	0.6027397260273972	92	16083	5	18	87	16065	16175	0.1062296321610976
M1	string	0	network_modules	179	TRUE	2.647953490662703e-4	93	23	5	0.21739130434782608	0.053763440860215055	GO:0009132	GO:BP	nucleoside diphosphate metabolic process	16175	3299		0.6111111111111112	0.6164383561643836	93	16082	5	18	88	16064	16175	0.10562939042806055
M1	string	0	network_modules	179	TRUE	3.013003562227607e-4	37	23	4	0.17391304347826086	0.10810810810810811	GO:0046365	GO:BP	monosaccharide catabolic process	16175	12096		0.625	0.6301369863013698	37	16138	4	19	33	16119	16175	0.13556616519032536
M1	string	0	network_modules	179	TRUE	3.1056116353252725e-4	96	23	5	0.21739130434782608	0.052083333333333336	GO:0006090	GO:BP	pyruvate metabolic process	16175	1953		0.6388888888888888	0.6438356164383562	96	16079	5	18	91	16061	16175	0.10388441138272818
M1	string	0	network_modules	179	TRUE	3.623843510983862e-4	99	23	5	0.21739130434782608	0.050505050505050504	GO:0006195	GO:BP	purine nucleotide catabolic process	16175	2024		0.6527777777777778	0.6575342465753424	99	16076	5	18	94	16058	16175	0.10221810563871171
M1	string	0	network_modules	179	TRUE	3.777696960997705e-4	196	23	6	0.2608695652173913	0.030612244897959183	GO:1901136	GO:BP	carbohydrate derivative catabolic process	16175	21244		0.6666666666666666	0.6712328767123288	196	15979	6	17	190	15962	16175	0.08579440686706112
M1	string	0	network_modules	179	TRUE	5.655408604094873e-4	349	23	7	0.30434782608695654	0.02005730659025788	GO:0006163	GO:BP	purine nucleotide metabolic process	16175	1998		0.6805555555555556	0.684931506849315	349	15826	7	16	342	15810	16175	0.07343990696783786
M1	string	0	network_modules	179	TRUE	6.032009903669477e-4	56	21	4	0.19047619047619047	0.07142857142857142	KEGG:00480	KEGG	Glutathione metabolism	8484	61		0.6666666666666666	0.7142857142857143	56	8428	4	17	52	8411	8484	0.11311385359660081
M1	string	0	network_modules	179	TRUE	7.998867233547183e-4	116	23	5	0.21739130434782608	0.04310344827586207	GO:0072523	GO:BP	purine-containing compound catabolic process	16175	17425		0.6944444444444444	0.6986301369863014	116	16059	5	18	111	16041	16175	0.09401135497030956
M1	string	0	network_modules	179	TRUE	9.082999546291666e-4	119	23	5	0.21739130434782608	0.04201680672268908	GO:0006006	GO:BP	glucose metabolic process	16175	1881		0.7083333333333334	0.7123287671232876	119	16056	5	18	114	16038	16175	0.09274554541125146
M1	string	0	network_modules	179	TRUE	0.0015297803608699347	55	23	4	0.17391304347826086	0.07272727272727272	GO:0019674	GO:BP	NAD metabolic process	16175	5993		0.7222222222222222	0.726027397260274	55	16120	4	19	51	16101	16175	0.11053199526428753
M1	string	0	network_modules	179	TRUE	0.001712179129013784	15	23	3	0.13043478260869565	0.2	GO:0006221	GO:BP	pyrimidine nucleotide biosynthetic process	16175	2044		0.7361111111111112	0.7397260273972602	15	16160	3	20	12	16140	16175	0.16055484548270105
M1	string	0	network_modules	179	TRUE	0.002176988764304547	60	23	4	0.17391304347826086	0.06666666666666667	GO:0006094	GO:BP	gluconeogenesis	16175	1955		0.75	0.7534246575342466	60	16115	4	19	56	16096	16175	0.10565086450772422
M1	string	0	network_modules	179	TRUE	0.0023779606691678597	79	21	4	0.19047619047619047	0.05063291139240506	KEGG:00983	KEGG	Drug metabolism - other enzymes	8484	157		0.8333333333333334	0.8571428571428571	79	8405	4	17	75	8388	8484	0.09395911984338853
M1	string	0	network_modules	179	TRUE	0.0028012989060342687	276	23	6	0.2608695652173913	0.021739130434782608	GO:0009259	GO:BP	ribonucleotide metabolic process	16175	3424		0.7638888888888888	0.7671232876712328	276	15899	6	17	270	15882	16175	0.07103957372441942
M1	string	0	network_modules	179	TRUE	0.00293052110335139	2	23	2	0.08695652173913043	1	GO:0009177	GO:BP	pyrimidine deoxyribonucleoside monophosphate biosynthetic process	16175	3343		0.7777777777777778	0.8082191780821918	2	16173	2	21	0	16152	16175	0.29469240258173435
M1	string	0	network_modules	179	TRUE	0.00293052110335139	2	23	2	0.08695652173913043	1	GO:0006231	GO:BP	dTMP biosynthetic process	16175	2053		0.7777777777777778	0.8082191780821918	2	16173	2	21	0	16152	16175	0.29469240258173435
M1	string	0	network_modules	179	TRUE	0.00293052110335139	2	23	2	0.08695652173913043	1	GO:0046073	GO:BP	dTMP metabolic process	16175	11850		0.7777777777777778	0.8082191780821918	2	16173	2	21	0	16152	16175	0.29469240258173435
M1	string	0	network_modules	179	TRUE	0.0030173495068361498	448	23	7	0.30434782608695654	0.015625	GO:0034655	GO:BP	nucleobase-containing compound catabolic process	16175	8711		0.8194444444444444	0.821917808219178	448	15727	7	16	441	15711	16175	0.06361579748942495
M1	string	0	network_modules	179	TRUE	0.0036328697091528943	19	23	3	0.13043478260869565	0.15789473684210525	GO:0006098	GO:BP	pentose-phosphate shunt	16175	1958		0.8333333333333334	0.8356164383561644	19	16156	3	20	16	16136	16175	0.14240194503174
M1	string	0	network_modules	179	TRUE	0.004090367069351928	469	23	7	0.30434782608695654	0.014925373134328358	GO:0072521	GO:BP	purine-containing compound metabolic process	16175	17423		0.8472222222222222	0.8493150684931506	469	15706	7	16	462	15690	16175	0.06192482697897668
M1	string	0	network_modules	179	TRUE	0.004902592936976385	482	23	7	0.30434782608695654	0.014522821576763486	GO:0044283	GO:BP	small molecule biosynthetic process	16175	10950		0.8611111111111112	0.863013698630137	482	15693	7	16	475	15677	16175	0.060930960470692484
M1	string	0	network_modules	179	TRUE	0.004977048109978554	21	23	3	0.13043478260869565	0.14285714285714285	GO:0072528	GO:BP	pyrimidine-containing compound biosynthetic process	16175	17430		0.875	0.8767123287671232	21	16154	3	20	18	16134	16175	0.13533007461701302
M1	string	0	network_modules	179	TRUE	0.0057575537717758475	22	23	3	0.13043478260869565	0.13636363636363635	GO:0006740	GO:BP	NADPH regeneration	16175	2439		0.8888888888888888	0.8904109589041096	22	16153	3	20	19	16133	16175	0.13215941380754104
M1	string	0	network_modules	179	TRUE	0.006584173874626248	504	23	7	0.30434782608695654	0.013888888888888888	GO:0032787	GO:BP	monocarboxylic acid metabolic process	16175	7822		0.9027777777777778	0.9041095890410958	504	15671	7	16	497	15655	16175	0.05933269165504806
M1	string	0	network_modules	179	TRUE	0.0066150469696928576	23	23	3	0.13043478260869565	0.13043478260869565	GO:0009124	GO:BP	nucleoside monophosphate biosynthetic process	16175	3291		0.9166666666666666	0.9178082191780822	23	16152	3	20	20	16132	16175	0.1291965458578289
M1	string	0	network_modules	179	TRUE	0.007590957479539566	742	23	8	0.34782608695652173	0.01078167115902965	GO:0019752	GO:BP	carboxylic acid metabolic process	16175	6036		0.9305555555555556	0.9315068493150684	742	15433	8	15	734	15418	16175	0.05446368494862512
M1	string	0	network_modules	179	TRUE	0.007788465170453732	184	23	5	0.21739130434782608	0.02717391304347826	GO:0046034	GO:BP	ATP metabolic process	16175	11811		0.9444444444444444	0.9452054794520548	184	15991	5	18	179	15973	16175	0.07330754939251234
M1	string	0	network_modules	179	TRUE	0.008389788579208754	109	21	4	0.19047619047619047	0.03669724770642202	KEGG:04066	KEGG	HIF-1 signaling pathway	8484	257		1	1	109	8375	4	17	105	8358	8484	0.07856969593361632
M1	string	0	network_modules	179	TRUE	0.008783952978863854	3	23	2	0.08695652173913043	0.6666666666666666	GO:0009176	GO:BP	pyrimidine deoxyribonucleoside monophosphate metabolic process	16175	3342		0.9583333333333334	0.9726027397260274	3	16172	2	21	1	16151	16175	0.24045145819458102
M1	string	0	network_modules	179	TRUE	0.008783952978863854	3	23	2	0.08695652173913043	0.6666666666666666	GO:0009157	GO:BP	deoxyribonucleoside monophosphate biosynthetic process	16175	3324		0.9583333333333334	0.9726027397260274	3	16172	2	21	1	16151	16175	0.24045145819458102
M1	string	0	network_modules	179	TRUE	0.009151957906495029	761	23	8	0.34782608695652173	0.010512483574244415	GO:0043436	GO:BP	oxoacid metabolic process	16175	10693		0.9861111111111112	0.9863013698630136	761	15414	8	15	753	15399	16175	0.0536032801595363
M1	string	0	network_modules	179	TRUE	0.009698418977059205	767	23	8	0.34782608695652173	0.010430247718383311	GO:0006082	GO:BP	organic acid metabolic process	16175	1947		1	1	767	15408	8	15	759	15393	16175	0.05333774113672475
M1	string	0	network_modules	181	TRUE	2.313577371102535e-11	6	22	5	0.22727272727272727	0.8333333333333334	GO:0016255	GO:BP	attachment of GPI anchor to protein	16175	5186		0	0.5	6	16169	5	17	1	16152	16175	0.4348602777347742
M1	string	0	network_modules	181	TRUE	3.3505292137840084e-11	7	17	5	0.29411764705882354	0.7142857142857143	REAC:R-HSA-162791	REAC	Attachment of GPI anchor to uPAR	10916	188		0	0.5	7	10909	5	12	2	10897	10916	0.4578532840731716
M1	string	0	network_modules	181	TRUE	1.3408541815768586e-8	91	17	7	0.4117647058823529	0.07692307692307693	REAC:R-HSA-163125	REAC	Post-translational modification: synthesis of GPI-anchored proteins	10916	1775		1	1	91	10825	7	10	84	10815	10916	0.17523723551297352
M1	string	0	network_modules	181	TRUE	3.355895790693077e-8	26	15	5	0.3333333333333333	0.19230769230769232	KEGG:00563	KEGG	Glycosylphosphatidylinositol (GPI)-anchor biosynthesis	8484	87		0	0.3333333333333333	26	8458	5	10	21	8448	8484	0.2514647875365398
M1	string	0	network_modules	181	TRUE	6.409651669777664e-7	31	22	5	0.22727272727272727	0.16129032258064516	GO:0180046	GO:BP	GPI anchored protein biosynthesis	16175	20314		1	1	31	16144	5	17	26	16127	16175	0.1901569059327076
M1	string	0	network_modules	181	TRUE	1.2747802616791608e-4	15	15	3	0.2	0.2	KEGG:00730	KEGG	Thiamine metabolism	8484	118		0.5	0.6666666666666666	15	8469	3	12	12	8457	8484	0.1985830676585193
M1	string	0	network_modules	181	TRUE	8.091222833914851e-4	27	15	3	0.2	0.1111111111111111	KEGG:00790	KEGG	Folate biosynthesis	8484	125		1	1	27	8457	3	12	24	8445	8484	0.14706318670281238
M1	string	0	network_modules	182	TRUE	1.9294115359879064e-4	22	12	3	0.25	0.13636363636363635	KEGG:00900	KEGG	Terpenoid backbone biosynthesis	8484	129		NA	1	22	8462	3	9	19	8453	8484	0.18308899346777507
M1	string	0	network_modules	182	TRUE	0.004204086732519456	22	21	3	0.14285714285714285	0.13636363636363635	GO:0008299	GO:BP	isoprenoid biosynthetic process	16175	3159		NA	1	22	16153	3	18	19	16135	16175	0.13842777919895227
M1	string	0	network_modules	185	TRUE	2.705818511837442e-8	8	13	4	0.3076923076923077	0.5	REAC:R-HSA-446388	REAC	Regulation of cytoskeletal remodeling and cell spreading by IPP complex components	10916	2026		0	0.25	8	10908	4	9	4	10899	10916	0.391674800380093
M1	string	0	network_modules	185	TRUE	1.1750445553345665e-6	18	13	4	0.3076923076923077	0.2222222222222222	REAC:R-HSA-446353	REAC	Cell-extracellular matrix interactions	10916	330		0.3333333333333333	0.5	18	10898	4	9	14	10889	10916	0.26045667547536644
M1	string	0	network_modules	185	TRUE	3.9646895526768354e-05	279	20	7	0.35	0.025089605734767026	GO:0031589	GO:BP	cell-substrate adhesion	16175	7233		0	0.5	279	15896	7	13	272	15883	16175	0.08992477387155881
M1	string	0	network_modules	185	TRUE	8.087843235465832e-5	86	20	5	0.25	0.05813953488372093	GO:0034446	GO:BP	substrate adhesion-dependent cell spreading	16175	8640		1	1	86	16089	5	15	81	16074	16175	0.1183848485142349
M1	string	0	network_modules	185	TRUE	0.0024046107838899735	114	13	4	0.3076923076923077	0.03508771929824561	REAC:R-HSA-446728	REAC	Cell junction organization	10916	324		0.6666666666666666	0.75	114	10802	4	9	110	10793	10916	0.10096665606567103
M1	string	0	network_modules	185	TRUE	0.007128424036558246	150	13	4	0.3076923076923077	0.02666666666666667	REAC:R-HSA-1500931	REAC	Cell-Cell communication	10916	328		1	1	150	10766	4	9	146	10757	10916	0.0871895301523568
M1	string	0	network_modules	186	TRUE	1.3145620641208855e-8	81	22	7	0.3181818181818182	0.08641975308641975	GO:0007565	GO:BP	female pregnancy	16175	3043		0	0.2	81	16094	7	15	74	16079	16175	0.16373455722807415
M1	string	0	network_modules	186	TRUE	3.035102616585262e-8	91	22	7	0.3181818181818182	0.07692307692307693	GO:0044703	GO:BP	multi-organism reproductive process	16175	11118		0.25	0.4	91	16084	7	15	84	16069	16175	0.15421937535134658
M1	string	0	network_modules	186	TRUE	3.828895342097418e-8	94	22	7	0.3181818181818182	0.07446808510638298	GO:0044706	GO:BP	multi-multicellular organism process	16175	11119		0.5	0.6	94	16081	7	15	87	16066	16175	0.151662575721029
M1	string	0	network_modules	186	TRUE	1.5491985840447348e-7	191	19	8	0.42105263157894735	0.041884816753926704	REAC:R-HSA-202733	REAC	Cell surface interactions at the vascular wall	10916	327		NA	1	191	10725	8	11	183	10714	10916	0.1285211666733924
M1	string	0	network_modules	186	TRUE	0.0018542504089550096	365	10	5	0.5	0.0136986301369863	KEGG:04080	KEGG	Neuroactive ligand-receptor interaction	8484	263		NA	1	365	8119	5	5	360	8114	8484	0.07736666355049879
M1	string	0	network_modules	186	TRUE	0.0028286756272065698	69	22	4	0.18181818181818182	0.057971014492753624	GO:0007218	GO:BP	neuropeptide signaling pathway	16175	2772		0.75	0.8	69	16106	4	18	65	16088	16175	0.10053957371608498
M1	string	0	network_modules	186	TRUE	0.007153384906324254	3	22	2	0.09090909090909091	0.6666666666666666	GO:0042756	GO:BP	drinking behavior	16175	10349		1	1	3	16172	2	20	1	16152	16175	0.2458707737811223
M1	string	0	network_modules	187	TRUE	1.3754473975864927e-8	41	9	5	0.5555555555555556	0.12195121951219512	KEGG:03440	KEGG	Homologous recombination	8484	240		0	0.5	41	8443	5	4	36	8439	8484	0.2587884544667697
M1	string	0	network_modules	187	TRUE	5.809252608019042e-8	27	15	5	0.3333333333333333	0.18518518518518517	REAC:R-HSA-5693554	REAC	Resolution of D-loop Structures through Synthesis-Dependent Strand Annealing (SDSA)	10916	2078		0	0.05	27	10889	5	10	22	10879	10916	0.24708378165468528
M1	string	0	network_modules	187	TRUE	1.9916077254597633e-7	34	15	5	0.3333333333333333	0.14705882352941177	REAC:R-HSA-5693568	REAC	Resolution of D-loop Structures through Holliday Junction Intermediates	10916	2077		0.05263157894736842	0.1	34	10882	5	10	29	10872	10916	0.21982837569089375
M1	string	0	network_modules	187	TRUE	2.3217648098349747e-7	35	15	5	0.3333333333333333	0.14285714285714285	REAC:R-HSA-5693537	REAC	Resolution of D-Loop Structures	10916	2076		0.10526315789473684	0.15	35	10881	5	10	30	10871	10916	0.21661505883846321
M1	string	0	network_modules	187	TRUE	6.842459491840719e-7	43	15	5	0.3333333333333333	0.11627906976744186	REAC:R-HSA-5693579	REAC	Homologous DNA Pairing and Strand Exchange	10916	1129		0.15789473684210525	0.2	43	10873	5	10	38	10863	10916	0.19506662138250447
M1	string	0	network_modules	187	TRUE	7.269222217987712e-6	68	15	5	0.3333333333333333	0.07352941176470588	REAC:R-HSA-5685942	REAC	HDR through Homologous Recombination (HRR)	10916	1097		0.21052631578947367	0.25	68	10848	5	10	63	10838	10916	0.15421707950012983
M1	string	0	network_modules	187	TRUE	7.590332384015425e-6	24	15	4	0.26666666666666666	0.16666666666666666	REAC:R-HSA-9709603	REAC	Impaired BRCA2 binding to PALB2	10916	1172		0.2631578947368421	0.3	24	10892	4	11	20	10881	10916	0.20945453964332494
M1	string	0	network_modules	187	TRUE	9.028816577550182e-6	25	15	4	0.26666666666666666	0.16	REAC:R-HSA-9704646	REAC	Defective HDR through Homologous Recombination Repair (HRR) due to PALB2 loss of BRCA2/RAD51/RAD51C binding function	10916	563		0.3157894736842105	0.5	25	10891	4	11	21	10880	10916	0.20516103001246017
M1	string	0	network_modules	187	TRUE	9.028816577550182e-6	25	15	4	0.26666666666666666	0.16	REAC:R-HSA-9701193	REAC	Defective homologous recombination repair (HRR) due to PALB2 loss of function	10916	699		0.3157894736842105	0.5	25	10891	4	11	21	10880	10916	0.20516103001246017
M1	string	0	network_modules	187	TRUE	9.028816577550182e-6	25	15	4	0.26666666666666666	0.16	REAC:R-HSA-9701192	REAC	Defective homologous recombination repair (HRR) due to BRCA1 loss of function	10916	697		0.3157894736842105	0.5	25	10891	4	11	21	10880	10916	0.20516103001246017
M1	string	0	network_modules	187	TRUE	9.028816577550182e-6	25	15	4	0.26666666666666666	0.16	REAC:R-HSA-9704331	REAC	Defective HDR through Homologous Recombination Repair (HRR) due to PALB2 loss of BRCA1 binding function	10916	562		0.3157894736842105	0.5	25	10891	4	11	21	10880	10916	0.20516103001246017
M1	string	0	network_modules	187	TRUE	7.13523432673031e-5	41	15	4	0.26666666666666666	0.0975609756097561	REAC:R-HSA-9675136	REAC	Diseases of DNA Double-Strand Break Repair	10916	757		0.5263157894736842	0.6	41	10875	4	11	37	10864	10916	0.1594328123539581
M1	string	0	network_modules	187	TRUE	7.13523432673031e-5	41	15	4	0.26666666666666666	0.0975609756097561	REAC:R-HSA-9701190	REAC	Defective homologous recombination repair (HRR) due to BRCA2 loss of function	10916	698		0.5263157894736842	0.6	41	10875	4	11	37	10864	10916	0.1594328123539581
M1	string	0	network_modules	187	TRUE	8.171435016016887e-5	281	22	7	0.3181818181818182	0.02491103202846975	GO:0006310	GO:BP	DNA recombination	16175	2115		0	0.2	281	15894	7	15	274	15879	16175	0.084967056034985
M1	string	0	network_modules	187	TRUE	1.1599745188487078e-4	172	22	6	0.2727272727272727	0.03488372093023256	GO:0000724	GO:BP	double-strand break repair via homologous recombination	16175	203		0.25	0.4	172	16003	6	16	166	15987	16175	0.09430190978614442
M1	string	0	network_modules	187	TRUE	1.2209012513117015e-4	298	22	7	0.3181818181818182	0.02348993288590604	GO:0006302	GO:BP	double-strand break repair	16175	2109		0.5	0.6	298	15877	7	15	291	15862	16175	0.08226364190528285
M1	string	0	network_modules	187	TRUE	1.3296891086966454e-4	176	22	6	0.2727272727272727	0.03409090909090909	GO:0000725	GO:BP	recombinational repair	16175	204		0.75	0.8	176	15999	6	16	170	15983	16175	0.0931478197987245
M1	string	0	network_modules	187	TRUE	1.6108772598526444e-4	50	15	4	0.26666666666666666	0.08	REAC:R-HSA-9675135	REAC	Diseases of DNA repair	10916	758		0.631578947368421	0.65	50	10866	4	11	46	10855	10916	0.14397939522205072
M1	string	0	network_modules	187	TRUE	2.0535476192502065e-4	132	15	5	0.3333333333333333	0.03787878787878788	REAC:R-HSA-5693567	REAC	HDR through Homologous Recombination (HRR) or Single Strand Annealing (SSA)	10916	1098		0.6842105263157895	0.7	132	10784	5	10	127	10774	10916	0.10902599016895699
M1	string	0	network_modules	187	TRUE	2.5614630158020304e-4	138	15	5	0.3333333333333333	0.036231884057971016	REAC:R-HSA-5693538	REAC	Homology Directed Repair	10916	1130		0.7368421052631579	0.75	138	10778	5	10	133	10768	10916	0.10647670083077052
M1	string	0	network_modules	187	TRUE	5.542489865897746e-4	2	15	2	0.13333333333333333	1	REAC:R-HSA-3359467	REAC	Defective MTRR causes HMAE	10916	588		0.7894736842105263	0.85	2	10914	2	13	0	10901	10916	0.36493083716272035
M1	string	0	network_modules	187	TRUE	5.542489865897746e-4	2	15	2	0.13333333333333333	1	REAC:R-HSA-3359469	REAC	Defective MTR causes HMAG	10916	587		0.7894736842105263	0.85	2	10914	2	13	0	10901	10916	0.36493083716272035
M1	string	0	network_modules	187	TRUE	6.781638525114589e-4	168	15	5	0.3333333333333333	0.02976190476190476	REAC:R-HSA-5693532	REAC	DNA Double-Strand Break Repair	10916	443		0.8947368421052632	0.9	168	10748	5	10	163	10738	10916	0.0958091295876664
M1	string	0	network_modules	187	TRUE	8.9573434826399e-4	329	15	6	0.4	0.0182370820668693	REAC:R-HSA-73894	REAC	DNA Repair	10916	444		0.9473684210526315	0.95	329	10587	6	9	323	10578	10916	0.08024718984081146
M1	string	0	network_modules	187	TRUE	0.0010773566190975864	54	9	3	0.3333333333333333	0.05555555555555555	KEGG:03460	KEGG	Fanconi anemia pathway	8484	242		1	1	54	8430	3	6	51	8424	8484	0.1339822265705558
M1	string	0	network_modules	187	TRUE	0.005709288252055444	528	22	7	0.3181818181818182	0.013257575757575758	GO:0006281	GO:BP	DNA repair	16175	2095		1	1	528	15647	7	15	521	15632	16175	0.05930096186677158
M1	string	0	network_modules	187	TRUE	0.006326439940151853	40	15	3	0.2	0.075	REAC:R-HSA-5693616	REAC	Presynaptic phase of homologous DNA pairing and strand exchange	10916	1793		1	1	40	10876	3	12	37	10864	10916	0.1205342764400132
M1	string	0	network_modules	188	TRUE	2.8442336685861744e-8	19	20	5	0.25	0.2631578947368421	GO:0030150	GO:BP	protein import into mitochondrial matrix	16175	6684		0	0.1111111111111111	19	16156	5	15	14	16141	16175	0.2555975596256606
M1	string	0	network_modules	188	TRUE	9.100787346903916e-7	36	20	5	0.25	0.1388888888888889	GO:0044743	GO:BP	protein transmembrane import into intracellular organelle	16175	11137		0.125	0.2222222222222222	36	16139	5	15	31	16124	16175	0.18500036202228937
M1	string	0	network_modules	188	TRUE	1.1695194887965178e-6	88	20	6	0.3	0.06818181818181818	GO:1990542	GO:BP	mitochondrial transmembrane transport	16175	25201		0.25	0.3333333333333333	88	16087	6	14	82	16073	16175	0.14089642732560237
M1	string	0	network_modules	188	TRUE	2.928912638896786e-6	45	20	5	0.25	0.1111111111111111	GO:0170036	GO:BP	import into the mitochondrion	16175	20284		0.375	0.4444444444444444	45	16130	5	15	40	16115	16175	0.16514382112940776
M1	string	0	network_modules	188	TRUE	4.557220115811483e-6	49	20	5	0.25	0.10204081632653061	GO:0071806	GO:BP	protein transmembrane transport	16175	16919		0.5	0.5555555555555556	49	16126	5	15	44	16111	16175	0.15812107356619148
M1	string	0	network_modules	188	TRUE	3.725600935587853e-5	156	20	6	0.3	0.038461538461538464	GO:0006839	GO:BP	mitochondrial transport	16175	2508		0.625	0.6666666666666666	156	16019	6	14	150	16005	16175	0.10453358466111654
M1	string	0	network_modules	188	TRUE	1.6443496239322653e-4	99	20	5	0.25	0.050505050505050504	GO:0006626	GO:BP	protein targeting to mitochondrion	16175	2340		0.75	0.7777777777777778	99	16076	5	15	94	16061	16175	0.1100207004166649
M1	string	0	network_modules	188	TRUE	2.789929688686516e-4	110	20	5	0.25	0.045454545454545456	GO:0072655	GO:BP	establishment of protein localization to mitochondrion	16175	17476		0.875	0.8888888888888888	110	16065	5	15	105	16050	16175	0.10411937801093649
M1	string	0	network_modules	188	TRUE	3.798629011684806e-4	117	20	5	0.25	0.042735042735042736	GO:0070585	GO:BP	protein localization to mitochondrion	16175	16190		1	1	117	16058	5	15	112	16043	16175	0.1007989739564291
M1	string	0	network_modules	188	TRUE	0.0016510715784359862	65	7	3	0.42857142857142855	0.046153846153846156	REAC:R-HSA-1268020	REAC	Mitochondrial protein import	10916	1468		NA	1	65	10851	3	4	62	10847	10916	0.13914747874777733
M1	string	0	network_modules	189	TRUE	2.021157135219672e-6	28	10	4	0.4	0.14285714285714285	REAC:R-HSA-525793	REAC	Myogenesis	10916	1504		0	0.25	28	10888	4	6	24	10882	10916	0.23792702428672818
M1	string	0	network_modules	189	TRUE	2.3219794665334827e-5	347	23	8	0.34782608695652173	0.023054755043227664	GO:0007507	GO:BP	heart development	16175	2993		0	0.5	347	15828	8	15	339	15813	16175	0.08500252420426727
M1	string	0	network_modules	189	TRUE	5.0769828917147014e-5	61	10	4	0.4	0.06557377049180328	REAC:R-HSA-198725	REAC	Nuclear Events (kinase and transcription factor activation)	10916	1614		0.3333333333333333	0.5	61	10855	4	6	57	10849	10916	0.16021417153740763
M1	string	0	network_modules	189	TRUE	4.28523186374033e-4	138	9	4	0.4444444444444444	0.028985507246376812	KEGG:04371	KEGG	Apelin signaling pathway	8484	308		0	0.3333333333333333	138	8346	4	5	134	8341	8484	0.11030576647888167
M1	string	0	network_modules	189	TRUE	5.907628768036684e-4	112	10	4	0.4	0.03571428571428571	REAC:R-HSA-187037	REAC	Signaling by NTRK1 (TRKA)	10916	2284		0.6666666666666666	0.75	112	10804	4	6	108	10798	10916	0.117112775664857
M1	string	0	network_modules	189	TRUE	8.50129356153497e-4	164	9	4	0.4444444444444444	0.024390243902439025	KEGG:04022	KEGG	cGMP-PKG signaling pathway	8484	251		0.5	0.6666666666666666	164	8320	4	5	160	8315	8484	0.10061756898731876
M1	string	0	network_modules	189	TRUE	0.0011051267158211746	131	10	4	0.4	0.030534351145038167	REAC:R-HSA-166520	REAC	Signaling by NTRKs	10916	2287		1	1	131	10785	4	6	127	10779	10916	0.1078986381044352
M1	string	0	network_modules	189	TRUE	0.00774376802873437	744	23	8	0.34782608695652173	0.010752688172043012	GO:0072359	GO:BP	circulatory system development	16175	17370		1	1	744	15431	8	15	736	15416	16175	0.054371682494492174
M1	string	0	network_modules	189	TRUE	0.007923890366760243	105	9	3	0.3333333333333333	0.02857142857142857	KEGG:04928	KEGG	Parathyroid hormone synthesis, secretion and action	8484	385		1	1	105	8379	3	6	102	8373	8484	0.09460373826441922
M1	string	0	network_modules	190	TRUE	3.9296017741931215e-11	33	24	7	0.2916666666666667	0.21212121212121213	GO:0045730	GO:BP	respiratory burst	16175	11572		0	0.25	33	16142	7	17	26	16125	16175	0.2474302694386634
M1	string	0	network_modules	190	TRUE	2.80964082834901e-10	94	18	8	0.4444444444444444	0.0851063829787234	REAC:R-HSA-9013423	REAC	RAC3 GTPase cycle	10916	1838		0	0.1111111111111111	94	10822	8	10	86	10812	10916	0.19170305220291695
M1	string	0	network_modules	190	TRUE	3.2309456941486133e-10	24	18	6	0.3333333333333333	0.25	REAC:R-HSA-5668599	REAC	RHO GTPases Activate NADPH Oxidases	10916	1849		0.125	0.2222222222222222	24	10892	6	12	18	10880	10916	0.2873238438017922
M1	string	0	network_modules	190	TRUE	1.9479599444217413e-6	34	24	5	0.20833333333333334	0.14705882352941177	GO:0042554	GO:BP	superoxide anion generation	16175	10244		0.3333333333333333	0.5	34	16141	5	19	29	16122	16175	0.17358018800713726
M1	string	0	network_modules	190	TRUE	2.896729841220045e-6	184	18	7	0.3888888888888889	0.03804347826086957	REAC:R-HSA-9013149	REAC	RAC1 GTPase cycle	10916	1836		0.25	0.3333333333333333	184	10732	7	11	177	10721	10916	0.1174514760642914
M1	string	0	network_modules	190	TRUE	3.3568510251640657e-6	449	18	9	0.5	0.0200445434298441	REAC:R-HSA-9012999	REAC	RHO GTPase cycle	10916	1847		0.375	0.4444444444444444	449	10467	9	9	440	10458	10916	0.09390302867160397
M1	string	0	network_modules	190	TRUE	2.3857050037692487e-5	55	24	5	0.20833333333333334	0.09090909090909091	GO:0006801	GO:BP	superoxide metabolic process	16175	2486		0.6666666666666666	0.75	55	16120	5	19	50	16101	16175	0.13570576174666923
M1	string	0	network_modules	190	TRUE	4.5018979848665965e-5	138	12	5	0.4166666666666667	0.036231884057971016	KEGG:05418	KEGG	Fluid shear stress and atherosclerosis	8484	495		0	0.16666666666666666	138	8346	5	7	133	8339	8484	0.11912816796510002
M1	string	0	network_modules	190	TRUE	6.474012089189847e-5	8	18	3	0.16666666666666666	0.375	REAC:R-HSA-1236973	REAC	Cross-presentation of particulate exogenous antigens (phagosomes)	10916	415		0.5	0.5555555555555556	8	10908	3	15	5	10893	10916	0.2491974947902711
M1	string	0	network_modules	190	TRUE	7.391493483585682e-5	88	18	5	0.2777777777777778	0.056818181818181816	REAC:R-HSA-9013404	REAC	RAC2 GTPase cycle	10916	1837		0.625	0.6666666666666666	88	10828	5	13	83	10815	10916	0.12257953723523478
M1	string	0	network_modules	190	TRUE	9.104278011127086e-5	36	18	4	0.2222222222222222	0.1111111111111111	REAC:R-HSA-1222556	REAC	ROS and RNS production in phagocytes	10916	1910		0.75	0.7777777777777778	36	10880	4	14	32	10866	10916	0.15518676181371432
M1	string	0	network_modules	190	TRUE	2.6334652989186614e-4	175	24	6	0.25	0.03428571428571429	GO:0072593	GO:BP	reactive oxygen species metabolic process	16175	17457		1	1	175	16000	6	18	169	15982	16175	0.08912459369454138
M1	string	0	network_modules	190	TRUE	8.286776294334292e-4	114	12	4	0.3333333333333333	0.03508771929824561	KEGG:04670	KEGG	Leukocyte transendothelial migration	8484	343		0.2	0.3333333333333333	114	8370	4	8	110	8362	8484	0.10456644374779434
M1	string	0	network_modules	190	TRUE	0.0024847806755316625	318	18	6	0.3333333333333333	0.018867924528301886	REAC:R-HSA-195258	REAC	RHO GTPase Effectors	10916	1846		0.875	0.8888888888888888	318	10598	6	12	312	10586	10916	0.07351274094653068
M1	string	0	network_modules	190	TRUE	0.005916218851790708	188	12	4	0.3333333333333333	0.02127659574468085	KEGG:04613	KEGG	Neutrophil extracellular trap formation	8484	323		0.4	0.5	188	8296	4	8	184	8288	8484	0.07955881027028264
M1	string	0	network_modules	190	TRUE	0.007179951413126187	72	12	3	0.25	0.041666666666666664	KEGG:05140	KEGG	Leishmaniasis	8484	433		0.6	0.6666666666666666	72	8412	3	9	69	8403	8484	0.09908860804144459
M1	string	0	network_modules	190	TRUE	0.00781883048350152	202	12	4	0.3333333333333333	0.019801980198019802	KEGG:05415	KEGG	Diabetic cardiomyopathy	8484	492		0.8	0.8333333333333334	202	8282	4	8	198	8274	8484	0.07640980184509015
M1	string	0	network_modules	190	TRUE	0.00801937447570252	36	18	3	0.16666666666666666	0.08333333333333333	REAC:R-HSA-3299685	REAC	Detoxification of Reactive Oxygen Species	10916	735		1	1	36	10880	3	15	33	10865	10916	0.11580563172355006
M1	string	0	network_modules	190	TRUE	0.009775408236455887	214	12	4	0.3333333333333333	0.018691588785046728	KEGG:05417	KEGG	Lipid and atherosclerosis	8484	494		1	1	214	8270	4	8	210	8262	8484	0.07395092169954467
M1	string	0	network_modules	191	TRUE	1.1085798390766088e-4	112	17	5	0.29411764705882354	0.044642857142857144	GO:0031047	GO:BP	regulatory ncRNA-mediated gene silencing	16175	7011		0	0.5	112	16063	5	12	107	16051	16175	0.11233808954552592
M1	string	0	network_modules	191	TRUE	7.150182625128048e-4	65	17	4	0.23529411764705882	0.06153846153846154	GO:0070918	GO:BP	regulatory ncRNA processing	16175	16370		1	1	65	16110	4	13	61	16097	16175	0.11857694595299752
M1	string	0	network_modules	191	TRUE	0.009795339157893589	9	11	2	0.18181818181818182	0.2222222222222222	REAC:R-HSA-426486	REAC	Small interfering RNA (siRNA) biogenesis	10916	2335		NA	1	9	10907	2	9	7	10898	10916	0.20027954273656026
M1	string	0	network_modules	192	TRUE	4.718126019186169e-13	38	24	8	0.3333333333333333	0.21052631578947367	GO:0000731	GO:BP	DNA synthesis involved in DNA repair	16175	208		0	0.1	38	16137	8	16	30	16121	16175	0.2635445513700056
M1	string	0	network_modules	192	TRUE	7.775097828439752e-12	12	24	6	0.25	0.5	GO:0042276	GO:BP	error-prone translesion synthesis	16175	10073		0.1111111111111111	0.2	12	16163	6	18	6	16145	16175	0.35289694394064525
M1	string	0	network_modules	192	TRUE	3.8467913789672833e-10	140	24	9	0.375	0.06428571428571428	GO:0071897	GO:BP	DNA biosynthetic process	16175	16970		0.2222222222222222	0.3	140	16035	9	15	131	16020	16175	0.15245496627784103
M1	string	0	network_modules	192	TRUE	1.9115640644454037e-9	26	24	6	0.25	0.23076923076923078	GO:0019985	GO:BP	translesion synthesis	16175	6075		0.3333333333333333	0.4	26	16149	6	18	20	16131	16175	0.239017297034195
M1	string	0	network_modules	192	TRUE	2.15891909406676e-9	32	18	6	0.3333333333333333	0.1875	REAC:R-HSA-5656169	REAC	Termination of translesion DNA synthesis	10916	2492		0	0.03225806451612903	32	10884	6	12	26	10872	10916	0.24837026523963182
M1	string	0	network_modules	192	TRUE	4.066085466568849e-9	14	18	5	0.2777777777777778	0.35714285714285715	REAC:R-HSA-69091	REAC	Polymerase switching	10916	1769		0.03333333333333333	0.12903225806451613	14	10902	5	13	9	10889	10916	0.3139763644542408
M1	string	0	network_modules	192	TRUE	4.066085466568849e-9	14	18	5	0.2777777777777778	0.35714285714285715	REAC:R-HSA-69166	REAC	Removal of the Flap Intermediate	10916	2058		0.03333333333333333	0.12903225806451613	14	10902	5	13	9	10889	10916	0.3139763644542408
M1	string	0	network_modules	192	TRUE	4.066085466568849e-9	14	18	5	0.2777777777777778	0.35714285714285715	REAC:R-HSA-69109	REAC	Leading Strand Synthesis	10916	1308		0.03333333333333333	0.12903225806451613	14	10902	5	13	9	10889	10916	0.3139763644542408
M1	string	0	network_modules	192	TRUE	5.889204635078464e-9	329	18	10	0.5555555555555556	0.030395136778115502	REAC:R-HSA-73894	REAC	DNA Repair	10916	444		0.13333333333333333	0.16129032258064516	329	10587	10	8	319	10579	10916	0.12489513525038604
M1	string	0	network_modules	192	TRUE	6.093069754091955e-9	15	18	5	0.2777777777777778	0.3333333333333333	REAC:R-HSA-69183	REAC	Processive synthesis on the lagging strand	10916	1802		0.16666666666666666	0.1935483870967742	15	10901	5	13	10	10888	10916	0.3032433942413363
M1	string	0	network_modules	192	TRUE	7.72165764768091e-9	39	18	6	0.3333333333333333	0.15384615384615385	REAC:R-HSA-110313	REAC	Translesion synthesis by Y family DNA polymerases bypasses lesions on DNA template	10916	2577		0.2	0.22580645161290322	39	10877	6	12	33	10865	10916	0.22461474862025124
M1	string	0	network_modules	192	TRUE	1.3361455581952023e-8	35	24	6	0.25	0.17142857142857143	GO:0006301	GO:BP	postreplication repair	16175	2108		0.4444444444444444	0.5	35	16140	6	18	29	16122	16175	0.20560283458696268
M1	string	0	network_modules	192	TRUE	2.879696582644934e-8	48	18	6	0.3333333333333333	0.125	REAC:R-HSA-73893	REAC	DNA Damage Bypass	10916	438		0.23333333333333334	0.25806451612903225	48	10868	6	12	42	10856	10916	0.20204239465190535
M1	string	0	network_modules	192	TRUE	3.130157517223118e-8	20	18	5	0.2777777777777778	0.25	REAC:R-HSA-69186	REAC	Lagging Strand Synthesis	10916	1302		0.26666666666666666	0.2903225806451613	20	10896	5	13	15	10883	10916	0.2622414356494045
M1	string	0	network_modules	192	TRUE	3.1559714773843035e-8	168	18	8	0.4444444444444444	0.047619047619047616	REAC:R-HSA-5693532	REAC	DNA Double-Strand Break Repair	10916	443		0.3	0.3225806451612903	168	10748	8	10	160	10738	10916	0.14165113448870714
M1	string	0	network_modules	192	TRUE	3.5862177709408365e-8	231	24	9	0.375	0.03896103896103896	GO:0006260	GO:BP	DNA replication	16175	2077		0.5555555555555556	0.6	231	15944	9	15	222	15929	16175	0.11719638830207509
M1	string	0	network_modules	192	TRUE	3.903577358687608e-8	147	24	8	0.3333333333333333	0.05442176870748299	GO:0006261	GO:BP	DNA-templated DNA replication	16175	2078		0.6666666666666666	0.7	147	16028	8	16	139	16012	16175	0.13171203783019647
M1	string	0	network_modules	192	TRUE	4.6991740093484536e-8	36	12	5	0.4166666666666667	0.1388888888888889	KEGG:03030	KEGG	DNA replication	8484	214		0	0.16666666666666666	36	8448	5	7	31	8441	8484	0.23878848985082615
M1	string	0	network_modules	192	TRUE	1.3201568312344578e-7	26	18	5	0.2777777777777778	0.19230769230769232	REAC:R-HSA-174411	REAC	Polymerase switching on the C-strand of the telomere	10916	1770		0.3333333333333333	0.3548387096774194	26	10890	5	13	21	10877	10916	0.2296060449289502
M1	string	0	network_modules	192	TRUE	4.0174253484746846e-7	32	18	5	0.2777777777777778	0.15625	REAC:R-HSA-69190	REAC	DNA strand elongation	10916	449		0.36666666666666664	0.3870967741935484	32	10884	5	13	27	10871	10916	0.20660794522490875
M1	string	0	network_modules	192	TRUE	5.54013846822926e-7	34	18	5	0.2777777777777778	0.14705882352941177	REAC:R-HSA-174417	REAC	Telomere C-strand (Lagging Strand) Synthesis	10916	2486		0.4	0.41935483870967744	34	10882	5	13	29	10869	10916	0.20032393853448738
M1	string	0	network_modules	192	TRUE	2.562728196185171e-6	528	24	10	0.4166666666666667	0.01893939393939394	GO:0006281	GO:BP	DNA repair	16175	2095		0.7777777777777778	0.8	528	15647	10	14	518	15633	16175	0.08330589330022777
M1	string	0	network_modules	192	TRUE	4.598566859532682e-6	51	18	5	0.2777777777777778	0.09803921568627451	REAC:R-HSA-180786	REAC	Extension of Telomeres	10916	887		0.43333333333333335	0.45161290322580644	51	10865	5	13	46	10852	10916	0.16276358509173638
M1	string	0	network_modules	192	TRUE	4.4759285037255744e-5	5	24	3	0.125	0.6	GO:0006269	GO:BP	DNA replication, synthesis of primer	16175	2084		0.8888888888888888	0.9	5	16170	3	21	2	16149	16175	0.27342919440425356
M1	string	0	network_modules	192	TRUE	1.3170036366720207e-4	798	24	10	0.4166666666666667	0.012531328320802004	GO:0006974	GO:BP	DNA damage response	16175	2601		1	1	798	15377	10	14	788	15363	16175	0.06538390457937039
M1	string	0	network_modules	192	TRUE	2.2170559342709066e-4	23	12	3	0.25	0.13043478260869565	KEGG:03430	KEGG	Mismatch repair	8484	239		0.2	0.3333333333333333	23	8461	3	9	20	8452	8484	0.17898983504405983
M1	string	0	network_modules	192	TRUE	2.363274249146055e-4	111	18	5	0.2777777777777778	0.04504504504504504	REAC:R-HSA-157579	REAC	Telomere Maintenance	10916	2489		0.4666666666666667	0.4838709677419355	111	10805	5	13	106	10792	10916	0.10840606278287727
M1	string	0	network_modules	192	TRUE	3.6291750127909656e-4	121	18	5	0.2777777777777778	0.04132231404958678	REAC:R-HSA-69239	REAC	Synthesis of DNA	10916	2376		0.5	0.5161290322580645	121	10795	5	13	116	10782	10916	0.10352236856022469
M1	string	0	network_modules	192	TRUE	4.182145653099572e-4	14	18	3	0.16666666666666666	0.21428571428571427	REAC:R-HSA-5358565	REAC	Mismatch repair (MMR) directed by MSH2:MSH6 (MutSalpha)	10916	1459		0.5333333333333333	0.5806451612903226	14	10902	3	15	11	10887	10916	0.1878032679153477
M1	string	0	network_modules	192	TRUE	4.182145653099572e-4	14	18	3	0.16666666666666666	0.21428571428571427	REAC:R-HSA-5358606	REAC	Mismatch repair (MMR) directed by MSH2:MSH3 (MutSbeta)	10916	1458		0.5333333333333333	0.5806451612903226	14	10902	3	15	11	10887	10916	0.1878032679153477
M1	string	0	network_modules	192	TRUE	5.222292692891012e-4	15	18	3	0.16666666666666666	0.2	REAC:R-HSA-5358508	REAC	Mismatch Repair	10916	1457		0.6	0.6129032258064516	15	10901	3	15	12	10886	10916	0.1813430115663804
M1	string	0	network_modules	192	TRUE	6.957034383925788e-4	138	18	5	0.2777777777777778	0.036231884057971016	REAC:R-HSA-5693538	REAC	Homology Directed Repair	10916	1130		0.6333333333333333	0.6774193548387096	138	10778	5	13	133	10765	10916	0.0964464155648261
M1	string	0	network_modules	192	TRUE	6.957034383925788e-4	138	18	5	0.2777777777777778	0.036231884057971016	REAC:R-HSA-73886	REAC	Chromosome Maintenance	10916	357		0.6333333333333333	0.6774193548387096	138	10778	5	13	133	10765	10916	0.0964464155648261
M1	string	0	network_modules	192	TRUE	7.788661028879105e-4	17	18	3	0.16666666666666666	0.17647058823529413	REAC:R-HSA-174437	REAC	Removal of the Flap Intermediate from the C-strand	10916	2059		0.7	0.7096774193548387	17	10899	3	15	14	10884	10916	0.17016889495644696
M1	string	0	network_modules	192	TRUE	0.0011075969177213707	19	18	3	0.16666666666666666	0.15789473684210525	REAC:R-HSA-174414	REAC	Processive synthesis on the C-strand of the telomere	10916	1801		0.7333333333333333	0.7419354838709677	19	10897	3	15	16	10882	10916	0.16079979746721307
M1	string	0	network_modules	192	TRUE	0.0012179488731929198	68	18	4	0.2222222222222222	0.058823529411764705	REAC:R-HSA-5685942	REAC	HDR through Homologous Recombination (HRR)	10916	1097		0.7666666666666667	0.7741935483870968	68	10848	4	14	64	10834	10916	0.11156717239540045
M1	string	0	network_modules	192	TRUE	0.001315478575447418	41	12	3	0.25	0.07317073170731707	KEGG:03440	KEGG	Homologous recombination	8484	240		0.4	0.5	41	8443	3	9	38	8434	8484	0.13305177154863182
M1	string	0	network_modules	192	TRUE	0.0015170981055791966	21	18	3	0.16666666666666666	0.14285714285714285	REAC:R-HSA-5651801	REAC	PCNA-Dependent Long Patch Base Excision Repair	10916	1658		0.8	0.8064516129032258	21	10895	3	15	18	10880	10916	0.1527952243258098
M1	string	0	network_modules	192	TRUE	0.001530853266824475	162	18	5	0.2777777777777778	0.030864197530864196	REAC:R-HSA-69242	REAC	S Phase	10916	2111		0.8333333333333334	0.8387096774193549	162	10754	5	13	157	10741	10916	0.08837630707086498
M1	string	0	network_modules	192	TRUE	0.0016304471184573192	44	12	3	0.25	0.06818181818181818	KEGG:03410	KEGG	Base excision repair	8484	237		0.6	0.6666666666666666	44	8440	3	9	41	8431	8484	0.1282733935618766
M1	string	0	network_modules	192	TRUE	0.002612750665537783	25	18	3	0.16666666666666666	0.12	REAC:R-HSA-5696397	REAC	Gap-filling DNA repair synthesis and ligation in GG-NER	10916	1037		0.8666666666666667	0.9032258064516129	25	10891	3	15	22	10876	10916	0.13975330669802405
M1	string	0	network_modules	192	TRUE	0.002612750665537783	25	18	3	0.16666666666666666	0.12	REAC:R-HSA-110373	REAC	Resolution of AP sites via the multiple-nucleotide patch replacement pathway	10916	2073		0.8666666666666667	0.9032258064516129	25	10891	3	15	22	10876	10916	0.13975330669802405
M1	string	0	network_modules	192	TRUE	0.0030293184252014084	54	12	3	0.25	0.05555555555555555	KEGG:03460	KEGG	Fanconi anemia pathway	8484	242		0.8	0.8333333333333334	54	8430	3	9	51	8421	8484	0.11529950926835403
M1	string	0	network_modules	192	TRUE	0.0030855853977187903	187	18	5	0.2777777777777778	0.026737967914438502	REAC:R-HSA-69306	REAC	DNA Replication	10916	445		0.9333333333333333	0.9354838709677419	187	10729	5	13	182	10716	10916	0.08163541726115353
M1	string	0	network_modules	192	TRUE	0.004370983622239227	61	12	3	0.25	0.04918032786885246	KEGG:03420	KEGG	Nucleotide excision repair	8484	238		1	1	61	8423	3	9	58	8414	8484	0.10815996846921777
M1	string	0	network_modules	192	TRUE	0.004588347037971318	30	18	3	0.16666666666666666	0.1	REAC:R-HSA-110314	REAC	Recognition of DNA damage by PCNA-containing replication complex	10916	1948		0.9666666666666667	0.967741935483871	30	10886	3	15	27	10871	10916	0.1272504453227571
M1	string	0	network_modules	192	TRUE	0.00801937447570252	36	18	3	0.16666666666666666	0.08333333333333333	REAC:R-HSA-73933	REAC	Resolution of Abasic Sites (AP sites)	10916	2075		1	1	36	10880	3	15	33	10865	10916	0.11580563172355006
M1	string	0	network_modules	193	TRUE	2.9088754178139407e-8	5	24	4	0.16666666666666666	0.8	GO:0140639	GO:BP	positive regulation of pyroptotic inflammatory response	16175	19843		0	0.04	5	16170	4	20	1	16150	16175	0.3647982104044354
M1	string	0	network_modules	193	TRUE	8.717991818213654e-8	6	24	4	0.16666666666666666	0.6666666666666666	GO:0051715	GO:BP	cytolysis in another organism	16175	13908		0.041666666666666664	0.08	6	16169	4	20	2	16149	16175	0.33290021664463487
M1	string	0	network_modules	193	TRUE	4.060349208678262e-7	8	24	4	0.16666666666666666	0.5	GO:0019835	GO:BP	cytolysis	16175	6047		0.08333333333333333	0.12	8	16167	4	20	4	16147	16175	0.2881035005970586
M1	string	0	network_modules	193	TRUE	1.3886487675550271e-5	107	24	6	0.25	0.056074766355140186	GO:0034341	GO:BP	response to type II interferon	16175	8579		0.125	0.16	107	16068	6	18	101	16050	16175	0.11573666080115504
M1	string	0	network_modules	193	TRUE	7.707360626689427e-5	247	24	7	0.2916666666666667	0.02834008097165992	GO:0006520	GO:BP	amino acid metabolic process	16175	2241		0.16666666666666666	0.2	247	15928	7	17	240	15911	16175	0.0868866693864707
M1	string	0	network_modules	193	TRUE	2.1842476362494292e-4	85	24	5	0.20833333333333334	0.058823529411764705	GO:0071346	GO:BP	cellular response to type II interferon	16175	16598		0.20833333333333334	0.24	85	16090	5	19	80	16071	16175	0.10827451763826942
M1	string	0	network_modules	193	TRUE	2.253208448987604e-4	289	24	7	0.2916666666666667	0.02422145328719723	GO:0006790	GO:BP	sulfur compound metabolic process	16175	2476		0.25	0.28	289	15886	7	17	282	15869	16175	0.07967586575272266
M1	string	0	network_modules	193	TRUE	2.3155350559415187e-4	33	24	4	0.16666666666666666	0.12121212121212122	GO:0070269	GO:BP	pyroptotic inflammatory response	16175	16029		0.2916666666666667	0.32	33	16142	4	20	29	16122	16175	0.14064174805694146
M1	string	0	network_modules	193	TRUE	2.816660631567501e-4	177	24	6	0.25	0.03389830508474576	GO:1901605	GO:BP	alpha-amino acid metabolic process	16175	21589		0.3333333333333333	0.36	177	15998	6	18	171	15980	16175	0.0885793577502704
M1	string	0	network_modules	193	TRUE	4.1717504087836893e-4	91	24	5	0.20833333333333334	0.054945054945054944	REAC:R-HSA-877300	REAC	Interferon gamma signaling	10916	1229		0	0.3333333333333333	91	10825	5	19	86	10806	10916	0.10325332541535237
M1	string	0	network_modules	193	TRUE	6.259268330780171e-4	12	24	3	0.125	0.25	REAC:R-HSA-174403	REAC	Glutathione synthesis and recycling	10916	1059		0.5	0.6666666666666666	12	10904	3	21	9	10883	10916	0.17551148219841245
M1	string	0	network_modules	193	TRUE	7.418683523812092e-4	182	25	6	0.24	0.03296703296703297	KEGG:04621	KEGG	NOD-like receptor signaling pathway	8484	326		0	0.3333333333333333	182	8302	6	19	176	8283	8484	0.08200316997212123
M1	string	0	network_modules	193	TRUE	8.078211229569186e-4	50	25	4	0.16	0.08	KEGG:00270	KEGG	Cysteine and methionine metabolism	8484	30		0.5	0.6666666666666666	50	8434	4	21	46	8413	8484	0.10945370299833476
M1	string	0	network_modules	193	TRUE	9.406931675449987e-4	742	24	9	0.375	0.012129380053908356	GO:0019752	GO:BP	carboxylic acid metabolic process	16175	6036		0.375	0.4	742	15433	9	15	733	15418	16175	0.060643776348682794
M1	string	0	network_modules	193	TRUE	0.0011632196008410092	761	24	9	0.375	0.011826544021024968	GO:0043436	GO:BP	oxoacid metabolic process	16175	10693		0.4166666666666667	0.44	761	15414	9	15	752	15399	16175	0.059704985101878875
M1	string	0	network_modules	193	TRUE	0.0012424042235918073	767	24	9	0.375	0.011734028683181226	GO:0006082	GO:BP	organic acid metabolic process	16175	1947		0.4583333333333333	0.48	767	15408	9	15	758	15393	16175	0.05941529799735828
M1	string	0	network_modules	193	TRUE	0.001273090667204308	56	25	4	0.16	0.07142857142857142	KEGG:00480	KEGG	Glutathione metabolism	8484	61		1	1	56	8428	4	21	52	8407	8484	0.10298604155405752
M1	string	0	network_modules	193	TRUE	0.0014299037347152072	2	24	2	0.08333333333333333	1	REAC:R-HSA-5578999	REAC	Defective GCLC causes HAGGSD	10916	556		1	1	2	10914	2	22	0	10892	10916	0.2883840379923303
M1	string	0	network_modules	193	TRUE	0.0016744637234634863	389	24	7	0.2916666666666667	0.017994858611825194	GO:0043603	GO:BP	amide metabolic process	16175	10795		0.5	0.52	389	15786	7	17	382	15769	16175	0.06733694151799337
M1	string	0	network_modules	193	TRUE	0.002450166669189141	138	24	5	0.20833333333333334	0.036231884057971016	GO:0170039	GO:BP	proteinogenic amino acid metabolic process	16175	20287		0.5416666666666666	0.56	138	16037	5	19	133	16018	16175	0.08374293179753635
M1	string	0	network_modules	193	TRUE	0.0026865693280671023	60	24	4	0.16666666666666666	0.06666666666666667	GO:0141061	GO:BP	disruption of cell in another organism	16175	19997		0.5833333333333334	0.64	60	16115	4	20	56	16095	16175	0.10333158190001307
M1	string	0	network_modules	193	TRUE	0.0026865693280671023	60	24	4	0.16666666666666666	0.06666666666666667	GO:0031640	GO:BP	killing of cells of another organism	16175	7250		0.5833333333333334	0.64	60	16115	4	20	56	16095	16175	0.10333158190001307
M1	string	0	network_modules	193	TRUE	0.0030082549124477594	17	24	3	0.125	0.17647058823529413	GO:0001562	GO:BP	response to protozoan	16175	351		0.6666666666666666	0.72	17	16158	3	21	14	16137	16175	0.1474602446488705
M1	string	0	network_modules	193	TRUE	0.0030082549124477594	17	24	3	0.125	0.17647058823529413	GO:0042832	GO:BP	defense response to protozoan	16175	10388		0.6666666666666666	0.72	17	16158	3	21	14	16137	16175	0.1474602446488705
M1	string	0	network_modules	193	TRUE	0.003022673841357643	144	24	5	0.20833333333333334	0.034722222222222224	GO:0170033	GO:BP	L-amino acid metabolic process	16175	20281		0.75	0.76	144	16031	5	19	139	16012	16175	0.08184283690197877
M1	string	0	network_modules	193	TRUE	0.0032968362412703106	2	24	2	0.08333333333333333	1	GO:0140973	GO:BP	positive regulation of AIM2 inflammasome complex assembly	16175	19957		0.7916666666666666	0.8	2	16173	2	22	0	16151	16175	0.28847872656338225
M1	string	0	network_modules	193	TRUE	0.00472059961142502	69	24	4	0.16666666666666666	0.057971014492753624	GO:0141060	GO:BP	disruption of anatomical structure in another organism	16175	19996		0.8333333333333334	0.84	69	16106	4	20	65	16086	16175	0.09605501368088011
M1	string	0	network_modules	193	TRUE	0.006145670761244845	300	24	6	0.25	0.02	GO:0044282	GO:BP	small molecule catabolic process	16175	10949		0.875	0.88	300	15875	6	18	294	15857	16175	0.06612950283689223
M1	string	0	network_modules	193	TRUE	0.00625194093603015	74	24	4	0.16666666666666666	0.05405405405405406	GO:0043648	GO:BP	dicarboxylic acid metabolic process	16175	10828		0.9166666666666666	0.92	74	16101	4	20	70	16081	16175	0.09259098582456968
M1	string	0	network_modules	193	TRUE	0.009121288171350508	721	24	8	0.3333333333333333	0.011095700416088766	GO:0045087	GO:BP	innate immune response	16175	11270		0.9583333333333334	0.96	721	15454	8	16	713	15438	16175	0.053938231125245296
M1	string	0	network_modules	193	TRUE	0.009881539404908083	3	24	2	0.08333333333333333	0.6666666666666666	GO:0019405	GO:BP	alditol catabolic process	16175	5762		1	1	3	16172	2	22	1	16150	16175	0.23537416597204877
M1	string	0	network_modules	195	TRUE	9.481656246853362e-7	5	11	3	0.2727272727272727	0.6	KEGG:00524	KEGG	Neomycin, kanamycin and gentamicin biosynthesis	8484	73		0	0.1	5	8479	3	8	2	8471	8484	0.4040267810167512
M1	string	0	network_modules	195	TRUE	6.919322340223276e-5	9	16	3	0.1875	0.3333333333333333	REAC:R-HSA-391908	REAC	Prostanoid ligand receptors	10916	1810		0	0.5	9	10907	3	13	6	10894	10916	0.24918605401745583
M1	string	0	network_modules	195	TRUE	3.7279175096128554e-4	15	16	3	0.1875	0.2	REAC:R-HSA-391903	REAC	Eicosanoid ligand-binding receptors	10916	834		1	1	15	10901	3	13	12	10888	10916	0.19250331445187688
M1	string	0	network_modules	195	TRUE	4.613828067822407e-4	32	11	3	0.2727272727272727	0.09375	KEGG:00052	KEGG	Galactose metabolism	8484	7		0.1111111111111111	0.2	32	8452	3	8	29	8444	8484	0.1580898700070195
M1	string	0	network_modules	195	TRUE	5.34501193424152e-4	10	24	3	0.125	0.3	GO:0046835	GO:BP	carbohydrate phosphorylation	16175	12392		NA	1	10	16165	3	21	7	16144	16175	0.19289414781169373
M1	string	0	network_modules	195	TRUE	5.558476201018622e-4	34	11	3	0.2727272727272727	0.08823529411764706	KEGG:00051	KEGG	Fructose and mannose metabolism	8484	6		0.2222222222222222	0.3	34	8450	3	8	31	8442	8484	0.15325340738829454
M1	string	0	network_modules	195	TRUE	6.62287800632442e-4	36	11	3	0.2727272727272727	0.08333333333333333	KEGG:00500	KEGG	Starch and sucrose metabolism	8484	62		0.3333333333333333	0.4	36	8448	3	8	33	8440	8484	0.14882249857544025
M1	string	0	network_modules	195	TRUE	7.202142829218135e-4	37	11	3	0.2727272727272727	0.08108108108108109	KEGG:01250	KEGG	Biosynthesis of nucleotide sugars	8484	191		0.4444444444444444	0.5	37	8447	3	8	34	8439	8484	0.14674184699920295
M1	string	0	network_modules	195	TRUE	0.0013981100027457784	46	11	3	0.2727272727272727	0.06521739130434782	KEGG:04930	KEGG	Type II diabetes mellitus	8484	387		0.5555555555555556	0.6	46	8438	3	8	43	8430	8484	0.1311557381045583
M1	string	0	network_modules	195	TRUE	0.0014923770032171644	47	11	3	0.2727272727272727	0.06382978723404255	KEGG:04973	KEGG	Carbohydrate digestion and absorption	8484	404		0.6666666666666666	0.7	47	8437	3	8	44	8429	8484	0.1297034336199694
M1	string	0	network_modules	195	TRUE	0.0016932829085621502	49	11	3	0.2727272727272727	0.061224489795918366	KEGG:00520	KEGG	Amino sugar and nucleotide sugar metabolism	8484	69		0.7777777777777778	0.8	49	8435	3	8	46	8427	8484	0.12693181753685706
M1	string	0	network_modules	195	TRUE	0.004346902612317056	67	11	3	0.2727272727272727	0.04477611940298507	KEGG:00010	KEGG	Glycolysis / Gluconeogenesis	8484	2		0.8888888888888888	0.9	67	8417	3	8	64	8409	8484	0.10780269152456042
M1	string	0	network_modules	195	TRUE	0.004956544238623312	70	11	3	0.2727272727272727	0.04285714285714286	KEGG:05230	KEGG	Central carbon metabolism in cancer	8484	478		1	1	70	8414	3	8	67	8406	8484	0.10534529129174183
M1	string	0	network_modules	197	TRUE	2.578890011069347e-4	202	11	5	0.45454545454545453	0.024752475247524754	REAC:R-HSA-72163	REAC	mRNA Splicing - Major Pathway	10916	2707		0	0.3333333333333333	202	10714	5	6	197	10708	10916	0.10275959063576609
M1	string	0	network_modules	197	TRUE	3.052996659492034e-4	209	11	5	0.45454545454545453	0.023923444976076555	REAC:R-HSA-72172	REAC	mRNA Splicing	10916	2706		0.5	0.6666666666666666	209	10707	5	6	204	10701	10916	0.10090847990884624
M1	string	0	network_modules	197	TRUE	0.0012025490119315211	276	11	5	0.45454545454545453	0.018115942028985508	REAC:R-HSA-72203	REAC	Processing of Capped Intron-Containing Pre-mRNA	10916	1796		1	1	276	10640	5	6	271	10634	10916	0.0868447532972575
M1	string	0	network_modules	197	TRUE	0.0017547768662394148	397	16	6	0.375	0.015113350125944584	GO:0008380	GO:BP	RNA splicing	16175	3186		0	0.25	397	15778	6	10	391	15768	16175	0.07127040872284031
M1	string	0	network_modules	197	TRUE	0.007944034410447748	174	6	3	0.5	0.017241379310344827	KEGG:03040	KEGG	Spliceosome	8484	215		NA	1	174	8310	3	3	171	8307	8484	0.08999838729959335
M1	string	0	network_modules	197	TRUE	0.008102637962305745	287	16	5	0.3125	0.017421602787456445	GO:0000398	GO:BP	mRNA splicing, via spliceosome	16175	121		0.3333333333333333	0.75	287	15888	5	11	282	15877	16175	0.07025625055190057
M1	string	0	network_modules	197	TRUE	0.008102637962305745	287	16	5	0.3125	0.017421602787456445	GO:0000377	GO:BP	RNA splicing, via transesterification reactions with bulged adenosine as nucleophile	16175	109		0.3333333333333333	0.75	287	15888	5	11	282	15877	16175	0.07025625055190057
M1	string	0	network_modules	197	TRUE	0.008667558048443482	291	16	5	0.3125	0.01718213058419244	GO:0000375	GO:BP	RNA splicing, via transesterification reactions	16175	107		1	1	291	15884	5	11	286	15873	16175	0.06972195898094978
M1	string	0	network_modules	198	TRUE	1.1061400075389195e-10	60	14	7	0.5	0.11666666666666667	REAC:R-HSA-9033241	REAC	Peroxisomal protein import	10916	1728		0	0.2	60	10856	7	7	53	10849	10916	0.2396808116437425
M1	string	0	network_modules	198	TRUE	1.1549095681268769e-7	158	14	7	0.5	0.04430379746835443	REAC:R-HSA-9609507	REAC	Protein localization	10916	1815		0.25	0.4	158	10758	7	7	151	10751	10916	0.1456775017796387
M1	string	0	network_modules	198	TRUE	1.4352734730920613e-6	91	20	6	0.3	0.06593406593406594	GO:0019395	GO:BP	fatty acid oxidation	16175	5752		0	0.08333333333333333	91	16084	6	14	85	16070	16175	0.1384801664709202
M1	string	0	network_modules	198	TRUE	1.7492923240963752e-6	94	20	6	0.3	0.06382978723404255	GO:0009062	GO:BP	fatty acid catabolic process	16175	3238		0.09090909090909091	0.16666666666666666	94	16081	6	14	88	16067	16175	0.13617931256855356
M1	string	0	network_modules	198	TRUE	1.98873829384027e-6	96	20	6	0.3	0.0625	GO:0034440	GO:BP	lipid oxidation	16175	8634		0.18181818181818182	0.25	96	16079	6	14	90	16065	16175	0.13470505191773433
M1	string	0	network_modules	198	TRUE	3.503423096905714e-6	83	12	5	0.4166666666666667	0.060240963855421686	KEGG:04146	KEGG	Peroxisome	8484	282		NA	1	83	8401	5	7	78	8394	8484	0.1555836292693561
M1	string	0	network_modules	198	TRUE	4.0684832673282495e-6	108	20	6	0.3	0.05555555555555555	GO:0072329	GO:BP	monocarboxylic acid catabolic process	16175	17352		0.2727272727272727	0.3333333333333333	108	16067	6	14	102	16053	16175	0.12672803270511984
M1	string	0	network_modules	198	TRUE	5.574418610431008e-6	24	14	4	0.2857142857142857	0.16666666666666666	REAC:R-HSA-390918	REAC	Peroxisomal lipid metabolism	10916	1727		0.5	0.6	24	10892	4	10	20	10882	10916	0.216916255470491
M1	string	0	network_modules	198	TRUE	1.9496994866609966e-5	65	20	5	0.25	0.07692307692307693	GO:0006635	GO:BP	fatty acid beta-oxidation	16175	2346		0.36363636363636365	0.4166666666666667	65	16110	5	15	60	16095	16175	0.13680555104681771
M1	string	0	network_modules	198	TRUE	4.8432809013670244e-5	163	20	6	0.3	0.03680981595092025	GO:0030258	GO:BP	lipid modification	16175	6747		0.45454545454545453	0.5	163	16012	6	14	157	15998	16175	0.10213426407056074
M1	string	0	network_modules	198	TRUE	2.2459556803656168e-4	211	20	6	0.3	0.02843601895734597	GO:0046395	GO:BP	carboxylic acid catabolic process	16175	12121		0.5454545454545454	0.6666666666666666	211	15964	6	14	205	15950	16175	0.08898315175140478
M1	string	0	network_modules	198	TRUE	2.2459556803656168e-4	211	20	6	0.3	0.02843601895734597	GO:0016054	GO:BP	organic acid catabolic process	16175	5086		0.5454545454545454	0.6666666666666666	211	15964	6	14	205	15950	16175	0.08898315175140478
M1	string	0	network_modules	198	TRUE	5.29184128413452e-4	173	14	5	0.35714285714285715	0.028901734104046242	REAC:R-HSA-8978868	REAC	Fatty acid metabolism	10916	935		0.75	0.8	173	10743	5	9	168	10734	10916	0.0979305027107112
M1	string	0	network_modules	198	TRUE	5.821909239414043e-4	248	20	6	0.3	0.024193548387096774	GO:0016042	GO:BP	lipid catabolic process	16175	5076		0.7272727272727273	0.75	248	15927	6	14	242	15913	16175	0.08151755844477178
M1	string	0	network_modules	198	TRUE	9.793640683197283e-4	271	20	6	0.3	0.02214022140221402	GO:0044248	GO:BP	cellular catabolic process	16175	10939		0.8181818181818182	0.8333333333333334	271	15904	6	14	265	15890	16175	0.07764819749671331
M1	string	0	network_modules	198	TRUE	0.0017732045190601104	300	20	6	0.3	0.02	GO:0044282	GO:BP	small molecule catabolic process	16175	10949		0.9090909090909091	0.9166666666666666	300	15875	6	14	294	15861	16175	0.07339964793059373
M1	string	0	network_modules	198	TRUE	0.0025344661185796066	319	20	6	0.3	0.018808777429467086	GO:0006631	GO:BP	fatty acid metabolic process	16175	2343		1	1	319	15856	6	14	313	15842	16175	0.07092559317263394
M1	string	0	network_modules	198	TRUE	0.004792936273151985	5	14	2	0.14285714285714285	0.4	REAC:R-HSA-389599	REAC	Alpha-oxidation of phytanate	10916	134		1	1	5	10911	2	12	3	10899	10916	0.23848684005241802
M1	string	0	network_modules	199	TRUE	2.6776890037416585e-6	42	21	5	0.23809523809523808	0.11904761904761904	GO:0097720	GO:BP	calcineurin-mediated signaling	16175	18746		0	0.1111111111111111	42	16133	5	16	37	16117	16175	0.1668476468100508
M1	string	0	network_modules	199	TRUE	1.8771944080210946e-5	107	13	5	0.38461538461538464	0.04672897196261682	KEGG:04922	KEGG	Glucagon signaling pathway	8484	379		0	0.14285714285714285	107	8377	5	8	102	8369	8484	0.13059175804369288
M1	string	0	network_modules	199	TRUE	4.9554359674161704e-5	251	13	6	0.46153846153846156	0.02390438247011952	KEGG:04020	KEGG	Calcium signaling pathway	8484	250		0.16666666666666666	0.2857142857142857	251	8233	6	7	245	8226	8484	0.09986790360873221
M1	string	0	network_modules	199	TRUE	1.5688481097286046e-4	164	13	5	0.38461538461538464	0.03048780487804878	KEGG:04022	KEGG	cGMP-PKG signaling pathway	8484	251		0.3333333333333333	0.42857142857142855	164	8320	5	8	159	8312	8484	0.10393291407796024
M1	string	0	network_modules	199	TRUE	1.7701367512306274e-4	36	21	4	0.19047619047619047	0.1111111111111111	GO:0106056	GO:BP	regulation of calcineurin-mediated signaling	16175	19232		0.125	0.2222222222222222	36	16139	4	17	32	16122	16175	0.1440325176618291
M1	string	0	network_modules	199	TRUE	3.0304523141550346e-4	41	21	4	0.19047619047619047	0.0975609756097561	GO:0033173	GO:BP	calcineurin-NFAT signaling cascade	16175	8068		0.25	0.3333333333333333	41	16134	4	17	37	16117	16175	0.1347638576034627
M1	string	0	network_modules	199	TRUE	4.052031408301205e-4	44	21	4	0.19047619047619047	0.09090909090909091	GO:0098703	GO:BP	calcium ion import across plasma membrane	16175	18835		0.375	0.4444444444444444	44	16131	4	17	40	16114	16175	0.12997224081133105
M1	string	0	network_modules	199	TRUE	0.00048627139105686683	46	21	4	0.19047619047619047	0.08695652173913043	GO:1902656	GO:BP	calcium ion import into cytosol	16175	22422		0.5	0.5555555555555556	46	16129	4	17	42	16112	16175	0.12703952246325517
M1	string	0	network_modules	199	TRUE	9.213032502611694e-4	23	14	3	0.21428571428571427	0.13043478260869565	REAC:R-HSA-180024	REAC	DARPP-32 events	10916	434		NA	1	23	10893	3	11	20	10882	10916	0.16582064566761434
M1	string	0	network_modules	199	TRUE	0.0013414553644541796	59	21	4	0.19047619047619047	0.06779661016949153	GO:0007613	GO:BP	memory	16175	3070		0.625	0.6666666666666666	59	16116	4	17	55	16099	16175	0.1117384363158638
M1	string	0	network_modules	199	TRUE	0.0028080578703497537	166	21	5	0.23809523809523808	0.030120481927710843	GO:0019722	GO:BP	calcium-mediated signaling	16175	6018		0.75	0.7777777777777778	166	16009	5	16	161	15993	16175	0.08150671724356576
M1	string	0	network_modules	199	TRUE	0.0033488235952079514	74	21	4	0.19047619047619047	0.05405405405405406	GO:0050848	GO:BP	regulation of calcium-mediated signaling	16175	13296		0.875	1	74	16101	4	17	70	16084	16175	0.09932392510228266
M1	string	0	network_modules	199	TRUE	0.0033488235952079514	74	21	4	0.19047619047619047	0.05405405405405406	GO:0070509	GO:BP	calcium ion import	16175	16164		0.875	1	74	16101	4	17	70	16084	16175	0.09932392510228266
M1	string	0	network_modules	199	TRUE	0.0035752378889125198	154	13	4	0.3076923076923077	0.025974025974025976	KEGG:04921	KEGG	Oxytocin signaling pathway	8484	378		0.5	0.5714285714285714	154	8330	4	9	150	8321	8484	0.0849633138150988
M1	string	0	network_modules	199	TRUE	0.006922875532671144	67	13	3	0.23076923076923078	0.04477611940298507	KEGG:04720	KEGG	Long-term potentiation	8484	350		0.6666666666666666	0.7142857142857143	67	8417	3	10	64	8407	8484	0.09863804701176711
M1	string	0	network_modules	199	TRUE	0.007558177009597993	69	13	3	0.23076923076923078	0.043478260869565216	KEGG:05031	KEGG	Amphetamine addiction	8484	419		0.8333333333333334	0.8571428571428571	69	8415	3	10	66	8405	8484	0.09710672689381805
M1	string	0	network_modules	199	TRUE	0.008771094648234782	194	13	4	0.3076923076923077	0.020618556701030927	KEGG:05167	KEGG	Kaposi sarcoma-associated herpesvirus infection	8484	448		1	1	194	8290	4	9	190	8281	8484	0.07464592294161748
M1	string	0	network_modules	200	TRUE	8.087843235465832e-5	86	20	5	0.25	0.05813953488372093	GO:0045103	GO:BP	intermediate filament-based process	16175	11274		0	0.3333333333333333	86	16089	5	15	81	16074	16175	0.1183848485142349
M1	string	0	network_modules	200	TRUE	0.004745509872486298	85	20	4	0.2	0.047058823529411764	GO:0045104	GO:BP	intermediate filament cytoskeleton organization	16175	11275		0.5	0.6666666666666666	85	16090	4	16	81	16074	16175	0.09477299067839848
M1	string	0	network_modules	200	TRUE	0.006403418026022153	3	20	2	0.1	0.6666666666666666	GO:0033693	GO:BP	neurofilament bundle assembly	16175	8354		1	1	3	16172	2	18	1	16154	16175	0.25790340281345747
M1	string	0	network_modules	201	TRUE	2.6850611118153755e-18	24	21	9	0.42857142857142855	0.375	GO:0031145	GO:BP	anaphase-promoting complex-dependent catabolic process	16175	7063		0	0.047619047619047616	24	16151	9	12	15	16139	16175	0.4000604219435521
M1	string	0	network_modules	201	TRUE	1.0337550450306625e-16	20	16	8	0.5	0.4	REAC:R-HSA-176412	REAC	Phosphorylation of the APC/C	10916	1753		0	0.08108108108108109	20	10896	8	8	12	10888	10916	0.446310804419569
M1	string	0	network_modules	201	TRUE	1.0337550450306625e-16	20	16	8	0.5	0.4	REAC:R-HSA-176407	REAC	Conversion from APC/C:Cdc20 to APC/C:Cdh1 in late anaphase	10916	409		0	0.08108108108108109	20	10896	8	8	12	10888	10916	0.446310804419569
M1	string	0	network_modules	201	TRUE	1.0337550450306625e-16	20	16	8	0.5	0.4	REAC:R-HSA-9687136	REAC	Aberrant regulation of mitotic exit in cancer due to RB1 defects	10916	49		0	0.08108108108108109	20	10896	8	8	12	10888	10916	0.446310804419569
M1	string	0	network_modules	201	TRUE	1.6688223797125885e-16	21	16	8	0.5	0.38095238095238093	REAC:R-HSA-141405	REAC	Inhibition of the proteolytic activity of APC/C required for the onset of anaphase by mitotic spindle checkpoint components	10916	1199		0.08333333333333333	0.13513513513513514	21	10895	8	8	13	10887	10916	0.43549463654380555
M1	string	0	network_modules	201	TRUE	1.6688223797125885e-16	21	16	8	0.5	0.38095238095238093	REAC:R-HSA-141430	REAC	Inactivation of APC/C via direct inhibition of the APC/C complex	10916	1176		0.08333333333333333	0.13513513513513514	21	10895	8	8	13	10887	10916	0.43549463654380555
M1	string	0	network_modules	201	TRUE	6.019799991464981e-16	24	16	8	0.5	0.3333333333333333	REAC:R-HSA-174048	REAC	APC/C:Cdc20 mediated degradation of Cyclin B	10916	25		0.1388888888888889	0.16216216216216217	24	10892	8	8	16	10884	10916	0.4071992217082234
M1	string	0	network_modules	201	TRUE	1.2770469487247463e-15	26	16	8	0.5	0.3076923076923077	REAC:R-HSA-179409	REAC	APC-Cdc20 mediated degradation of Nek2A	10916	23		0.16666666666666666	0.1891891891891892	26	10890	8	8	18	10882	10916	0.3911162765503596
M1	string	0	network_modules	201	TRUE	5.056356152161387e-15	50	21	9	0.42857142857142855	0.18	GO:0051445	GO:BP	regulation of meiotic cell cycle	16175	13708		0.05	0.09523809523809523	50	16125	9	12	41	16113	16175	0.2763493373811034
M1	string	0	network_modules	201	TRUE	1.1570939703452837e-14	102	11	9	0.8181818181818182	0.08823529411764706	KEGG:04914	KEGG	Progesterone-mediated oocyte maturation	8484	371		0	0.2	102	8382	9	2	93	8380	8484	0.2665172312242765
M1	string	0	network_modules	201	TRUE	2.4574589660866012e-14	36	16	8	0.5	0.2222222222222222	REAC:R-HSA-9687139	REAC	Aberrant regulation of mitotic cell cycle due to RB1 defects	10916	48		0.19444444444444445	0.21621621621621623	36	10880	8	8	28	10872	10916	0.3319254536876924
M1	string	0	network_modules	201	TRUE	3.966292215064486e-14	38	16	8	0.5	0.21052631578947367	REAC:R-HSA-9675126	REAC	Diseases of mitotic cell cycle	10916	769		0.2222222222222222	0.24324324324324326	38	10878	8	8	30	10870	10916	0.3229830291698354
M1	string	0	network_modules	201	TRUE	4.986591257837506e-14	39	16	8	0.5	0.20512820512820512	REAC:R-HSA-8853884	REAC	Transcriptional Regulation by VENTX	10916	2547		0.25	0.2702702702702703	39	10877	8	8	31	10869	10916	0.3187711620289006
M1	string	0	network_modules	201	TRUE	1.186891792244044e-13	131	11	9	0.8181818181818182	0.06870229007633588	KEGG:04114	KEGG	Oocyte meiosis	8484	268		0.25	0.4	131	8353	9	2	122	8351	8484	0.23458322335990542
M1	string	0	network_modules	201	TRUE	2.1942690214617648e-13	140	11	9	0.8181818181818182	0.06428571428571428	KEGG:04120	KEGG	Ubiquitin mediated proteolysis	8484	270		0.5	0.6	140	8344	9	2	131	8342	8484	0.22674012087082973
M1	string	0	network_modules	201	TRUE	6.312756034463011e-13	157	11	9	0.8181818181818182	0.05732484076433121	KEGG:04110	KEGG	Cell cycle	8484	264		0.75	0.8	157	8327	9	2	148	8325	8484	0.21379550398275193
M1	string	0	network_modules	201	TRUE	3.529275073162101e-12	64	16	8	0.5	0.125	REAC:R-HSA-174084	REAC	Autodegradation of Cdh1 by Cdh1:APC/C	10916	190		0.2777777777777778	0.2972972972972973	64	10852	8	8	56	10844	10916	0.24797780126337157
M1	string	0	network_modules	201	TRUE	5.8787186778561136e-12	68	16	8	0.5	0.11764705882352941	REAC:R-HSA-174154	REAC	APC/C:Cdc20 mediated degradation of Securin	10916	26		0.3055555555555556	0.32432432432432434	68	10848	8	8	60	10840	10916	0.24043971965850827
M1	string	0	network_modules	201	TRUE	7.692401907823358e-12	31	21	7	0.3333333333333333	0.22580645161290322	GO:0070979	GO:BP	protein K11-linked ubiquitination	16175	16411		0.1	0.14285714285714285	31	16144	7	14	24	16130	16175	0.2732133961568128
M1	string	0	network_modules	201	TRUE	1.065529486926595e-11	73	16	8	0.5	0.1095890410958904	REAC:R-HSA-69017	REAC	CDK-mediated phosphorylation and removal of Cdc6	10916	272		0.3333333333333333	0.3783783783783784	73	10843	8	8	65	10835	10916	0.2318976197934274
M1	string	0	network_modules	201	TRUE	1.065529486926595e-11	73	16	8	0.5	0.1095890410958904	REAC:R-HSA-174184	REAC	Cdc20:Phospho-APC/C mediated degradation of Cyclin A	10916	319		0.3333333333333333	0.3783783783783784	73	10843	8	8	65	10835	10916	0.2318976197934274
M1	string	0	network_modules	201	TRUE	1.1939019618597897e-11	74	16	8	0.5	0.10810810810810811	REAC:R-HSA-179419	REAC	APC:Cdc20 mediated degradation of cell cycle proteins prior to satisfation of the cell cycle checkpoint	10916	29		0.3888888888888889	0.43243243243243246	74	10842	8	8	66	10834	10916	0.23029326243694614
M1	string	0	network_modules	201	TRUE	1.1939019618597897e-11	74	16	8	0.5	0.10810810810810811	REAC:R-HSA-174178	REAC	APC/C:Cdh1 mediated degradation of Cdc20 and other APC/C:Cdh1 targeted proteins in late mitosis/early G1	10916	28		0.3888888888888889	0.43243243243243246	74	10842	8	8	66	10834	10916	0.23029326243694614
M1	string	0	network_modules	201	TRUE	1.2771965834243039e-11	218	11	9	0.8181818181818182	0.04128440366972477	KEGG:05166	KEGG	Human T-cell leukemia virus 1 infection	8484	447		1	1	218	8266	9	2	209	8264	8484	0.1804655316310089
M1	string	0	network_modules	201	TRUE	1.4917311559162973e-11	76	16	8	0.5	0.10526315789473684	REAC:R-HSA-176409	REAC	APC/C:Cdc20 mediated degradation of mitotic proteins	10916	27		0.4444444444444444	0.4594594594594595	76	10840	8	8	68	10832	10916	0.22717942633419436
M1	string	0	network_modules	201	TRUE	1.6635947460084678e-11	77	16	8	0.5	0.1038961038961039	REAC:R-HSA-176814	REAC	Activation of APC/C and APC/C:Cdc20 mediated degradation of mitotic proteins	10916	74		0.4722222222222222	0.4864864864864865	77	10839	8	8	69	10831	10916	0.22566788761779374
M1	string	0	network_modules	201	TRUE	2.5362593629843204e-11	81	16	8	0.5	0.09876543209876543	REAC:R-HSA-176408	REAC	Regulation of APC/C activators between G1/S and early anaphase	10916	1963		0.5	0.5135135135135135	81	10835	8	8	73	10827	10916	0.219902320159751
M1	string	0	network_modules	201	TRUE	4.2110848770747083e-11	130	21	9	0.42857142857142855	0.06923076923076923	GO:2000241	GO:BP	regulation of reproductive process	16175	25569		0.15	0.19047619047619047	130	16045	9	12	121	16033	16175	0.16981412820898098
M1	string	0	network_modules	201	TRUE	5.045235478107803e-11	88	16	8	0.5	0.09090909090909091	REAC:R-HSA-453276	REAC	Regulation of mitotic cell cycle	10916	2044		0.5277777777777778	0.5675675675675675	88	10828	8	8	80	10820	10916	0.21076843384585628
M1	string	0	network_modules	201	TRUE	5.045235478107803e-11	88	16	8	0.5	0.09090909090909091	REAC:R-HSA-174143	REAC	APC/C-mediated degradation of cell cycle proteins	10916	24		0.5277777777777778	0.5675675675675675	88	10828	8	8	80	10820	10916	0.21076843384585628
M1	string	0	network_modules	201	TRUE	7.286972995893094e-11	92	16	8	0.5	0.08695652173913043	REAC:R-HSA-69052	REAC	Switching of origins to a post-replicative state	10916	2365		0.5833333333333334	0.5945945945945946	92	10824	8	8	84	10816	10916	0.2060201054974301
M1	string	0	network_modules	201	TRUE	2.941157238224505e-10	109	16	8	0.5	0.07339449541284404	REAC:R-HSA-69618	REAC	Mitotic Spindle Checkpoint	10916	1486		0.6111111111111112	0.6216216216216216	109	10807	8	8	101	10799	10916	0.1888224009473143
M1	string	0	network_modules	201	TRUE	3.4137033230623373e-10	111	16	8	0.5	0.07207207207207207	REAC:R-HSA-2559582	REAC	Senescence-Associated Secretory Phenotype (SASP)	10916	2194		0.6388888888888888	0.6486486486486487	111	10805	8	8	103	10797	10916	0.1870609137546176
M1	string	0	network_modules	201	TRUE	6.910902169443571e-10	121	16	8	0.5	0.06611570247933884	REAC:R-HSA-69239	REAC	Synthesis of DNA	10916	2376		0.6666666666666666	0.6756756756756757	121	10795	8	8	113	10787	10916	0.17891219201030348
M1	string	0	network_modules	201	TRUE	2.454007534451798e-9	203	21	9	0.42857142857142855	0.04433497536945813	GO:0051321	GO:BP	meiotic cell cycle	16175	13648		0.2	0.23809523809523808	203	15972	9	12	194	15960	16175	0.1347415958337651
M1	string	0	network_modules	201	TRUE	2.5410480149100246e-9	142	16	8	0.5	0.056338028169014086	REAC:R-HSA-68867	REAC	Assembly of the pre-replicative complex	10916	181		0.6944444444444444	0.7027027027027027	142	10774	8	8	134	10766	10916	0.1646641500664363
M1	string	0	network_modules	201	TRUE	6.345855383748346e-9	159	16	8	0.5	0.050314465408805034	REAC:R-HSA-69002	REAC	DNA Replication Pre-Initiation	10916	446		0.7222222222222222	0.7297297297297297	159	10757	8	8	151	10749	10916	0.15523745542913175
M1	string	0	network_modules	201	TRUE	7.379653301788606e-9	162	16	8	0.5	0.04938271604938271	REAC:R-HSA-69242	REAC	S Phase	10916	2111		0.75	0.7567567567567568	162	10754	8	8	154	10746	10916	0.15372772333470477
M1	string	0	network_modules	201	TRUE	2.3432242516551226e-8	187	16	8	0.5	0.0427807486631016	REAC:R-HSA-69306	REAC	DNA Replication	10916	445		0.7777777777777778	0.7837837837837838	187	10729	8	8	179	10721	10916	0.14257367121579625
M1	string	0	network_modules	201	TRUE	2.4457505998224196e-8	188	16	8	0.5	0.0425531914893617	REAC:R-HSA-2467813	REAC	Separation of Sister Chromatids	10916	2204		0.8055555555555556	0.8108108108108109	188	10728	8	8	180	10720	10916	0.14217362950219423
M1	string	0	network_modules	201	TRUE	3.146987619220398e-8	194	16	8	0.5	0.041237113402061855	REAC:R-HSA-2559583	REAC	Cellular Senescence	10916	331		0.8333333333333334	0.8378378378378378	194	10722	8	8	186	10714	10916	0.13983756615715212
M1	string	0	network_modules	201	TRUE	1.144880365160833e-7	228	16	8	0.5	0.03508771929824561	REAC:R-HSA-68882	REAC	Mitotic Anaphase	10916	1479		0.8611111111111112	0.8648648648648649	228	10688	8	8	220	10680	10916	0.12836090936261843
M1	string	0	network_modules	201	TRUE	1.1855377889866291e-7	229	16	8	0.5	0.034934497816593885	REAC:R-HSA-2555396	REAC	Mitotic Metaphase and Anaphase	10916	1482		0.8888888888888888	0.8918918918918919	229	10687	8	8	221	10679	10916	0.12806184024199377
M1	string	0	network_modules	201	TRUE	4.4586502854125826e-7	363	21	9	0.42857142857142855	0.024793388429752067	GO:0043161	GO:BP	proteasome-mediated ubiquitin-dependent protein catabolic process	16175	10561		0.25	0.2857142857142857	363	15812	9	12	354	15800	16175	0.09886250242014578
M1	string	0	network_modules	201	TRUE	7.522199383679932e-7	289	16	8	0.5	0.02768166089965398	REAC:R-HSA-69620	REAC	Cell Cycle Checkpoints	10916	321		0.9166666666666666	0.918918918918919	289	10627	8	8	281	10619	10916	0.11300535211574803
M1	string	0	network_modules	201	TRUE	1.8685746521239384e-6	427	21	9	0.42857142857142855	0.02107728337236534	GO:0007346	GO:BP	regulation of mitotic cell cycle	16175	2855		0.3	0.3333333333333333	427	15748	9	12	418	15736	16175	0.09044817448321806
M1	string	0	network_modules	201	TRUE	4.336881524124892e-6	470	21	9	0.42857142857142855	0.019148936170212766	GO:0010498	GO:BP	proteasomal protein catabolic process	16175	4177		0.35	0.38095238095238093	470	15705	9	12	461	15693	16175	0.08575871468903619
M1	string	0	network_modules	201	TRUE	1.0856475597930771e-5	406	16	8	0.5	0.019704433497536946	REAC:R-HSA-68886	REAC	M Phase	10916	1343		0.9444444444444444	0.9459459459459459	406	10510	8	8	398	10502	10916	0.09370132010016094
M1	string	0	network_modules	201	TRUE	1.6293275694640577e-5	547	21	9	0.42857142857142855	0.016453382084095063	GO:0006511	GO:BP	ubiquitin-dependent protein catabolic process	16175	2235		0.4	0.42857142857142855	547	15628	9	12	538	15616	16175	0.07873990056028816
M1	string	0	network_modules	201	TRUE	1.8483757316237406e-5	555	21	9	0.42857142857142855	0.016216216216216217	GO:0019941	GO:BP	modification-dependent protein catabolic process	16175	6072		0.45	0.47619047619047616	555	15620	9	12	546	15608	16175	0.07809239596274108
M1	string	0	network_modules	201	TRUE	1.967298683623813e-5	559	21	9	0.42857142857142855	0.016100178890876567	GO:0043632	GO:BP	modification-dependent macromolecule catabolic process	16175	10812		0.5	0.5238095238095238	559	15616	9	12	550	15604	16175	0.0777736457323717
M1	string	0	network_modules	201	TRUE	2.3750434116694498e-5	792	21	10	0.47619047619047616	0.012626262626262626	GO:0000278	GO:BP	mitotic cell cycle	16175	76		0.55	0.5714285714285714	792	15383	10	11	782	15372	16175	0.07138196300756312
M1	string	0	network_modules	201	TRUE	2.605974472284672e-5	248	21	7	0.3333333333333333	0.028225806451612902	GO:0000209	GO:BP	protein polyubiquitination	16175	59		0.6	0.6190476190476191	248	15927	7	14	241	15913	16175	0.09331459901719416
M1	string	0	network_modules	201	TRUE	3.920072029940576e-5	308	16	7	0.4375	0.022727272727272728	REAC:R-HSA-983168	REAC	Antigen processing: Ubiquitination & Proteasome degradation	10916	154		0.9722222222222222	0.972972972972973	308	10608	7	9	301	10599	10916	0.09469858550305453
M1	string	0	network_modules	201	TRUE	7.343064179756501e-5	651	21	9	0.42857142857142855	0.013824884792626729	GO:0019953	GO:BP	sexual reproduction	16175	6073		0.65	0.6666666666666666	651	15524	9	12	642	15512	16175	0.07123869707500843
M1	string	0	network_modules	201	TRUE	9.7719124221567e-5	673	21	9	0.42857142857142855	0.01337295690936107	GO:0051603	GO:BP	proteolysis involved in protein catabolic process	16175	13820		0.7	0.7142857142857143	673	15502	9	12	664	15490	16175	0.06986876610497707
M1	string	0	network_modules	201	TRUE	1.6386466925721112e-4	380	16	7	0.4375	0.018421052631578946	REAC:R-HSA-983169	REAC	Class I MHC mediated antigen processing & presentation	10916	368		1	1	380	10536	7	9	373	10527	10916	0.08416858921512135
M1	string	0	network_modules	201	TRUE	5.874122510837073e-4	590	21	8	0.38095238095238093	0.013559322033898305	GO:0016567	GO:BP	protein ubiquitination	16175	5254		0.75	0.7619047619047619	590	15585	8	13	582	15572	16175	0.06625122052938645
M1	string	0	network_modules	201	TRUE	0.001489077675439036	667	21	8	0.38095238095238093	0.01199400299850075	GO:0032446	GO:BP	protein modification by small protein conjugation	16175	7568		0.8	0.8095238095238095	667	15508	8	13	659	15495	16175	0.061601170525948566
M1	string	0	network_modules	201	TRUE	0.003560119556118705	749	21	8	0.38095238095238093	0.010680907877169559	GO:0070647	GO:BP	protein modification by small protein conjugation or removal	16175	16231		0.85	0.8571428571428571	749	15426	8	13	741	15413	16175	0.057415932365368794
M1	string	0	network_modules	201	TRUE	0.0057130229853451075	798	21	8	0.38095238095238093	0.010025062656641603	GO:0043687	GO:BP	post-translational protein modification	16175	10838		0.9	0.9047619047619048	798	15377	8	13	790	15364	16175	0.05520944907632885
M1	string	0	network_modules	201	TRUE	0.0073371534378839235	90	21	4	0.19047619047619047	0.044444444444444446	GO:0007091	GO:BP	metaphase/anaphase transition of mitotic cell cycle	16175	2675		0.95	0.9523809523809523	90	16085	4	17	86	16068	16175	0.08962874583382072
M1	string	0	network_modules	201	TRUE	0.00800982601651334	92	21	4	0.19047619047619047	0.043478260869565216	GO:0044784	GO:BP	metaphase/anaphase transition of cell cycle	16175	11156		1	1	92	16083	4	17	88	16066	16175	0.08859539718877721
M1	string	0	network_modules	202	TRUE	1.1331257295242738e-7	91	13	6	0.46153846153846156	0.06593406593406594	KEGG:04970	KEGG	Salivary secretion	8484	401		NA	1	91	8393	6	7	85	8386	8484	0.17144369965058084
M1	string	0	network_modules	203	TRUE	1.3606016817874282e-15	26	19	8	0.42105263157894735	0.3076923076923077	GO:0006506	GO:BP	GPI anchor biosynthetic process	16175	2232		0	0.047619047619047616	26	16149	8	11	18	16138	16175	0.3590623908250124
M1	string	0	network_modules	203	TRUE	1.932316217492482e-15	27	19	8	0.42105263157894735	0.2962962962962963	GO:0006505	GO:BP	GPI anchor metabolic process	16175	2231		0.05	0.09523809523809523	27	16148	8	11	19	16137	16175	0.352309326275282
M1	string	0	network_modules	203	TRUE	6.8496025396913245e-15	31	19	8	0.42105263157894735	0.25806451612903225	GO:0180046	GO:BP	GPI anchored protein biosynthesis	16175	20314		0.1	0.14285714285714285	31	16144	8	11	23	16133	16175	0.32864180539215476
M1	string	0	network_modules	203	TRUE	2.050802908129682e-13	26	14	7	0.5	0.2692307692307692	KEGG:00563	KEGG	Glycosylphosphatidylinositol (GPI)-anchor biosynthesis	8484	87		NA	1	26	8458	7	7	19	8451	8484	0.36551264029451386
M1	string	0	network_modules	203	TRUE	5.540976662339214e-12	67	19	8	0.42105263157894735	0.11940298507462686	GO:0009247	GO:BP	glycolipid biosynthetic process	16175	3412		0.15	0.19047619047619047	67	16108	8	11	59	16097	16175	0.2226069519162906
M1	string	0	network_modules	203	TRUE	1.3419677421248566e-11	17	16	6	0.375	0.35294117647058826	REAC:R-HSA-162710	REAC	Synthesis of glycosylphosphatidylinositol (GPI)	10916	2409		0	0.16666666666666666	17	10899	6	10	11	10889	10916	0.3628410391305709
M1	string	0	network_modules	203	TRUE	7.788448781991948e-11	92	19	8	0.42105263157894735	0.08695652173913043	GO:0006664	GO:BP	glycolipid metabolic process	16175	2373		0.2	0.23809523809523808	92	16083	8	11	84	16072	16175	0.18941154919165662
M1	string	0	network_modules	203	TRUE	8.516304594553973e-11	93	19	8	0.42105263157894735	0.08602150537634409	GO:1903509	GO:BP	liposaccharide metabolic process	16175	23059		0.25	0.2857142857142857	93	16082	8	11	85	16071	16175	0.18836827101214304
M1	string	0	network_modules	203	TRUE	5.238831226871599e-10	116	19	8	0.42105263157894735	0.06896551724137931	GO:0006661	GO:BP	phosphatidylinositol biosynthetic process	16175	2370		0.3	0.3333333333333333	116	16059	8	11	108	16048	16175	0.16820600169959996
M1	string	0	network_modules	203	TRUE	1.3279768412856165e-9	130	19	8	0.42105263157894735	0.06153846153846154	GO:0046467	GO:BP	membrane lipid biosynthetic process	16175	12175		0.35	0.38095238095238093	130	16045	8	11	122	16034	16175	0.15862769750533054
M1	string	0	network_modules	203	TRUE	1.9171578634209163e-9	136	19	8	0.42105263157894735	0.058823529411764705	GO:0046488	GO:BP	phosphatidylinositol metabolic process	16175	12192		0.4	0.42857142857142855	136	16039	8	11	128	16028	16175	0.15497877723973083
M1	string	0	network_modules	203	TRUE	7.635448673844047e-9	91	16	7	0.4375	0.07692307692307693	REAC:R-HSA-163125	REAC	Post-translational modification: synthesis of GPI-anchored proteins	10916	1775		0.2	0.3333333333333333	91	10825	7	9	84	10816	10916	0.18084167193302705
M1	string	0	network_modules	203	TRUE	1.8512761084763207e-8	180	19	8	0.42105263157894735	0.044444444444444446	GO:0006643	GO:BP	membrane lipid metabolic process	16175	2354		0.45	0.47619047619047616	180	15995	8	11	172	15984	16175	0.13400762383134607
M1	string	0	network_modules	203	TRUE	2.7409919023022087e-8	189	19	8	0.42105263157894735	0.042328042328042326	GO:0046474	GO:BP	glycerophospholipid biosynthetic process	16175	12181		0.5	0.5238095238095238	189	15986	8	11	181	15975	16175	0.13063729559606174
M1	string	0	network_modules	203	TRUE	8.608950829079333e-8	218	19	8	0.42105263157894735	0.03669724770642202	GO:0008654	GO:BP	phospholipid biosynthetic process	16175	3225		0.55	0.5714285714285714	218	15957	8	11	210	15946	16175	0.1212154228916103
M1	string	0	network_modules	203	TRUE	1.1483183631240456e-7	226	19	8	0.42105263157894735	0.035398230088495575	GO:0045017	GO:BP	glycerolipid biosynthetic process	16175	11231		0.6	0.6190476190476191	226	15949	8	11	218	15938	16175	0.11893603804576175
M1	string	0	network_modules	203	TRUE	4.5979521537815604e-7	269	19	8	0.42105263157894735	0.02973977695167286	GO:0006650	GO:BP	glycerophospholipid metabolic process	16175	2360		0.65	0.6666666666666666	269	15906	8	11	261	15895	16175	0.10845069562574977
M1	string	0	network_modules	203	TRUE	2.2084549599426773e-6	328	19	8	0.42105263157894735	0.024390243902439025	GO:0006644	GO:BP	phospholipid metabolic process	16175	2355		0.7	0.7142857142857143	328	15847	8	11	320	15836	16175	0.09750877846382547
M1	string	0	network_modules	203	TRUE	2.7336337643077796e-6	337	19	8	0.42105263157894735	0.02373887240356083	GO:0046486	GO:BP	glycerolipid metabolic process	16175	12190		0.75	0.7619047619047619	337	15838	8	11	329	15827	16175	0.09609165564687884
M1	string	0	network_modules	203	TRUE	4.562613379411492e-5	483	19	8	0.42105263157894735	0.016563146997929608	GO:0051604	GO:BP	protein maturation	16175	13821		0.8	0.8095238095238095	483	15692	8	11	475	15681	16175	0.07881903677281349
M1	string	0	network_modules	203	TRUE	7.168613453861596e-5	512	19	8	0.42105263157894735	0.015625	GO:0090407	GO:BP	organophosphate biosynthetic process	16175	18274		0.85	0.8571428571428571	512	15663	8	11	504	15652	16175	0.07627397357039807
M1	string	0	network_modules	203	TRUE	7.388143144580316e-5	514	19	8	0.42105263157894735	0.01556420233463035	GO:1901137	GO:BP	carbohydrate derivative biosynthetic process	16175	21245		0.9	0.9047619047619048	514	15661	8	11	506	15650	16175	0.07610612266356141
M1	string	0	network_modules	203	TRUE	1.5528732974810387e-4	9	19	3	0.15789473684210525	0.3333333333333333	GO:0050915	GO:BP	sensory perception of sour taste	16175	13357		0.95	0.9523809523809523	9	16166	3	16	6	16150	16175	0.2288053323123006
M1	string	0	network_modules	203	TRUE	3.32769582656215e-4	625	19	8	0.42105263157894735	0.0128	GO:0008610	GO:BP	lipid biosynthetic process	16175	3206		1	1	625	15550	8	11	617	15539	16175	0.06804266761152554
M1	string	0	network_modules	203	TRUE	0.0019351698119499442	3	16	2	0.125	0.6666666666666666	REAC:R-HSA-162699	REAC	Synthesis of dolichyl-phosphate mannose	10916	2406		0.4	1	3	10913	2	14	1	10899	10916	0.2882913972771879
M1	string	0	network_modules	203	TRUE	0.0019351698119499442	3	16	2	0.125	0.6666666666666666	REAC:R-HSA-4719360	REAC	Defective DPM3 causes DPM3-CDG	10916	537		0.4	1	3	10913	2	14	1	10899	10916	0.2882913972771879
M1	string	0	network_modules	203	TRUE	0.0019351698119499442	3	16	2	0.125	0.6666666666666666	REAC:R-HSA-4719377	REAC	Defective DPM2 causes DPM2-CDG	10916	536		0.4	1	3	10913	2	14	1	10899	10916	0.2882913972771879
M1	string	0	network_modules	203	TRUE	0.0019351698119499442	3	16	2	0.125	0.6666666666666666	REAC:R-HSA-4717374	REAC	Defective DPM1 causes DPM1-CDG	10916	535		0.4	1	3	10913	2	14	1	10899	10916	0.2882913972771879
M1	string	0	network_modules	204	TRUE	5.744715548280132e-11	141	17	9	0.5294117647058824	0.06382978723404255	REAC:R-HSA-3214847	REAC	HATs acetylate histones	10916	1087		0	0.3333333333333333	141	10775	9	8	132	10767	10916	0.18065190321560098
M1	string	0	network_modules	204	TRUE	2.138182735419358e-8	271	17	9	0.5294117647058824	0.033210332103321034	REAC:R-HSA-3247509	REAC	Chromatin modifying enzymes	10916	355		0.5	1	271	10645	9	8	262	10637	10916	0.1280773183169728
M1	string	0	network_modules	204	TRUE	2.138182735419358e-8	271	17	9	0.5294117647058824	0.033210332103321034	REAC:R-HSA-4839726	REAC	Chromatin organization	10916	356		0.5	1	271	10645	9	8	262	10637	10916	0.1280773183169728
M1	string	0	network_modules	204	TRUE	0.002554117226310345	17	23	3	0.13043478260869565	0.17647058823529413	GO:0002098	GO:BP	tRNA wobble uridine modification	16175	681		0	0.5	17	16158	3	20	14	16138	16175	0.15068034991580065
M1	string	0	network_modules	204	TRUE	0.004270000937332811	20	23	3	0.13043478260869565	0.15	GO:0002097	GO:BP	tRNA wobble base modification	16175	680		1	1	20	16155	3	20	17	16135	16175	0.13873415606930908
M1	string	0	network_modules	205	TRUE	1.3219268546021136e-5	108	12	5	0.4166666666666667	0.046296296296296294	KEGG:03013	KEGG	Nucleocytoplasmic transport	8484	209		0	0.5	108	8376	5	7	103	8369	8484	0.13560682312519928
M1	string	0	network_modules	205	TRUE	8.392913225502298e-5	2	7	2	0.2857142857142857	1	REAC:R-HSA-141333	REAC	Biogenic amines are oxidatively deaminated to aldehydes by MAOA and MAOB	10916	226		0	0.25	2	10914	2	5	0	10909	10916	0.5344000301603649
M1	string	0	network_modules	205	TRUE	2.517104963323631e-4	3	7	2	0.2857142857142857	0.6666666666666666	REAC:R-HSA-140179	REAC	Amine Oxidase reactions	10916	138		0.3333333333333333	0.5	3	10913	2	5	1	10908	10916	0.4362157899272416
M1	string	0	network_modules	205	TRUE	0.0010852533253036365	261	21	6	0.2857142857142857	0.022988505747126436	GO:0051169	GO:BP	nuclear transport	16175	13552		0	0.25	261	15914	6	15	255	15899	16175	0.07714163763355844
M1	string	0	network_modules	205	TRUE	0.0010852533253036365	261	21	6	0.2857142857142857	0.022988505747126436	GO:0006913	GO:BP	nucleocytoplasmic transport	16175	2562		0	0.25	261	15914	6	15	255	15899	16175	0.07714163763355844
M1	string	0	network_modules	205	TRUE	0.0018182989018037726	152	21	5	0.23809523809523808	0.03289473684210526	GO:0051168	GO:BP	nuclear export	16175	13551		0.2857142857142857	0.375	152	16023	5	16	147	16007	16175	0.08546387733766984
M1	string	0	network_modules	205	TRUE	0.002156842971704246	71	7	3	0.42857142857142855	0.04225352112676056	REAC:R-HSA-159236	REAC	Transport of Mature mRNA derived from an Intron-Containing Transcript	10916	2586		0.6666666666666666	0.75	71	10845	3	4	68	10841	10916	0.1330018683675745
M1	string	0	network_modules	205	TRUE	0.0025266934995087907	69	21	4	0.19047619047619047	0.057971014492753624	GO:0006406	GO:BP	mRNA export from nucleus	16175	2167		0.42857142857142855	0.5	69	16106	4	17	65	16089	16175	0.10301472718470382
M1	string	0	network_modules	205	TRUE	0.0029785803300356522	168	21	5	0.23809523809523808	0.02976190476190476	GO:0015931	GO:BP	nucleobase-containing compound transport	16175	5016		0.5714285714285714	0.625	168	16007	5	16	163	15991	16175	0.08098119361712719
M1	string	0	network_modules	205	TRUE	0.0030927571820933662	80	7	3	0.42857142857142855	0.0375	REAC:R-HSA-72202	REAC	Transport of Mature Transcript to Cytoplasm	10916	2584		1	1	80	10836	3	4	77	10832	10916	0.12510452263556632
M1	string	0	network_modules	205	TRUE	0.0037277317357393533	76	21	4	0.19047619047619047	0.05263157894736842	GO:0051028	GO:BP	mRNA transport	16175	13445		0.7142857142857143	0.75	76	16099	4	17	72	16082	16175	0.0979492141431276
M1	string	0	network_modules	205	TRUE	0.005066760425508641	363	12	5	0.4166666666666667	0.013774104683195593	KEGG:05014	KEGG	Amyotrophic lateral sclerosis	8484	413		1	1	363	8121	5	7	358	8114	8484	0.0695300850078261
M1	string	0	network_modules	205	TRUE	0.0055161512417743344	24	21	3	0.14285714285714285	0.125	GO:0016973	GO:BP	poly(A)+ mRNA export from nucleus	16175	5260		0.8571428571428571	0.875	24	16151	3	18	21	16133	16175	0.1324268911233211
M1	string	0	network_modules	205	TRUE	0.0073371534378839235	90	21	4	0.19047619047619047	0.044444444444444446	GO:0006405	GO:BP	RNA export from nucleus	16175	2166		1	1	90	16085	4	17	86	16068	16175	0.08962874583382072
M1	string	0	network_modules	206	TRUE	1.5639740983749013e-15	575	23	16	0.6956521739130435	0.02782608695652174	GO:0098662	GO:BP	inorganic cation transmembrane transport	16175	18818		0	0.02631578947368421	575	15600	16	7	559	15593	16175	0.13452743454400135
M1	string	0	network_modules	206	TRUE	1.6531455458328133e-15	577	23	16	0.6956521739130435	0.02772963604852686	GO:0098655	GO:BP	monoatomic cation transmembrane transport	16175	18811		0.02702702702702703	0.05263157894736842	577	15598	16	7	561	15591	16175	0.13427753480610527
M1	string	0	network_modules	206	TRUE	6.713776678305964e-15	630	23	16	0.6956521739130435	0.025396825396825397	GO:0098660	GO:BP	inorganic ion transmembrane transport	16175	18816		0.05405405405405406	0.07894736842105263	630	15545	16	7	614	15538	16175	0.12808507733021157
M1	string	0	network_modules	206	TRUE	1.491344147283444e-14	43	22	9	0.4090909090909091	0.20930232558139536	REAC:R-HSA-1296072	REAC	Voltage gated Potassium channels	10916	2663		0	0.14285714285714285	43	10873	9	13	34	10860	10916	0.290663143146146
M1	string	0	network_modules	206	TRUE	1.830970924671681e-14	671	23	16	0.6956521739130435	0.02384500745156483	GO:0034220	GO:BP	monoatomic ion transmembrane transport	16175	8508		0.08108108108108109	0.10526315789473684	671	15504	16	7	655	15497	16175	0.12379453636480846
M1	string	0	network_modules	206	TRUE	2.1092833557203446e-14	677	23	16	0.6956521739130435	0.023633677991137372	GO:0030001	GO:BP	metal ion transport	16175	6646		0.10810810810810811	0.13157894736842105	677	15498	16	7	661	15491	16175	0.12319869873027911
M1	string	0	network_modules	206	TRUE	1.0267461929834261e-13	748	23	16	0.6956521739130435	0.0213903743315508	GO:0006812	GO:BP	monoatomic cation transport	16175	2492		0.13513513513513514	0.15789473684210525	748	15427	16	7	732	15420	16175	0.11668663877246406
M1	string	0	network_modules	206	TRUE	5.229175597557772e-13	183	23	11	0.4782608695652174	0.060109289617486336	GO:0071805	GO:BP	potassium ion transmembrane transport	16175	16918		0.16216216216216217	0.18421052631578946	183	15992	11	12	172	15980	16175	0.1666041496583304
M1	string	0	network_modules	206	TRUE	1.260606852616075e-12	198	23	11	0.4782608695652174	0.05555555555555555	GO:0006813	GO:BP	potassium ion transport	16175	2493		0.1891891891891892	0.21052631578947367	198	15977	11	12	187	15965	16175	0.15992603516555154
M1	string	0	network_modules	206	TRUE	6.221368858917796e-11	103	22	9	0.4090909090909091	0.08737864077669903	REAC:R-HSA-1296071	REAC	Potassium Channels	10916	1780		0.16666666666666666	0.2857142857142857	103	10813	9	13	94	10800	10916	0.18576973265131874
M1	string	0	network_modules	206	TRUE	4.705868903229198e-9	4	23	4	0.17391304347826086	1	GO:1904044	GO:BP	response to aldosterone	16175	23484		0.21621621621621623	0.2894736842105263	4	16171	4	19	0	16152	16175	0.41678376359954594
M1	string	0	network_modules	206	TRUE	4.705868903229198e-9	4	23	4	0.17391304347826086	1	GO:1904045	GO:BP	cellular response to aldosterone	16175	23485		0.21621621621621623	0.2894736842105263	4	16171	4	19	0	16152	16175	0.41678376359954594
M1	string	0	network_modules	206	TRUE	4.705868903229198e-9	4	23	4	0.17391304347826086	1	GO:0050914	GO:BP	sensory perception of salty taste	16175	13356		0.21621621621621623	0.2894736842105263	4	16171	4	19	0	16152	16175	0.41678376359954594
M1	string	0	network_modules	206	TRUE	2.350722800902543e-8	5	23	4	0.17391304347826086	0.8	GO:1904117	GO:BP	cellular response to vasopressin	16175	23540		0.2972972972972973	0.3684210526315789	5	16170	4	19	1	16151	16175	0.3726615455678662
M1	string	0	network_modules	206	TRUE	2.350722800902543e-8	5	23	4	0.17391304347826086	0.8	GO:1904116	GO:BP	response to vasopressin	16175	23539		0.2972972972972973	0.3684210526315789	5	16170	4	19	1	16151	16175	0.3726615455678662
M1	string	0	network_modules	206	TRUE	2.350722800902543e-8	5	23	4	0.17391304347826086	0.8	GO:0071389	GO:BP	cellular response to mineralocorticoid stimulus	16175	16641		0.2972972972972973	0.3684210526315789	5	16170	4	19	1	16151	16175	0.3726615455678662
M1	string	0	network_modules	206	TRUE	6.169261848415857e-8	6	22	4	0.18181818181818182	0.6666666666666666	REAC:R-HSA-9730628	REAC	Sensory perception of salty taste	10916	2197		0.3333333333333333	0.42857142857142855	6	10910	4	18	2	10892	10916	0.347548640586219
M1	string	0	network_modules	206	TRUE	1.4375947243677982e-7	7	22	4	0.18181818181818182	0.5714285714285714	REAC:R-HSA-447043	REAC	Neurofascin interactions	10916	1589		0.5	0.5714285714285714	7	10909	4	18	3	10891	10916	0.3216196437396268
M1	string	0	network_modules	206	TRUE	3.2817402115632113e-7	8	23	4	0.17391304347826086	0.5	GO:0051385	GO:BP	response to mineralocorticoid	16175	13689		0.3783783783783784	0.39473684210526316	8	16167	4	19	4	16148	16175	0.2943273699007012
M1	string	0	network_modules	206	TRUE	5.901579673450242e-7	9	23	4	0.17391304347826086	0.4444444444444444	GO:0050915	GO:BP	sensory perception of sour taste	16175	13357		0.40540540540540543	0.42105263157894735	9	16166	4	19	5	16147	16175	0.2774041580041943
M1	string	0	network_modules	206	TRUE	2.3119456020844105e-6	12	23	4	0.17391304347826086	0.3333333333333333	GO:0110096	GO:BP	cellular response to aldehyde	16175	19409		0.43243243243243246	0.4473684210526316	12	16163	4	19	8	16144	16175	0.24000429053172148
M1	string	0	network_modules	206	TRUE	3.336337716946882e-6	13	23	4	0.17391304347826086	0.3076923076923077	GO:0071468	GO:BP	cellular response to acidic pH	16175	16701		0.4594594594594595	0.47368421052631576	13	16162	4	19	9	16143	16175	0.2305134722841177
M1	string	0	network_modules	206	TRUE	9.87976807875081e-6	47	22	5	0.22727272727272727	0.10638297872340426	REAC:R-HSA-9717189	REAC	Sensory perception of taste	10916	2200		0.6666666666666666	0.7142857142857143	47	10869	5	17	42	10852	10916	0.15303060119977965
M1	string	0	network_modules	206	TRUE	1.1824208173460045e-5	400	22	9	0.4090909090909091	0.0225	REAC:R-HSA-112316	REAC	Neuronal System	10916	1590		0.8333333333333334	0.8571428571428571	400	10516	9	13	391	10503	10916	0.08908219358380702
M1	string	0	network_modules	206	TRUE	1.7984440559514626e-5	19	23	4	0.17391304347826086	0.21052631578947367	GO:0010447	GO:BP	response to acidic pH	16175	4144		0.4864864864864865	0.5263157894736842	19	16156	4	19	15	16137	16175	0.19030061956360644
M1	string	0	network_modules	206	TRUE	1.7984440559514626e-5	19	23	4	0.17391304347826086	0.21052631578947367	GO:0006883	GO:BP	intracellular sodium ion homeostasis	16175	2539		0.4864864864864865	0.5263157894736842	19	16156	4	19	15	16137	16175	0.19030061956360644
M1	string	0	network_modules	206	TRUE	3.384558526236148e-5	22	23	4	0.17391304347826086	0.18181818181818182	GO:0098719	GO:BP	sodium ion import across plasma membrane	16175	18849		0.5405405405405406	0.5789473684210527	22	16153	4	19	18	16134	16175	0.17667676148943728
M1	string	0	network_modules	206	TRUE	3.384558526236148e-5	22	23	4	0.17391304347826086	0.18181818181818182	GO:0071467	GO:BP	cellular response to pH	16175	16700		0.5405405405405406	0.5789473684210527	22	16153	4	19	18	16134	16175	0.17667676148943728
M1	string	0	network_modules	206	TRUE	5.836502990867852e-5	25	23	4	0.17391304347826086	0.16	GO:0071384	GO:BP	cellular response to corticosteroid stimulus	16175	16636		0.5945945945945946	0.6052631578947368	25	16150	4	19	21	16131	16175	0.16557472388135833
M1	string	0	network_modules	206	TRUE	1.0917168234734073e-4	29	23	4	0.17391304347826086	0.13793103448275862	GO:0009268	GO:BP	response to pH	16175	3433		0.6216216216216216	0.631578947368421	29	16146	4	19	25	16127	16175	0.15353072663351128
M1	string	0	network_modules	206	TRUE	1.7187654821057858e-4	85	11	4	0.36363636363636365	0.047058823529411764	KEGG:04742	KEGG	Taste transduction	8484	361		0	0.3333333333333333	85	8399	4	7	81	8392	8484	0.12793486077562546
M1	string	0	network_modules	206	TRUE	1.873827317738152e-4	33	23	4	0.17391304347826086	0.12121212121212122	GO:0055078	GO:BP	sodium ion homeostasis	16175	14232		0.6486486486486487	0.6578947368421053	33	16142	4	19	29	16123	16175	0.14373638289442384
M1	string	0	network_modules	206	TRUE	4.157503720516649e-4	40	23	4	0.17391304347826086	0.1	GO:0031960	GO:BP	response to corticosteroid	16175	7304		0.6756756756756757	0.6842105263157895	40	16135	4	19	36	16116	16175	0.1302545681627528
M1	string	0	network_modules	206	TRUE	5.600680672011281e-4	108	23	5	0.21739130434782608	0.046296296296296294	GO:0001508	GO:BP	action potential	16175	323		0.7027027027027027	0.7105263157894737	108	16067	5	18	103	16049	16175	0.09763597309145437
M1	string	0	network_modules	206	TRUE	7.202142829218135e-4	37	11	3	0.2727272727272727	0.08108108108108109	KEGG:04960	KEGG	Aldosterone-regulated sodium reabsorption	8484	396		0.5	0.6666666666666666	37	8447	3	8	34	8439	8484	0.14674184699920295
M1	string	0	network_modules	206	TRUE	8.348185708279513e-4	117	23	5	0.21739130434782608	0.042735042735042736	GO:0098659	GO:BP	inorganic cation import across plasma membrane	16175	18815		0.7297297297297297	0.7631578947368421	117	16058	5	18	112	16040	16175	0.09358411918566684
M1	string	0	network_modules	206	TRUE	8.348185708279513e-4	117	23	5	0.21739130434782608	0.042735042735042736	GO:0099587	GO:BP	inorganic ion import across plasma membrane	16175	19152		0.7297297297297297	0.7631578947368421	117	16058	5	18	112	16040	16175	0.09358411918566684
M1	string	0	network_modules	206	TRUE	0.0010709605741957553	119	22	5	0.22727272727272727	0.04201680672268908	REAC:R-HSA-373760	REAC	L1CAM interactions	10916	1294		1	1	119	10797	5	17	114	10780	10916	0.09363879176805931
M1	string	0	network_modules	206	TRUE	0.0011251372535722782	51	23	4	0.17391304347826086	0.0784313725490196	GO:1901655	GO:BP	cellular response to ketone	16175	21622		0.7837837837837838	0.7894736842105263	51	16124	4	19	47	16105	16175	0.11493698295902664
M1	string	0	network_modules	206	TRUE	0.001217752334874337	52	23	4	0.17391304347826086	0.07692307692307693	GO:0050909	GO:BP	sensory perception of taste	16175	13351		0.8108108108108109	0.8157894736842105	52	16123	4	19	48	16104	16175	0.1137887723152264
M1	string	0	network_modules	206	TRUE	0.001780584865964731	153	11	4	0.36363636363636365	0.026143790849673203	KEGG:04514	KEGG	Cell adhesion molecules	8484	315		1	1	153	8331	4	7	149	8324	8484	0.09357522674774238
M1	string	0	network_modules	206	TRUE	0.0018976713166204253	58	23	4	0.17391304347826086	0.06896551724137931	GO:0097306	GO:BP	cellular response to alcohol	16175	18587		0.8378378378378378	0.8421052631578947	58	16117	4	19	54	16098	16175	0.1075283848103184
M1	string	0	network_modules	206	TRUE	0.003008376482897423	65	23	4	0.17391304347826086	0.06153846153846154	GO:1901379	GO:BP	regulation of potassium ion transmembrane transport	16175	21429		0.8648648648648649	0.868421052631579	65	16110	4	19	61	16091	16175	0.10133743702927497
M1	string	0	network_modules	206	TRUE	0.0038079431756170125	159	23	5	0.21739130434782608	0.031446540880503145	GO:0006814	GO:BP	sodium ion transport	16175	2494		0.8918918918918919	0.8947368421052632	159	16016	5	18	154	15998	16175	0.07939001531064105
M1	string	0	network_modules	206	TRUE	0.004800081137155754	73	23	4	0.17391304347826086	0.0547945205479452	GO:1901654	GO:BP	response to ketone	16175	21621		0.918918918918919	0.9210526315789473	73	16102	4	19	69	16083	16175	0.0953689229535735
M1	string	0	network_modules	206	TRUE	0.005069597900828473	74	23	4	0.17391304347826086	0.05405405405405406	GO:0043266	GO:BP	regulation of potassium ion transport	16175	10590		0.9459459459459459	0.9473684210526315	74	16101	4	19	70	16082	16175	0.09469071726424708
M1	string	0	network_modules	206	TRUE	0.007383560215916372	182	23	5	0.21739130434782608	0.027472527472527472	GO:0098739	GO:BP	import across plasma membrane	16175	18866		0.972972972972973	0.9736842105263158	182	15993	5	18	177	15975	16175	0.07374886504650395
M1	string	0	network_modules	206	TRUE	0.007553043285001973	24	23	3	0.13043478260869565	0.125	GO:0050891	GO:BP	multicellular organismal-level water homeostasis	16175	13335		1	1	24	16151	3	20	21	16131	16175	0.12641961913648028
M1	string	0	network_modules	207	TRUE	4.976411233361849e-4	66	15	4	0.26666666666666666	0.06060606060606061	REAC:R-HSA-1234176	REAC	Oxygen-dependent proline hydroxylation of Hypoxia-inducible Factor Alpha	10916	1655		0	0.5	66	10850	4	11	62	10839	10916	0.12470897699578327
M1	string	0	network_modules	207	TRUE	8.331525511283573e-4	75	15	4	0.26666666666666666	0.05333333333333334	REAC:R-HSA-1234174	REAC	Cellular response to hypoxia	10916	335		1	1	75	10841	4	11	71	10830	10916	0.11666569514577167
M1	string	0	network_modules	210	TRUE	6.772874312605154e-8	36	12	5	0.4166666666666667	0.1388888888888889	REAC:R-HSA-390522	REAC	Striated Muscle Contraction	10916	2356		0	0.5	36	10880	5	7	31	10873	10916	0.23918458003755771
M1	string	0	network_modules	210	TRUE	9.627645361645717e-6	203	12	6	0.5	0.029556650246305417	REAC:R-HSA-397014	REAC	Muscle contraction	10916	1496		1	1	203	10713	6	6	197	10707	10916	0.11821343867069786
M1	string	0	network_modules	210	TRUE	1.1872344474259014e-5	59	20	5	0.25	0.0847457627118644	GO:0030239	GO:BP	myofibril assembly	16175	6736		0	0.07142857142857142	59	16116	5	15	54	16101	16175	0.1437831390341632
M1	string	0	network_modules	210	TRUE	2.3126273472386536e-5	258	20	7	0.35	0.027131782945736434	GO:0006936	GO:BP	muscle contraction	16175	2575		0.07692307692307693	0.14285714285714285	258	15917	7	13	251	15904	16175	0.09381582837873566
M1	string	0	network_modules	210	TRUE	2.436166621531962e-5	414	20	8	0.4	0.01932367149758454	GO:0061061	GO:BP	muscle structure development	16175	15177		0.15384615384615385	0.21428571428571427	414	15761	8	12	406	15749	16175	0.08341714620706081
M1	string	0	network_modules	210	TRUE	6.986817467345256e-5	303	20	7	0.35	0.0231023102310231	GO:0003012	GO:BP	muscle system process	16175	1463		0.23076923076923078	0.2857142857142857	303	15872	7	13	296	15859	16175	0.08597008331732518
M1	string	0	network_modules	210	TRUE	8.972665090891862e-5	708	20	9	0.45	0.012711864406779662	GO:0030029	GO:BP	actin filament-based process	16175	6653		0.3076923076923077	0.35714285714285715	708	15467	9	11	699	15456	16175	0.06986453756132799
M1	string	0	network_modules	210	TRUE	1.1317582235405094e-4	34	20	4	0.2	0.11764705882352941	GO:0045214	GO:BP	sarcomere organization	16175	11327		0.38461538461538464	0.42857142857142855	34	16141	4	16	30	16125	16175	0.15203462719654293
M1	string	0	network_modules	210	TRUE	1.4085433027223983e-4	96	20	5	0.25	0.052083333333333336	GO:0010927	GO:BP	cellular component assembly involved in morphogenesis	16175	4511		0.46153846153846156	0.5714285714285714	96	16079	5	15	91	16064	16175	0.11180108666209096
M1	string	0	network_modules	210	TRUE	1.4085433027223983e-4	96	20	5	0.25	0.052083333333333336	GO:0032989	GO:BP	cellular anatomical entity morphogenesis	16175	7969		0.46153846153846156	0.5714285714285714	96	16079	5	15	91	16064	16175	0.11180108666209096
M1	string	0	network_modules	210	TRUE	2.0063787619028345e-4	103	20	5	0.25	0.04854368932038835	GO:0055002	GO:BP	striated muscle cell development	16175	14191		0.6153846153846154	0.6428571428571429	103	16072	5	15	98	16057	16175	0.10776725644410307
M1	string	0	network_modules	210	TRUE	3.963632993058707e-4	118	20	5	0.25	0.0423728813559322	GO:0055001	GO:BP	muscle cell development	16175	14190		0.6923076923076923	0.7142857142857143	118	16057	5	15	113	16042	16175	0.10034851469500546
M1	string	0	network_modules	210	TRUE	0.002644355949331062	173	20	5	0.25	0.028901734104046242	GO:0031032	GO:BP	actomyosin structure organization	16175	7004		0.7692307692307693	0.7857142857142857	173	16002	5	15	168	15987	16175	0.08185523402922705
M1	string	0	network_modules	210	TRUE	0.0027983137957623737	175	20	5	0.25	0.02857142857142857	GO:0051146	GO:BP	striated muscle cell differentiation	16175	13529		0.8461538461538461	0.8571428571428571	175	16000	5	15	170	15985	16175	0.0813491777041178
M1	string	0	network_modules	210	TRUE	0.0033936772581031646	182	20	5	0.25	0.027472527472527472	GO:0007517	GO:BP	muscle organ development	16175	2999		0.9230769230769231	0.9285714285714286	182	15993	5	15	177	15978	16175	0.07964252293516273
M1	string	0	network_modules	210	TRUE	0.009827327590554106	632	20	7	0.35	0.011075949367088608	GO:0030036	GO:BP	actin cytoskeleton organization	16175	6660		1	1	632	15543	7	13	625	15530	16175	0.0564597276149367
M1	string	0	network_modules	211	TRUE	1.9666134486504575e-8	193	10	7	0.7	0.03626943005181347	KEGG:04814	KEGG	Motor proteins	8484	366		0	0.1	193	8291	7	3	186	8288	8484	0.1560357680728648
M1	string	0	network_modules	211	TRUE	8.575040597394151e-8	116	20	7	0.35	0.0603448275862069	GO:0006937	GO:BP	regulation of muscle contraction	16175	2576		0	0.05263157894736842	116	16059	7	13	109	16046	16175	0.14295337183121856
M1	string	0	network_modules	211	TRUE	6.354119421375748e-7	154	20	7	0.35	0.045454545454545456	GO:0090257	GO:BP	regulation of muscle system process	16175	18146		0.05555555555555555	0.10526315789473684	154	16021	7	13	147	16008	16175	0.12336476552393862
M1	string	0	network_modules	211	TRUE	2.1028562890882786e-6	93	10	5	0.5	0.053763440860215055	KEGG:04520	KEGG	Adherens junction	8484	316		0.1111111111111111	0.2	93	8391	5	5	88	8386	8484	0.16134327575126522
M1	string	0	network_modules	211	TRUE	9.627645361645717e-6	203	12	6	0.5	0.029556650246305417	REAC:R-HSA-397014	REAC	Muscle contraction	10916	1496		0	0.3333333333333333	203	10713	6	6	197	10707	10916	0.11821343867069786
M1	string	0	network_modules	211	TRUE	2.3126273472386536e-5	258	20	7	0.35	0.027131782945736434	GO:0006936	GO:BP	muscle contraction	16175	2575		0.1111111111111111	0.15789473684210525	258	15917	7	13	251	15904	16175	0.09381582837873566
M1	string	0	network_modules	211	TRUE	6.986817467345256e-5	303	20	7	0.35	0.0231023102310231	GO:0003012	GO:BP	muscle system process	16175	1463		0.16666666666666666	0.21052631578947367	303	15872	7	13	296	15859	16175	0.08597008331732518
M1	string	0	network_modules	211	TRUE	1.276779561090346e-4	35	20	4	0.2	0.11428571428571428	GO:0055010	GO:BP	ventricular cardiac muscle tissue morphogenesis	16175	14199		0.2222222222222222	0.2631578947368421	35	16140	4	16	31	16124	16175	0.14980479257980603
M1	string	0	network_modules	211	TRUE	1.9628338441116398e-4	97	10	4	0.4	0.041237113402061855	KEGG:05410	KEGG	Hypertrophic cardiomyopathy	8484	489		0.2222222222222222	0.3	97	8387	4	6	93	8381	8484	0.12555465985409295
M1	string	0	network_modules	211	TRUE	2.4005326483272007e-4	102	10	4	0.4	0.0392156862745098	KEGG:05414	KEGG	Dilated cardiomyopathy	8484	491		0.3333333333333333	0.4	102	8382	4	6	98	8376	8484	0.12228942689311534
M1	string	0	network_modules	211	TRUE	2.457720188151276e-4	41	20	4	0.2	0.0975609756097561	GO:0003229	GO:BP	ventricular cardiac muscle tissue development	16175	1659		0.2777777777777778	0.3157894736842105	41	16134	4	16	37	16118	16175	0.13817627281659906
M1	string	0	network_modules	211	TRUE	3.286716547135475e-4	44	20	4	0.2	0.09090909090909091	GO:0055008	GO:BP	cardiac muscle tissue morphogenesis	16175	14197		0.3333333333333333	0.3684210526315789	44	16131	4	16	40	16115	16175	0.13326967450420388
M1	string	0	network_modules	211	TRUE	3.332006609517924e-4	381	20	7	0.35	0.01837270341207349	GO:0044057	GO:BP	regulation of system process	16175	10893		0.3888888888888889	0.42105263157894735	381	15794	7	13	374	15781	16175	0.07573688644018782
M1	string	0	network_modules	211	TRUE	3.74370417860631e-4	114	10	4	0.4	0.03508771929824561	KEGG:04670	KEGG	Leukocyte transendothelial migration	8484	343		0.4444444444444444	0.5	114	8370	4	6	110	8364	8484	0.11533509913239752
M1	string	0	network_modules	211	TRUE	5.109520732725684e-4	49	20	4	0.2	0.08163265306122448	GO:0048644	GO:BP	muscle organ morphogenesis	16175	12902		0.4444444444444444	0.5263157894736842	49	16126	4	16	45	16110	16175	0.12610895309641054
M1	string	0	network_modules	211	TRUE	5.109520732725684e-4	49	20	4	0.2	0.08163265306122448	GO:0060415	GO:BP	muscle tissue morphogenesis	16175	14616		0.4444444444444444	0.5263157894736842	49	16126	4	16	45	16110	16175	0.12610895309641054
M1	string	0	network_modules	211	TRUE	7.039305106944525e-4	53	20	4	0.2	0.07547169811320754	GO:0003208	GO:BP	cardiac ventricle morphogenesis	16175	1638		0.5555555555555556	0.5789473684210527	53	16122	4	16	49	16106	16175	0.1211195639858134
M1	string	0	network_modules	211	TRUE	0.0015023451919805011	708	20	8	0.4	0.011299435028248588	GO:0030029	GO:BP	actin filament-based process	16175	6653		0.6111111111111112	0.631578947368421	708	15467	8	12	700	15455	16175	0.061265375402864496
M1	string	0	network_modules	211	TRUE	0.0019171105564017897	18	20	3	0.15	0.16666666666666666	GO:0002026	GO:BP	regulation of the force of heart contraction	16175	628		0.6666666666666666	0.6842105263157895	18	16157	3	17	15	16140	16175	0.15712542687316935
M1	string	0	network_modules	211	TRUE	0.0021134394013098625	36	12	3	0.25	0.08333333333333333	REAC:R-HSA-390522	REAC	Striated Muscle Contraction	10916	2356		0.5	0.6666666666666666	36	10880	3	9	33	10871	10916	0.14274744937012845
M1	string	0	network_modules	211	TRUE	0.002644355949331062	173	20	5	0.25	0.028901734104046242	GO:0031032	GO:BP	actomyosin structure organization	16175	7004		0.7222222222222222	0.7368421052631579	173	16002	5	15	168	15987	16175	0.08185523402922705
M1	string	0	network_modules	211	TRUE	0.0030284577432423045	76	20	4	0.2	0.05263157894736842	GO:0003231	GO:BP	cardiac ventricle development	16175	1661		0.7777777777777778	0.7894736842105263	76	16099	4	16	72	16083	16175	0.1004858466941227
M1	string	0	network_modules	211	TRUE	0.003361735675362324	78	20	4	0.2	0.05128205128205128	GO:0006942	GO:BP	regulation of striated muscle contraction	16175	2580		0.8333333333333334	0.8421052631578947	78	16097	4	16	74	16081	16175	0.09913256082814248
M1	string	0	network_modules	211	TRUE	0.0035918603892072624	202	10	4	0.4	0.019801980198019802	KEGG:04510	KEGG	Focal adhesion	8484	313		0.5555555555555556	0.6	202	8282	4	6	198	8276	8484	0.08476585145316887
M1	string	0	network_modules	211	TRUE	0.003637130098314877	43	12	3	0.25	0.06976744186046512	REAC:R-HSA-445355	REAC	Smooth Muscle Contraction	10916	2336		1	1	43	10873	3	9	40	10864	10916	0.13031511395583956
M1	string	0	network_modules	211	TRUE	0.004313685359797789	83	20	4	0.2	0.04819277108433735	GO:0003206	GO:BP	cardiac chamber morphogenesis	16175	1636		0.8888888888888888	0.8947368421052632	83	16092	4	16	79	16076	16175	0.09596296705258629
M1	string	0	network_modules	211	TRUE	0.005665122223161564	227	10	4	0.4	0.01762114537444934	KEGG:04810	KEGG	Regulation of actin cytoskeleton	8484	365		0.6666666666666666	0.7	227	8257	4	6	223	8251	8484	0.07945567229855248
M1	string	0	network_modules	211	TRUE	0.0072801886596020595	87	10	3	0.3	0.034482758620689655	KEGG:04260	KEGG	Cardiac muscle contraction	8484	296		0.7777777777777778	0.8	87	8397	3	7	84	8390	8484	0.09879871170519594
M1	string	0	network_modules	211	TRUE	0.0077444064853106325	246	10	4	0.4	0.016260162601626018	KEGG:05131	KEGG	Shigellosis	8484	428		0.8888888888888888	0.9	246	8238	4	6	242	8232	8484	0.07595508593727616
M1	string	0	network_modules	211	TRUE	0.008117508515475134	249	10	4	0.4	0.01606425702811245	KEGG:05132	KEGG	Salmonella infection	8484	429		1	1	249	8235	4	6	245	8229	8484	0.07543791992598209
M1	string	0	network_modules	211	TRUE	0.00837929822998974	98	20	4	0.2	0.04081632653061224	GO:0003205	GO:BP	cardiac chamber development	16175	1635		0.9444444444444444	0.9473684210526315	98	16077	4	16	94	16061	16175	0.08793474157835751
M1	string	0	network_modules	211	TRUE	0.009827327590554106	632	20	7	0.35	0.011075949367088608	GO:0030036	GO:BP	actin cytoskeleton organization	16175	6660		1	1	632	15543	7	13	625	15530	16175	0.0564597276149367
M1	string	0	network_modules	212	TRUE	1.1046729596474314e-10	41	10	6	0.6	0.14634146341463414	KEGG:03440	KEGG	Homologous recombination	8484	240		NA	1	41	8443	6	4	35	8439	8484	0.29481883307803824
M1	string	0	network_modules	212	TRUE	7.691651129354455e-10	36	14	6	0.42857142857142855	0.16666666666666666	REAC:R-HSA-5689901	REAC	Metalloprotease DUBs	10916	1444		0	0.07692307692307693	36	10880	6	8	30	10872	10916	0.2658135386100492
M1	string	0	network_modules	212	TRUE	3.337362714254371e-8	47	21	6	0.2857142857142857	0.1276595744680851	GO:0044818	GO:BP	mitotic G2/M transition checkpoint	16175	11174		0	0.03225806451612903	47	16128	6	15	41	16113	16175	0.18943807517533165
M1	string	0	network_modules	212	TRUE	1.3871108602495348e-7	59	21	6	0.2857142857142857	0.1016949152542373	GO:0010972	GO:BP	negative regulation of G2/M transition of mitotic cell cycle	16175	4548		0.03333333333333333	0.06451612903225806	59	16116	6	15	53	16101	16175	0.1686984340281311
M1	string	0	network_modules	212	TRUE	1.7066460842902884e-7	61	21	6	0.2857142857142857	0.09836065573770492	GO:1902750	GO:BP	negative regulation of cell cycle G2/M phase transition	16175	22476		0.06666666666666667	0.0967741935483871	61	16114	6	15	55	16099	16175	0.1658474005287631
M1	string	0	network_modules	212	TRUE	3.0996873681906147e-7	94	14	6	0.42857142857142855	0.06382978723404255	REAC:R-HSA-69473	REAC	G2/M DNA damage checkpoint	10916	1006		0.08333333333333333	0.15384615384615385	94	10822	6	8	88	10814	10916	0.16287893255764846
M1	string	0	network_modules	212	TRUE	3.754797334430952e-7	97	14	6	0.42857142857142855	0.061855670103092786	REAC:R-HSA-5693607	REAC	Processing of DNA double-strand break ends	10916	1798		0.16666666666666666	0.23076923076923078	97	10819	6	8	91	10811	10916	0.1602576902514683
M1	string	0	network_modules	212	TRUE	5.397167868638822e-7	31	21	5	0.23809523809523808	0.16129032258064516	GO:0007095	GO:BP	mitotic G2 DNA damage checkpoint signaling	16175	2678		0.1	0.12903225806451613	31	16144	5	16	26	16128	16175	0.19470100994265238
M1	string	0	network_modules	212	TRUE	1.4165584874826402e-6	86	21	6	0.2857142857142857	0.06976744186046512	GO:0010389	GO:BP	regulation of G2/M transition of mitotic cell cycle	16175	4098		0.13333333333333333	0.16129032258064516	86	16089	6	15	80	16074	16175	0.1390190089818859
M1	string	0	network_modules	212	TRUE	2.4332514325092596e-6	132	14	6	0.42857142857142855	0.045454545454545456	REAC:R-HSA-5693567	REAC	HDR through Homologous Recombination (HRR) or Single Strand Annealing (SSA)	10916	1098		0.25	0.3076923076923077	132	10784	6	8	126	10776	10916	0.13654969975789738
M1	string	0	network_modules	212	TRUE	3.141270449705253e-6	98	21	6	0.2857142857142857	0.061224489795918366	GO:1902749	GO:BP	regulation of cell cycle G2/M phase transition	16175	22475		0.16666666666666666	0.1935483870967742	98	16077	6	15	92	16062	16175	0.12993369868138693
M1	string	0	network_modules	212	TRUE	3.1810557392954544e-6	138	14	6	0.42857142857142855	0.043478260869565216	REAC:R-HSA-5693538	REAC	Homology Directed Repair	10916	1130		0.3333333333333333	0.38461538461538464	138	10778	6	8	132	10770	10916	0.13340910771406378
M1	string	0	network_modules	212	TRUE	4.8695661021386305e-6	68	14	5	0.35714285714285715	0.07352941176470588	REAC:R-HSA-5693571	REAC	Nonhomologous End-Joining (NHEJ)	10916	1605		0.4166666666666667	0.46153846153846156	68	10848	5	9	63	10839	10916	0.15982517896460968
M1	string	0	network_modules	212	TRUE	7.85773035084007e-6	114	21	6	0.2857142857142857	0.05263157894736842	GO:0000086	GO:BP	G2/M transition of mitotic cell cycle	16175	34		0.2	0.22580645161290322	114	16061	6	15	108	16046	16175	0.12010462860809469
M1	string	0	network_modules	212	TRUE	9.172572930624848e-6	77	14	5	0.35714285714285715	0.06493506493506493	REAC:R-HSA-5693565	REAC	Recruitment and ATM-mediated phosphorylation of repair and signaling proteins at DNA double strand breaks	10916	1949		0.5	0.5384615384615384	77	10839	5	9	72	10830	10916	0.1499039026646331
M1	string	0	network_modules	212	TRUE	9.794065857878744e-6	78	14	5	0.35714285714285715	0.0641025641025641	REAC:R-HSA-5693606	REAC	DNA Double Strand Break Response	10916	442		0.5833333333333334	0.6153846153846154	78	10838	5	9	73	10829	10916	0.148907776196502
M1	string	0	network_modules	212	TRUE	1.0000022790154318e-5	167	14	6	0.42857142857142855	0.03592814371257485	REAC:R-HSA-69481	REAC	G2/M Checkpoints	10916	1005		0.6666666666666666	0.6923076923076923	167	10749	6	8	161	10741	10916	0.12066157648290284
M1	string	0	network_modules	212	TRUE	1.0363805106087966e-5	168	14	6	0.42857142857142855	0.03571428571428571	REAC:R-HSA-5693532	REAC	DNA Double-Strand Break Repair	10916	443		0.75	0.7692307692307693	168	10748	6	8	162	10740	10916	0.12028085688510744
M1	string	0	network_modules	212	TRUE	1.5802189550543043e-5	128	21	6	0.2857142857142857	0.046875	GO:0044839	GO:BP	cell cycle G2/M phase transition	16175	11188		0.23333333333333334	0.25806451612903225	128	16047	6	15	122	16032	16175	0.11304348540501108
M1	string	0	network_modules	212	TRUE	2.0813658470208466e-5	134	21	6	0.2857142857142857	0.04477611940298507	GO:0007093	GO:BP	mitotic cell cycle checkpoint signaling	16175	2676		0.26666666666666666	0.2903225806451613	134	16041	6	15	128	16026	16175	0.11035678461434942
M1	string	0	network_modules	212	TRUE	5.79778867311766e-5	159	21	6	0.2857142857142857	0.03773584905660377	GO:1901991	GO:BP	negative regulation of mitotic cell cycle phase transition	16175	21924		0.3	0.3225806451612903	159	16016	6	15	153	16001	16175	0.10082431809791796
M1	string	0	network_modules	212	TRUE	6.041992609148977e-5	77	21	5	0.23809523809523808	0.06493506493506493	GO:0044773	GO:BP	mitotic DNA damage checkpoint signaling	16175	11149		0.3333333333333333	0.3548387096774194	77	16098	5	16	72	16082	16175	0.12222557762668497
M1	string	0	network_modules	212	TRUE	7.809286431543705e-5	81	21	5	0.23809523809523808	0.06172839506172839	GO:0044774	GO:BP	mitotic DNA integrity checkpoint signaling	16175	11150		0.36666666666666664	0.3870967741935484	81	16094	5	16	76	16078	16175	0.11905794775456402
M1	string	0	network_modules	212	TRUE	1.0619244706697872e-4	176	21	6	0.2857142857142857	0.03409090909090909	GO:0000075	GO:BP	cell cycle checkpoint signaling	16175	26		0.4	0.41935483870967744	176	15999	6	15	170	15984	16175	0.09551695992040522
M1	string	0	network_modules	212	TRUE	1.3296121695642262e-4	90	21	5	0.23809523809523808	0.05555555555555555	GO:0010212	GO:BP	response to ionizing radiation	16175	3993		0.43333333333333335	0.45161290322580644	90	16085	5	16	85	16069	16175	0.11271018133552506
M1	string	0	network_modules	212	TRUE	2.1735922098437615e-4	338	21	7	0.3333333333333333	0.020710059171597635	GO:0045786	GO:BP	negative regulation of cell cycle	16175	11618		0.4666666666666667	0.4838709677419355	338	15837	7	14	331	15823	16175	0.07875559058715086
M1	string	0	network_modules	212	TRUE	2.404037242156945e-4	202	21	6	0.2857142857142857	0.0297029702970297	GO:0045930	GO:BP	negative regulation of mitotic cell cycle	16175	11724		0.5	0.5161290322580645	202	15973	6	15	196	15958	16175	0.08870881882946514
M1	string	0	network_modules	212	TRUE	2.582470928967778e-4	289	14	6	0.42857142857142855	0.020761245674740483	REAC:R-HSA-69620	REAC	Cell Cycle Checkpoints	10916	321		0.8333333333333334	0.8461538461538461	289	10627	6	8	283	10619	10916	0.08975331930767373
M1	string	0	network_modules	212	TRUE	3.091220659141298e-4	298	14	6	0.42857142857142855	0.020134228187919462	REAC:R-HSA-5688426	REAC	Deubiquitination	10916	736		0.9166666666666666	0.9230769230769231	298	10618	6	8	292	10610	10916	0.08824373378014112
M1	string	0	network_modules	212	TRUE	4.3539829261923503e-4	114	21	5	0.23809523809523808	0.043859649122807015	GO:0000077	GO:BP	DNA damage checkpoint signaling	16175	28		0.5333333333333333	0.5483870967741935	114	16061	5	16	109	16045	16175	0.09958091782657073
M1	string	0	network_modules	212	TRUE	4.424712114866042e-4	224	21	6	0.2857142857142857	0.026785714285714284	GO:1901988	GO:BP	negative regulation of cell cycle phase transition	16175	21921		0.5666666666666667	0.5806451612903226	224	15951	6	15	218	15936	16175	0.08387845748445712
M1	string	0	network_modules	212	TRUE	5.513797773308097e-4	329	14	6	0.42857142857142855	0.0182370820668693	REAC:R-HSA-73894	REAC	DNA Repair	10916	444		1	1	329	10587	6	8	323	10579	10916	0.08351114954356362
M1	string	0	network_modules	212	TRUE	6.360823427079727e-4	123	21	5	0.23809523809523808	0.04065040650406504	GO:0031570	GO:BP	DNA integrity checkpoint signaling	16175	7220		0.6	0.6129032258064516	123	16052	5	16	118	16036	16175	0.0956644479212831
M1	string	0	network_modules	212	TRUE	7.459468504421486e-4	127	21	5	0.23809523809523808	0.03937007874015748	GO:0045739	GO:BP	positive regulation of DNA repair	16175	11579		0.6333333333333333	0.6451612903225806	127	16048	5	16	122	16032	16175	0.09405657819362959
M1	string	0	network_modules	212	TRUE	0.0011097973496928186	262	21	6	0.2857142857142857	0.022900763358778626	GO:0010948	GO:BP	negative regulation of cell cycle process	16175	4526		0.6666666666666666	0.6774193548387096	262	15913	6	15	256	15898	16175	0.07697904115512313
M1	string	0	network_modules	212	TRUE	0.001850856556179973	286	21	6	0.2857142857142857	0.02097902097902098	GO:1901990	GO:BP	regulation of mitotic cell cycle phase transition	16175	21923		0.7	0.7096774193548387	286	15889	6	15	280	15874	16175	0.07332808517965095
M1	string	0	network_modules	212	TRUE	0.0023507862777230287	298	21	6	0.2857142857142857	0.020134228187919462	GO:0006302	GO:BP	double-strand break repair	16175	2109		0.7333333333333333	0.7419354838709677	298	15877	6	15	292	15862	16175	0.07166474203754128
M1	string	0	network_modules	212	TRUE	0.003344084823733576	172	21	5	0.23809523809523808	0.029069767441860465	GO:0042770	GO:BP	signal transduction in response to DNA damage	16175	10355		0.7666666666666667	0.7741935483870968	172	16003	5	16	167	15987	16175	0.07995708532311561
M1	string	0	network_modules	212	TRUE	0.0036338352675194347	21	21	3	0.14285714285714285	0.14285714285714285	GO:0140861	GO:BP	DNA repair-dependent chromatin remodeling	16175	19904		0.8	0.8064516129032258	21	16154	3	18	18	16136	16175	0.14174286775500097
M1	string	0	network_modules	212	TRUE	0.004358332157058758	528	21	7	0.3333333333333333	0.013257575757575758	GO:0006281	GO:BP	DNA repair	16175	2095		0.8333333333333334	0.8387096774193549	528	15647	7	14	521	15633	16175	0.06100998360482883
M1	string	0	network_modules	212	TRUE	0.005400838084656259	792	21	8	0.38095238095238093	0.010101010101010102	GO:0000278	GO:BP	mitotic cell cycle	16175	76		0.8666666666666667	0.8709677419354839	792	15383	8	13	784	15370	16175	0.05546935049020024
M1	string	0	network_modules	212	TRUE	0.006263121718363735	25	21	3	0.14285714285714285	0.12	GO:0070536	GO:BP	protein K63-linked deubiquitination	16175	16169		0.9	0.9032258064516129	25	16150	3	18	22	16132	16175	0.1296985984599606
M1	string	0	network_modules	212	TRUE	0.008208230084552747	370	21	6	0.2857142857142857	0.016216216216216217	GO:0044772	GO:BP	mitotic cell cycle phase transition	16175	11148		0.9333333333333333	0.9354838709677419	370	15805	6	15	364	15790	16175	0.06338790273181531
M1	string	0	network_modules	212	TRUE	0.008283610317520689	207	21	5	0.23809523809523808	0.024154589371980676	GO:0006282	GO:BP	regulation of DNA repair	16175	2096		0.9666666666666667	0.967741935483871	207	15968	5	16	202	15952	16175	0.0722703640130679
M1	string	0	network_modules	212	TRUE	0.009002203474778567	376	21	6	0.2857142857142857	0.015957446808510637	GO:1901987	GO:BP	regulation of cell cycle phase transition	16175	21920		1	1	376	15799	6	15	370	15784	16175	0.06280329422888366
M1	string	0	network_modules	213	TRUE	2.9742366987012964e-4	15	15	3	0.2	0.2	REAC:R-HSA-71336	REAC	Pentose phosphate pathway	10916	1721		NA	1	15	10901	3	12	12	10889	10916	0.19889918356114117
M1	string	0	network_modules	213	TRUE	5.591377148325997e-4	31	12	3	0.25	0.0967741935483871	KEGG:00030	KEGG	Pentose phosphate pathway	8484	4		NA	1	31	8453	3	9	28	8444	8484	0.1536588767568576
M1	string	0	network_modules	213	TRUE	0.002651933779897005	19	21	3	0.14285714285714285	0.15789473684210525	GO:0006098	GO:BP	pentose-phosphate shunt	16175	1958		0	0.3333333333333333	19	16156	3	18	16	16138	16175	0.1491373278339042
M1	string	0	network_modules	213	TRUE	0.004204086732519456	22	21	3	0.14285714285714285	0.13636363636363635	GO:0006740	GO:BP	NADPH regeneration	16175	2439		0.5	0.6666666666666666	22	16153	3	18	19	16135	16175	0.13842777919895227
M1	string	0	network_modules	213	TRUE	0.00889854498437559	28	21	3	0.14285714285714285	0.10714285714285714	GO:0051156	GO:BP	glucose 6-phosphate metabolic process	16175	13539		1	1	28	16147	3	18	25	16129	16175	0.12240417370554593
M1	string	0	network_modules	214	TRUE	9.584757416498403e-7	298	16	8	0.5	0.026845637583892617	REAC:R-HSA-1474244	REAC	Extracellular matrix organization	10916	889		0	0.25	298	10618	8	8	290	10610	10916	0.11113911941823285
M1	string	0	network_modules	214	TRUE	1.6518815074675867e-5	6	16	3	0.1875	0.5	REAC:R-HSA-1566977	REAC	Fibronectin matrix formation	10916	941		0.3333333333333333	0.5	6	10910	3	13	3	10897	10916	0.30559662038979246
M1	string	0	network_modules	214	TRUE	3.1336959295626584e-5	84	16	5	0.3125	0.05952380952380952	REAC:R-HSA-216083	REAC	Integrin cell surface interactions	10916	1216		0.6666666666666666	0.75	84	10832	5	11	79	10821	10916	0.13364053555987643
M1	string	0	network_modules	214	TRUE	5.8860891353014594e-5	191	16	6	0.375	0.031413612565445025	REAC:R-HSA-202733	REAC	Cell surface interactions at the vascular wall	10916	327		1	1	191	10725	6	10	185	10715	10916	0.10446584464340511
M1	string	0	network_modules	214	TRUE	8.026622891497808e-4	52	21	4	0.19047619047619047	0.07692307692307693	GO:0007157	GO:BP	heterophilic cell-cell adhesion via plasma membrane cell adhesion molecules	16175	2721		0	0.5	52	16123	4	17	48	16106	16175	0.11927171253120372
M1	string	0	network_modules	214	TRUE	0.005883735704816513	193	21	5	0.23809523809523808	0.025906735751295335	GO:0098742	GO:BP	cell-cell adhesion via plasma-membrane adhesion molecules	16175	18867		1	1	193	15982	5	16	188	15966	16175	0.0751003057610585
M1	string	0	network_modules	214	TRUE	0.009266053425802822	153	7	3	0.42857142857142855	0.0196078431372549	KEGG:04514	KEGG	Cell adhesion molecules	8484	315		NA	1	153	8331	3	4	150	8327	8484	0.08865171063950138
M1	string	0	network_modules	216	TRUE	0.005632197509640658	155	6	3	0.5	0.01935483870967742	KEGG:04150	KEGG	mTOR signaling pathway	8484	284		NA	1	155	8329	3	3	152	8326	8484	0.09569104044165659
M1	string	0	network_modules	217	TRUE	1.1751472527064295e-7	13	11	4	0.36363636363636365	0.3076923076923077	REAC:R-HSA-432047	REAC	Passive transport by Aquaporins	10916	1718		0	0.5	13	10903	4	7	9	10896	10916	0.3337682379912613
M1	string	0	network_modules	217	TRUE	1.6560767293169672e-5	20	22	4	0.18181818181818182	0.2	GO:0006833	GO:BP	water transport	16175	2504		0	0.25	20	16155	4	18	16	16137	16175	0.18964190325095334
M1	string	0	network_modules	217	TRUE	3.0186603071835978e-5	23	22	4	0.18181818181818182	0.17391304347826086	GO:0042044	GO:BP	fluid transport	16175	9936		0.3333333333333333	0.5	23	16152	4	18	19	16134	16175	0.17667676148943728
M1	string	0	network_modules	217	TRUE	4.361207303889695e-5	52	11	4	0.36363636363636365	0.07692307692307693	REAC:R-HSA-445717	REAC	Aquaporin-mediated transport	10916	164		1	1	52	10864	4	7	48	10857	10916	0.1655354155377982
M1	string	0	network_modules	217	TRUE	1.0292588478150545e-4	7	22	3	0.13636363636363635	0.42857142857142855	GO:0015793	GO:BP	glycerol transmembrane transport	16175	4907		0.6666666666666666	0.75	7	16168	3	19	4	16149	16175	0.24119592085972666
M1	string	0	network_modules	217	TRUE	2.465870052445487e-4	9	22	3	0.13636363636363635	0.3333333333333333	GO:0015791	GO:BP	polyol transmembrane transport	16175	4905		1	1	9	16166	3	19	6	16147	16175	0.21253446069585727
M1	string	0	network_modules	218	TRUE	3.741343728890259e-36	141	23	21	0.9130434782608695	0.14893617021276595	REAC:R-HSA-3214847	REAC	HATs acetylate histones	10916	1087		0	0.125	141	10775	21	2	120	10773	10916	0.36630185818597605
M1	string	0	network_modules	218	TRUE	7.195005622404789e-30	271	23	21	0.9130434782608695	0.07749077490774908	REAC:R-HSA-4839726	REAC	Chromatin organization	10916	356		0.14285714285714285	0.375	271	10645	21	2	250	10643	10916	0.2623104288006001
M1	string	0	network_modules	218	TRUE	7.195005622404789e-30	271	23	21	0.9130434782608695	0.07749077490774908	REAC:R-HSA-3247509	REAC	Chromatin modifying enzymes	10916	355		0.14285714285714285	0.375	271	10645	21	2	250	10643	10916	0.2623104288006001
M1	string	0	network_modules	218	TRUE	6.094404901494652e-24	175	23	16	0.6956521739130435	0.09142857142857143	GO:0043484	GO:BP	regulation of RNA splicing	16175	10730		0	0.058823529411764705	175	16000	16	7	159	15993	16175	0.24980476809149602
M1	string	0	network_modules	218	TRUE	9.881749227041021e-23	207	23	16	0.6956521739130435	0.07729468599033816	GO:0006282	GO:BP	regulation of DNA repair	16175	2096		0.0625	0.11764705882352941	207	15968	16	7	191	15961	16175	0.22925187103094563
M1	string	0	network_modules	218	TRUE	2.1104604001373988e-19	437	23	17	0.7391304347826086	0.038901601830663615	GO:0080135	GO:BP	regulation of cellular response to stress	16175	17817		0.125	0.17647058823529413	437	15738	17	6	420	15732	16175	0.165740537808573
M1	string	0	network_modules	218	TRUE	4.083468182767644e-18	397	23	16	0.6956521739130435	0.04030226700251889	GO:0008380	GO:BP	RNA splicing	16175	3186		0.1875	0.23529411764705882	397	15778	16	7	381	15771	16175	0.16366895953908867
M1	string	0	network_modules	218	TRUE	1.7827219157086965e-17	435	23	16	0.6956521739130435	0.0367816091954023	GO:0051052	GO:BP	regulation of DNA metabolic process	16175	13462		0.25	0.29411764705882354	435	15740	16	7	419	15733	16175	0.15599748068646382
M1	string	0	network_modules	218	TRUE	1.5452827506329468e-16	17	23	8	0.34782608695652173	0.47058823529411764	GO:0090043	GO:BP	regulation of tubulin deacetylation	16175	17974		0.3125	0.35294117647058826	17	16158	8	15	9	16143	16175	0.4038542664704269
M1	string	0	network_modules	218	TRUE	3.999906359750718e-16	528	23	16	0.6956521739130435	0.030303030303030304	GO:0006281	GO:BP	DNA repair	16175	2095		0.375	0.4117647058823529	528	15647	16	7	512	15640	16175	0.1407933397018286
M1	string	0	network_modules	218	TRUE	7.987569965266603e-16	20	23	8	0.34782608695652173	0.4	GO:0090042	GO:BP	tubulin deacetylation	16175	17973		0.4375	0.47058823529411764	20	16155	8	15	12	16140	16175	0.37217064565851893
M1	string	0	network_modules	218	TRUE	4.648137162034713e-15	24	23	8	0.34782608695652173	0.3333333333333333	GO:0090311	GO:BP	regulation of protein deacetylation	16175	18191		0.5	0.5294117647058824	24	16151	8	15	16	16136	16175	0.3395433907926794
M1	string	0	network_modules	218	TRUE	5.965440462098673e-15	798	23	17	0.7391304347826086	0.021303258145363407	GO:0006974	GO:BP	DNA damage response	16175	2601		0.5625	0.5882352941176471	798	15377	17	6	781	15371	16175	0.120192638539311
M1	string	0	network_modules	218	TRUE	3.840393578359297e-13	39	23	8	0.34782608695652173	0.20512820512820512	GO:0006476	GO:BP	protein deacetylation	16175	2213		0.625	0.6470588235294118	39	16136	8	15	31	16121	16175	0.26576999585285066
M1	string	0	network_modules	218	TRUE	1.949951635493136e-12	47	23	8	0.34782608695652173	0.1702127659574468	GO:0035601	GO:BP	protein deacylation	16175	9110		0.6875	0.7647058823529411	47	16128	8	15	39	16113	16175	0.24181025171579604
M1	string	0	network_modules	218	TRUE	1.949951635493136e-12	47	23	8	0.34782608695652173	0.1702127659574468	GO:0098732	GO:BP	macromolecule deacylation	16175	18861		0.6875	0.7647058823529411	47	16128	8	15	39	16113	16175	0.24181025171579604
M1	string	0	network_modules	218	TRUE	2.967577627766343e-12	41	23	8	0.34782608695652173	0.1951219512195122	REAC:R-HSA-9917777	REAC	Epigenetic regulation by WDR5-containing histone modifying complexes	10916	850		0.42857142857142855	0.625	41	10875	8	15	33	10860	10916	0.2584604562230308
M1	string	0	network_modules	218	TRUE	2.967577627766343e-12	41	23	8	0.34782608695652173	0.1951219512195122	REAC:R-HSA-9772755	REAC	Formation of WDR5-containing histone-modifying complexes	10916	952		0.42857142857142855	0.625	41	10875	8	15	33	10860	10916	0.2584604562230308
M1	string	0	network_modules	218	TRUE	5.0914664469611474e-11	69	23	8	0.34782608695652173	0.11594202898550725	GO:0045995	GO:BP	regulation of embryonic development	16175	11787		0.8125	0.8235294117647058	69	16106	8	15	61	16091	16175	0.1989205104075651
M1	string	0	network_modules	218	TRUE	1.0005816895647518e-8	131	23	8	0.34782608695652173	0.061068702290076333	GO:0051302	GO:BP	regulation of cell division	16175	13633		0.875	0.8823529411764706	131	16044	8	15	123	16029	16175	0.1430320488927168
M1	string	0	network_modules	218	TRUE	7.592161548184668e-7	185	23	8	0.34782608695652173	0.043243243243243246	REAC:R-HSA-212165	REAC	Epigenetic regulation of gene expression	10916	852		0.7142857142857143	0.75	185	10731	8	15	177	10716	10916	0.11779212669462753
M1	string	0	network_modules	218	TRUE	2.80506565062024e-6	265	23	8	0.34782608695652173	0.03018867924528302	GO:0051301	GO:BP	cell division	16175	13632		0.9375	0.9411764705882353	265	15910	8	15	257	15895	16175	0.09852480631105372
M1	string	0	network_modules	218	TRUE	3.0884215493143154e-6	221	23	8	0.34782608695652173	0.03619909502262444	REAC:R-HSA-5689880	REAC	Ub-specific processing proteases	10916	2617		0.8571428571428571	0.875	221	10695	8	15	213	10680	10916	0.10687725815458152
M1	string	0	network_modules	218	TRUE	3.8252668350318185e-6	43	9	4	0.4444444444444444	0.09302325581395349	KEGG:03022	KEGG	Basal transcription factors	8484	213		NA	1	43	8441	4	5	39	8436	8484	0.2016309951266283
M1	string	0	network_modules	218	TRUE	2.4799983403178728e-5	512	23	9	0.391304347826087	0.017578125	GO:0009790	GO:BP	embryo development	16175	3677		1	1	512	15663	9	14	503	15649	16175	0.07751813975057117
M1	string	0	network_modules	218	TRUE	3.1712934405052855e-5	298	23	8	0.34782608695652173	0.026845637583892617	REAC:R-HSA-5688426	REAC	Deubiquitination	10916	736		1	1	298	10618	8	15	290	10603	10916	0.09038334837342393
M1	string	0	network_modules	219	TRUE	1.9784003666116278e-42	18	22	16	0.7272727272727273	0.8888888888888888	REAC:R-HSA-8964315	REAC	G beta:gamma signalling through BTK	10916	991		0	0.016666666666666666	18	10898	16	6	2	10892	10916	0.8036797569632733
M1	string	0	network_modules	219	TRUE	1.2523376427448355e-41	19	22	16	0.7272727272727273	0.8421052631578947	REAC:R-HSA-392851	REAC	Prostacyclin signalling through prostacyclin receptor	10916	1809		0.01694915254237288	0.03333333333333333	19	10897	16	6	3	10891	10916	0.7821815642469986
M1	string	0	network_modules	219	TRUE	6.258443339938787e-41	20	22	16	0.7272727272727273	0.8	REAC:R-HSA-8964616	REAC	G beta:gamma signalling through CDC42	10916	992		0.03389830508474576	0.06666666666666667	20	10896	16	6	4	10890	10916	0.7623150029724765
M1	string	0	network_modules	219	TRUE	6.258443339938787e-41	20	22	16	0.7272727272727273	0.8	REAC:R-HSA-418217	REAC	G beta:gamma signalling through PLC beta	10916	994		0.03389830508474576	0.06666666666666667	20	10896	16	6	4	10890	10916	0.7623150029724765
M1	string	0	network_modules	219	TRUE	1.0899649848459885e-40	38	22	18	0.8181818181818182	0.47368421052631576	REAC:R-HSA-6814122	REAC	Cooperation of PDCL (PhLP1) and TRiC/CCT in G-protein beta folding	10916	410		0.06779661016949153	0.08333333333333333	38	10878	18	4	20	10874	10916	0.621602768827143
M1	string	0	network_modules	219	TRUE	2.6271839464183302e-40	21	22	16	0.7272727272727273	0.7619047619047619	REAC:R-HSA-500657	REAC	Presynaptic function of Kainate receptors	10916	1791		0.0847457627118644	0.1	21	10895	16	6	5	10889	10916	0.7438834582443106
M1	string	0	network_modules	219	TRUE	9.628015028466581e-40	22	22	16	0.7272727272727273	0.7272727272727273	REAC:R-HSA-392170	REAC	ADP signalling through P2Y purinoceptor 12	10916	13		0.1016949152542373	0.11666666666666667	22	10894	16	6	6	10888	10916	0.7267219653854499
M1	string	0	network_modules	219	TRUE	9.480635456175342e-39	24	22	16	0.7272727272727273	0.6666666666666666	REAC:R-HSA-428930	REAC	Thromboxane signalling through TP receptor	10916	2507		0.11864406779661017	0.16666666666666666	24	10892	16	6	8	10886	10916	0.6956713991550058
M1	string	0	network_modules	219	TRUE	9.480635456175342e-39	24	22	16	0.7272727272727273	0.6666666666666666	REAC:R-HSA-202040	REAC	G-protein activation	10916	996		0.11864406779661017	0.16666666666666666	24	10892	16	6	8	10886	10916	0.6956713991550058
M1	string	0	network_modules	219	TRUE	9.480635456175342e-39	24	22	16	0.7272727272727273	0.6666666666666666	REAC:R-HSA-418592	REAC	ADP signalling through P2Y purinoceptor 1	10916	12		0.11864406779661017	0.16666666666666666	24	10892	16	6	8	10886	10916	0.6956713991550058
M1	string	0	network_modules	219	TRUE	2.632144556651363e-38	25	22	16	0.7272727272727273	0.64	REAC:R-HSA-392451	REAC	G beta:gamma signalling through PI3Kgamma	10916	993		0.1694915254237288	0.18333333333333332	25	10891	16	6	9	10885	10916	0.6815611526054653
M1	string	0	network_modules	219	TRUE	3.913408685278183e-37	28	22	16	0.7272727272727273	0.5714285714285714	REAC:R-HSA-400042	REAC	Adrenaline,noradrenaline inhibits insulin secretion	10916	124		0.1864406779661017	0.2	28	10888	16	6	12	10882	10916	0.6438593057553944
M1	string	0	network_modules	219	TRUE	8.725384291060713e-37	29	22	16	0.7272727272727273	0.5517241379310345	REAC:R-HSA-997272	REAC	Inhibition  of voltage gated Ca2+ channels via Gbeta/gamma subunits	10916	1188		0.2033898305084746	0.25	29	10887	16	6	13	10881	10916	0.6326099765905413
M1	string	0	network_modules	219	TRUE	8.725384291060713e-37	29	22	16	0.7272727272727273	0.5517241379310345	REAC:R-HSA-1296059	REAC	G protein gated Potassium channels	10916	995		0.2033898305084746	0.25	29	10887	16	6	13	10881	10916	0.6326099765905413
M1	string	0	network_modules	219	TRUE	8.725384291060713e-37	29	22	16	0.7272727272727273	0.5517241379310345	REAC:R-HSA-1296041	REAC	Activation of G protein gated Potassium channels	10916	82		0.2033898305084746	0.25	29	10887	16	6	13	10881	10916	0.6326099765905413
M1	string	0	network_modules	219	TRUE	1.8687554706819125e-36	30	22	16	0.7272727272727273	0.5333333333333333	REAC:R-HSA-451326	REAC	Activation of kainate receptors upon glutamate binding	10916	102		0.2542372881355932	0.26666666666666666	30	10886	16	6	14	10880	10916	0.6219270497057675
M1	string	0	network_modules	219	TRUE	2.9672771697054643e-36	43	22	17	0.7727272727272727	0.3953488372093023	REAC:R-HSA-432040	REAC	Vasopressin regulates renal water homeostasis via Aquaporins	10916	2643		0.2711864406779661	0.2833333333333333	43	10873	17	5	26	10868	10916	0.5515424105993992
M1	string	0	network_modules	219	TRUE	3.860091390642378e-36	31	22	16	0.7272727272727273	0.5161290322580645	REAC:R-HSA-456926	REAC	Thrombin signalling through proteinase activated receptors (PARs)	10916	2506		0.288135593220339	0.3	31	10885	16	6	15	10879	10916	0.6117644825425549
M1	string	0	network_modules	219	TRUE	7.716178021733085e-36	32	22	16	0.7272727272727273	0.5	REAC:R-HSA-392518	REAC	Signal amplification	10916	2213		0.3050847457627119	0.3333333333333333	32	10884	16	6	16	10878	10916	0.6020813084449116
M1	string	0	network_modules	219	TRUE	7.716178021733085e-36	32	22	16	0.7272727272727273	0.5	REAC:R-HSA-397795	REAC	G-protein beta:gamma signalling	10916	997		0.3050847457627119	0.3333333333333333	32	10884	16	6	16	10878	10916	0.6020813084449116
M1	string	0	network_modules	219	TRUE	1.4970692646201393e-35	33	22	16	0.7272727272727273	0.48484848484848486	REAC:R-HSA-420092	REAC	Glucagon-type ligand receptors	10916	1050		0.3389830508474576	0.35	33	10883	16	6	17	10877	10916	0.5928409390968797
M1	string	0	network_modules	219	TRUE	5.203696585077721e-35	35	22	16	0.7272727272727273	0.45714285714285713	REAC:R-HSA-1296065	REAC	Inwardly rectifying K+ channels	10916	1271		0.3559322033898305	0.36666666666666664	35	10881	16	6	19	10875	10916	0.5755607423458964
M1	string	0	network_modules	219	TRUE	1.540096669474051e-34	52	22	17	0.7727272727272727	0.3269230769230769	REAC:R-HSA-445717	REAC	Aquaporin-mediated transport	10916	164		0.3728813559322034	0.38333333333333336	52	10864	17	5	35	10859	10916	0.5012164088121241
M1	string	0	network_modules	219	TRUE	2.126448068947781e-33	42	22	16	0.7272727272727273	0.38095238095238093	REAC:R-HSA-381676	REAC	Glucagon-like Peptide-1 (GLP1) regulates insulin secretion	10916	1049		0.3898305084745763	0.4	42	10874	16	6	26	10868	10916	0.5251162813092022
M1	string	0	network_modules	219	TRUE	3.3848070566680744e-33	43	22	16	0.7272727272727273	0.37209302325581395	REAC:R-HSA-991365	REAC	Activation of GABAB receptors	10916	83		0.4067796610169492	0.45	43	10873	16	6	27	10867	10916	0.5189325021677427
M1	string	0	network_modules	219	TRUE	3.3848070566680744e-33	43	22	16	0.7272727272727273	0.37209302325581395	REAC:R-HSA-977444	REAC	GABA B receptor activation	10916	1010		0.4067796610169492	0.45	43	10873	16	6	27	10867	10916	0.5189325021677427
M1	string	0	network_modules	219	TRUE	3.3848070566680744e-33	43	22	16	0.7272727272727273	0.37209302325581395	REAC:R-HSA-9660821	REAC	ADORA2B mediated anti-inflammatory cytokines production	10916	11		0.4067796610169492	0.45	43	10873	16	6	27	10867	10916	0.5189325021677427
M1	string	0	network_modules	219	TRUE	5.3162205387565995e-33	44	22	16	0.7272727272727273	0.36363636363636365	REAC:R-HSA-9634597	REAC	GPER1 signaling	10916	1020		0.4576271186440678	0.4666666666666667	44	10872	16	6	28	10866	10916	0.5129602689190601
M1	string	0	network_modules	219	TRUE	1.5053522207765862e-32	91	22	18	0.8181818181818182	0.1978021978021978	REAC:R-HSA-390466	REAC	Chaperonin-mediated protein folding	10916	345		0.4745762711864407	0.48333333333333334	91	10825	18	4	73	10821	10916	0.4002659710045263
M1	string	0	network_modules	219	TRUE	2.870641885794437e-32	48	22	16	0.7272727272727273	0.3333333333333333	REAC:R-HSA-418597	REAC	G alpha (z) signalling events	10916	990		0.4915254237288136	0.5	48	10868	16	6	32	10862	10916	0.49096356228693433
M1	string	0	network_modules	219	TRUE	6.539675071804714e-32	98	22	18	0.8181818181818182	0.1836734693877551	REAC:R-HSA-391251	REAC	Protein folding	10916	1812		0.5084745762711864	0.5166666666666667	98	10818	18	4	80	10814	10916	0.38552519724003576
M1	string	0	network_modules	219	TRUE	4.352360001327516e-31	78	22	17	0.7727272727272727	0.21794871794871795	REAC:R-HSA-422356	REAC	Regulation of insulin secretion	10916	2040		0.5254237288135594	0.5333333333333333	78	10838	17	5	61	10833	10916	0.4084612920148367
M1	string	0	network_modules	219	TRUE	1.3887864771933609e-30	59	22	16	0.7272727272727273	0.2711864406779661	REAC:R-HSA-4086398	REAC	Ca2+ pathway	10916	296		0.5423728813559322	0.55	59	10857	16	6	43	10851	10916	0.44244362036212237
M1	string	0	network_modules	219	TRUE	1.8928150118290232e-30	60	22	16	0.7272727272727273	0.26666666666666666	REAC:R-HSA-977443	REAC	GABA receptor activation	10916	1011		0.559322033898305	0.5666666666666667	60	10856	16	6	44	10850	10916	0.4387056240284108
M1	string	0	network_modules	219	TRUE	3.1524197341383356e-30	89	20	17	0.85	0.19101123595505617	KEGG:05032	KEGG	Morphine addiction	8484	420		0	0.11764705882352941	89	8395	17	3	72	8392	8484	0.40054210631337445
M1	string	0	network_modules	219	TRUE	3.1524197341383356e-30	89	20	17	0.85	0.19101123595505617	KEGG:04727	KEGG	GABAergic synapse	8484	357		0	0.11764705882352941	89	8395	17	3	72	8392	8484	0.40054210631337445
M1	string	0	network_modules	219	TRUE	6.624751741976772e-29	73	22	16	0.7272727272727273	0.2191780821917808	REAC:R-HSA-9009391	REAC	Extra-nuclear estrogen signaling	10916	888		0.576271186440678	0.5833333333333334	73	10843	16	6	57	10837	10916	0.3973108441590065
M1	string	0	network_modules	219	TRUE	1.5902465724406764e-28	107	22	17	0.7727272727272727	0.1588785046728972	REAC:R-HSA-163685	REAC	Integration of energy metabolism	10916	1213		0.5932203389830508	0.6	107	10809	17	5	90	10804	10916	0.3479993757889159
M1	string	0	network_modules	219	TRUE	2.217847545965896e-28	112	20	17	0.85	0.15178571428571427	KEGG:04726	KEGG	Serotonergic synapse	8484	356		0.125	0.17647058823529413	112	8372	17	3	95	8369	8484	0.35638974227816594
M1	string	0	network_modules	219	TRUE	2.609708496567582e-28	113	20	17	0.85	0.1504424778761062	KEGG:04725	KEGG	Cholinergic synapse	8484	355		0.1875	0.23529411764705882	113	8371	17	3	96	8368	8484	0.35478050395975247
M1	string	0	network_modules	219	TRUE	3.3753734070953335e-28	80	22	16	0.7272727272727273	0.2	REAC:R-HSA-416482	REAC	G alpha (12/13) signalling events	10916	986		0.6101694915254238	0.6166666666666667	80	10836	16	6	64	10830	10916	0.3793153590557779
M1	string	0	network_modules	219	TRUE	9.825966486988455e-28	85	22	16	0.7272727272727273	0.18823529411764706	REAC:R-HSA-418346	REAC	Platelet homeostasis	10916	1765		0.6271186440677966	0.6333333333333333	85	10831	16	6	69	10825	10916	0.3678407032021169
M1	string	0	network_modules	219	TRUE	2.1996230894841668e-27	89	22	16	0.7272727272727273	0.1797752808988764	REAC:R-HSA-111885	REAC	Opioid Signalling	10916	1642		0.6440677966101694	0.65	89	10827	16	6	73	10821	10916	0.3593628761677309
M1	string	0	network_modules	219	TRUE	3.8397331482190656e-27	131	20	17	0.85	0.1297709923664122	KEGG:04728	KEGG	Dopaminergic synapse	8484	358		0.25	0.29411764705882354	131	8353	17	3	114	8350	8484	0.3290243769187673
M1	string	0	network_modules	219	TRUE	4.73586911707884e-27	93	22	16	0.7272727272727273	0.17204301075268819	REAC:R-HSA-373080	REAC	Class B/2 (Secretin family receptors)	10916	366		0.6610169491525424	0.6666666666666666	93	10823	16	6	77	10817	10916	0.3514354950320376
M1	string	0	network_modules	219	TRUE	6.899868518849703e-27	97	20	16	0.8	0.16494845360824742	KEGG:04713	KEGG	Circadian entrainment	8484	348		0.3125	0.35294117647058826	97	8387	16	4	81	8383	8484	0.3605596162293119
M1	string	0	network_modules	219	TRUE	1.8783485181002923e-26	33	22	13	0.5909090909090909	0.3939393939393939	REAC:R-HSA-163359	REAC	Glucagon signaling in metabolic regulation	10916	1048		0.6779661016949152	0.6833333333333333	33	10883	13	9	20	10874	10916	0.48121928053570795
M1	string	0	network_modules	219	TRUE	2.778071088982333e-26	103	22	16	0.7272727272727273	0.1553398058252427	REAC:R-HSA-1296071	REAC	Potassium Channels	10916	1780		0.6949152542372882	0.7	103	10813	16	6	87	10807	10916	0.333668592925054
M1	string	0	network_modules	219	TRUE	3.458797031182393e-26	148	20	17	0.85	0.11486486486486487	KEGG:04723	KEGG	Retrograde endocannabinoid signaling	8484	353		0.375	0.4117647058823529	148	8336	17	3	131	8333	8484	0.30912295822187363
M1	string	0	network_modules	219	TRUE	1.292815483756344e-25	115	20	16	0.8	0.1391304347826087	KEGG:04724	KEGG	Glutamatergic synapse	8484	354		0.4375	0.47058823529411764	115	8369	16	4	99	8365	8484	0.33060584100432727
M1	string	0	network_modules	219	TRUE	1.4649166681909717e-25	156	22	17	0.7727272727272727	0.10897435897435898	REAC:R-HSA-418555	REAC	G alpha (s) signalling events	10916	989		0.711864406779661	0.7166666666666667	156	10760	17	5	139	10755	10916	0.2871652413674008
M1	string	0	network_modules	219	TRUE	9.138558256705815e-25	129	20	16	0.8	0.12403100775193798	KEGG:04926	KEGG	Relaxin signaling pathway	8484	383		0.5	0.5294117647058824	129	8355	16	4	113	8351	8484	0.31175679254189925
M1	string	0	network_modules	219	TRUE	1.9193716224501187e-24	132	22	16	0.7272727272727273	0.12121212121212122	REAC:R-HSA-9662851	REAC	Anti-inflammatory response favouring Leishmania parasite infection	10916	150		0.7288135593220338	0.75	132	10784	16	6	116	10778	10916	0.2940491117954921
M1	string	0	network_modules	219	TRUE	1.9193716224501187e-24	132	22	16	0.7272727272727273	0.12121212121212122	REAC:R-HSA-9664433	REAC	Leishmania parasite growth and survival	10916	1311		0.7288135593220338	0.75	132	10784	16	6	116	10778	10916	0.2940491117954921
M1	string	0	network_modules	219	TRUE	2.8597779978266008e-24	138	20	16	0.8	0.11594202898550725	KEGG:04371	KEGG	Apelin signaling pathway	8484	308		0.5625	0.5882352941176471	138	8346	16	4	122	8342	8484	0.30117424708275514
M1	string	0	network_modules	219	TRUE	7.04886786505874e-24	259	22	18	0.8181818181818182	0.0694980694980695	REAC:R-HSA-112315	REAC	Transmission across Chemical Synapses	10916	2580		0.7627118644067796	0.7666666666666667	259	10657	18	4	241	10653	10916	0.23457580598141914
M1	string	0	network_modules	219	TRUE	7.408333232006897e-24	143	22	16	0.7272727272727273	0.11188811188811189	REAC:R-HSA-3858494	REAC	Beta-catenin independent WNT signaling	10916	216		0.7796610169491526	0.7833333333333333	143	10773	16	6	127	10767	10916	0.2822591779738141
M1	string	0	network_modules	219	TRUE	2.191683382654895e-22	312	22	18	0.8181818181818182	0.057692307692307696	REAC:R-HSA-418594	REAC	G alpha (i) signalling events	10916	987		0.7966101694915254	0.8	312	10604	18	4	294	10600	10916	0.21294925306287862
M1	string	0	network_modules	219	TRUE	4.613444122232959e-22	187	20	16	0.8	0.0855614973262032	KEGG:05034	KEGG	Alcoholism	8484	422		0.625	0.6470588235294118	187	8297	16	4	171	8293	8484	0.25757453113799805
M1	string	0	network_modules	219	TRUE	6.007367275874839e-22	190	20	16	0.8	0.08421052631578947	KEGG:04062	KEGG	Chemokine signaling pathway	8484	255		0.6875	0.7058823529411765	190	8294	16	4	174	8290	8484	0.2554629981436823
M1	string	0	network_modules	219	TRUE	8.484888571591925e-22	194	20	16	0.8	0.08247422680412371	KEGG:05167	KEGG	Kaposi sarcoma-associated herpesvirus infection	8484	448		0.75	0.7647058823529411	194	8290	16	4	178	8286	8484	0.25272330369801377
M1	string	0	network_modules	219	TRUE	1.4240818770243722e-21	196	22	16	0.7272727272727273	0.08163265306122448	REAC:R-HSA-112314	REAC	Neurotransmitter receptors and postsynaptic signal transmission	10916	1594		0.8135593220338984	0.8166666666666667	196	10720	16	6	180	10714	10916	0.24004705755542033
M1	string	0	network_modules	219	TRUE	3.145961535010819e-21	210	20	16	0.8	0.0761904761904762	KEGG:05170	KEGG	Human immunodeficiency virus 1 infection	8484	451		0.8125	0.8235294117647058	210	8274	16	4	194	8270	8484	0.24254973974144892
M1	string	0	network_modules	219	TRUE	5.623211373301773e-21	213	22	16	0.7272727272727273	0.07511737089201878	REAC:R-HSA-416476	REAC	G alpha (q) signalling events	10916	988		0.8305084745762712	0.8333333333333334	213	10703	16	6	197	10697	10916	0.2299453777915511
M1	string	0	network_modules	219	TRUE	6.559346768348071e-21	215	22	16	0.7272727272727273	0.07441860465116279	REAC:R-HSA-9658195	REAC	Leishmania infection	10916	1310		0.847457627118644	0.8666666666666667	215	10701	16	6	199	10695	10916	0.2288354987615326
M1	string	0	network_modules	219	TRUE	6.559346768348071e-21	215	22	16	0.7272727272727273	0.07441860465116279	REAC:R-HSA-9824443	REAC	Parasitic Infection Pathways	10916	1717		0.847457627118644	0.8666666666666667	215	10701	16	6	199	10695	10916	0.2288354987615326
M1	string	0	network_modules	219	TRUE	7.080361384132714e-21	216	22	16	0.7272727272727273	0.07407407407407407	REAC:R-HSA-8939211	REAC	ESR-mediated signaling	10916	830		0.8813559322033898	0.8833333333333333	216	10700	16	6	200	10694	10916	0.22828628103693488
M1	string	0	network_modules	219	TRUE	8.467460300800676e-21	223	20	16	0.8	0.07174887892376682	KEGG:05163	KEGG	Human cytomegalovirus infection	8484	444		0.875	0.8823529411764706	223	8261	16	4	207	8257	8484	0.23509328943067667
M1	string	0	network_modules	219	TRUE	2.004886050152971e-20	235	20	16	0.8	0.06808510638297872	KEGG:04014	KEGG	Ras signaling pathway	8484	247		0.9375	0.9411764705882353	235	8249	16	4	219	8245	8484	0.2287598130478154
M1	string	0	network_modules	219	TRUE	2.0790225798075134e-20	400	22	18	0.8181818181818182	0.045	REAC:R-HSA-112316	REAC	Neuronal System	10916	1590		0.8983050847457628	0.9	400	10516	18	4	382	10512	10916	0.18692879063277104
M1	string	0	network_modules	219	TRUE	1.216283146460381e-19	774	22	19	0.8636363636363636	0.02454780361757106	GO:0007186	GO:BP	G protein-coupled receptor signaling pathway	16175	2744		0	0.5	774	15401	19	3	755	15398	16175	0.1410456413749746
M1	string	0	network_modules	219	TRUE	1.3919878103231678e-19	259	22	16	0.7272727272727273	0.06177606177606178	REAC:R-HSA-76002	REAC	Platelet activation, signaling and aggregation	10916	1762		0.9152542372881356	0.9166666666666666	259	10657	16	6	243	10651	10916	0.20773341908385456
M1	string	0	network_modules	219	TRUE	8.798977524140359e-19	290	22	16	0.7272727272727273	0.05517241379310345	REAC:R-HSA-9006931	REAC	Signaling by Nuclear Receptors	10916	2289		0.9322033898305084	0.9333333333333333	290	10626	16	6	274	10620	10916	0.19580927051803376
M1	string	0	network_modules	219	TRUE	6.184920554699802e-18	327	22	16	0.7272727272727273	0.04892966360856269	REAC:R-HSA-195721	REAC	Signaling by WNT	10916	2314		0.9491525423728814	0.95	327	10589	16	6	311	10583	10916	0.18382725295880306
M1	string	0	network_modules	219	TRUE	1.747201889134924e-17	356	20	16	0.8	0.0449438202247191	KEGG:04151	KEGG	PI3K-Akt signaling pathway	8484	285		1	1	356	8128	16	4	340	8124	8484	0.18378173182516644
M1	string	0	network_modules	219	TRUE	2.257641977369256e-17	460	22	17	0.7727272727272727	0.036956521739130437	REAC:R-HSA-500792	REAC	GPCR ligand binding	10916	1019		0.9661016949152542	0.9666666666666667	460	10456	17	5	443	10451	10916	0.1634148780376779
M1	string	0	network_modules	219	TRUE	0.0030769327692432304	21	22	3	0.13636363636363635	0.14285714285714285	REAC:R-HSA-381771	REAC	Synthesis, secretion, and inactivation of Glucagon-like Peptide-1 (GLP-1)	10916	2415		0.9830508474576272	0.9833333333333333	21	10895	3	19	18	10876	10916	0.13787513538282495
M1	string	0	network_modules	219	TRUE	0.004664176146263619	24	22	3	0.13636363636363635	0.125	REAC:R-HSA-400508	REAC	Incretin synthesis, secretion, and inactivation	10916	1180		1	1	24	10892	3	19	21	10873	10916	0.12872445833395138
M1	string	0	network_modules	219	TRUE	0.008451357026087224	27	22	3	0.13636363636363635	0.1111111111111111	GO:0007212	GO:BP	G protein-coupled dopamine receptor signaling pathway	16175	2766		1	1	27	16148	3	19	24	16129	16175	0.12176915729780585
M1	string	0	network_modules	220	TRUE	2.6582055155940236e-15	60	14	9	0.6428571428571429	0.15	KEGG:04330	KEGG	Notch signaling pathway	8484	301		0	0.16666666666666666	60	8424	9	5	51	8419	8484	0.30845971324120963
M1	string	0	network_modules	220	TRUE	1.502450967420193e-14	109	19	10	0.5263157894736842	0.09174311926605505	GO:0007219	GO:BP	Notch signaling pathway	16175	2773		0	0.16666666666666666	109	16066	10	9	99	16057	16175	0.21778950666568414
M1	string	0	network_modules	220	TRUE	3.416291257968444e-14	232	14	11	0.7857142857142857	0.047413793103448273	REAC:R-HSA-157118	REAC	Signaling by NOTCH	10916	2274		0	0.041666666666666664	232	10684	11	3	221	10681	10916	0.18994108005385474
M1	string	0	network_modules	220	TRUE	2.1231280465350415e-11	48	14	7	0.5	0.14583333333333334	REAC:R-HSA-9012852	REAC	Signaling by NOTCH3	10916	2282		0.043478260869565216	0.08333333333333333	48	10868	7	7	41	10861	10916	0.26841869497773363
M1	string	0	network_modules	220	TRUE	4.381956735418139e-10	33	14	6	0.42857142857142855	0.18181818181818182	REAC:R-HSA-1980145	REAC	Signaling by NOTCH2	10916	2281		0.08695652173913043	0.125	33	10883	6	8	27	10875	10916	0.27777430871745534
M1	string	0	network_modules	220	TRUE	7.772487120029647e-9	108	14	7	0.5	0.06481481481481481	REAC:R-HSA-1912422	REAC	Pre-NOTCH Expression and Processing	10916	1783		0.13043478260869565	0.16666666666666666	108	10808	7	7	101	10801	10916	0.1774517004037977
M1	string	0	network_modules	220	TRUE	1.819652834599352e-7	89	14	6	0.42857142857142855	0.06741573033707865	KEGG:04658	KEGG	Th1 and Th2 cell differentiation	8484	336		0.2	0.3333333333333333	89	8395	6	8	83	8387	8484	0.1668315357190702
M1	string	0	network_modules	220	TRUE	3.8995893677446534e-7	79	19	6	0.3157894736842105	0.0759493670886076	GO:0008593	GO:BP	regulation of Notch signaling pathway	16175	3202		0.2	0.3333333333333333	79	16096	6	13	73	16083	16175	0.15293605949765277
M1	string	0	network_modules	220	TRUE	1.6123663430618673e-6	18	14	4	0.2857142857142857	0.2222222222222222	REAC:R-HSA-1912420	REAC	Pre-NOTCH Processing in Golgi	10916	1784		0.17391304347826086	0.20833333333333334	18	10898	4	10	14	10888	10916	0.2508898161847943
M1	string	0	network_modules	220	TRUE	1.9708811400709206e-6	57	14	5	0.35714285714285715	0.08771929824561403	REAC:R-HSA-2644602	REAC	Signaling by NOTCH1 PEST Domain Mutants in Cancer	10916	2278		0.21739130434782608	0.4166666666666667	57	10859	5	9	52	10850	10916	0.17497963137629666
M1	string	0	network_modules	220	TRUE	1.9708811400709206e-6	57	14	5	0.35714285714285715	0.08771929824561403	REAC:R-HSA-2644603	REAC	Signaling by NOTCH1 in Cancer	10916	2279		0.21739130434782608	0.4166666666666667	57	10859	5	9	52	10850	10916	0.17497963137629666
M1	string	0	network_modules	220	TRUE	1.9708811400709206e-6	57	14	5	0.35714285714285715	0.08771929824561403	REAC:R-HSA-2644606	REAC	Constitutive Signaling by NOTCH1 PEST Domain Mutants	10916	406		0.21739130434782608	0.4166666666666667	57	10859	5	9	52	10850	10916	0.17497963137629666
M1	string	0	network_modules	220	TRUE	1.9708811400709206e-6	57	14	5	0.35714285714285715	0.08771929824561403	REAC:R-HSA-2894862	REAC	Constitutive Signaling by NOTCH1 HD+PEST Domain Mutants	10916	405		0.21739130434782608	0.4166666666666667	57	10859	5	9	52	10850	10916	0.17497963137629666
M1	string	0	network_modules	220	TRUE	1.9708811400709206e-6	57	14	5	0.35714285714285715	0.08771929824561403	REAC:R-HSA-2894858	REAC	Signaling by NOTCH1 HD+PEST Domain Mutants in Cancer	10916	2277		0.21739130434782608	0.4166666666666667	57	10859	5	9	52	10850	10916	0.17497963137629666
M1	string	0	network_modules	220	TRUE	3.8430998307767615e-6	22	14	4	0.2857142857142857	0.18181818181818182	REAC:R-HSA-2979096	REAC	NOTCH2 Activation and Transmission of Signal to the Nucleus	10916	1533		0.43478260869565216	0.4583333333333333	22	10894	4	10	18	10884	10916	0.2266872401264935
M1	string	0	network_modules	220	TRUE	5.2734812549501156e-6	5	14	3	0.21428571428571427	0.6	REAC:R-HSA-5083630	REAC	Defective LFNG causes SCDO3	10916	575		0.4782608695652174	0.5	5	10911	3	11	2	10900	10916	0.3581138203856684
M1	string	0	network_modules	220	TRUE	5.574418610431008e-6	24	14	4	0.2857142857142857	0.16666666666666666	REAC:R-HSA-9013508	REAC	NOTCH3 Intracellular Domain Regulates Transcription	10916	1536		0.5217391304347826	0.5416666666666666	24	10892	4	10	20	10882	10916	0.216916255470491
M1	string	0	network_modules	220	TRUE	6.51804143966302e-6	72	14	5	0.35714285714285715	0.06944444444444445	REAC:R-HSA-1980143	REAC	Signaling by NOTCH1	10916	2275		0.5652173913043478	0.5833333333333334	72	10844	5	9	67	10835	10916	0.15518857697142244
M1	string	0	network_modules	220	TRUE	6.631342921658949e-6	25	14	4	0.2857142857142857	0.16	REAC:R-HSA-9013507	REAC	NOTCH3 Activation and Transmission of Signal to the Nucleus	10916	1535		0.6086956521739131	0.625	25	10891	4	10	21	10881	10916	0.21247473788525997
M1	string	0	network_modules	220	TRUE	1.0538988862205604e-5	6	14	3	0.21428571428571427	0.5	REAC:R-HSA-1912399	REAC	Pre-NOTCH Processing in the Endoplasmic Reticulum	10916	1785		0.6521739130434783	0.6666666666666666	6	10910	3	11	3	10899	10916	0.32678661498676614
M1	string	0	network_modules	220	TRUE	1.0709726160366345e-5	28	14	4	0.2857142857142857	0.14285714285714285	REAC:R-HSA-350054	REAC	Notch-HLH transcription pathway	10916	1610		0.6956521739130435	0.7083333333333334	28	10888	4	10	24	10878	10916	0.20060270734246272
M1	string	0	network_modules	220	TRUE	6.479918335300456e-5	7	19	3	0.15789473684210525	0.42857142857142855	GO:0002315	GO:BP	marginal zone B cell differentiation	16175	847		0.4	0.5	7	16168	3	16	4	16152	16175	0.2596286878898475
M1	string	0	network_modules	220	TRUE	1.1540396568951454e-4	12	14	3	0.21428571428571427	0.25	REAC:R-HSA-2197563	REAC	NOTCH2 intracellular domain regulates transcription	10916	1534		0.7391304347826086	0.75	12	10904	3	11	9	10893	10916	0.23054219769374462
M1	string	0	network_modules	220	TRUE	2.3813536645775487e-4	15	14	3	0.21428571428571427	0.2	REAC:R-HSA-2691230	REAC	Signaling by NOTCH1 HD Domain Mutants in Cancer	10916	2276		0.782608695652174	0.8333333333333334	15	10901	3	11	12	10890	10916	0.2059657220886868
M1	string	0	network_modules	220	TRUE	2.3813536645775487e-4	15	14	3	0.21428571428571427	0.2	REAC:R-HSA-2691232	REAC	Constitutive Signaling by NOTCH1 HD Domain Mutants	10916	404		0.782608695652174	0.8333333333333334	15	10901	3	11	12	10890	10916	0.2059657220886868
M1	string	0	network_modules	220	TRUE	4.399866539673808e-4	330	14	6	0.42857142857142855	0.01818181818181818	KEGG:05165	KEGG	Human papillomavirus infection	8484	446		0.4	0.5	330	8154	6	8	324	8146	8484	0.08193752440950483
M1	string	0	network_modules	220	TRUE	5.943942804599393e-4	20	14	3	0.21428571428571427	0.15	REAC:R-HSA-9013695	REAC	NOTCH4 Intracellular Domain Regulates Transcription	10916	1538		0.8695652173913043	0.875	20	10896	3	11	17	10885	10916	0.17802864463696338
M1	string	0	network_modules	220	TRUE	7.816491618158731e-4	95	14	4	0.2857142857142857	0.042105263157894736	KEGG:01522	KEGG	Endocrine resistance	8484	196		0.6	0.6666666666666666	95	8389	4	10	91	8379	8484	0.10606568506579366
M1	string	0	network_modules	220	TRUE	8.369896598676678e-4	81	14	4	0.2857142857142857	0.04938271604938271	REAC:R-HSA-9013694	REAC	Signaling by NOTCH4	10916	2283		0.9130434782608695	0.9166666666666666	81	10835	4	10	77	10825	10916	0.11620406182697848
M1	string	0	network_modules	220	TRUE	0.0013943389732301394	92	14	4	0.2857142857142857	0.043478260869565216	REAC:R-HSA-1912408	REAC	Pre-NOTCH Transcription and Translation	10916	1786		0.9565217391304348	0.9583333333333334	92	10824	4	10	88	10814	10916	0.10869637176431482
M1	string	0	network_modules	220	TRUE	0.0014984612348917467	18	19	3	0.15789473684210525	0.16666666666666666	GO:0002313	GO:BP	mature B cell differentiation involved in immune response	16175	845		0.6	0.6666666666666666	18	16157	3	16	15	16141	16175	0.16126254114621588
M1	string	0	network_modules	220	TRUE	0.001778102346443505	19	19	3	0.15789473684210525	0.15789473684210525	GO:0002335	GO:BP	mature B cell differentiation	16175	867		0.8	0.8333333333333334	19	16156	3	16	16	16140	16175	0.15690439269751502
M1	string	0	network_modules	220	TRUE	0.002324260510694122	31	14	3	0.21428571428571427	0.0967741935483871	REAC:R-HSA-2122948	REAC	Activated NOTCH1 Transmits Signal to the Nucleus	10916	58		1	1	31	10885	3	11	28	10874	10916	0.1423896919152723
M1	string	0	network_modules	220	TRUE	0.003205257762086875	47	14	3	0.21428571428571427	0.06382978723404255	KEGG:00514	KEGG	Other types of O-glycan biosynthesis	8484	67		0.8	0.8333333333333334	47	8437	3	11	44	8426	8484	0.11433992956382405
M1	string	0	network_modules	220	TRUE	0.004363451182340092	147	14	4	0.2857142857142857	0.027210884353741496	KEGG:05224	KEGG	Breast cancer	8484	475		1	1	147	8337	4	10	143	8327	8484	0.08362223582025562
M1	string	0	network_modules	220	TRUE	0.009014129295979612	32	19	3	0.15789473684210525	0.09375	GO:0045746	GO:BP	negative regulation of Notch signaling pathway	16175	11586		1	1	32	16143	3	16	29	16127	16175	0.12033134874051403
M1	string	0	network_modules	221	TRUE	1.6728289312118642e-7	96	7	5	0.7142857142857143	0.052083333333333336	KEGG:03015	KEGG	mRNA surveillance pathway	8484	210		NA	1	96	8388	5	2	91	8386	8484	0.19098564942919846
M1	string	0	network_modules	221	TRUE	8.246599613074921e-5	55	12	4	0.3333333333333333	0.07272727272727272	REAC:R-HSA-6784531	REAC	tRNA processing in the nucleus	10916	2745		0	0.2	55	10861	4	8	51	10853	10916	0.1538186718653884
M1	string	0	network_modules	221	TRUE	2.8985905863507597e-4	19	12	3	0.25	0.15789473684210525	REAC:R-HSA-77595	REAC	Processing of Intronless Pre-mRNAs	10916	1799		0.25	0.4	19	10897	3	9	16	10888	10916	0.19757715000289244
M1	string	0	network_modules	221	TRUE	4.058002299582739e-4	12	19	3	0.15789473684210525	0.25	GO:0006388	GO:BP	tRNA splicing, via endonucleolytic cleavage and ligation	16175	2152		0	0.25	12	16163	3	16	9	16147	16175	0.1979360151912499
M1	string	0	network_modules	221	TRUE	5.271488521564476e-4	13	19	3	0.15789473684210525	0.23076923076923078	GO:0000394	GO:BP	RNA splicing, via endonucleolytic cleavage and ligation	16175	119		0.3333333333333333	0.5	13	16162	3	16	10	16146	16175	0.19010183994272611
M1	string	0	network_modules	221	TRUE	9.745117700394923e-4	28	12	3	0.25	0.10714285714285714	REAC:R-HSA-75067	REAC	Processing of Capped Intronless Pre-mRNA	10916	1797		0.5	0.6	28	10888	3	9	25	10879	10916	0.1622815749981811
M1	string	0	network_modules	221	TRUE	0.0010392515278206864	103	12	4	0.3333333333333333	0.038834951456310676	REAC:R-HSA-72306	REAC	tRNA processing	10916	2743		0.75	0.8	103	10813	4	8	99	10805	10916	0.11114176820544837
M1	string	0	network_modules	221	TRUE	0.005296018232941796	3	19	2	0.10526315789473684	0.6666666666666666	GO:0000379	GO:BP	tRNA-type intron splice site recognition and cleavage	16175	111		0.6666666666666666	0.75	3	16172	2	17	1	16155	16175	0.26461970208734953
M1	string	0	network_modules	221	TRUE	0.008104074220396579	56	12	3	0.25	0.05357142857142857	REAC:R-HSA-72187	REAC	mRNA 3'-end processing	10916	2701		1	1	56	10860	3	9	53	10851	10916	0.1137071394993144
M1	string	0	network_modules	221	TRUE	0.00990818471842332	33	19	3	0.15789473684210525	0.09090909090909091	GO:0031124	GO:BP	mRNA 3'-end processing	16175	7049		1	1	33	16142	3	16	30	16126	16175	0.1184508047106856
M1	string	0	network_modules	223	TRUE	3.429403612464953e-5	14	11	3	0.2727272727272727	0.21428571428571427	KEGG:00533	KEGG	Glycosaminoglycan biosynthesis - keratan sulfate	8484	77		NA	1	14	8470	3	8	11	8462	8484	0.24063872588653704
M1	string	0	network_modules	223	TRUE	4.1084362557340225e-4	265	18	6	0.3333333333333333	0.022641509433962263	GO:0009101	GO:BP	glycoprotein biosynthetic process	16175	3273		0	0.125	265	15910	6	12	259	15898	16175	0.08333605619699672
M1	string	0	network_modules	223	TRUE	7.691420499870983e-4	61	18	4	0.2222222222222222	0.06557377049180328	GO:1903510	GO:BP	mucopolysaccharide metabolic process	16175	23060		0.14285714285714285	0.25	61	16114	4	14	57	16100	16175	0.11895633089754788
M1	string	0	network_modules	223	TRUE	0.0010533948283642735	514	18	7	0.3888888888888889	0.013618677042801557	GO:1901137	GO:BP	carbohydrate derivative biosynthetic process	16175	21245		0.2857142857142857	0.375	514	15661	7	11	507	15650	16175	0.06795362916172432
M1	string	0	network_modules	223	TRUE	0.001058563238993572	66	18	4	0.2222222222222222	0.06060606060606061	GO:0006024	GO:BP	glycosaminoglycan biosynthetic process	16175	1897		0.42857142857142855	0.5	66	16109	4	14	62	16095	16175	0.11421756977281648
M1	string	0	network_modules	223	TRUE	0.0011249928097720409	67	18	4	0.2222222222222222	0.05970149253731343	GO:0006023	GO:BP	aminoglycan biosynthetic process	16175	1896		0.5714285714285714	0.625	67	16108	4	14	63	16094	16175	0.11333338512666752
M1	string	0	network_modules	223	TRUE	0.0011325014951164467	315	18	6	0.3333333333333333	0.01904761904761905	GO:0009100	GO:BP	glycoprotein metabolic process	16175	3272		0.7142857142857143	0.75	315	15860	6	12	309	15848	16175	0.07581020487206017
M1	string	0	network_modules	223	TRUE	0.002248646835688929	125	12	4	0.3333333333333333	0.032	REAC:R-HSA-1630316	REAC	Glycosaminoglycan metabolism	10916	1076		0	0.5	125	10791	4	8	121	10783	10916	0.10036271642506095
M1	string	0	network_modules	223	TRUE	0.0025405813550945584	82	18	4	0.2222222222222222	0.04878048780487805	GO:0030203	GO:BP	glycosaminoglycan metabolic process	16175	6712		0.8571428571428571	0.875	82	16093	4	14	78	16079	16175	0.10205632418171402
M1	string	0	network_modules	223	TRUE	0.003291177469690408	5	12	2	0.16666666666666666	0.4	REAC:R-HSA-446205	REAC	Synthesis of GDP-mannose	10916	2378		1	1	5	10911	2	10	3	10901	10916	0.2576899618144285
M1	string	0	network_modules	223	TRUE	0.003690965959728122	90	18	4	0.2222222222222222	0.044444444444444446	GO:0006022	GO:BP	aminoglycan metabolic process	16175	1895		1	1	90	16085	4	14	86	16071	16175	0.09721723887975751
M1	string	0	network_modules	224	TRUE	0.0011563708061067882	5	8	2	0.25	0.4	REAC:R-HSA-2161517	REAC	Abacavir transmembrane transport	10916	45		0	0.2	5	10911	2	6	3	10905	10916	0.31583645181620407
M1	string	0	network_modules	224	TRUE	0.0035263504037166406	3	16	2	0.125	0.6666666666666666	GO:0015847	GO:BP	putrescine transport	16175	4956		NA	1	3	16172	2	14	1	16158	16175	0.2884162244125957
M1	string	0	network_modules	224	TRUE	0.004156834737373672	9	8	2	0.25	0.2222222222222222	REAC:R-HSA-2161522	REAC	Abacavir ADME	10916	43		0.25	0.4	9	10907	2	6	7	10901	10916	0.23510800786592262
M1	string	0	network_modules	224	TRUE	0.005194138758048245	10	8	2	0.25	0.2	REAC:R-HSA-112311	REAC	Neurotransmitter clearance	10916	1593		0.5	0.8	10	10906	2	6	8	10900	10916	0.22297126089211025
M1	string	0	network_modules	224	TRUE	0.005194138758048245	10	8	2	0.25	0.2	REAC:R-HSA-549127	REAC	Organic cation transport	10916	1649		0.5	0.8	10	10906	2	6	8	10900	10916	0.22297126089211025
M1	string	0	network_modules	224	TRUE	0.005897222169016033	84	8	3	0.375	0.03571428571428571	REAC:R-HSA-425366	REAC	Transport of bile salts and organic acids, metal ions and amine compounds	10916	2590		1	1	84	10832	3	5	81	10827	10916	0.11383313011209865
M1	string	0	network_modules	225	TRUE	0.0013286370922210963	156	9	4	0.4444444444444444	0.02564102564102564	REAC:R-HSA-418555	REAC	G alpha (s) signalling events	10916	989		NA	1	156	10760	4	5	152	10755	10916	0.10410872950661289
M1	string	0	network_modules	225	TRUE	0.002093968739161961	165	20	5	0.25	0.030303030303030304	GO:0003341	GO:BP	cilium movement	16175	1761		0	0.5	165	16010	5	15	160	15995	16175	0.08396835926332989
M1	string	0	network_modules	225	TRUE	0.006403418026022153	3	20	2	0.1	0.6666666666666666	GO:0009214	GO:BP	cyclic nucleotide catabolic process	16175	3380		1	1	3	16172	2	18	1	16154	16175	0.25790340281345747
M1	string	0	network_modules	226	TRUE	3.048017612669659e-20	29	21	10	0.47619047619047616	0.3448275862068966	GO:0001990	GO:BP	regulation of systemic arterial blood pressure by hormone	16175	594		0	0.019230769230769232	29	16146	10	11	19	16135	16175	0.40431969296129766
M1	string	0	network_modules	226	TRUE	5.17340367075225e-19	62	21	11	0.5238095238095238	0.1774193548387097	GO:0003073	GO:BP	regulation of systemic arterial blood pressure	16175	1524		0.0196078431372549	0.038461538461538464	62	16113	11	10	51	16103	16175	0.3033985648889074
M1	string	0	network_modules	226	TRUE	5.2744221426189175e-19	37	21	10	0.47619047619047616	0.2702702702702703	GO:0003044	GO:BP	regulation of systemic arterial blood pressure mediated by a chemical signal	16175	1495		0.0392156862745098	0.057692307692307696	37	16138	10	11	27	16127	16175	0.35766598018699575
M1	string	0	network_modules	226	TRUE	6.458204352306393e-17	57	21	10	0.47619047619047616	0.17543859649122806	GO:0050886	GO:BP	endocrine process	16175	13330		0.058823529411764705	0.07692307692307693	57	16118	10	11	47	16107	16175	0.28759129391138244
M1	string	0	network_modules	226	TRUE	6.358307909993229e-16	114	21	11	0.5238095238095238	0.09649122807017543	GO:0008217	GO:BP	regulation of blood pressure	16175	3144		0.0784313725490196	0.09615384615384616	114	16061	11	10	103	16051	16175	0.22272318251571446
M1	string	0	network_modules	226	TRUE	1.482000528018146e-13	71	21	9	0.42857142857142855	0.1267605633802817	GO:0035150	GO:BP	regulation of tube size	16175	8847		0.09803921568627451	0.15384615384615385	71	16104	9	12	62	16092	16175	0.2313502721613511
M1	string	0	network_modules	226	TRUE	1.482000528018146e-13	71	21	9	0.42857142857142855	0.1267605633802817	GO:0035296	GO:BP	regulation of tube diameter	16175	8954		0.09803921568627451	0.15384615384615385	71	16104	9	12	62	16092	16175	0.2313502721613511
M1	string	0	network_modules	226	TRUE	1.482000528018146e-13	71	21	9	0.42857142857142855	0.1267605633802817	GO:0097746	GO:BP	blood vessel diameter maintenance	16175	18758		0.09803921568627451	0.15384615384615385	71	16104	9	12	62	16092	16175	0.2313502721613511
M1	string	0	network_modules	226	TRUE	4.455616344328324e-13	44	21	8	0.38095238095238093	0.18181818181818182	GO:0042310	GO:BP	vasoconstriction	16175	10083		0.1568627450980392	0.17307692307692307	44	16131	8	13	36	16118	16175	0.26182754657671486
M1	string	0	network_modules	226	TRUE	4.159550575599732e-12	358	21	12	0.5714285714285714	0.0335195530726257	GO:0008015	GO:BP	blood circulation	16175	3096		0.17647058823529413	0.19230769230769232	358	15817	12	9	346	15808	16175	0.13462213900422396
M1	string	0	network_modules	226	TRUE	3.9395969331244625e-11	17	21	6	0.2857142857142857	0.35294117647058826	GO:0003081	GO:BP	regulation of systemic arterial blood pressure by renin-angiotensin	16175	1526		0.19607843137254902	0.21153846153846154	17	16158	6	15	11	16143	16175	0.31675763055502343
M1	string	0	network_modules	226	TRUE	4.771090858383669e-11	439	21	12	0.5714285714285714	0.02733485193621868	GO:0003013	GO:BP	circulatory system process	16175	1464		0.21568627450980393	0.23076923076923078	439	15736	12	9	427	15727	16175	0.12077113875868296
M1	string	0	network_modules	226	TRUE	9.653791493280064e-11	23	16	6	0.375	0.2608695652173913	KEGG:04614	KEGG	Renin-angiotensin system	8484	324		0	0.25	23	8461	6	10	17	8451	8484	0.31122586477681563
M1	string	0	network_modules	226	TRUE	1.224324811323596e-9	188	21	9	0.42857142857142855	0.047872340425531915	GO:0003018	GO:BP	vascular process in circulatory system	16175	1469		0.23529411764705882	0.25	188	15987	9	12	179	15975	16175	0.1402600395735574
M1	string	0	network_modules	226	TRUE	1.3476444083884736e-9	190	21	9	0.42857142857142855	0.04736842105263158	GO:1903522	GO:BP	regulation of blood circulation	16175	23072		0.2549019607843137	0.2692307692307692	190	15985	9	12	181	15973	16175	0.13948722607575223
M1	string	0	network_modules	226	TRUE	2.8504016910426255e-9	32	21	6	0.2857142857142857	0.1875	GO:0016486	GO:BP	peptide hormone processing	16175	5234		0.27450980392156865	0.28846153846153844	32	16143	6	15	26	16128	16175	0.23022957434431301
M1	string	0	network_modules	226	TRUE	4.223626328756865e-9	34	21	6	0.2857142857142857	0.17647058823529413	GO:0140448	GO:BP	signaling receptor ligand precursor processing	16175	19778		0.29411764705882354	0.3076923076923077	34	16141	6	15	28	16126	16175	0.2232719914027881
M1	string	0	network_modules	226	TRUE	6.449141118988191e-9	14	21	5	0.23809523809523808	0.35714285714285715	GO:0001991	GO:BP	regulation of systemic arterial blood pressure by circulatory renin-angiotensin	16175	595		0.3137254901960784	0.3269230769230769	14	16161	5	16	9	16145	16175	0.29086055803971067
M1	string	0	network_modules	226	TRUE	1.1296565027250068e-8	361	21	10	0.47619047619047616	0.027700831024930747	GO:0010817	GO:BP	regulation of hormone levels	16175	4429		0.3333333333333333	0.34615384615384615	361	15814	10	11	351	15803	16175	0.11078294360989044
M1	string	0	network_modules	226	TRUE	1.3532922332122788e-8	18	17	5	0.29411764705882354	0.2777777777777778	REAC:R-HSA-2022377	REAC	Metabolism of Angiotensinogen to Angiotensins	10916	1418		0	0.16666666666666666	18	10898	5	12	13	10886	10916	0.28468487161291545
M1	string	0	network_modules	226	TRUE	1.54225092839061e-8	5	21	4	0.19047619047619047	0.8	GO:0003100	GO:BP	regulation of systemic arterial blood pressure by endothelin	16175	1544		0.35294117647058826	0.36538461538461536	5	16170	4	17	1	16153	16175	0.39004005033238803
M1	string	0	network_modules	226	TRUE	1.0941288526514267e-7	69	16	6	0.375	0.08695652173913043	KEGG:04924	KEGG	Renin secretion	8484	381		0.3333333333333333	0.5	69	8415	6	10	63	8405	8484	0.1775527164909375
M1	string	0	network_modules	226	TRUE	1.8634414367705438e-7	329	21	9	0.42857142857142855	0.02735562310030395	GO:0090066	GO:BP	regulation of anatomical structure size	16175	17992		0.37254901960784315	0.38461538461538464	329	15846	9	12	320	15834	16175	0.10427075700753054
M1	string	0	network_modules	226	TRUE	3.873414012982003e-7	9	21	4	0.19047619047619047	0.4444444444444444	GO:0002003	GO:BP	angiotensin maturation	16175	607		0.39215686274509803	0.4230769230769231	9	16166	4	17	5	16149	16175	0.29037655295651454
M1	string	0	network_modules	226	TRUE	3.873414012982003e-7	9	21	4	0.19047619047619047	0.4444444444444444	GO:0002002	GO:BP	regulation of angiotensin levels in blood	16175	606		0.39215686274509803	0.4230769230769231	9	16166	4	17	5	16149	16175	0.29037655295651454
M1	string	0	network_modules	226	TRUE	6.840939213535931e-7	381	21	9	0.42857142857142855	0.023622047244094488	GO:0044057	GO:BP	regulation of system process	16175	10893		0.43137254901960786	0.4423076923076923	381	15794	9	12	372	15782	16175	0.09628932081260397
M1	string	0	network_modules	226	TRUE	8.816847942379909e-7	34	21	5	0.23809523809523808	0.14705882352941177	GO:0019229	GO:BP	regulation of vasoconstriction	16175	5603		0.45098039215686275	0.46153846153846156	34	16141	5	16	29	16125	16175	0.18578419389261436
M1	string	0	network_modules	226	TRUE	8.873275808919374e-7	88	17	6	0.35294117647058826	0.06818181818181818	REAC:R-HSA-2980736	REAC	Peptide hormone metabolism	10916	1725		0.2	0.3333333333333333	88	10828	6	11	82	10817	10916	0.15231642131439807
M1	string	0	network_modules	226	TRUE	1.0583957386381562e-6	82	21	6	0.2857142857142857	0.07317073170731707	GO:0002027	GO:BP	regulation of heart rate	16175	629		0.47058823529411764	0.4807692307692308	82	16093	6	15	76	16078	16175	0.1424771971766148
M1	string	0	network_modules	226	TRUE	1.4084118882618923e-6	163	21	7	0.3333333333333333	0.04294478527607362	GO:0008016	GO:BP	regulation of heart contraction	16175	3097		0.49019607843137253	0.5	163	16012	7	14	156	15998	16175	0.11669277593287343
M1	string	0	network_modules	226	TRUE	2.7115388477519414e-6	179	21	7	0.3333333333333333	0.03910614525139665	GO:0042445	GO:BP	hormone metabolic process	16175	10185		0.5098039215686274	0.5192307692307693	179	15996	7	14	172	15982	16175	0.11107014758728355
M1	string	0	network_modules	226	TRUE	2.9050255867447783e-6	195	17	7	0.4117647058823529	0.035897435897435895	REAC:R-HSA-375276	REAC	Peptide ligand-binding receptors	10916	1726		0.4	0.5	195	10721	7	10	188	10711	10916	0.11744832099595345
M1	string	0	network_modules	226	TRUE	3.4131055012414856e-6	185	21	7	0.3333333333333333	0.03783783783783784	GO:0060047	GO:BP	heart contraction	16175	14310		0.5294117647058824	0.5384615384615384	185	15990	7	14	178	15976	16175	0.10914888079464657
M1	string	0	network_modules	226	TRUE	4.2635962545671626e-6	191	21	7	0.3333333333333333	0.03664921465968586	GO:0003015	GO:BP	heart process	16175	1466		0.5490196078431373	0.5576923076923077	191	15984	7	14	184	15970	16175	0.10731716907503644
M1	string	0	network_modules	226	TRUE	5.8627837544567415e-6	133	16	6	0.375	0.045112781954887216	KEGG:04270	KEGG	Vascular smooth muscle contraction	8484	298		0.6666666666666666	0.75	133	8351	6	10	127	8341	8484	0.12573630791036378
M1	string	0	network_modules	226	TRUE	9.335889681826667e-6	18	21	4	0.19047619047619047	0.2222222222222222	GO:0010460	GO:BP	positive regulation of heart rate	16175	4156		0.5686274509803921	0.5769230769230769	18	16157	4	17	14	16140	16175	0.20478268740351066
M1	string	0	network_modules	226	TRUE	1.1085083407547973e-5	4	21	3	0.14285714285714285	0.75	GO:0014826	GO:BP	vein smooth muscle contraction	16175	4705		0.5882352941176471	0.5961538461538461	4	16171	3	18	1	16153	16175	0.3270129708505223
M1	string	0	network_modules	226	TRUE	4.5305553069393134e-5	26	21	4	0.19047619047619047	0.15384615384615385	GO:0045823	GO:BP	positive regulation of heart contraction	16175	11643		0.6078431372549019	0.6346153846153846	26	16149	4	17	22	16132	16175	0.16998655088032633
M1	string	0	network_modules	226	TRUE	4.5305553069393134e-5	26	21	4	0.19047619047619047	0.15384615384615385	GO:1903524	GO:BP	positive regulation of blood circulation	16175	23074		0.6078431372549019	0.6346153846153846	26	16149	4	17	22	16132	16175	0.16998655088032633
M1	string	0	network_modules	226	TRUE	5.4238336509316334e-5	460	17	8	0.47058823529411764	0.017391304347826087	REAC:R-HSA-500792	REAC	GPCR ligand binding	10916	1019		0.6	0.6666666666666666	460	10456	8	9	452	10447	10916	0.08422312258955088
M1	string	0	network_modules	226	TRUE	1.0379234577803577e-4	328	17	7	0.4117647058823529	0.021341463414634148	REAC:R-HSA-373076	REAC	Class A/1 (Rhodopsin-like receptors)	10916	365		0.8	0.8333333333333334	328	10588	7	10	321	10578	10916	0.0883064353674216
M1	string	0	network_modules	226	TRUE	1.322524468796804e-4	365	16	7	0.4375	0.019178082191780823	KEGG:04080	KEGG	Neuroactive ligand-receptor interaction	8484	263		1	1	365	8119	7	9	358	8110	8484	0.08450747697993322
M1	string	0	network_modules	226	TRUE	2.13575938436644e-4	198	21	6	0.2857142857142857	0.030303030303030304	GO:0016485	GO:BP	protein processing	16175	5233		0.6470588235294118	0.6538461538461539	198	15977	6	15	192	15962	16175	0.08967025693065418
M1	string	0	network_modules	226	TRUE	3.0304523141550346e-4	41	21	4	0.19047619047619047	0.0975609756097561	GO:0051353	GO:BP	positive regulation of oxidoreductase activity	16175	13680		0.6666666666666666	0.6730769230769231	41	16134	4	17	37	16117	16175	0.1347638576034627
M1	string	0	network_modules	226	TRUE	5.31058631397783e-4	47	21	4	0.19047619047619047	0.0851063829787234	GO:0006518	GO:BP	peptide metabolic process	16175	2240		0.6862745098039216	0.6923076923076923	47	16128	4	17	43	16111	16175	0.12564325581801428
M1	string	0	network_modules	226	TRUE	6.05620010167272e-4	12	21	3	0.14285714285714285	0.25	GO:0014829	GO:BP	vascular associated smooth muscle contraction	16175	4708		0.7058823529411765	0.7307692307692307	12	16163	3	18	9	16145	16175	0.1881927954648218
M1	string	0	network_modules	226	TRUE	6.05620010167272e-4	12	21	3	0.14285714285714285	0.25	GO:0014821	GO:BP	phasic smooth muscle contraction	16175	4700		0.7058823529411765	0.7307692307692307	12	16163	3	18	9	16145	16175	0.1881927954648218
M1	string	0	network_modules	226	TRUE	0.001085302558041308	56	21	4	0.19047619047619047	0.07142857142857142	GO:0006939	GO:BP	smooth muscle contraction	16175	2577		0.7450980392156863	0.75	56	16119	4	17	52	16102	16175	0.11479555955280907
M1	string	0	network_modules	226	TRUE	0.0018404536759029728	686	21	8	0.38095238095238093	0.011661807580174927	GO:0008284	GO:BP	positive regulation of cell population proliferation	16175	3151		0.7647058823529411	0.7692307692307693	686	15489	8	13	678	15476	16175	0.06056918731116368
M1	string	0	network_modules	226	TRUE	0.0018648620036952194	64	21	4	0.19047619047619047	0.0625	GO:0051341	GO:BP	regulation of oxidoreductase activity	16175	13668		0.7843137254901961	0.7884615384615384	64	16111	4	17	60	16094	16175	0.10712401155772265
M1	string	0	network_modules	226	TRUE	0.0022350730008551182	18	21	3	0.14285714285714285	0.16666666666666666	GO:0043171	GO:BP	peptide catabolic process	16175	10567		0.803921568627451	0.8076923076923077	18	16157	3	18	15	16139	16175	0.1532861548213182
M1	string	0	network_modules	226	TRUE	0.0023609057482242633	2	21	2	0.09523809523809523	1	GO:0060584	GO:BP	regulation of prostaglandin-endoperoxide synthase activity	16175	14766		0.8235294117647058	0.9038461538461539	2	16173	2	19	0	16154	16175	0.3084253714623902
M1	string	0	network_modules	226	TRUE	0.0023609057482242633	2	21	2	0.09523809523809523	1	GO:0002019	GO:BP	regulation of renal output by angiotensin	16175	622		0.8235294117647058	0.9038461538461539	2	16173	2	19	0	16154	16175	0.3084253714623902
M1	string	0	network_modules	226	TRUE	0.0023609057482242633	2	21	2	0.09523809523809523	1	GO:0051387	GO:BP	negative regulation of neurotrophin TRK receptor signaling pathway	16175	13691		0.8235294117647058	0.9038461538461539	2	16173	2	19	0	16154	16175	0.3084253714623902
M1	string	0	network_modules	226	TRUE	0.0023609057482242633	2	21	2	0.09523809523809523	1	GO:0007199	GO:BP	G protein-coupled receptor signaling pathway coupled to cGMP nucleotide second messenger	16175	2757		0.8235294117647058	0.9038461538461539	2	16173	2	19	0	16154	16175	0.3084253714623902
M1	string	0	network_modules	226	TRUE	0.0023609057482242633	2	21	2	0.09523809523809523	1	GO:0060585	GO:BP	positive regulation of prostaglandin-endoperoxide synthase activity	16175	14767		0.8235294117647058	0.9038461538461539	2	16173	2	19	0	16154	16175	0.3084253714623902
M1	string	0	network_modules	226	TRUE	0.002410020825051276	483	21	7	0.3333333333333333	0.014492753623188406	GO:0051604	GO:BP	protein maturation	16175	13821		0.9215686274509803	0.9230769230769231	483	15692	7	14	476	15678	16175	0.06428659660697617
M1	string	0	network_modules	226	TRUE	0.002651933779897005	19	21	3	0.14285714285714285	0.15789473684210525	GO:0001974	GO:BP	blood vessel remodeling	16175	579		0.9411764705882353	0.9423076923076923	19	16156	3	18	16	16138	16175	0.1491373278339042
M1	string	0	network_modules	226	TRUE	0.004550130841691384	774	21	8	0.38095238095238093	0.0103359173126615	GO:0007186	GO:BP	G protein-coupled receptor signaling pathway	16175	2744		0.9607843137254902	0.9615384615384616	774	15401	8	13	766	15388	16175	0.05626581031053551
M1	string	0	network_modules	226	TRUE	0.004598295889188832	213	17	5	0.29411764705882354	0.023474178403755867	REAC:R-HSA-416476	REAC	G alpha (q) signalling events	10916	988		1	1	213	10703	5	12	208	10691	10916	0.07840803058031715
M1	string	0	network_modules	226	TRUE	0.007077170072321803	3	21	2	0.09523809523809523	0.6666666666666666	GO:0010814	GO:BP	substance P catabolic process	16175	4426		0.9803921568627451	1	3	16172	2	19	1	16153	16175	0.25167235521278336
M1	string	0	network_modules	226	TRUE	0.007077170072321803	3	21	2	0.09523809523809523	0.6666666666666666	GO:0014824	GO:BP	artery smooth muscle contraction	16175	4703		0.9803921568627451	1	3	16172	2	19	1	16153	16175	0.25167235521278336
M1	string	0	network_modules	229	TRUE	7.275237696565543e-18	35	14	9	0.6428571428571429	0.2571428571428571	REAC:R-HSA-2172127	REAC	DAP12 interactions	10916	432		0	0.3333333333333333	35	10881	9	5	26	10876	10916	0.40546092174487364
M1	string	0	network_modules	229	TRUE	4.246624668978558e-9	181	14	8	0.5714285714285714	0.04419889502762431	REAC:R-HSA-198933	REAC	Immunoregulatory interactions between a Lymphoid and a non-Lymphoid cell	10916	1171		0.5	0.6666666666666666	181	10735	8	6	173	10729	10916	0.15570684476804755
M1	string	0	network_modules	229	TRUE	6.61974404295423e-7	421	14	8	0.5714285714285714	0.019002375296912115	GO:0002694	GO:BP	regulation of leukocyte activation	16175	1212		0	0.023809523809523808	421	15754	8	6	413	15748	16175	0.10082156975329423
M1	string	0	network_modules	229	TRUE	1.0557847426189166e-6	699	14	9	0.6428571428571429	0.012875536480686695	GO:0045321	GO:BP	leukocyte activation	16175	11356		0.024390243902439025	0.047619047619047616	699	15476	9	5	690	15471	16175	0.08679575967706102
M1	string	0	network_modules	229	TRUE	1.5296634444081842e-6	468	14	8	0.5714285714285714	0.017094017094017096	GO:0050865	GO:BP	regulation of cell activation	16175	13313		0.04878048780487805	0.07142857142857142	468	15707	8	6	460	15701	16175	0.09525776970826871
M1	string	0	network_modules	229	TRUE	2.6652483456004395e-5	416	14	7	0.5	0.016826923076923076	GO:0002757	GO:BP	immune response-activating signaling pathway	16175	1268		0.07317073170731707	0.09523809523809523	416	15759	7	7	409	15752	16175	0.08818590963620371
M1	string	0	network_modules	229	TRUE	3.7410282074288375e-5	437	14	7	0.5	0.016018306636155607	GO:0002764	GO:BP	immune response-regulating signaling pathway	16175	1275		0.0975609756097561	0.11904761904761904	437	15738	7	7	430	15731	16175	0.08586263915249107
M1	string	0	network_modules	229	TRUE	3.762946669741834e-5	243	14	6	0.42857142857142855	0.024691358024691357	GO:0002758	GO:BP	innate immune response-activating signaling pathway	16175	1269		0.12195121951219512	0.14285714285714285	243	15932	6	8	237	15924	16175	0.10006036623528801
M1	string	0	network_modules	229	TRUE	6.025149402259886e-5	263	14	6	0.42857142857142855	0.022813688212927757	GO:0002218	GO:BP	activation of innate immune response	16175	753		0.14634146341463414	0.16666666666666666	263	15912	6	8	257	15904	16175	0.09595324439136801
M1	string	0	network_modules	229	TRUE	6.302681807574337e-5	265	14	6	0.42857142857142855	0.022641509433962263	GO:0002429	GO:BP	immune response-activating cell surface receptor signaling pathway	16175	952		0.17073170731707318	0.19047619047619047	265	15910	6	8	259	15902	16175	0.09556781061833972
M1	string	0	network_modules	229	TRUE	6.633898811074553e-5	475	14	7	0.5	0.014736842105263158	GO:0002253	GO:BP	activation of immune response	16175	785		0.1951219512195122	0.21428571428571427	475	15700	7	7	468	15693	16175	0.08204659786006321
M1	string	0	network_modules	229	TRUE	7.140839601670586e-5	124	7	4	0.5714285714285714	0.03225806451612903	KEGG:04650	KEGG	Natural killer cell mediated cytotoxicity	8484	334		0	0.5	124	8360	4	3	120	8357	8484	0.133328758777287
M1	string	0	network_modules	229	TRUE	1.011925792059733e-4	287	14	6	0.42857142857142855	0.020905923344947737	GO:0002768	GO:BP	immune response-regulating cell surface receptor signaling pathway	16175	1279		0.21951219512195122	0.23809523809523808	287	15888	6	8	281	15880	16175	0.0915922358340658
M1	string	0	network_modules	229	TRUE	1.013295574509476e-4	50	14	4	0.2857142857142857	0.08	GO:0006968	GO:BP	cellular defense response	16175	2596		0.24390243902439024	0.2619047619047619	50	16125	4	10	46	16115	16175	0.14984662894237805
M1	string	0	network_modules	229	TRUE	1.892044979721896e-4	319	14	6	0.42857142857142855	0.018808777429467086	GO:0045089	GO:BP	positive regulation of innate immune response	16175	11272		0.2682926829268293	0.2857142857142857	319	15856	6	8	313	15848	16175	0.08654573031067787
M1	string	0	network_modules	229	TRUE	2.70935078438595e-4	339	14	6	0.42857142857142855	0.017699115044247787	GO:0002833	GO:BP	positive regulation of response to biotic stimulus	16175	1343		0.2926829268292683	0.30952380952380953	339	15836	6	8	333	15828	16175	0.08375288829321052
M1	string	0	network_modules	229	TRUE	3.513686745808724e-4	177	14	5	0.35714285714285715	0.02824858757062147	GO:0002703	GO:BP	regulation of leukocyte mediated immunity	16175	1221		0.3170731707317073	0.3333333333333333	177	15998	5	9	172	15989	16175	0.09794490099467448
M1	string	0	network_modules	229	TRUE	4.377349147839536e-4	185	14	5	0.35714285714285715	0.02702702702702703	GO:0006909	GO:BP	phagocytosis	16175	2559		0.34146341463414637	0.35714285714285715	185	15990	5	9	180	15981	16175	0.09569083116709094
M1	string	0	network_modules	229	TRUE	4.413523360401481e-4	627	14	7	0.5	0.011164274322169059	GO:0050778	GO:BP	positive regulation of immune response	16175	13252		0.36585365853658536	0.38095238095238093	627	15548	7	7	620	15541	16175	0.07032776259730254
M1	string	0	network_modules	229	TRUE	4.464671486596518e-4	369	14	6	0.42857142857142855	0.016260162601626018	GO:0051249	GO:BP	regulation of lymphocyte activation	16175	13596		0.3902439024390244	0.40476190476190477	369	15806	6	8	363	15798	16175	0.07998666477752585
M1	string	0	network_modules	229	TRUE	5.263901829525189e-4	192	14	5	0.35714285714285715	0.026041666666666668	GO:0002699	GO:BP	positive regulation of immune effector process	16175	1217		0.4146341463414634	0.42857142857142855	192	15983	5	9	187	15974	16175	0.09383322708544661
M1	string	0	network_modules	229	TRUE	5.817754172393e-4	386	14	6	0.42857142857142855	0.015544041450777202	GO:0045088	GO:BP	regulation of innate immune response	16175	11271		0.43902439024390244	0.4523809523809524	386	15789	6	8	380	15781	16175	0.07804487991715969
M1	string	0	network_modules	229	TRUE	7.20863608165587e-4	81	14	4	0.2857142857142857	0.04938271604938271	GO:0050764	GO:BP	regulation of phagocytosis	16175	13238		0.4634146341463415	0.47619047619047616	81	16094	4	10	77	16084	16175	0.11704483201274954
M1	string	0	network_modules	229	TRUE	8.547141890285448e-4	69	7	3	0.42857142857142855	0.043478260869565216	KEGG:04612	KEGG	Antigen processing and presentation	8484	322		1	1	69	8415	3	4	66	8411	8484	0.1345176997386078
M1	string	0	network_modules	229	TRUE	8.721032248619976e-4	21	14	3	0.21428571428571427	0.14285714285714285	GO:1990840	GO:BP	response to lectin	16175	25313		0.4878048780487805	0.5476190476190477	21	16154	3	11	18	16143	16175	0.17409185260561777
M1	string	0	network_modules	229	TRUE	8.721032248619976e-4	21	14	3	0.21428571428571427	0.14285714285714285	GO:0002223	GO:BP	stimulatory C-type lectin receptor signaling pathway	16175	757		0.4878048780487805	0.5476190476190477	21	16154	3	11	18	16143	16175	0.17409185260561777
M1	string	0	network_modules	229	TRUE	8.721032248619976e-4	21	14	3	0.21428571428571427	0.14285714285714285	GO:1990858	GO:BP	cellular response to lectin	16175	25318		0.4878048780487805	0.5476190476190477	21	16154	3	11	18	16143	16175	0.17409185260561777
M1	string	0	network_modules	229	TRUE	8.755578800406271e-4	85	14	4	0.2857142857142857	0.047058823529411764	GO:0002220	GO:BP	innate immune response activating cell surface receptor signaling pathway	16175	754		0.5609756097560976	0.5714285714285714	85	16090	4	10	81	16080	16175	0.11417118136541317
M1	string	0	network_modules	229	TRUE	8.918977271069437e-4	2	14	2	0.14285714285714285	1	GO:0034125	GO:BP	negative regulation of MyD88-dependent toll-like receptor signaling pathway	16175	8433		0.5853658536585366	0.5952380952380952	2	16173	2	12	0	16161	16175	0.377824226446696
M1	string	0	network_modules	229	TRUE	9.949999809106204e-4	423	14	6	0.42857142857142855	0.014184397163120567	GO:0031349	GO:BP	positive regulation of defense response	16175	7140		0.6097560975609756	0.6190476190476191	423	15752	6	8	417	15744	16175	0.07421909776971197
M1	string	0	network_modules	229	TRUE	0.001136007606817632	721	14	7	0.5	0.009708737864077669	GO:0045087	GO:BP	innate immune response	16175	11270		0.6341463414634146	0.6428571428571429	721	15454	7	7	714	15447	16175	0.06495356755836795
M1	string	0	network_modules	229	TRUE	0.0011600894323542772	23	14	3	0.21428571428571427	0.13043478260869565	GO:0045954	GO:BP	positive regulation of natural killer cell mediated cytotoxicity	16175	11746		0.6585365853658537	0.6666666666666666	23	16152	3	11	20	16141	16175	0.16626424487184172
M1	string	0	network_modules	229	TRUE	0.0011946885154910285	25	14	3	0.21428571428571427	0.12	REAC:R-HSA-2424491	REAC	DAP12 signaling	10916	433		1	1	25	10891	3	11	22	10880	10916	0.15892682638423264
M1	string	0	network_modules	229	TRUE	0.0012040602422735474	92	14	4	0.2857142857142857	0.043478260869565216	GO:0002708	GO:BP	positive regulation of lymphocyte mediated immunity	16175	1226		0.6829268292682927	0.6904761904761905	92	16083	4	10	88	16073	16175	0.10959629516362333
M1	string	0	network_modules	229	TRUE	0.001447252673470077	451	14	6	0.42857142857142855	0.013303769401330377	GO:0002831	GO:BP	regulation of response to biotic stimulus	16175	1341		0.7073170731707317	0.7142857142857143	451	15724	6	8	445	15716	16175	0.07163276390442373
M1	string	0	network_modules	229	TRUE	0.001505072393870592	25	14	3	0.21428571428571427	0.12	GO:0032814	GO:BP	regulation of natural killer cell activation	16175	7838		0.7317073170731707	0.7380952380952381	25	16150	3	11	22	16139	16175	0.15939229457778828
M1	string	0	network_modules	229	TRUE	0.0015635227324874426	756	14	7	0.5	0.009259259259259259	GO:0050776	GO:BP	regulation of immune response	16175	13250		0.7560975609756098	0.7619047619047619	756	15419	7	7	749	15412	16175	0.06320242466422313
M1	string	0	network_modules	229	TRUE	0.0019121064006808203	27	14	3	0.21428571428571427	0.1111111111111111	GO:0002717	GO:BP	positive regulation of natural killer cell mediated immunity	16175	1235		0.7804878048780488	0.7857142857142857	27	16148	3	11	24	16137	16175	0.15329565532848902
M1	string	0	network_modules	229	TRUE	0.002465661318601021	110	14	4	0.2857142857142857	0.03636363636363636	GO:0002705	GO:BP	positive regulation of leukocyte mediated immunity	16175	1223		0.8048780487804879	0.8095238095238095	110	16065	4	10	106	16055	16175	0.09988661155438221
M1	string	0	network_modules	229	TRUE	0.00315678674231531	276	14	5	0.35714285714285715	0.018115942028985508	GO:0002697	GO:BP	regulation of immune effector process	16175	1215		0.8292682926829268	0.8333333333333334	276	15899	5	9	271	15890	16175	0.0772885543600313
M1	string	0	network_modules	229	TRUE	0.003742651067797151	531	14	6	0.42857142857142855	0.011299435028248588	GO:0032103	GO:BP	positive regulation of response to external stimulus	16175	7367		0.8536585365853658	0.8571428571428571	531	15644	6	8	525	15636	16175	0.06536815964903146
M1	string	0	network_modules	229	TRUE	0.005346093569584706	4	14	2	0.14285714285714285	0.5	GO:0034124	GO:BP	regulation of MyD88-dependent toll-like receptor signaling pathway	16175	8432		0.8780487804878049	0.8809523809523809	4	16171	2	12	2	16159	16175	0.26694714088648164
M1	string	0	network_modules	229	TRUE	0.0054838300145612084	38	14	3	0.21428571428571427	0.07894736842105263	GO:0042269	GO:BP	regulation of natural killer cell mediated cytotoxicity	16175	10067		0.9024390243902439	0.9047619047619048	38	16137	3	11	35	16126	16175	0.1288476693809798
M1	string	0	network_modules	229	TRUE	0.005583869094286593	569	14	6	0.42857142857142855	0.01054481546572935	GO:0046649	GO:BP	lymphocyte activation	16175	12286		0.926829268292683	0.9285714285714286	569	15606	6	8	563	15598	16175	0.06284918376500633
M1	string	0	network_modules	229	TRUE	0.0057481478842127485	136	14	4	0.2857142857142857	0.029411764705882353	GO:0002706	GO:BP	regulation of lymphocyte mediated immunity	16175	1224		0.9512195121951219	0.9523809523809523	136	16039	4	10	132	16029	16175	0.08938728571599781
M1	string	0	network_modules	229	TRUE	0.006415948967409174	40	14	3	0.21428571428571427	0.075	GO:0002715	GO:BP	regulation of natural killer cell mediated immunity	16175	1233		0.975609756097561	0.9761904761904762	40	16135	3	11	37	16124	16175	0.12551968344240563
M1	string	0	network_modules	229	TRUE	0.008023550331795257	334	14	5	0.35714285714285715	0.014970059880239521	GO:0002443	GO:BP	leukocyte mediated immunity	16175	966		1	1	334	15841	5	9	329	15832	16175	0.06964446532042617
M1	string	0	network_modules	230	TRUE	9.015640641249671e-9	42	8	5	0.625	0.11904761904761904	REAC:R-HSA-419037	REAC	NCAM1 interactions	10916	1512		0	0.125	42	10874	5	3	37	10871	10916	0.27171576664885433
M1	string	0	network_modules	230	TRUE	9.602625688533472e-9	11	8	4	0.5	0.36363636363636365	REAC:R-HSA-112308	REAC	Presynaptic depolarization and calcium channel opening	10916	1790		0.14285714285714285	0.25	11	10905	4	4	7	10901	10916	0.42591273569786137
M1	string	0	network_modules	230	TRUE	5.2852251349268245e-8	59	8	5	0.625	0.0847457627118644	REAC:R-HSA-375165	REAC	NCAM signaling for neurite out-growth	10916	1511		0.2857142857142857	0.375	59	10857	5	3	54	10854	10916	0.22885636651250432
M1	string	0	network_modules	230	TRUE	8.469097482092624e-8	84	7	5	0.7142857142857143	0.05952380952380952	KEGG:05412	KEGG	Arrhythmogenic right ventricular cardiomyopathy	8484	490		0	0.14285714285714285	84	8400	5	2	79	8398	8484	0.20443687378483064
M1	string	0	network_modules	230	TRUE	1.0130404968258047e-7	87	7	5	0.7142857142857143	0.05747126436781609	KEGG:04260	KEGG	Cardiac muscle contraction	8484	296		0.16666666666666666	0.2857142857142857	87	8397	5	2	82	8395	8484	0.20081619792449432
M1	string	0	network_modules	230	TRUE	1.7633938208725486e-7	97	7	5	0.7142857142857143	0.05154639175257732	KEGG:05410	KEGG	Hypertrophic cardiomyopathy	8484	489		0.3333333333333333	0.42857142857142855	97	8387	5	2	92	8385	8484	0.18997810403238335
M1	string	0	network_modules	230	TRUE	2.2767954530712348e-7	102	7	5	0.7142857142857143	0.049019607843137254	KEGG:05414	KEGG	Dilated cardiomyopathy	8484	491		0.5	0.5714285714285714	102	8382	5	2	97	8380	8484	0.18516312986575603
M1	string	0	network_modules	230	TRUE	1.7698043440976784e-6	153	7	5	0.7142857142857143	0.032679738562091505	KEGG:04261	KEGG	Adrenergic signaling in cardiomyocytes	8484	297		0.6666666666666666	0.7142857142857143	153	8331	5	2	148	8329	8484	0.15034902519309062
M1	string	0	network_modules	230	TRUE	1.8288290469473279e-6	154	7	5	0.7142857142857143	0.032467532467532464	KEGG:04921	KEGG	Oxytocin signaling pathway	8484	378		0.8333333333333334	0.8571428571428571	154	8330	5	2	149	8328	8484	0.1498437074750073
M1	string	0	network_modules	230	TRUE	2.0770215643685225e-6	15	18	4	0.2222222222222222	0.26666666666666666	GO:0061577	GO:BP	calcium ion transmembrane transport via high voltage-gated calcium channel	16175	15567		0	0.06666666666666667	15	16160	4	14	11	16146	16175	0.24266391979530774
M1	string	0	network_modules	230	TRUE	4.6398908819537545e-6	125	18	6	0.3333333333333333	0.048	GO:1903169	GO:BP	regulation of calcium ion transmembrane transport	16175	22802		0.07142857142857142	0.13333333333333333	125	16050	6	12	119	16038	16175	0.12410783436977625
M1	string	0	network_modules	230	TRUE	1.3399511487058091e-5	23	18	4	0.2222222222222222	0.17391304347826086	GO:1901385	GO:BP	regulation of voltage-gated calcium channel activity	16175	21435		0.14285714285714285	0.2	23	16152	4	14	19	16138	16175	0.1955792236812224
M1	string	0	network_modules	230	TRUE	2.8837778164454513e-5	15	8	3	0.375	0.2	REAC:R-HSA-5576893	REAC	Phase 2 - plateau phase	10916	1734		0.42857142857142855	0.5	15	10901	3	5	12	10896	10916	0.2731455290143974
M1	string	0	network_modules	230	TRUE	4.011239291504856e-5	179	18	6	0.3333333333333333	0.0335195530726257	GO:0051924	GO:BP	regulation of calcium ion transport	16175	13997		0.21428571428571427	0.26666666666666666	179	15996	6	12	173	15984	16175	0.10282142795115315
M1	string	0	network_modules	230	TRUE	4.1268899709536865e-5	30	18	4	0.2222222222222222	0.13333333333333333	GO:0007528	GO:BP	neuromuscular junction development	16175	3010		0.2857142857142857	0.3333333333333333	30	16145	4	14	26	16131	16175	0.17094959970795912
M1	string	0	network_modules	230	TRUE	5.230688671639695e-5	301	7	5	0.7142857142857143	0.016611295681063124	KEGG:04010	KEGG	MAPK signaling pathway	8484	243		1	1	301	8183	5	2	296	8181	8484	0.10544730474819432
M1	string	0	network_modules	230	TRUE	8.374515987038179e-5	354	18	7	0.3888888888888889	0.01977401129943503	GO:0034762	GO:BP	regulation of transmembrane transport	16175	8731		0.35714285714285715	0.4	354	15821	7	11	347	15810	16175	0.08372429679836926
M1	string	0	network_modules	230	TRUE	1.7351533373389011e-4	229	18	6	0.3333333333333333	0.026200873362445413	GO:1904062	GO:BP	regulation of monoatomic cation transmembrane transport	16175	23501		0.42857142857142855	0.4666666666666667	229	15946	6	12	223	15934	16175	0.09017504220570713
M1	string	0	network_modules	230	TRUE	2.0670555160302623e-4	28	8	3	0.375	0.10714285714285714	REAC:R-HSA-400042	REAC	Adrenaline,noradrenaline inhibits insulin secretion	10916	124		0.5714285714285714	0.625	28	10888	3	5	25	10883	10916	0.19940375049129044
M1	string	0	network_modules	230	TRUE	2.846177165534847e-4	249	18	6	0.3333333333333333	0.024096385542168676	GO:0070588	GO:BP	calcium ion transmembrane transport	16175	16193		0.5	0.5333333333333333	249	15926	6	12	243	15914	16175	0.08619681847197869
M1	string	0	network_modules	230	TRUE	3.1253026708284666e-4	32	8	3	0.375	0.09375	REAC:R-HSA-5576892	REAC	Phase 0 - rapid depolarisation	10916	1732		0.7142857142857143	0.75	32	10884	3	5	29	10879	10916	0.18637584724291806
M1	string	0	network_modules	230	TRUE	3.8420356850983085e-4	262	18	6	0.3333333333333333	0.022900763358778626	GO:0034765	GO:BP	regulation of monoatomic ion transmembrane transport	16175	8734		0.5714285714285714	0.6	262	15913	6	12	256	15901	16175	0.08385295231259432
M1	string	0	network_modules	230	TRUE	6.172624816234677e-4	284	18	6	0.3333333333333333	0.02112676056338028	GO:0010959	GO:BP	regulation of metal ion transport	16175	4536		0.6428571428571429	0.6666666666666666	284	15891	6	12	278	15879	16175	0.08024974352179699
M1	string	0	network_modules	230	TRUE	9.95098037860876e-4	65	18	4	0.2222222222222222	0.06153846153846154	GO:1901019	GO:BP	regulation of calcium ion transmembrane transporter activity	16175	21141		0.7142857142857143	0.7333333333333333	65	16110	4	14	61	16096	16175	0.11512185840219975
M1	string	0	network_modules	230	TRUE	0.0013350808511226118	324	18	6	0.3333333333333333	0.018518518518518517	GO:0006816	GO:BP	calcium ion transport	16175	2495		0.7857142857142857	0.8	324	15851	6	12	318	15839	16175	0.07463853263459334
M1	string	0	network_modules	230	TRUE	0.0017989394292845895	341	18	6	0.3333333333333333	0.017595307917888565	GO:0043269	GO:BP	regulation of monoatomic ion transport	16175	10593		0.8571428571428571	0.8666666666666667	341	15834	6	12	335	15822	16175	0.07254910968723689
M1	string	0	network_modules	230	TRUE	0.004582689092251573	95	18	4	0.2222222222222222	0.042105263157894736	GO:2001257	GO:BP	regulation of cation channel activity	16175	26443		0.9285714285714286	0.9333333333333333	95	16080	4	14	91	16066	16175	0.094503995104565
M1	string	0	network_modules	230	TRUE	0.004718177169325072	78	8	3	0.375	0.038461538461538464	REAC:R-HSA-422356	REAC	Regulation of insulin secretion	10916	2040		0.8571428571428571	0.875	78	10838	3	5	75	10833	10916	0.11827424499900885
M1	string	0	network_modules	230	TRUE	0.004953372210067279	259	8	4	0.5	0.015444015444015444	REAC:R-HSA-112315	REAC	Transmission across Chemical Synapses	10916	2580		1	1	259	10657	4	4	255	10653	10916	0.08474710693881903
M1	string	0	network_modules	230	TRUE	0.005009523127675268	3	18	2	0.1111111111111111	0.6666666666666666	GO:0098912	GO:BP	membrane depolarization during atrial cardiac muscle cell action potential	16175	18945		1	1	3	16172	2	16	1	16156	16175	0.27188774182133574
M1	string	0	network_modules	233	TRUE	5.331358654948189e-7	48	13	5	0.38461538461538464	0.10416666666666667	REAC:R-HSA-72165	REAC	mRNA Splicing - Minor Pathway	10916	2708		0	0.3333333333333333	48	10868	5	8	43	10860	10916	0.19842648090760318
M1	string	0	network_modules	233	TRUE	1.7057825403117827e-6	397	16	8	0.5	0.020151133501259445	GO:0008380	GO:BP	RNA splicing	16175	3186		0	0.25	397	15778	8	8	389	15770	16175	0.09669101030373387
M1	string	0	network_modules	233	TRUE	2.2551334800088113e-5	209	13	6	0.46153846153846156	0.028708133971291867	REAC:R-HSA-72172	REAC	mRNA Splicing	10916	2706		0.5	0.6666666666666666	209	10707	6	7	203	10700	10916	0.11147119759156728
M1	string	0	network_modules	233	TRUE	1.1726395333486261e-4	276	13	6	0.46153846153846156	0.021739130434782608	REAC:R-HSA-72203	REAC	Processing of Capped Intron-Containing Pre-mRNA	10916	1796		1	1	276	10640	6	7	270	10633	10916	0.09595701656869521
M1	string	0	network_modules	233	TRUE	0.008102637962305745	287	16	5	0.3125	0.017421602787456445	GO:0000377	GO:BP	RNA splicing, via transesterification reactions with bulged adenosine as nucleophile	16175	109		0.3333333333333333	0.75	287	15888	5	11	282	15877	16175	0.07025625055190057
M1	string	0	network_modules	233	TRUE	0.008102637962305745	287	16	5	0.3125	0.017421602787456445	GO:0000398	GO:BP	mRNA splicing, via spliceosome	16175	121		0.3333333333333333	0.75	287	15888	5	11	282	15877	16175	0.07025625055190057
M1	string	0	network_modules	233	TRUE	0.008667558048443482	291	16	5	0.3125	0.01718213058419244	GO:0000375	GO:BP	RNA splicing, via transesterification reactions	16175	107		1	1	291	15884	5	11	286	15873	16175	0.06972195898094978
M1	string	0	network_modules	234	TRUE	2.5905266299662216e-33	111	22	18	0.8181818181818182	0.16216216216216217	GO:0006413	GO:BP	translational initiation	16175	2171		0	0.047619047619047616	111	16064	18	4	93	16060	16175	0.3626874634362149
M1	string	0	network_modules	234	TRUE	3.609227927671617e-31	59	21	16	0.7619047619047619	0.2711864406779661	REAC:R-HSA-72649	REAC	Translation initiation complex formation	10916	2566		0	0.1111111111111111	59	10857	16	5	43	10852	10916	0.45298881584801065
M1	string	0	network_modules	234	TRUE	3.609227927671617e-31	59	21	16	0.7619047619047619	0.2711864406779661	REAC:R-HSA-72702	REAC	Ribosomal scanning and start codon recognition	10916	2106		0	0.1111111111111111	59	10857	16	5	43	10852	10916	0.45298881584801065
M1	string	0	network_modules	234	TRUE	4.9195417931959316e-31	60	21	16	0.7619047619047619	0.26666666666666666	REAC:R-HSA-72662	REAC	Activation of the mRNA upon binding of the cap-binding complex and eIFs, and subsequent binding to 43S	10916	105		0.11764705882352941	0.16666666666666666	60	10856	16	5	44	10851	10916	0.4491643379498736
M1	string	0	network_modules	234	TRUE	3.49150762531668e-29	43	22	14	0.6363636363636364	0.32558139534883723	GO:0002183	GO:BP	cytoplasmic translational initiation	16175	731		0.05	0.09523809523809523	43	16132	14	8	29	16124	16175	0.45419042917935343
M1	string	0	network_modules	234	TRUE	2.6219087816994282e-27	15	22	11	0.5	0.7333333333333333	GO:0001732	GO:BP	formation of cytoplasmic translation initiation complex	16175	411		0.1	0.14285714285714285	15	16160	11	11	4	16149	16175	0.6050990760855702
M1	string	0	network_modules	234	TRUE	3.059334907599547e-26	112	21	16	0.7619047619047619	0.14285714285714285	REAC:R-HSA-156827	REAC	L13a-mediated translational silencing of Ceruloplasmin expression	10916	1293		0.17647058823529413	0.2222222222222222	112	10804	16	5	96	10799	10916	0.3274694541308458
M1	string	0	network_modules	234	TRUE	3.5624161107629364e-26	113	21	16	0.7619047619047619	0.1415929203539823	REAC:R-HSA-72706	REAC	GTP hydrolysis and joining of the 60S ribosomal subunit	10916	1027		0.23529411764705882	0.2777777777777778	113	10803	16	5	97	10798	10916	0.32599260708158706
M1	string	0	network_modules	234	TRUE	9.945439345582503e-26	120	21	16	0.7619047619047619	0.13333333333333333	REAC:R-HSA-72737	REAC	Cap-dependent Translation Initiation	10916	304		0.29411764705882354	0.3888888888888889	120	10796	16	5	104	10791	10916	0.31617416569063345
M1	string	0	network_modules	234	TRUE	9.945439345582503e-26	120	21	16	0.7619047619047619	0.13333333333333333	REAC:R-HSA-72613	REAC	Eukaryotic Translation Initiation	10916	871		0.29411764705882354	0.3888888888888889	120	10796	16	5	104	10791	10916	0.31617416569063345
M1	string	0	network_modules	234	TRUE	1.617470482674729e-20	158	22	14	0.6363636363636364	0.08860759493670886	GO:0002181	GO:BP	cytoplasmic translation	16175	729		0.15	0.19047619047619047	158	16017	14	8	144	16009	16175	0.2351241056670631
M1	string	0	network_modules	234	TRUE	4.123171242101056e-20	566	22	18	0.8181818181818182	0.03180212014134275	GO:0006412	GO:BP	translation	16175	2170		0.2	0.23809523809523808	566	15609	18	4	548	15605	16175	0.1572896547931756
M1	string	0	network_modules	234	TRUE	2.6100180132603346e-19	292	21	16	0.7619047619047619	0.0547945205479452	REAC:R-HSA-72766	REAC	Translation	10916	2565		0.4117647058823529	0.4444444444444444	292	10624	16	5	276	10619	10916	0.2000336397801909
M1	string	0	network_modules	234	TRUE	9.964374366222692e-19	52	21	11	0.5238095238095238	0.21153846153846154	REAC:R-HSA-72695	REAC	Formation of the ternary complex, and subsequently, the 43S complex	10916	973		0.47058823529411764	0.5	52	10864	11	10	41	10854	10916	0.33095485009078296
M1	string	0	network_modules	234	TRUE	2.817234305792235e-15	102	21	11	0.5238095238095238	0.10784313725490197	REAC:R-HSA-72689	REAC	Formation of a pool of free 40S subunits	10916	953		0.5294117647058824	0.5555555555555556	102	10814	11	10	91	10804	10916	0.2347591323433875
M1	string	0	network_modules	234	TRUE	1.8016288386832967e-13	178	22	11	0.5	0.06179775280898876	GO:0022618	GO:BP	protein-RNA complex assembly	16175	6625		0.25	0.2857142857142857	178	15997	11	11	167	15986	16175	0.17298342858369503
M1	string	0	network_modules	234	TRUE	3.3225407552456464e-13	188	22	11	0.5	0.05851063829787234	GO:0071826	GO:BP	protein-RNA complex organization	16175	16929		0.3	0.3333333333333333	188	15987	11	11	177	15976	16175	0.16815970437350983
M1	string	0	network_modules	234	TRUE	3.859343486947754e-12	5	22	5	0.22727272727272727	1	GO:0075525	GO:BP	viral translational termination-reinitiation	16175	17758		0.35	0.38095238095238093	5	16170	5	17	0	16153	16175	0.476480627856055
M1	string	0	network_modules	234	TRUE	2.2954776941497112e-11	390	22	12	0.5454545454545454	0.03076923076923077	GO:0022613	GO:BP	ribonucleoprotein complex biogenesis	16175	6620		0.4	0.42857142857142855	390	15785	12	10	378	15775	16175	0.12542906996270561
M1	string	0	network_modules	234	TRUE	4.076087162075437e-11	290	22	11	0.5	0.03793103448275862	GO:0006417	GO:BP	regulation of translation	16175	2174		0.45	0.47619047619047616	290	15885	11	11	279	15874	16175	0.13407491144018238
M1	string	0	network_modules	234	TRUE	5.967958836780382e-11	75	22	8	0.36363636363636365	0.10666666666666667	GO:0006446	GO:BP	regulation of translational initiation	16175	2196		0.5	0.5238095238095238	75	16100	8	14	67	16086	16175	0.1950201122829232
M1	string	0	network_modules	234	TRUE	3.3449263180285855e-9	434	22	11	0.5	0.02534562211981567	GO:0010608	GO:BP	post-transcriptional regulation of gene expression	16175	4255		0.55	0.5714285714285714	434	15741	11	11	423	15730	16175	0.10806468856497324
M1	string	0	network_modules	234	TRUE	3.467191307079557e-9	4	22	4	0.18181818181818182	1	GO:1902416	GO:BP	positive regulation of mRNA binding	16175	22267		0.6	0.6666666666666666	4	16171	4	18	0	16153	16175	0.4261640521284216
M1	string	0	network_modules	234	TRUE	3.467191307079557e-9	4	22	4	0.18181818181818182	1	GO:1902415	GO:BP	regulation of mRNA binding	16175	22266		0.6	0.6666666666666666	4	16171	4	18	0	16153	16175	0.4261640521284216
M1	string	0	network_modules	234	TRUE	3.9185460009327994e-9	12	21	5	0.23809523809523808	0.4166666666666667	REAC:R-HSA-9820865	REAC	Z-decay: degradation of maternal mRNAs by zygotically expressed factors	10916	2679		0.5882352941176471	0.6111111111111112	12	10904	5	16	7	10888	10916	0.3139907891756531
M1	string	0	network_modules	234	TRUE	1.7320519161450034e-8	5	22	4	0.18181818181818182	0.8	GO:1905216	GO:BP	positive regulation of RNA binding	16175	24451		0.7	0.7142857142857143	5	16170	4	18	1	16152	16175	0.38105471123905893
M1	string	0	network_modules	234	TRUE	7.743989197411734e-8	21	22	5	0.22727272727272727	0.23809523809523808	GO:0019081	GO:BP	viral translation	16175	5571		0.75	0.7619047619047619	21	16154	5	17	16	16137	16175	0.23160004595479577
M1	string	0	network_modules	234	TRUE	1.2102779483552935e-7	7	22	4	0.18181818181818182	0.5714285714285714	GO:1905214	GO:BP	regulation of RNA binding	16175	24449		0.8	0.8095238095238095	7	16168	4	18	3	16150	16175	0.3218505283705509
M1	string	0	network_modules	234	TRUE	2.587213134442863e-7	25	21	5	0.23809523809523808	0.2	REAC:R-HSA-429947	REAC	Deadenylation of mRNA	10916	453		0.6470588235294118	0.7222222222222222	25	10891	5	16	20	10875	10916	0.2165751997709923
M1	string	0	network_modules	234	TRUE	2.587213134442863e-7	25	21	5	0.23809523809523808	0.2	REAC:R-HSA-9820841	REAC	M-decay: degradation of maternal mRNAs by maternally stored factors	10916	1344		0.6470588235294118	0.7222222222222222	25	10891	5	16	20	10875	10916	0.2165751997709923
M1	string	0	network_modules	234	TRUE	1.7908025262945627e-5	56	21	5	0.23809523809523808	0.08928571428571429	REAC:R-HSA-429914	REAC	Deadenylation-dependent mRNA decay	10916	454		0.7647058823529411	0.7777777777777778	56	10860	5	16	51	10844	10916	0.14316656216553408
M1	string	0	network_modules	234	TRUE	5.992770599806633e-5	71	21	5	0.23809523809523808	0.07042253521126761	REAC:R-HSA-1169408	REAC	ISG15 antiviral mechanism	10916	1166		0.8235294117647058	0.8333333333333334	71	10845	5	16	66	10829	10916	0.1264845056570613
M1	string	0	network_modules	234	TRUE	2.952175490161339e-4	102	22	5	0.22727272727272727	0.049019607843137254	GO:0019080	GO:BP	viral gene expression	16175	5570		0.85	0.8571428571428571	102	16073	5	17	97	16056	16175	0.10301662171835216
M1	string	0	network_modules	234	TRUE	0.00048351415682192865	11	22	3	0.13636363636363635	0.2727272727272727	GO:0075522	GO:BP	IRES-dependent viral translational initiation	16175	17755		0.9	0.9047619047619048	11	16164	3	19	8	16145	16175	0.19208150336741148
M1	string	0	network_modules	234	TRUE	6.114765526974399e-4	118	22	5	0.22727272727272727	0.0423728813559322	GO:0045727	GO:BP	positive regulation of translation	16175	11569		0.95	0.9523809523809523	118	16057	5	17	113	16040	16175	0.09539686980158112
M1	string	0	network_modules	234	TRUE	7.925396491461494e-4	119	21	5	0.23809523809523808	0.04201680672268908	REAC:R-HSA-9816359	REAC	Maternal to zygotic transition (MZT)	10916	1394		0.8823529411764706	0.8888888888888888	119	10797	5	16	114	10781	10916	0.09605744226287974
M1	string	0	network_modules	234	TRUE	0.0022389101950526275	147	21	5	0.23809523809523808	0.034013605442176874	REAC:R-HSA-1169410	REAC	Antiviral mechanism by IFN-stimulated genes	10916	157		0.9411764705882353	0.9444444444444444	147	10769	5	16	142	10753	10916	0.08556153635024448
M1	string	0	network_modules	234	TRUE	0.0038297198916125894	24	21	3	0.14285714285714285	0.125	REAC:R-HSA-166208	REAC	mTORC1-mediated signalling	10916	2711		1	1	24	10892	3	18	21	10874	10916	0.1318457729520745
M1	string	0	network_modules	234	TRUE	0.007397076397921806	350	22	6	0.2727272727272727	0.017142857142857144	GO:0016032	GO:BP	viral process	16175	5071		1	1	350	15825	6	16	344	15809	16175	0.06368699217081629
M1	string	0	network_modules	235	TRUE	7.502508893395722e-5	9	15	3	0.2	0.3333333333333333	GO:0070383	GO:BP	DNA cytosine deamination	16175	16090		0	0.07692307692307693	9	16166	3	12	6	16154	16175	0.25767172946612876
M1	string	0	network_modules	235	TRUE	1.9616637735068724e-4	12	15	3	0.2	0.25	GO:0016554	GO:BP	cytidine to uridine editing	16175	5245		0.08333333333333333	0.15384615384615385	12	16163	3	12	9	16151	16175	0.2229634354027391
M1	string	0	network_modules	235	TRUE	2.548743538256362e-4	13	15	3	0.2	0.23076923076923078	GO:0045006	GO:BP	DNA deamination	16175	11224		0.16666666666666666	0.23076923076923078	13	16162	3	12	10	16150	16175	0.21415649977466114
M1	string	0	network_modules	235	TRUE	4.050306783481016e-4	15	15	3	0.2	0.2	GO:0045869	GO:BP	negative regulation of single stranded viral RNA replication via double stranded DNA intermediate	16175	11677		0.25	0.3076923076923077	15	16160	3	12	12	16148	16175	0.19925742574257424
M1	string	0	network_modules	235	TRUE	7.251724331179435e-4	18	15	3	0.2	0.16666666666666666	GO:0045091	GO:BP	regulation of single stranded viral RNA replication via double stranded DNA intermediate	16175	11273		0.3333333333333333	0.38461538461538464	18	16157	3	12	15	16145	16175	0.18174371332799277
M1	string	0	network_modules	235	TRUE	8.606629353693945e-4	19	15	3	0.2	0.15789473684210525	GO:0039692	GO:BP	single stranded viral RNA replication via double stranded DNA intermediate	16175	9869		0.4166666666666667	0.5384615384615384	19	16156	3	12	16	16144	16175	0.17684682560957754
M1	string	0	network_modules	235	TRUE	8.606629353693945e-4	19	15	3	0.2	0.15789473684210525	GO:0016553	GO:BP	base conversion or substitution editing	16175	5244		0.4166666666666667	0.5384615384615384	19	16156	3	12	16	16144	16175	0.17684682560957754
M1	string	0	network_modules	235	TRUE	0.0016357216196144922	62	9	3	0.3333333333333333	0.04838709677419355	KEGG:03250	KEGG	Viral life cycle - HIV-1	8484	223		0	0.5	62	8422	3	6	59	8416	8484	0.12473838409971215
M1	string	0	network_modules	235	TRUE	0.002253978923787456	210	9	4	0.4444444444444444	0.01904761904761905	KEGG:05170	KEGG	Human immunodeficiency virus 1 infection	8484	451		1	1	210	8274	4	5	206	8269	8484	0.08802688110088136
M1	string	0	network_modules	235	TRUE	0.0025864295500052786	27	15	3	0.2	0.1111111111111111	GO:0006304	GO:BP	DNA modification	16175	2111		0.5833333333333334	0.6153846153846154	27	16148	3	12	24	16136	16175	0.14801920198550775
M1	string	0	network_modules	235	TRUE	0.0032274510309279613	29	15	3	0.2	0.10344827586206896	GO:0039694	GO:BP	viral RNA genome replication	16175	9871		0.6666666666666666	0.6923076923076923	29	16146	3	12	26	16134	16175	0.14274371530670452
M1	string	0	network_modules	235	TRUE	0.004373682735449354	32	15	3	0.2	0.09375	GO:0010526	GO:BP	transposable element silencing	16175	4199		0.75	0.7692307692307693	32	16143	3	12	29	16131	16175	0.135773426201086
M1	string	0	network_modules	235	TRUE	0.004808372626516765	33	15	3	0.2	0.09090909090909091	GO:0032197	GO:BP	retrotransposition	16175	7391		0.8333333333333334	0.8461538461538461	33	16142	3	12	30	16130	16175	0.13366282550790537
M1	string	0	network_modules	235	TRUE	0.005761687582763063	35	15	3	0.2	0.08571428571428572	GO:0032196	GO:BP	transposition	16175	7390		0.9166666666666666	0.9230769230769231	35	16140	3	12	32	16128	16175	0.12971468407795753
M1	string	0	network_modules	235	TRUE	0.006682065795610729	4	15	2	0.13333333333333333	0.5	GO:0032202	GO:BP	telomere assembly	16175	7394		1	1	4	16171	2	13	2	16158	16175	0.25787147420379075
M1	string	0	network_modules	237	TRUE	0.003291177469690408	5	12	2	0.16666666666666666	0.4	REAC:R-HSA-391906	REAC	Leukotriene receptors	10916	1313		NA	1	5	10911	2	10	3	10901	10916	0.2576899618144285
M1	string	0	network_modules	238	TRUE	1.1784893562136534e-4	36	7	3	0.42857142857142855	0.08333333333333333	KEGG:03030	KEGG	DNA replication	8484	214		NA	1	36	8448	3	4	33	8444	8484	0.18758677895754455
M1	string	0	network_modules	238	TRUE	0.008510555983739343	29	20	3	0.15	0.10344827586206896	GO:0006298	GO:BP	mismatch repair	16175	2107		NA	1	29	16146	3	17	26	16129	16175	0.12326601919885889
M1	string	0	network_modules	241	TRUE	2.2167443285318439e-4	10	19	3	0.15789473684210525	0.3	GO:0035871	GO:BP	protein K11-linked deubiquitination	16175	9300		0	0.1	10	16165	3	16	7	16149	16175	0.2169852164756029
M1	string	0	network_modules	241	TRUE	0.0013198831429166722	749	19	8	0.42105263157894735	0.010680907877169559	GO:0070647	GO:BP	protein modification by small protein conjugation or removal	16175	16231		0.1111111111111111	0.2	749	15426	8	11	741	15415	16175	0.06115392000739955
M1	string	0	network_modules	241	TRUE	0.0017665773513739864	2	19	2	0.10526315789473684	1	GO:0006726	GO:BP	eye pigment biosynthetic process	16175	2430		0.2222222222222222	0.5	2	16173	2	17	0	16156	16175	0.32427228087924065
M1	string	0	network_modules	241	TRUE	0.0017665773513739864	2	19	2	0.10526315789473684	1	GO:0042441	GO:BP	eye pigment metabolic process	16175	10181		0.2222222222222222	0.5	2	16173	2	17	0	16156	16175	0.32427228087924065
M1	string	0	network_modules	241	TRUE	0.0017665773513739864	2	19	2	0.10526315789473684	1	GO:0043324	GO:BP	pigment metabolic process involved in developmental pigmentation	16175	10632		0.2222222222222222	0.5	2	16173	2	17	0	16156	16175	0.32427228087924065
M1	string	0	network_modules	241	TRUE	0.002129841519561455	798	19	8	0.42105263157894735	0.010025062656641603	GO:0043687	GO:BP	post-translational protein modification	16175	10838		0.5555555555555556	0.6	798	15377	8	11	790	15366	16175	0.058861268281064125
M1	string	0	network_modules	241	TRUE	0.0037708250233749697	39	13	3	0.23076923076923078	0.07692307692307693	REAC:R-HSA-5689896	REAC	Ovarian tumor domain proteases	10916	1653		0	0.5	39	10877	3	10	36	10867	10916	0.1314852249217517
M1	string	0	network_modules	241	TRUE	0.004188003377386938	5	13	2	0.15384615384615385	0.4	REAC:R-HSA-5662702	REAC	Melanin biosynthesis	10916	1413		1	1	5	10911	2	11	3	10900	10916	0.24753500040008916
M1	string	0	network_modules	241	TRUE	0.004403726754551432	90	19	4	0.21052631578947367	0.044444444444444446	GO:0016579	GO:BP	protein deubiquitination	16175	5255		0.6666666666666666	0.7	90	16085	4	15	86	16070	16175	0.09449222997869211
M1	string	0	network_modules	241	TRUE	0.005296018232941796	3	19	2	0.10526315789473684	0.6666666666666666	GO:0043474	GO:BP	pigment metabolic process involved in pigmentation	16175	10720		0.7777777777777778	0.8	3	16172	2	17	1	16155	16175	0.26461970208734953
M1	string	0	network_modules	241	TRUE	0.009453410642189703	109	19	4	0.21052631578947367	0.03669724770642202	GO:0070646	GO:BP	protein modification by small protein removal	16175	16230		0.8888888888888888	0.9	109	16066	4	15	105	16051	16175	0.08542099470165226
M1	string	0	network_modules	241	TRUE	0.00990818471842332	33	19	3	0.15789473684210525	0.09090909090909091	GO:0048066	GO:BP	developmental pigmentation	16175	12496		1	1	33	16142	3	16	30	16126	16175	0.1184508047106856
M1	string	0	network_modules	243	TRUE	8.198323680992301e-5	32	7	3	0.42857142857142855	0.09375	KEGG:00052	KEGG	Galactose metabolism	8484	7		0	0.5	32	8452	3	4	29	8448	8484	0.1991397590817774
M1	string	0	network_modules	243	TRUE	0.009846216659474495	27	7	2	0.2857142857142857	0.07407407407407407	KEGG:00790	KEGG	Folate biosynthesis	8484	125		1	1	27	8457	2	5	25	8452	8484	0.14414710184470317
M1	string	0	network_modules	246	TRUE	2.775097715095278e-4	12	17	3	0.17647058823529413	0.25	GO:0006388	GO:BP	tRNA splicing, via endonucleolytic cleavage and ligation	16175	2152		0	0.5	12	16163	3	14	9	16149	16175	0.20934666238654798
M1	string	0	network_modules	246	TRUE	3.605284575783738e-4	13	17	3	0.17647058823529413	0.23076923076923078	GO:0000394	GO:BP	RNA splicing, via endonucleolytic cleavage and ligation	16175	119		1	1	13	16162	3	14	10	16148	16175	0.20106922580473965
M1	string	0	network_modules	246	TRUE	0.00767468224298628	55	12	3	0.25	0.05454545454545454	REAC:R-HSA-6784531	REAC	tRNA processing in the nucleus	10916	2745		NA	1	55	10861	3	9	52	10852	10916	0.1147738243609102
M1	string	0	network_modules	248	TRUE	0.003380824976026732	16	7	2	0.2857142857142857	0.125	KEGG:00360	KEGG	Phenylalanine metabolism	8484	42		NA	1	16	8468	2	5	14	8463	8484	0.18798967411231668
M1	string	0	network_modules	250	TRUE	3.898635049148085e-5	131	6	4	0.6666666666666666	0.030534351145038167	KEGG:04728	KEGG	Dopaminergic synapse	8484	358		0	0.125	131	8353	4	2	127	8351	8484	0.14050905499320357
M1	string	0	network_modules	250	TRUE	3.950192164190611e-4	64	6	3	0.5	0.046875	KEGG:04929	KEGG	GnRH secretion	8484	386		0.14285714285714285	0.25	64	8420	3	3	61	8417	8484	0.1514088713089869
M1	string	0	network_modules	250	TRUE	8.113403730564292e-4	29	11	3	0.2727272727272727	0.10344827586206896	REAC:R-HSA-1296041	REAC	Activation of G protein gated Potassium channels	10916	82		0	0.42857142857142855	29	10887	3	8	26	10879	10916	0.16663693494509232
M1	string	0	network_modules	250	TRUE	8.113403730564292e-4	29	11	3	0.2727272727272727	0.10344827586206896	REAC:R-HSA-997272	REAC	Inhibition  of voltage gated Ca2+ channels via Gbeta/gamma subunits	10916	1188		0	0.42857142857142855	29	10887	3	8	26	10879	10916	0.16663693494509232
M1	string	0	network_modules	250	TRUE	8.113403730564292e-4	29	11	3	0.2727272727272727	0.10344827586206896	REAC:R-HSA-1296059	REAC	G protein gated Potassium channels	10916	995		0	0.42857142857142855	29	10887	3	8	26	10879	10916	0.16663693494509232
M1	string	0	network_modules	250	TRUE	0.0010695495850991594	89	6	3	0.5	0.033707865168539325	KEGG:05032	KEGG	Morphine addiction	8484	420		0.2857142857142857	0.375	89	8395	3	3	86	8392	8484	0.12781608076995524
M1	string	0	network_modules	250	TRUE	0.0013856302054649813	97	6	3	0.5	0.030927835051546393	KEGG:04713	KEGG	Circadian entrainment	8484	348		0.42857142857142855	0.5	97	8387	3	3	94	8384	8484	0.12225433434182988
M1	string	0	network_modules	250	TRUE	0.0014484704857717812	35	11	3	0.2727272727272727	0.08571428571428572	REAC:R-HSA-1296065	REAC	Inwardly rectifying K+ channels	10916	1271		0.5	0.5714285714285714	35	10881	3	8	32	10873	10916	0.15141579055084173
M1	string	0	network_modules	250	TRUE	0.0021334010145917202	112	6	3	0.5	0.026785714285714284	KEGG:04726	KEGG	Serotonergic synapse	8484	356		0.5714285714285714	0.625	112	8372	3	3	109	8369	8484	0.11346328406395187
M1	string	0	network_modules	250	TRUE	0.00271917487129715	43	11	3	0.2727272727272727	0.06976744186046512	REAC:R-HSA-977444	REAC	GABA B receptor activation	10916	1010		0.6666666666666666	0.8571428571428571	43	10873	3	8	40	10865	10916	0.1362850292120363
M1	string	0	network_modules	250	TRUE	0.00271917487129715	43	11	3	0.2727272727272727	0.06976744186046512	REAC:R-HSA-991365	REAC	Activation of GABAB receptors	10916	83		0.6666666666666666	0.8571428571428571	43	10873	3	8	40	10865	10916	0.1362850292120363
M1	string	0	network_modules	250	TRUE	0.00381351064724192	136	6	3	0.5	0.022058823529411766	KEGG:04915	KEGG	Estrogen signaling pathway	8484	372		0.7142857142857143	0.75	136	8348	3	3	133	8345	8484	0.10251494658120765
M1	string	0	network_modules	250	TRUE	0.004907742810305817	148	6	3	0.5	0.02027027027027027	KEGG:04723	KEGG	Retrograde endocannabinoid signaling	8484	353		0.8571428571428571	0.875	148	8336	3	3	145	8333	8484	0.09805439100676794
M1	string	0	network_modules	250	TRUE	0.0055246700384789385	154	6	3	0.5	0.01948051948051948	KEGG:04921	KEGG	Oxytocin signaling pathway	8484	378		1	1	154	8330	3	3	151	8327	8484	0.09601894835951427
M1	string	0	network_modules	250	TRUE	0.007469634765877268	60	11	3	0.2727272727272727	0.05	REAC:R-HSA-977443	REAC	GABA receptor activation	10916	1011		1	1	60	10856	3	8	57	10848	10916	0.11479498851092422
M1	string	0	network_modules	251	TRUE	8.52020262058803e-5	184	10	5	0.5	0.02717391304347826	REAC:R-HSA-9013149	REAC	RAC1 GTPase cycle	10916	1836		0	0.5	184	10732	5	5	179	10727	10916	0.11364704170327079
M1	string	0	network_modules	251	TRUE	0.006867299052303574	449	10	5	0.5	0.011135857461024499	REAC:R-HSA-9012999	REAC	RHO GTPase cycle	10916	1847		1	1	449	10467	5	5	444	10462	10916	0.06996550971699858
M1	string	0	network_modules	251	TRUE	0.007509166212945977	242	18	5	0.2777777777777778	0.02066115702479339	GO:0051056	GO:BP	regulation of small GTPase mediated signal transduction	16175	13466		NA	1	242	15933	5	13	237	15920	16175	0.07225970922941712
M1	string	0	network_modules	252	TRUE	8.734510314481114e-5	9	17	3	0.17647058823529413	0.3333333333333333	REAC:R-HSA-390696	REAC	Adrenoceptors	10916	125		0	0.3333333333333333	9	10907	3	14	6	10893	10916	0.24169033691262573
M1	string	0	network_modules	252	TRUE	1.4482752461368308e-4	42	17	4	0.23529411764705882	0.09523809523809523	REAC:R-HSA-375280	REAC	Amine ligand-binding receptors	10916	139		0.5	0.6666666666666666	42	10874	4	13	38	10861	10916	0.14764749111371728
M1	string	0	network_modules	252	TRUE	0.0021919304915450793	328	17	6	0.35294117647058826	0.018292682926829267	REAC:R-HSA-373076	REAC	Class A/1 (Rhodopsin-like receptors)	10916	365		1	1	328	10588	6	11	322	10577	10916	0.07469819875791832
M1	string	0	network_modules	252	TRUE	0.002436912122067516	21	19	3	0.15789473684210525	0.14285714285714285	GO:0071880	GO:BP	adenylate cyclase-activating adrenergic receptor signaling pathway	16175	16961		0	0.5	21	16154	3	16	18	16138	16175	0.1491373278339042
M1	string	0	network_modules	252	TRUE	0.004746240057620695	26	19	3	0.15789473684210525	0.11538461538461539	GO:0071875	GO:BP	adrenergic receptor signaling pathway	16175	16957		1	1	26	16149	3	16	23	16133	16175	0.13378838606206206
M1	string	0	network_modules	252	TRUE	0.005201303028186909	365	12	5	0.4166666666666667	0.0136986301369863	KEGG:04080	KEGG	Neuroactive ligand-receptor interaction	8484	263		NA	1	365	8119	5	7	360	8112	8484	0.06930414479675827
M1	string	0	network_modules	253	TRUE	4.569478321236038e-14	15	20	7	0.35	0.4666666666666667	REAC:R-HSA-111447	REAC	Activation of BAD and translocation to mitochondria 	10916	76		0	0.03225806451612903	15	10901	7	13	8	10888	10916	0.4032048891562805
M1	string	0	network_modules	253	TRUE	5.122053936551264e-12	12	20	6	0.3	0.5	REAC:R-HSA-9755779	REAC	SARS-CoV-2 targets host intracellular signalling and regulatory pathways	10916	2127		0.03333333333333333	0.0967741935483871	12	10904	6	14	6	10890	10916	0.3864455936665128
M1	string	0	network_modules	253	TRUE	5.122053936551264e-12	12	20	6	0.3	0.5	REAC:R-HSA-9614399	REAC	Regulation of localization of FOXO transcription factors	10916	2042		0.03333333333333333	0.0967741935483871	12	10904	6	14	6	10890	10916	0.3864455936665128
M1	string	0	network_modules	253	TRUE	8.48699017580053e-12	54	20	8	0.4	0.14814814814814814	REAC:R-HSA-109606	REAC	Intrinsic Pathway for Apoptosis	10916	1268		0.1	0.12903225806451613	54	10862	8	12	46	10850	10916	0.2412396605917532
M1	string	0	network_modules	253	TRUE	9.501919535593077e-12	13	20	6	0.3	0.46153846153846156	REAC:R-HSA-75035	REAC	Chk1/Chk2(Cds1) mediated inactivation of Cyclin B:Cdk1 complex	10916	347		0.13333333333333333	0.16129032258064516	13	10903	6	14	7	10889	10916	0.37118814454065496
M1	string	0	network_modules	253	TRUE	1.4231488278538106e-11	30	20	7	0.35	0.23333333333333334	REAC:R-HSA-114452	REAC	Activation of BH3-only proteins	10916	77		0.16666666666666666	0.1935483870967742	30	10886	7	13	23	10873	10916	0.28418072406843187
M1	string	0	network_modules	253	TRUE	2.76529737890903e-11	15	20	6	0.3	0.4	REAC:R-HSA-9735871	REAC	SARS-CoV-1 targets host intracellular signalling and regulatory pathways	10916	2118		0.2	0.22580645161290322	15	10901	6	14	9	10887	10916	0.3453771541075371
M1	string	0	network_modules	253	TRUE	5.2430179956312226e-9	66	20	7	0.35	0.10606060606060606	REAC:R-HSA-9614085	REAC	FOXO-mediated transcription	10916	923		0.23333333333333334	0.25806451612903225	66	10850	7	13	59	10837	10916	0.19008957053759393
M1	string	0	network_modules	253	TRUE	2.992315588009076e-8	84	20	7	0.35	0.08333333333333333	REAC:R-HSA-5628897	REAC	TP53 Regulates Metabolic Genes	10916	2452		0.26666666666666666	0.2903225806451613	84	10832	7	13	77	10819	10916	0.16782787331743967
M1	string	0	network_modules	253	TRUE	1.2283837976224008e-7	157	21	8	0.38095238095238093	0.050955414012738856	KEGG:04110	KEGG	Cell cycle	8484	264		0	0.125	157	8327	8	13	149	8314	8484	0.13396720249023666
M1	string	0	network_modules	253	TRUE	1.405349747727231e-7	176	20	8	0.4	0.045454545454545456	REAC:R-HSA-109581	REAC	Apoptosis	10916	158		0.3	0.3225806451612903	176	10740	8	12	168	10728	10916	0.13058053903652023
M1	string	0	network_modules	253	TRUE	5.312918093557756e-7	208	20	8	0.4	0.038461538461538464	REAC:R-HSA-5357801	REAC	Programmed Cell Death	10916	1803		0.3333333333333333	0.3548387096774194	208	10708	8	12	200	10696	10916	0.11937733075755771
M1	string	0	network_modules	253	TRUE	8.106367051878072e-7	72	20	6	0.3	0.08333333333333333	REAC:R-HSA-1445148	REAC	Translocation of SLC2A4 (GLUT4) to the plasma membrane	10916	2578		0.36666666666666664	0.3870967741935484	72	10844	6	14	66	10830	10916	0.15529242353126388
M1	string	0	network_modules	253	TRUE	8.683360953243543e-7	201	21	8	0.38095238095238093	0.03980099502487562	KEGG:05203	KEGG	Viral carcinogenesis	8484	455		0.14285714285714285	0.25	201	8283	8	13	193	8270	8484	0.11701500456704203
M1	string	0	network_modules	253	TRUE	1.678354003836057e-6	359	20	9	0.45	0.025069637883008356	REAC:R-HSA-3700989	REAC	Transcriptional Regulation by TP53	10916	2546		0.4	0.41935483870967744	359	10557	9	11	350	10546	10916	0.10020299273069666
M1	string	0	network_modules	253	TRUE	3.831117298464171e-6	167	20	7	0.35	0.041916167664670656	REAC:R-HSA-69481	REAC	G2/M Checkpoints	10916	1005		0.43333333333333335	0.45161290322580644	167	10749	7	13	160	10736	10916	0.11683156173678441
M1	string	0	network_modules	253	TRUE	3.864126980849353e-6	93	20	6	0.3	0.06451612903225806	REAC:R-HSA-5625740	REAC	RHO GTPases activate PKNs	10916	1857		0.4666666666666667	0.4838709677419355	93	10823	6	14	87	10809	10916	0.13587483338610773
M1	string	0	network_modules	253	TRUE	4.088597618348745e-6	158	21	7	0.3333333333333333	0.04430379746835443	KEGG:05160	KEGG	Hepatitis C	8484	441		0.2857142857142857	0.375	158	8326	7	14	151	8312	8484	0.11596101059101357
M1	string	0	network_modules	253	TRUE	4.123027626069543e-6	94	20	6	0.3	0.06382978723404255	REAC:R-HSA-69473	REAC	G2/M DNA damage checkpoint	10916	1006		0.5	0.5161290322580645	94	10822	6	14	88	10808	10916	0.13511392855851043
M1	string	0	network_modules	253	TRUE	4.396119505400649e-6	95	20	6	0.3	0.06315789473684211	REAC:R-HSA-9692914	REAC	SARS-CoV-1-host interactions	10916	2119		0.5333333333333333	0.5483870967741935	95	10821	6	14	89	10807	10916	0.13436487560291507
M1	string	0	network_modules	253	TRUE	4.412190828699773e-6	356	21	9	0.42857142857142855	0.025280898876404494	KEGG:04151	KEGG	PI3K-Akt signaling pathway	8484	285		0.42857142857142855	0.5	356	8128	9	12	347	8116	8484	0.09605157137522372
M1	string	0	network_modules	253	TRUE	7.075194573657388e-6	289	20	8	0.4	0.02768166089965398	REAC:R-HSA-69620	REAC	Cell Cycle Checkpoints	10916	321		0.5666666666666667	0.5806451612903226	289	10627	8	12	281	10615	10916	0.0996805687902379
M1	string	0	network_modules	253	TRUE	1.4903681473522128e-5	318	20	8	0.4	0.025157232704402517	REAC:R-HSA-195258	REAC	RHO GTPase Effectors	10916	1846		0.6	0.6129032258064516	318	10598	8	12	310	10586	10916	0.09447988351319335
M1	string	0	network_modules	253	TRUE	4.0329398047154055e-5	26	20	4	0.2	0.15384615384615385	REAC:R-HSA-5674400	REAC	Constitutive Signaling by AKT1 E17K in Cancer	10916	400		0.6333333333333333	0.6451612903225806	26	10890	4	16	22	10874	10916	0.17368857348769814
M1	string	0	network_modules	253	TRUE	4.51475680198331e-5	140	20	6	0.3	0.04285714285714286	REAC:R-HSA-9678108	REAC	SARS-CoV-1 Infection	10916	2114		0.6666666666666666	0.6774193548387096	140	10776	6	14	134	10762	10916	0.10934488683379598
M1	string	0	network_modules	253	TRUE	7.317081832739095e-5	477	20	8	0.4	0.016771488469601678	GO:0009896	GO:BP	positive regulation of catabolic process	16175	3756		0	0.06666666666666667	477	15698	8	12	469	15686	16175	0.07705919049684722
M1	string	0	network_modules	253	TRUE	1.0977786065822174e-4	187	20	6	0.3	0.03208556149732621	GO:0031669	GO:BP	cellular response to nutrient levels	16175	7272		0.07142857142857142	0.13333333333333333	187	15988	6	14	181	15974	16175	0.09493838449930915
M1	string	0	network_modules	253	TRUE	1.7717426370515406e-4	292	20	7	0.35	0.023972602739726026	REAC:R-HSA-9694516	REAC	SARS-CoV-2 Infection	10916	2122		0.7	0.7096774193548387	292	10624	7	13	285	10611	10916	0.08583184017510741
M1	string	0	network_modules	253	TRUE	3.0841142274007594e-4	575	20	8	0.4	0.01391304347826087	GO:0044092	GO:BP	negative regulation of molecular function	16175	10914		0.14285714285714285	0.2	575	15600	8	12	567	15588	16175	0.06925467643840079
M1	string	0	network_modules	253	TRUE	3.3957928698804217e-4	197	20	6	0.3	0.030456852791878174	REAC:R-HSA-9705683	REAC	SARS-CoV-2-host interactions	10916	2128		0.7333333333333333	0.7419354838709677	197	10719	6	14	191	10705	10916	0.0907426791057158
M1	string	0	network_modules	253	TRUE	6.385722337373682e-4	14	20	3	0.15	0.21428571428571427	REAC:R-HSA-198323	REAC	AKT phosphorylates targets in the cytosol	10916	14		0.7666666666666667	0.7741935483870968	14	10902	3	17	11	10885	10916	0.17802864463696338
M1	string	0	network_modules	253	TRUE	8.035814263610686e-4	262	20	6	0.3	0.022900763358778626	GO:0031667	GO:BP	response to nutrient levels	16175	7271		0.21428571428571427	0.26666666666666666	262	15913	6	14	256	15899	16175	0.07910334184422996
M1	string	0	network_modules	253	TRUE	8.645690218323338e-4	138	20	5	0.25	0.036231884057971016	GO:0009267	GO:BP	cellular response to starvation	16175	3432		0.2857142857142857	0.3333333333333333	138	16037	5	15	133	16022	16175	0.09237721188308462
M1	string	0	network_modules	253	TRUE	8.72978234616603e-4	131	21	5	0.23809523809523808	0.03816793893129771	KEGG:04114	KEGG	Oocyte meiosis	8484	268		0.5714285714285714	0.625	131	8353	5	16	126	8337	8484	0.08995442799985008
M1	string	0	network_modules	253	TRUE	9.228998194693856e-4	443	20	7	0.35	0.01580135440180587	GO:0043549	GO:BP	regulation of kinase activity	16175	10763		0.35714285714285715	0.4	443	15732	7	13	436	15719	16175	0.06954926848306599
M1	string	0	network_modules	253	TRUE	0.0011828342115446663	147	20	5	0.25	0.034013605442176874	GO:0006469	GO:BP	negative regulation of protein kinase activity	16175	2208		0.42857142857142855	0.4666666666666667	147	16028	5	15	142	16013	16175	0.08932349889010041
M1	string	0	network_modules	253	TRUE	0.0015873144837409764	156	20	5	0.25	0.03205128205128205	GO:0033673	GO:BP	negative regulation of kinase activity	16175	8345		0.5	0.5333333333333333	156	16019	5	15	151	16004	16175	0.08653261870888018
M1	string	0	network_modules	253	TRUE	0.001646669767592923	72	21	4	0.19047619047619047	0.05555555555555555	KEGG:05223	KEGG	Non-small cell lung cancer	8484	474		0.7142857142857143	0.75	72	8412	4	17	68	8395	8484	0.098827746532307
M1	string	0	network_modules	253	TRUE	0.0017236299827560857	721	20	8	0.4	0.011095700416088766	GO:0045087	GO:BP	innate immune response	16175	11270		0.5714285714285714	0.6	721	15454	8	12	713	15442	16175	0.06059903927270571
M1	string	0	network_modules	253	TRUE	0.001744009511806684	159	20	5	0.25	0.031446540880503145	GO:0042594	GO:BP	response to starvation	16175	10254		0.6428571428571429	0.6666666666666666	159	16016	5	15	154	16001	16175	0.08565426638747932
M1	string	0	network_modules	253	TRUE	0.001950308599356037	418	20	7	0.35	0.01674641148325359	REAC:R-HSA-5663202	REAC	Diseases of signal transduction by growth factor receptors and second messengers	10916	773		0.8	0.8064516129032258	418	10498	7	13	411	10485	10916	0.06959065483017658
M1	string	0	network_modules	253	TRUE	0.0020982064765555277	157	21	5	0.23809523809523808	0.03184713375796178	KEGG:04390	KEGG	Hippo signaling pathway	8484	310		0.8571428571428571	0.875	157	8327	5	16	152	8311	8484	0.08116451975262143
M1	string	0	network_modules	253	TRUE	0.002314230743942589	21	20	3	0.15	0.14285714285714285	REAC:R-HSA-8863678	REAC	Neurodegenerative Diseases	10916	1588		0.8333333333333334	0.8709677419354839	21	10895	3	17	18	10878	10916	0.14477948506952504
M1	string	0	network_modules	253	TRUE	0.002314230743942589	21	20	3	0.15	0.14285714285714285	REAC:R-HSA-8862803	REAC	Deregulated CDK5 triggers multiple neurodegenerative pathways in Alzheimer's disease models	10916	733		0.8333333333333334	0.8709677419354839	21	10895	3	17	18	10878	10916	0.14477948506952504
M1	string	0	network_modules	253	TRUE	0.0024349533137721048	512	20	7	0.35	0.013671875	GO:0051338	GO:BP	regulation of transferase activity	16175	13665		0.7142857142857143	0.7333333333333333	512	15663	7	13	505	15650	16175	0.06397835065102274
M1	string	0	network_modules	253	TRUE	0.002439770991204797	162	21	5	0.23809523809523808	0.030864197530864196	KEGG:05161	KEGG	Hepatitis B	8484	442		1	1	162	8322	5	16	157	8306	8484	0.07971165452217903
M1	string	0	network_modules	253	TRUE	0.0030424178224940923	178	20	5	0.25	0.028089887640449437	GO:0051348	GO:BP	negative regulation of transferase activity	16175	13675		0.7857142857142857	0.8	178	15997	5	15	173	15982	16175	0.08060574710626581
M1	string	0	network_modules	253	TRUE	0.0033872597934140347	293	20	6	0.3	0.020477815699658702	REAC:R-HSA-9006925	REAC	Intracellular signaling by second messengers	10916	1266		0.9	0.9032258064516129	293	10623	6	14	287	10609	10916	0.07241066901787208
M1	string	0	network_modules	253	TRUE	0.0035094784688445447	24	20	3	0.15	0.125	REAC:R-HSA-9734009	REAC	Defective Intrinsic Pathway for Apoptosis	10916	572		0.9333333333333333	0.9354838709677419	24	10892	3	17	21	10875	10916	0.13519606957514896
M1	string	0	network_modules	253	TRUE	0.0036093213828626383	459	20	7	0.35	0.015250544662309368	REAC:R-HSA-9679506	REAC	SARS-CoV Infections	10916	2112		0.9666666666666667	0.967741935483871	459	10457	7	13	452	10444	10916	0.06573816677294025
M1	string	0	network_modules	253	TRUE	0.006512436560669125	92	20	4	0.2	0.043478260869565216	GO:1903432	GO:BP	regulation of TORC1 signaling	16175	23003		0.8571428571428571	0.8666666666666667	92	16083	4	16	88	16067	16175	0.09091351578689222
M1	string	0	network_modules	253	TRUE	0.006974921103044978	92	20	4	0.2	0.043478260869565216	REAC:R-HSA-2219528	REAC	PI3K/AKT Signaling in Cancer	10916	1674		1	1	92	10824	4	16	88	10808	10916	0.08978198753849509
M1	string	0	network_modules	253	TRUE	0.007627065395846844	386	20	6	0.3	0.015544041450777202	GO:0045088	GO:BP	regulation of innate immune response	16175	11271		0.9285714285714286	0.9333333333333333	386	15789	6	14	380	15775	16175	0.06365871829356648
M1	string	0	network_modules	253	TRUE	0.008043663661391864	97	20	4	0.2	0.041237113402061855	GO:0038202	GO:BP	TORC1 signaling	16175	9766		1	1	97	16078	4	16	93	16062	16175	0.08841227718885022
M1	string	0	network_modules	254	TRUE	7.344173587895144e-10	11	17	5	0.29411764705882354	0.45454545454545453	REAC:R-HSA-1362409	REAC	Mitochondrial iron-sulfur cluster biogenesis	10916	1466		0	0.2	11	10905	5	12	6	10893	10916	0.3648514260827194
M1	string	0	network_modules	254	TRUE	1.1370769517676937e-9	11	20	5	0.25	0.45454545454545453	GO:0044571	GO:BP	[2Fe-2S] cluster assembly	16175	11083		0	0.25	11	16164	5	15	6	16149	16175	0.3365054117726584
M1	string	0	network_modules	254	TRUE	2.882382964695921e-7	29	20	5	0.25	0.1724137931034483	GO:0016226	GO:BP	iron-sulfur cluster assembly	16175	5177		0.3333333333333333	0.75	29	16146	5	15	24	16131	16175	0.20643748068771248
M1	string	0	network_modules	254	TRUE	2.882382964695921e-7	29	20	5	0.25	0.1724137931034483	GO:0031163	GO:BP	metallo-sulfur cluster assembly	16175	7078		0.3333333333333333	0.75	29	16146	5	15	24	16131	16175	0.20643748068771248
M1	string	0	network_modules	254	TRUE	2.373612443413537e-5	5	20	3	0.15	0.6	GO:0044572	GO:BP	[4Fe-4S] cluster assembly	16175	11084		1	1	5	16170	3	17	2	16153	16175	0.2996133346554642
M1	string	0	network_modules	254	TRUE	4.114271149131254e-5	31	17	4	0.23529411764705882	0.12903225806451613	REAC:R-HSA-389661	REAC	Glyoxylate metabolism and glycine degradation	10916	1081		0.25	0.4	31	10885	4	13	27	10872	10916	0.17251906186444177
M1	string	0	network_modules	254	TRUE	0.0022807807055670263	3	17	2	0.11764705882352941	0.6666666666666666	REAC:R-HSA-2395516	REAC	Electron transport from NADPH to Ferredoxin	10916	838		0.5	0.6	3	10913	2	15	1	10898	10916	0.2796580487130793
M1	string	0	network_modules	254	TRUE	0.004374861034452472	370	17	6	0.35294117647058826	0.016216216216216217	REAC:R-HSA-71291	REAC	Metabolism of amino acids and derivatives	10916	1421		0.75	0.8	370	10546	6	11	364	10535	10916	0.06963108914554265
M1	string	0	network_modules	254	TRUE	0.004557382052659219	4	17	2	0.11764705882352941	0.5	REAC:R-HSA-5579026	REAC	Defective CYP11A1 causes AICSR	10916	514		1	1	4	10912	2	15	2	10897	10916	0.2420130338313592
M1	string	0	network_modules	254	TRUE	0.004824537106169319	10	12	2	0.16666666666666666	0.2	KEGG:00920	KEGG	Sulfur metabolism	8484	140		NA	1	10	8474	2	10	8	8464	8484	0.1815183467704569
M1	string	0	network_modules	255	TRUE	1.9794744791428202e-16	158	21	12	0.5714285714285714	0.0759493670886076	GO:0050851	GO:BP	antigen receptor-mediated signaling pathway	16175	13299		0	0.017241379310344827	158	16017	12	9	146	16008	16175	0.2059057996487255
M1	string	0	network_modules	255	TRUE	6.358307909993229e-16	114	21	11	0.5238095238095238	0.09649122807017543	GO:0050852	GO:BP	T cell receptor signaling pathway	16175	13300		0.017543859649122806	0.034482758620689655	114	16061	11	10	103	16051	16175	0.22272318251571446
M1	string	0	network_modules	255	TRUE	3.473040304646702e-15	287	21	13	0.6190476190476191	0.04529616724738676	GO:0002768	GO:BP	immune response-regulating cell surface receptor signaling pathway	16175	1279		0.03508771929824561	0.05172413793103448	287	15888	13	8	274	15880	16175	0.1642224632476979
M1	string	0	network_modules	255	TRUE	8.568465582108269e-15	569	21	15	0.7142857142857143	0.026362038664323375	GO:0046649	GO:BP	lymphocyte activation	16175	12286		0.05263157894736842	0.06896551724137931	569	15606	15	6	554	15600	16175	0.13290789842048992
M1	string	0	network_modules	255	TRUE	1.1058143814557449e-13	265	21	12	0.5714285714285714	0.045283018867924525	GO:0002429	GO:BP	immune response-activating cell surface receptor signaling pathway	16175	952		0.07017543859649122	0.08620689655172414	265	15910	12	9	253	15901	16175	0.15764647774363275
M1	string	0	network_modules	255	TRUE	1.8541445643815785e-13	699	21	15	0.7142857142857143	0.02145922746781116	GO:0045321	GO:BP	leukocyte activation	16175	11356		0.08771929824561403	0.10344827586206896	699	15476	15	6	684	15470	16175	0.11899106197917662
M1	string	0	network_modules	255	TRUE	5.476019045899858e-13	20	20	7	0.35	0.35	REAC:R-HSA-202430	REAC	Translocation of ZAP-70 to Immunological synapse	10916	2579		0	0.05	20	10896	7	13	13	10883	10916	0.3488069016152716
M1	string	0	network_modules	255	TRUE	8.423287254239064e-13	437	21	13	0.6190476190476191	0.029748283752860413	GO:0002764	GO:BP	immune response-regulating signaling pathway	16175	1275		0.10526315789473684	0.1206896551724138	437	15738	13	8	424	15730	16175	0.13165658193942317
M1	string	0	network_modules	255	TRUE	2.0478907891720266e-12	468	21	13	0.6190476190476191	0.027777777777777776	GO:0050865	GO:BP	regulation of cell activation	16175	13313		0.12280701754385964	0.13793103448275862	468	15707	13	8	455	15699	16175	0.12693468970229507
M1	string	0	network_modules	255	TRUE	5.9799973318733895e-12	369	21	12	0.5714285714285714	0.032520325203252036	GO:0051249	GO:BP	regulation of lymphocyte activation	16175	13596		0.14035087719298245	0.15517241379310345	369	15806	12	9	357	15797	16175	0.1324823030151037
M1	string	0	network_modules	255	TRUE	1.877095911731516e-11	406	21	12	0.5714285714285714	0.029556650246305417	GO:0042110	GO:BP	T cell activation	16175	9970		0.15789473684210525	0.1724137931034483	406	15769	12	9	394	15760	16175	0.12592221341110632
M1	string	0	network_modules	255	TRUE	2.5103903725415015e-11	416	21	12	0.5714285714285714	0.028846153846153848	GO:0002757	GO:BP	immune response-activating signaling pathway	16175	1268		0.17543859649122806	0.1896551724137931	416	15759	12	9	404	15750	16175	0.124298163749952
M1	string	0	network_modules	255	TRUE	2.8953327864112336e-11	421	21	12	0.5714285714285714	0.028503562945368172	GO:0002694	GO:BP	regulation of leukocyte activation	16175	1212		0.19298245614035087	0.20689655172413793	421	15754	12	9	409	15745	16175	0.12350745148028489
M1	string	0	network_modules	255	TRUE	4.1404772760611833e-11	206	21	10	0.47619047619047616	0.04854368932038835	GO:0030217	GO:BP	T cell differentiation	16175	6725		0.21052631578947367	0.22413793103448276	206	15969	10	11	196	15958	16175	0.14902145038653666
M1	string	0	network_modules	255	TRUE	4.1639155352120455e-11	119	18	9	0.5	0.07563025210084033	KEGG:04660	KEGG	T cell receptor signaling pathway	8484	338		0	0.1111111111111111	119	8365	9	9	110	8356	8484	0.19054782764912567
M1	string	0	network_modules	255	TRUE	5.252752100546056e-11	67	20	8	0.4	0.11940298507462686	REAC:R-HSA-388841	REAC	Regulation of T cell activation by CD28 family	10916	2007		0.05263157894736842	0.1	67	10849	8	12	59	10837	10916	0.21605138102666493
M1	string	0	network_modules	255	TRUE	1.2194472928845655e-10	475	21	12	0.5714285714285714	0.02526315789473684	GO:0002253	GO:BP	activation of immune response	16175	785		0.22807017543859648	0.2413793103448276	475	15700	12	9	463	15691	16175	0.11576211216181548
M1	string	0	network_modules	255	TRUE	5.528468804440124e-10	23	20	6	0.3	0.2608695652173913	REAC:R-HSA-202427	REAC	Phosphorylation of CD3 and TCR zeta chains	10916	1749		0.10526315789473684	0.15	23	10893	6	14	17	10879	10916	0.27833486292877846
M1	string	0	network_modules	255	TRUE	7.540556807679571e-10	275	21	10	0.47619047619047616	0.03636363636363636	GO:0002696	GO:BP	positive regulation of leukocyte activation	16175	1214		0.24561403508771928	0.25862068965517243	275	15900	10	11	265	15889	16175	0.12806793254718501
M1	string	0	network_modules	255	TRUE	9.714051490671996e-10	756	21	13	0.6190476190476191	0.017195767195767195	GO:0050776	GO:BP	regulation of immune response	16175	13250		0.2631578947368421	0.27586206896551724	756	15419	13	8	743	15411	16175	0.09775868205577228
M1	string	0	network_modules	255	TRUE	1.0401876765269502e-9	284	21	10	0.47619047619047616	0.035211267605633804	GO:0050863	GO:BP	regulation of T cell activation	16175	13311		0.2807017543859649	0.29310344827586204	284	15891	10	11	274	15880	16175	0.12590528368944098
M1	string	0	network_modules	255	TRUE	1.2815291951480116e-9	290	21	10	0.47619047619047616	0.034482758620689655	GO:0050867	GO:BP	positive regulation of cell activation	16175	13315		0.2982456140350877	0.3103448275862069	290	15885	10	11	280	15874	16175	0.12451874387562255
M1	string	0	network_modules	255	TRUE	1.6256515646891138e-9	297	21	10	0.47619047619047616	0.03367003367003367	GO:0030098	GO:BP	lymphocyte differentiation	16175	6676		0.3157894736842105	0.3275862068965517	297	15878	10	11	287	15867	16175	0.12295349813788872
M1	string	0	network_modules	255	TRUE	3.25783508230759e-9	627	21	12	0.5714285714285714	0.019138755980861243	GO:0050778	GO:BP	positive regulation of immune response	16175	13252		0.3333333333333333	0.3448275862068966	627	15548	12	9	615	15539	16175	0.09949403889737019
M1	string	0	network_modules	255	TRUE	6.423063958796121e-9	120	20	8	0.4	0.06666666666666667	REAC:R-HSA-202403	REAC	TCR signaling	10916	2422		0.15789473684210525	0.2	120	10796	8	12	112	10784	10916	0.15983809349454095
M1	string	0	network_modules	255	TRUE	8.772634259679463e-9	35	20	6	0.3	0.17142857142857143	REAC:R-HSA-202433	REAC	Generation of second messenger molecules	10916	1044		0.21052631578947367	0.25	35	10881	6	14	29	10867	10916	0.2249216311046814
M1	string	0	network_modules	255	TRUE	1.0116578463565275e-8	357	21	10	0.47619047619047616	0.028011204481792718	GO:1903131	GO:BP	mononuclear cell differentiation	16175	22787		0.3508771929824561	0.3620689655172414	357	15818	10	11	347	15807	16175	0.11144845156713616
M1	string	0	network_modules	255	TRUE	1.546357477425653e-8	249	21	9	0.42857142857142855	0.03614457831325301	GO:0051251	GO:BP	positive regulation of lymphocyte activation	16175	13598		0.3684210526315789	0.3793103448275862	249	15926	9	12	240	15914	16175	0.1210033303393912
M1	string	0	network_modules	255	TRUE	1.9614215987905225e-8	89	18	7	0.3888888888888889	0.07865168539325842	KEGG:05235	KEGG	PD-L1 expression and PD-1 checkpoint pathway in cancer	8484	480		0.125	0.2222222222222222	89	8395	7	11	82	8384	8484	0.17125446172313288
M1	string	0	network_modules	255	TRUE	2.4852809867668506e-8	92	18	7	0.3888888888888889	0.07608695652173914	KEGG:04640	KEGG	Hematopoietic cell lineage	8484	333		0.25	0.3333333333333333	92	8392	7	11	85	8381	8484	0.16831180097383172
M1	string	0	network_modules	255	TRUE	6.950404033553403e-8	434	21	10	0.47619047619047616	0.02304147465437788	GO:0002521	GO:BP	leukocyte differentiation	16175	1043		0.38596491228070173	0.39655172413793105	434	15741	10	11	424	15730	16175	0.10026428600050824
M1	string	0	network_modules	255	TRUE	1.1950839284961137e-7	638	21	11	0.5238095238095238	0.017241379310344827	GO:0030097	GO:BP	hemopoiesis	16175	6675		0.40350877192982454	0.41379310344827586	638	15537	11	10	627	15527	16175	0.08972088937244407
M1	string	0	network_modules	255	TRUE	1.688032313462538e-7	24	20	5	0.25	0.20833333333333334	REAC:R-HSA-389948	REAC	Co-inhibition by PD-1	10916	377		0.2631578947368421	0.3	24	10892	5	15	19	10877	10916	0.2266675146899578
M1	string	0	network_modules	255	TRUE	2.0585842755637055e-7	124	18	7	0.3888888888888889	0.056451612903225805	KEGG:04650	KEGG	Natural killer cell mediated cytotoxicity	8484	334		0.375	0.4444444444444444	124	8360	7	11	117	8349	8484	0.14380449510778961
M1	string	0	network_modules	255	TRUE	2.1537080866477697e-7	8	21	4	0.19047619047619047	0.5	GO:0045059	GO:BP	positive thymic T cell selection	16175	11257		0.42105263157894735	0.43103448275862066	8	16167	4	17	4	16150	16175	0.30808157498845967
M1	string	0	network_modules	255	TRUE	6.026252840003097e-7	37	18	5	0.2777777777777778	0.13513513513513514	KEGG:05340	KEGG	Primary immunodeficiency	8484	488		0.5	0.5555555555555556	37	8447	5	13	32	8434	8484	0.19132450268664275
M1	string	0	network_modules	255	TRUE	7.676050471544757e-7	386	21	9	0.42857142857142855	0.023316062176165803	GO:0022407	GO:BP	regulation of cell-cell adhesion	16175	6598		0.43859649122807015	0.4482758620689655	386	15789	9	12	377	15777	16175	0.09560577407433506
M1	string	0	network_modules	255	TRUE	1.0127597834840484e-6	11	21	4	0.19047619047619047	0.36363636363636365	GO:0045061	GO:BP	thymic T cell selection	16175	11259		0.45614035087719296	0.46551724137931033	11	16164	4	17	7	16147	16175	0.26250071076780146
M1	string	0	network_modules	255	TRUE	1.159857883773299e-6	89	18	6	0.3333333333333333	0.06741573033707865	KEGG:04658	KEGG	Th1 and Th2 cell differentiation	8484	336		0.625	0.6666666666666666	89	8395	6	12	83	8383	8484	0.14611129809770354
M1	string	0	network_modules	255	TRUE	1.3777708171028432e-6	37	21	5	0.23809523809523808	0.13513513513513514	GO:0045058	GO:BP	T cell selection	16175	11256		0.47368421052631576	0.4827586206896552	37	16138	5	16	32	16122	16175	0.1779697817709677
M1	string	0	network_modules	255	TRUE	2.183432365678585e-6	287	21	8	0.38095238095238093	0.027874564459930314	GO:1903037	GO:BP	regulation of leukocyte cell-cell adhesion	16175	22717		0.49122807017543857	0.5	287	15888	8	13	279	15875	16175	0.09919616328315692
M1	string	0	network_modules	255	TRUE	3.1499420825616194e-6	105	18	6	0.3333333333333333	0.05714285714285714	KEGG:04659	KEGG	Th17 cell differentiation	8484	337		0.75	0.7777777777777778	105	8379	6	12	99	8367	8484	0.13386098521398102
M1	string	0	network_modules	255	TRUE	4.925605260628769e-6	195	21	7	0.3333333333333333	0.035897435897435895	GO:0050870	GO:BP	positive regulation of T cell activation	16175	13318		0.5087719298245614	0.5172413793103449	195	15980	7	14	188	15966	16175	0.10614236874057183
M1	string	0	network_modules	255	TRUE	5.306712741395362e-6	98	20	6	0.3	0.061224489795918366	REAC:R-HSA-202424	REAC	Downstream TCR signaling	10916	789		0.3157894736842105	0.35	98	10818	6	14	92	10804	10916	0.13218579830706342
M1	string	0	network_modules	255	TRUE	5.6717084390449225e-6	324	21	8	0.38095238095238093	0.024691358024691357	GO:0007159	GO:BP	leukocyte cell-cell adhesion	16175	2723		0.5263157894736842	0.5344827586206896	324	15851	8	13	316	15838	16175	0.09288076328718181
M1	string	0	network_modules	255	TRUE	9.70716002074161e-6	215	21	7	0.3333333333333333	0.03255813953488372	GO:1903039	GO:BP	positive regulation of leukocyte cell-cell adhesion	16175	22719		0.543859649122807	0.5517241379310345	215	15960	7	14	208	15946	16175	0.10075906659060752
M1	string	0	network_modules	255	TRUE	1.3229816647198114e-5	745	21	10	0.47619047619047616	0.013422818791946308	GO:0098609	GO:BP	cell-cell adhesion	16175	18805		0.5614035087719298	0.5689655172413793	745	15430	10	11	735	15419	16175	0.07398680825873834
M1	string	0	network_modules	255	TRUE	3.3316301930117034e-5	257	21	7	0.3333333333333333	0.027237354085603113	GO:0022409	GO:BP	positive regulation of cell-cell adhesion	16175	6600		0.5789473684210527	0.5862068965517241	257	15918	7	14	250	15904	16175	0.09153159946248575
M1	string	0	network_modules	255	TRUE	4.728763860183331e-5	27	20	4	0.2	0.14814814814814814	REAC:R-HSA-164952	REAC	The role of Nef in HIV-1 replication and disease pathogenesis	10916	2504		0.3684210526315789	0.4	27	10889	4	16	23	10873	10916	0.1703705836778622
M1	string	0	network_modules	255	TRUE	4.958109304846234e-5	622	21	9	0.42857142857142855	0.014469453376205787	GO:0030155	GO:BP	regulation of cell adhesion	16175	6688		0.5964912280701754	0.603448275862069	622	15553	9	12	613	15541	16175	0.07314868466981728
M1	string	0	network_modules	255	TRUE	8.34074229514262e-5	169	21	6	0.2857142857142857	0.03550295857988166	GO:0050670	GO:BP	regulation of lymphocyte proliferation	16175	13204		0.6140350877192983	0.6206896551724138	169	16006	6	15	163	15991	16175	0.09760719008419066
M1	string	0	network_modules	255	TRUE	8.945956059946949e-5	171	21	6	0.2857142857142857	0.03508771929824561	GO:0032944	GO:BP	regulation of mononuclear cell proliferation	16175	7929		0.631578947368421	0.6379310344827587	171	16004	6	15	165	15989	16175	0.09699718188137191
M1	string	0	network_modules	255	TRUE	9.49533433906798e-5	31	21	4	0.19047619047619047	0.12903225806451613	GO:0043368	GO:BP	positive T cell selection	16175	10645		0.6491228070175439	0.6551724137931034	31	16144	4	17	27	16127	16175	0.15544481683557218
M1	string	0	network_modules	255	TRUE	1.5747799675675905e-4	35	21	4	0.19047619047619047	0.11428571428571428	GO:0050856	GO:BP	regulation of T cell receptor signaling pathway	16175	13304		0.6666666666666666	0.6724137931034483	35	16140	4	17	31	16123	16175	0.14611908036550386
M1	string	0	network_modules	255	TRUE	1.6728381313464987e-4	190	21	6	0.2857142857142857	0.031578947368421054	GO:0070663	GO:BP	regulation of leukocyte proliferation	16175	16244		0.6842105263157895	0.6896551724137931	190	15985	6	15	184	15970	16175	0.09168118980548436
M1	string	0	network_modules	255	TRUE	2.214461298927757e-4	38	21	4	0.19047619047619047	0.10526315789473684	GO:0033077	GO:BP	T cell differentiation in thymus	16175	8025		0.7017543859649122	0.7068965517241379	38	16137	4	17	34	16120	16175	0.14010755891032786
M1	string	0	network_modules	255	TRUE	2.7371017130311593e-4	40	21	4	0.19047619047619047	0.1	GO:0031295	GO:BP	T cell costimulation	16175	7117		0.7192982456140351	0.7241379310344828	40	16135	4	17	36	16118	16175	0.1364786591376327
M1	string	0	network_modules	255	TRUE	2.7501426519278274e-4	104	21	5	0.23809523809523808	0.04807692307692308	GO:0050671	GO:BP	positive regulation of lymphocyte proliferation	16175	13205		0.7368421052631579	0.7413793103448276	104	16071	5	16	99	16055	16175	0.10450504521589864
M1	string	0	network_modules	255	TRUE	2.8580642851121137e-4	208	21	6	0.2857142857142857	0.028846153846153848	GO:0046651	GO:BP	lymphocyte proliferation	16175	12287		0.7543859649122807	0.7586206896551724	208	15967	6	15	202	15952	16175	0.08731771860788239
M1	string	0	network_modules	255	TRUE	2.885261828388191e-4	105	21	5	0.23809523809523808	0.047619047619047616	GO:0032946	GO:BP	positive regulation of mononuclear cell proliferation	16175	7931		0.7719298245614035	0.7758620689655172	105	16070	5	16	100	16054	16175	0.10398169094092635
M1	string	0	network_modules	255	TRUE	2.9047958422388765e-4	11	20	3	0.15	0.2727272727272727	REAC:R-HSA-389359	REAC	CD28 dependent Vav1 pathway	10916	268		0.42105263157894735	0.45	11	10905	3	17	8	10888	10916	0.2011868721154232
M1	string	0	network_modules	255	TRUE	3.110252615027828e-4	211	21	6	0.2857142857142857	0.02843601895734597	GO:0032943	GO:BP	mononuclear cell proliferation	16175	7928		0.7894736842105263	0.7931034482758621	211	15964	6	15	205	15949	16175	0.08664396411124287
M1	string	0	network_modules	255	TRUE	3.3466286745884705e-4	42	21	4	0.19047619047619047	0.09523809523809523	GO:0031294	GO:BP	lymphocyte costimulation	16175	7116		0.8070175438596491	0.8103448275862069	42	16133	4	17	38	16116	16175	0.13311018619283962
M1	string	0	network_modules	255	TRUE	4.242210956448974e-4	373	21	7	0.3333333333333333	0.01876675603217158	GO:0045785	GO:BP	positive regulation of cell adhesion	16175	11617		0.8245614035087719	0.8275862068965517	373	15802	7	14	366	15788	16175	0.07453281338492651
M1	string	0	network_modules	255	TRUE	5.023221767054319e-4	13	20	3	0.15	0.23076923076923078	REAC:R-HSA-1433559	REAC	Regulation of KIT signaling	10916	1982		0.47368421052631576	0.5	13	10903	3	17	10	10886	10916	0.18485438162727327
M1	string	0	network_modules	255	TRUE	5.394402225940326e-4	119	21	5	0.23809523809523808	0.04201680672268908	GO:0070665	GO:BP	positive regulation of leukocyte proliferation	16175	16246		0.8421052631578947	0.8448275862068966	119	16056	5	16	114	16040	16175	0.09735118626874083
M1	string	0	network_modules	255	TRUE	6.01438664023324e-4	236	21	6	0.2857142857142857	0.025423728813559324	GO:0070661	GO:BP	leukocyte proliferation	16175	16242		0.8596491228070176	0.8620689655172413	236	15939	6	15	230	15924	16175	0.08152580823576806
M1	string	0	network_modules	255	TRUE	6.839585566792891e-4	50	21	4	0.19047619047619047	0.08	GO:0050854	GO:BP	regulation of antigen receptor-mediated signaling pathway	16175	13302		0.8771929824561403	0.8793103448275862	50	16125	4	17	46	16108	16175	0.12170652360703844
M1	string	0	network_modules	255	TRUE	0.0010086299170153034	55	21	4	0.19047619047619047	0.07272727272727272	GO:0050853	GO:BP	B cell receptor signaling pathway	16175	13301		0.8947368421052632	0.896551724137931	55	16120	4	17	51	16103	16175	0.11586915343137652
M1	string	0	network_modules	255	TRUE	0.0017445892058575066	65	20	4	0.2	0.06153846153846154	REAC:R-HSA-2219530	REAC	Constitutive Signaling by Aberrant PI3K in Cancer	10916	401		0.5263157894736842	0.55	65	10851	4	16	61	10835	10916	0.10805798235495745
M1	string	0	network_modules	255	TRUE	0.00198594639828663	20	20	3	0.15	0.15	REAC:R-HSA-389513	REAC	Co-inhibition by CTLA4	10916	376		0.5789473684210527	0.6	20	10896	3	17	17	10879	10916	0.1484397944199706
M1	string	0	network_modules	255	TRUE	0.002314230743942589	21	20	3	0.15	0.14285714285714285	REAC:R-HSA-164938	REAC	Nef-mediates down modulation of cell surface receptors by recruiting them to clathrin adapters	10916	1565		0.631578947368421	0.65	21	10895	3	17	18	10878	10916	0.14477948506952504
M1	string	0	network_modules	255	TRUE	0.0026765051786323546	22	20	3	0.15	0.13636363636363635	REAC:R-HSA-389357	REAC	CD28 dependent PI3K/Akt signaling	10916	267		0.6842105263157895	0.7	22	10894	3	17	19	10877	10916	0.14136975430520027
M1	string	0	network_modules	255	TRUE	0.003461906155283486	510	21	7	0.3333333333333333	0.013725490196078431	GO:0007169	GO:BP	cell surface receptor protein tyrosine kinase signaling pathway	16175	2733		0.9122807017543859	0.9137931034482759	510	15665	7	14	503	15651	16175	0.06227122965781601
M1	string	0	network_modules	255	TRUE	0.0035345112904441186	75	21	4	0.19047619047619047	0.05333333333333334	GO:0030101	GO:BP	natural killer cell activation	16175	6679		0.9298245614035088	0.9310344827586207	75	16100	4	17	71	16083	16175	0.09862979598175114
M1	string	0	network_modules	255	TRUE	0.004289654725078191	218	18	5	0.2777777777777778	0.022935779816513763	KEGG:05166	KEGG	Human T-cell leukemia virus 1 infection	8484	447		0.875	0.8888888888888888	218	8266	5	13	213	8253	8484	0.07346225811768796
M1	string	0	network_modules	255	TRUE	0.005075337126239994	181	20	5	0.25	0.027624309392265192	REAC:R-HSA-198933	REAC	Immunoregulatory interactions between a Lymphoid and a non-Lymphoid cell	10916	1171		0.7368421052631579	0.75	181	10735	5	15	176	10720	10916	0.07831420839101258
M1	string	0	network_modules	255	TRUE	0.0065841094537715285	191	20	5	0.25	0.02617801047120419	REAC:R-HSA-202733	REAC	Cell surface interactions at the vascular wall	10916	327		0.7894736842105263	0.8	191	10725	5	15	186	10710	10916	0.07597273028948087
M1	string	0	network_modules	255	TRUE	0.006974921103044978	92	20	4	0.2	0.043478260869565216	REAC:R-HSA-6811558	REAC	PI5P, PP2A and IER3 Regulate PI3K/AKT Signaling	10916	1677		0.8421052631578947	0.9	92	10824	4	16	88	10808	10916	0.08978198753849509
M1	string	0	network_modules	255	TRUE	0.006974921103044978	92	20	4	0.2	0.043478260869565216	REAC:R-HSA-2219528	REAC	PI3K/AKT Signaling in Cancer	10916	1674		0.8421052631578947	0.9	92	10824	4	16	88	10808	10916	0.08978198753849509
M1	string	0	network_modules	255	TRUE	0.007077170072321803	3	21	2	0.09523809523809523	0.6666666666666666	GO:0071661	GO:BP	regulation of granzyme B production	16175	16838		0.9473684210526315	0.9827586206896551	3	16172	2	19	1	16153	16175	0.25167235521278336
M1	string	0	network_modules	255	TRUE	0.007077170072321803	3	21	2	0.09523809523809523	0.6666666666666666	GO:0071663	GO:BP	positive regulation of granzyme B production	16175	16840		0.9473684210526315	0.9827586206896551	3	16172	2	19	1	16153	16175	0.25167235521278336
M1	string	0	network_modules	255	TRUE	0.007077170072321803	3	21	2	0.09523809523809523	0.6666666666666666	GO:0071613	GO:BP	granzyme B production	16175	16799		0.9473684210526315	0.9827586206896551	3	16172	2	19	1	16153	16175	0.25167235521278336
M1	string	0	network_modules	255	TRUE	0.007730513319576933	31	20	3	0.15	0.0967741935483871	REAC:R-HSA-389356	REAC	Co-stimulation by CD28	10916	378		0.9473684210526315	0.95	31	10885	3	17	28	10868	10916	0.11847864602131258
M1	string	0	network_modules	255	TRUE	0.00795176636613489	27	21	3	0.14285714285714285	0.1111111111111111	GO:0038094	GO:BP	Fc-gamma receptor signaling pathway	16175	9694		1	1	27	16148	3	18	24	16130	16175	0.12470105400611571
M1	string	0	network_modules	255	TRUE	0.009319766633021967	99	20	4	0.2	0.04040404040404041	REAC:R-HSA-199418	REAC	Negative regulation of the PI3K/AKT network	10916	1580		1	1	99	10817	4	16	95	10801	10916	0.08628788615561417
M1	string	0	network_modules	255	TRUE	0.009985291879070076	136	18	4	0.2222222222222222	0.029411764705882353	KEGG:05135	KEGG	Yersinia infection	8484	432		1	1	136	8348	4	14	132	8334	8484	0.07570229010616675
M1	string	0	network_modules	256	TRUE	7.334743021797567e-14	144	20	11	0.55	0.0763888888888889	REAC:R-HSA-8856828	REAC	Clathrin-mediated endocytosis	10916	372		0	0.08333333333333333	144	10772	11	9	133	10763	10916	0.20157414462544807
M1	string	0	network_modules	256	TRUE	2.284105751204451e-13	104	20	10	0.5	0.09615384615384616	REAC:R-HSA-8856825	REAC	Cargo recognition for clathrin-mediated endocytosis	10916	309		0.09090909090909091	0.16666666666666666	104	10812	10	10	94	10802	10916	0.21631673997861897
M1	string	0	network_modules	256	TRUE	1.110607171000054e-12	221	21	11	0.5238095238095238	0.049773755656108594	GO:0006898	GO:BP	receptor-mediated endocytosis	16175	2552		0	0.06666666666666667	221	15954	11	10	210	15944	16175	0.1584447476251857
M1	string	0	network_modules	256	TRUE	1.0995238337969997e-11	533	21	13	0.6190476190476191	0.024390243902439025	GO:0006897	GO:BP	endocytosis	16175	2551		0.07142857142857142	0.13333333333333333	533	15642	13	8	520	15634	16175	0.11837842654228188
M1	string	0	network_modules	256	TRUE	1.1100014161792707e-10	44	21	7	0.3333333333333333	0.1590909090909091	GO:0072583	GO:BP	clathrin-dependent endocytosis	16175	17454		0.14285714285714285	0.2	44	16131	7	14	37	16117	16175	0.22886372013536893
M1	string	0	network_modules	256	TRUE	7.39570242534762e-10	740	21	13	0.6190476190476191	0.01756756756756757	GO:0098657	GO:BP	import into cell	16175	18813		0.21428571428571427	0.26666666666666666	740	15435	13	8	727	15427	16175	0.09892934905864435
M1	string	0	network_modules	256	TRUE	1.1260681741577445e-5	121	21	6	0.2857142857142857	0.049586776859504134	GO:0099003	GO:BP	vesicle-mediated transport in synapse	16175	18999		0.2857142857142857	0.3333333333333333	121	16054	6	15	115	16039	16175	0.11642310207246082
M1	string	0	network_modules	256	TRUE	1.709236623309082e-5	119	20	6	0.3	0.05042016806722689	REAC:R-HSA-373760	REAC	L1CAM interactions	10916	1294		0.18181818181818182	0.25	119	10797	6	14	113	10783	10916	0.11927952225834333
M1	string	0	network_modules	256	TRUE	1.4948714167108146e-4	248	15	6	0.4	0.024193548387096774	KEGG:04144	KEGG	Endocytosis	8484	280		0	0.25	248	8236	6	9	242	8227	8484	0.09262944242493612
M1	string	0	network_modules	256	TRUE	1.54673624758919e-4	8	21	3	0.14285714285714285	0.375	GO:0140239	GO:BP	postsynaptic endocytosis	16175	19710		0.35714285714285715	0.4666666666666667	8	16167	3	18	5	16149	16175	0.230860669461925
M1	string	0	network_modules	256	TRUE	1.54673624758919e-4	8	21	3	0.14285714285714285	0.375	GO:0098884	GO:BP	postsynaptic neurotransmitter receptor internalization	16175	18929		0.35714285714285715	0.4666666666666667	8	16167	3	18	5	16149	16175	0.230860669461925
M1	string	0	network_modules	256	TRUE	1.6179642366474483e-4	90	20	5	0.25	0.05555555555555555	REAC:R-HSA-2682334	REAC	EPH-Ephrin signaling	10916	818		0.2727272727272727	0.3333333333333333	90	10826	5	15	85	10811	10916	0.1145422143382931
M1	string	0	network_modules	256	TRUE	4.0868993539930023e-4	221	21	6	0.2857142857142857	0.027149321266968326	GO:0030100	GO:BP	regulation of endocytosis	16175	6678		0.5	0.5333333333333333	221	15954	6	15	215	15939	16175	0.08449551420382602
M1	string	0	network_modules	256	TRUE	5.023221767054319e-4	13	20	3	0.15	0.23076923076923078	REAC:R-HSA-5140745	REAC	WNT5A-dependent internalization of FZD2, FZD5 and ROR2	10916	2671		0.36363636363636365	0.4166666666666667	13	10903	3	17	10	10886	10916	0.18485438162727327
M1	string	0	network_modules	256	TRUE	5.115106571547579e-4	48	20	4	0.2	0.08333333333333333	REAC:R-HSA-437239	REAC	Recycling pathway of L1	10916	1954		0.45454545454545453	0.5	48	10868	4	16	44	10852	10916	0.12665565282974744
M1	string	0	network_modules	256	TRUE	5.563241481466116e-4	49	20	4	0.2	0.08163265306122448	REAC:R-HSA-3928665	REAC	EPH-ephrin mediated repulsion of cells	10916	819		0.5454545454545454	0.5833333333333334	49	10867	4	16	45	10851	10916	0.12530364155386667
M1	string	0	network_modules	256	TRUE	6.297719044573107e-4	49	21	4	0.19047619047619047	0.08163265306122448	GO:0048488	GO:BP	synaptic vesicle endocytosis	16175	12781		0.5714285714285714	0.6666666666666666	49	16126	4	17	45	16109	16175	0.12297890348912398
M1	string	0	network_modules	256	TRUE	6.297719044573107e-4	49	21	4	0.19047619047619047	0.08163265306122448	GO:0140238	GO:BP	presynaptic endocytosis	16175	19709		0.5714285714285714	0.6666666666666666	49	16126	4	17	45	16109	16175	0.12297890348912398
M1	string	0	network_modules	256	TRUE	7.972827623184886e-4	15	20	3	0.15	0.2	REAC:R-HSA-5099900	REAC	WNT5A-dependent internalization of FZD4	10916	2672		0.6363636363636364	0.6666666666666666	15	10901	3	17	12	10884	10916	0.17189394896130689
M1	string	0	network_modules	256	TRUE	8.973366685096248e-4	89	15	4	0.26666666666666666	0.0449438202247191	KEGG:04512	KEGG	ECM-receptor interaction	8484	314		0.3333333333333333	0.5	89	8395	4	11	85	8384	8484	0.10581905340235692
M1	string	0	network_modules	256	TRUE	0.0010003536991064097	14	21	3	0.14285714285714285	0.21428571428571427	GO:0099590	GO:BP	neurotransmitter receptor internalization	16175	19154		0.7142857142857143	0.7333333333333333	14	16161	3	18	11	16143	16175	0.17409185260561777
M1	string	0	network_modules	256	TRUE	0.0013414553644541796	59	21	4	0.19047619047619047	0.06779661016949153	GO:0036465	GO:BP	synaptic vesicle recycling	16175	9613		0.7857142857142857	0.8	59	16116	4	17	55	16099	16175	0.1117384363158638
M1	string	0	network_modules	256	TRUE	0.0015364375000904867	16	21	3	0.14285714285714285	0.1875	GO:0048268	GO:BP	clathrin coat assembly	16175	12619		0.8571428571428571	0.8666666666666667	16	16159	3	18	13	16141	16175	0.16271627577867978
M1	string	0	network_modules	256	TRUE	0.00198594639828663	20	20	3	0.15	0.15	REAC:R-HSA-445144	REAC	Signal transduction by L1	10916	2216		0.7272727272727273	0.75	20	10896	3	17	17	10879	10916	0.1484397944199706
M1	string	0	network_modules	256	TRUE	0.0048306643420380204	23	21	3	0.14285714285714285	0.13043478260869565	GO:0035313	GO:BP	wound healing, spreading of epidermal cells	16175	8963		0.9285714285714286	0.9333333333333333	23	16152	3	18	20	16134	16175	0.13533007461701302
M1	string	0	network_modules	256	TRUE	0.004862064967159084	84	20	4	0.2	0.047619047619047616	REAC:R-HSA-216083	REAC	Integrin cell surface interactions	10916	1216		0.8181818181818182	0.8333333333333334	84	10832	4	16	80	10816	10916	0.09428471649841283
M1	string	0	network_modules	256	TRUE	0.0050539975353607975	27	20	3	0.15	0.1111111111111111	REAC:R-HSA-3000170	REAC	Syndecan interactions	10916	2367		0.9090909090909091	0.9166666666666666	27	10889	3	17	24	10872	10916	0.1272445913898661
M1	string	0	network_modules	256	TRUE	0.005568583213130306	84	21	4	0.19047619047619047	0.047619047619047616	GO:0048259	GO:BP	regulation of receptor-mediated endocytosis	16175	12611		1	1	84	16091	4	17	80	16074	16175	0.09294334318816869
M1	string	0	network_modules	256	TRUE	0.006303581727591272	53	15	3	0.2	0.05660377358490566	KEGG:04961	KEGG	Endocrine and other factor-regulated calcium reabsorption	8484	397		0.6666666666666666	0.75	53	8431	3	12	50	8419	8484	0.10349063691764517
M1	string	0	network_modules	256	TRUE	0.006906604164508069	507	20	7	0.35	0.013806706114398421	REAC:R-HSA-9006934	REAC	Signaling by Receptor Tyrosine Kinases	10916	2302		1	1	507	10409	7	13	500	10396	10916	0.061797804791059105
M1	string	0	network_modules	256	TRUE	0.008134457580835653	156	15	4	0.26666666666666666	0.02564102564102564	KEGG:04148	KEGG	Efferocytosis	8484	283		1	1	156	8328	4	11	152	8317	8484	0.07777459383657466
M1	string	0	network_modules	257	TRUE	6.308044837089094e-41	18	21	15	0.7142857142857143	0.8333333333333334	GO:0035720	GO:BP	intraciliary anterograde transport	16175	9190		0	0.07692307692307693	18	16157	15	6	3	16151	16175	0.771244545807628
M1	string	0	network_modules	257	TRUE	9.742726633763272e-39	45	21	17	0.8095238095238095	0.37777777777777777	GO:0042073	GO:BP	intraciliary transport	16175	9956		0.08333333333333333	0.15384615384615385	45	16130	17	4	28	16126	16175	0.5522363418126114
M1	string	0	network_modules	257	TRUE	5.150498199565886e-34	54	18	16	0.8888888888888888	0.2962962962962963	REAC:R-HSA-5620924	REAC	Intraflagellar transport	10916	1267		0	0.25	54	10862	16	2	38	10860	10916	0.5120335038119576
M1	string	0	network_modules	257	TRUE	1.8210465738172688e-29	137	21	17	0.8095238095238095	0.12408759124087591	GO:0031503	GO:BP	protein-containing complex localization	16175	7188		0.16666666666666666	0.23076923076923078	137	16038	17	4	120	16034	16175	0.3151666640182564
M1	string	0	network_modules	257	TRUE	4.469683063564374e-29	144	21	17	0.8095238095238095	0.11805555555555555	GO:0010970	GO:BP	transport along microtubule	16175	4546		0.25	0.3076923076923077	144	16031	17	4	127	16027	16175	0.3073119301832857
M1	string	0	network_modules	257	TRUE	5.122216119283817e-28	165	21	17	0.8095238095238095	0.10303030303030303	GO:0099111	GO:BP	microtubule-based transport	16175	19044		0.3333333333333333	0.38461538461538464	165	16010	17	4	148	16006	16175	0.28681278397575966
M1	string	0	network_modules	257	TRUE	3.921274098786205e-27	185	21	17	0.8095238095238095	0.0918918918918919	GO:0030705	GO:BP	cytoskeleton-dependent intracellular transport	16175	6886		0.4166666666666667	0.46153846153846156	185	15990	17	4	168	15986	16175	0.27061615231956043
M1	string	0	network_modules	257	TRUE	1.161450145725664e-24	348	21	18	0.8571428571428571	0.05172413793103448	GO:0007018	GO:BP	microtubule-based movement	16175	2626		0.5	0.5384615384615384	348	15827	18	3	330	15824	16175	0.20765292285845038
M1	string	0	network_modules	257	TRUE	3.2434301484771695e-24	368	21	18	0.8571428571428571	0.04891304347826087	GO:0044782	GO:BP	cilium organization	16175	11155		0.5833333333333334	0.6153846153846154	368	15807	18	3	350	15804	16175	0.20176007735449933
M1	string	0	network_modules	257	TRUE	4.026186305656022e-24	200	18	16	0.8888888888888888	0.08	REAC:R-HSA-5617833	REAC	Cilium Assembly	10916	361		0.3333333333333333	0.5	200	10716	16	2	184	10714	10916	0.2638136772835383
M1	string	0	network_modules	257	TRUE	2.0575949104198092e-21	292	18	16	0.8888888888888888	0.0547945205479452	REAC:R-HSA-1852241	REAC	Organelle biogenesis and maintenance	10916	1646		0.6666666666666666	0.75	292	10624	16	2	276	10622	10916	0.21715423070724726
M1	string	0	network_modules	257	TRUE	3.209348102991186e-20	343	21	16	0.7619047619047619	0.04664723032069971	GO:0060271	GO:BP	cilium assembly	16175	14488		0.6666666666666666	0.6923076923076923	343	15832	16	5	327	15827	16175	0.18537058525165817
M1	string	0	network_modules	257	TRUE	1.5691598313864598e-17	503	21	16	0.7619047619047619	0.03180914512922465	GO:0120031	GO:BP	plasma membrane bounded cell projection assembly	16175	19467		0.75	0.7692307692307693	503	15672	16	5	487	15667	16175	0.15179959868170897
M1	string	0	network_modules	257	TRUE	2.222393005230333e-17	514	21	16	0.7619047619047619	0.0311284046692607	GO:0030031	GO:BP	cell projection assembly	16175	6655		0.8333333333333334	0.8461538461538461	514	15661	16	5	498	15656	16175	0.1500794387473894
M1	string	0	network_modules	257	TRUE	0.001593701351886038	148	21	5	0.23809523809523808	0.033783783783783786	GO:0001822	GO:BP	kidney development	16175	479		0.9166666666666666	0.9230769230769231	148	16027	5	16	143	16011	16175	0.086693928404637
M1	string	0	network_modules	257	TRUE	0.0018781713243683018	153	21	5	0.23809523809523808	0.032679738562091505	GO:0072001	GO:BP	renal system development	16175	17037		1	1	153	16022	5	16	148	16006	16175	0.08516375557475693
M1	string	0	network_modules	257	TRUE	0.00919335415152018	113	18	4	0.2222222222222222	0.035398230088495575	REAC:R-HSA-5610787	REAC	Hedgehog 'off' state	10916	1112		1	1	113	10803	4	14	109	10789	10916	0.08507174609235313
M1	string	0	network_modules	258	TRUE	1.3230789574116212e-4	56	5	3	0.6	0.05357142857142857	KEGG:04340	KEGG	Hedgehog signaling pathway	8484	302		0	0.5	56	8428	3	2	53	8426	8484	0.17795251337893936
M1	string	0	network_modules	258	TRUE	1.893054568522725e-4	63	5	3	0.6	0.047619047619047616	KEGG:05217	KEGG	Basal cell carcinoma	8484	468		1	1	63	8421	3	2	60	8419	8484	0.1676115788172982
M1	string	0	network_modules	258	TRUE	5.033594723185619e-4	3	9	2	0.2222222222222222	0.6666666666666666	REAC:R-HSA-5635851	REAC	GLI proteins bind promoters of Hh responsive genes to promote transcription	10916	1015		NA	1	3	10913	2	7	1	10906	10916	0.3846355971777174
M1	string	0	network_modules	258	TRUE	0.001918318913567905	83	17	4	0.23529411764705882	0.04819277108433735	GO:0007224	GO:BP	smoothened signaling pathway	16175	2777		NA	1	83	16092	4	13	79	16079	16175	0.1044878788552164
M1	string	0	network_modules	260	TRUE	6.969513497480825e-8	56	9	5	0.5555555555555556	0.08928571428571429	KEGG:00480	KEGG	Glutathione metabolism	8484	61		0	0.1	56	8428	5	4	51	8424	8484	0.22091868352439592
M1	string	0	network_modules	260	TRUE	8.738275857166029e-8	34	13	5	0.38461538461538464	0.14705882352941177	REAC:R-HSA-156590	REAC	Glutathione conjugation	10916	1058		0	0.3333333333333333	34	10882	5	8	29	10874	10916	0.23640883685809885
M1	string	0	network_modules	260	TRUE	1.7544599585066873e-7	67	9	5	0.5555555555555556	0.07462686567164178	KEGG:05204	KEGG	Chemical carcinogenesis - DNA adducts	8484	456		0.1111111111111111	0.2	67	8417	5	4	62	8413	8484	0.20162561250563282
M1	string	0	network_modules	260	TRUE	1.8929541771782472e-7	68	9	5	0.5555555555555556	0.07352941176470588	KEGG:00982	KEGG	Drug metabolism - cytochrome P450	8484	156		0.2222222222222222	0.3	68	8416	5	4	63	8412	8484	0.20010639335388433
M1	string	0	network_modules	260	TRUE	2.2496240432229157e-7	36	16	5	0.3125	0.1388888888888889	GO:0006749	GO:BP	glutathione metabolic process	16175	2447		0	0.08333333333333333	36	16139	5	11	31	16128	16175	0.20718263100741482
M1	string	0	network_modules	260	TRUE	2.536757546252647e-7	72	9	5	0.5555555555555556	0.06944444444444445	KEGG:01524	KEGG	Platinum drug resistance	8484	198		0.3333333333333333	0.4	72	8412	5	4	67	8408	8484	0.1943471968269035
M1	string	0	network_modules	260	TRUE	2.918313342707318e-7	74	9	5	0.5555555555555556	0.06756756756756757	KEGG:00980	KEGG	Metabolism of xenobiotics by cytochrome P450	8484	154		0.4444444444444444	0.5	74	8410	5	4	69	8406	8484	0.19164307070338668
M1	string	0	network_modules	260	TRUE	4.074894953337563e-7	79	9	5	0.5555555555555556	0.06329113924050633	KEGG:00983	KEGG	Drug metabolism - other enzymes	8484	157		0.5555555555555556	0.6	79	8405	5	4	74	8401	8484	0.18533449746940528
M1	string	0	network_modules	260	TRUE	1.0181045070638464e-6	3	16	3	0.1875	1	GO:0018916	GO:BP	nitrobenzene metabolic process	16175	5478		0.09090909090909091	0.16666666666666666	3	16172	3	13	0	16159	16175	0.4328386264271376
M1	string	0	network_modules	260	TRUE	1.2424475903011651e-6	221	9	6	0.6666666666666666	0.027149321266968326	KEGG:05208	KEGG	Chemical carcinogenesis - reactive oxygen species	8484	460		0.6666666666666666	0.7	221	8263	6	3	215	8260	8484	0.1310647599707522
M1	string	0	network_modules	260	TRUE	3.927702346613792e-6	20	16	4	0.25	0.2	GO:0042178	GO:BP	xenobiotic catabolic process	16175	10006		0.18181818181818182	0.25	20	16155	4	12	16	16143	16175	0.22274874279624585
M1	string	0	network_modules	260	TRUE	4.278009974637712e-6	144	16	6	0.375	0.041666666666666664	GO:0006575	GO:BP	modified amino acid metabolic process	16175	2294		0.2727272727272727	0.3333333333333333	144	16031	6	10	138	16021	16175	0.12263998790456007
M1	string	0	network_modules	260	TRUE	6.84600144726797e-6	138	9	5	0.5555555555555556	0.036231884057971016	KEGG:05418	KEGG	Fluid shear stress and atherosclerosis	8484	495		0.7777777777777778	0.8	138	8346	5	4	133	8342	8484	0.138929799108931
M1	string	0	network_modules	260	TRUE	1.0168772534800623e-5	5	16	3	0.1875	0.6	GO:0051410	GO:BP	detoxification of nitrogen compound	16175	13698		0.36363636363636365	0.5	5	16170	3	13	2	16157	16175	0.33507476086645344
M1	string	0	network_modules	260	TRUE	1.0168772534800623e-5	5	16	3	0.1875	0.6	GO:0070458	GO:BP	cellular detoxification of nitrogen compound	16175	16129		0.36363636363636365	0.5	5	16170	3	13	2	16157	16175	0.33507476086645344
M1	string	0	network_modules	260	TRUE	1.7264468134172004e-5	166	9	5	0.5555555555555556	0.030120481927710843	KEGG:05225	KEGG	Hepatocellular carcinoma	8484	476		0.8888888888888888	0.9	166	8318	5	4	161	8314	8484	0.12610859574459274
M1	string	0	network_modules	260	TRUE	2.6690491629759354e-5	215	13	6	0.46153846153846156	0.027906976744186046	REAC:R-HSA-211859	REAC	Biological oxidations	10916	227		0.5	0.6666666666666666	215	10701	6	7	209	10694	10916	0.10979899705872187
M1	string	0	network_modules	260	TRUE	3.0449414794003472e-5	106	13	5	0.38461538461538464	0.04716981132075472	REAC:R-HSA-156580	REAC	Phase II - Conjugation of compounds	10916	1738		1	1	106	10810	5	8	101	10802	10916	0.13201324211840568
M1	string	0	network_modules	260	TRUE	5.700116047751169e-5	211	9	5	0.5555555555555556	0.023696682464454975	KEGG:05207	KEGG	Chemical carcinogenesis - receptor activation	8484	459		1	1	211	8273	5	4	206	8269	8484	0.11104942306843252
M1	string	0	network_modules	260	TRUE	6.864901007004839e-4	17	16	3	0.1875	0.17647058823529413	GO:0042537	GO:BP	benzene-containing compound metabolic process	16175	10229		0.5454545454545454	0.5833333333333334	17	16158	3	13	14	16145	16175	0.18106679952472396
M1	string	0	network_modules	260	TRUE	0.0015585079083260055	389	16	6	0.375	0.015424164524421594	GO:0043603	GO:BP	amide metabolic process	16175	10795		0.6363636363636364	0.6666666666666666	389	15786	6	10	383	15776	16175	0.07208287607430701
M1	string	0	network_modules	260	TRUE	0.002310774502569948	25	16	3	0.1875	0.12	GO:0042759	GO:BP	long-chain fatty acid biosynthetic process	16175	10351		0.7272727272727273	0.75	25	16150	3	13	22	16137	16175	0.14895231009052606
M1	string	0	network_modules	260	TRUE	0.005482424058129304	116	16	4	0.25	0.034482758620689655	GO:0006805	GO:BP	xenobiotic metabolic process	16175	2487		0.8181818181818182	0.8333333333333334	116	16059	4	12	112	16047	16175	0.090554147106604
M1	string	0	network_modules	260	TRUE	0.007048630844640989	4	16	2	0.125	0.5	GO:0046416	GO:BP	D-amino acid metabolic process	16175	12133		0.9090909090909091	0.9166666666666666	4	16171	2	14	2	16157	16175	0.24965977593568692
M1	string	0	network_modules	260	TRUE	0.008381357109184468	289	16	5	0.3125	0.01730103806228374	GO:0006790	GO:BP	sulfur compound metabolic process	16175	2476		1	1	289	15886	5	11	284	15875	16175	0.06998776281658167
M1	string	0	network_modules	261	TRUE	2.4574521207698924e-5	58	10	4	0.4	0.06896551724137931	KEGG:04923	KEGG	Regulation of lipolysis in adipocytes	8484	380		0	0.5	58	8426	4	6	54	8420	8484	0.16390983426327055
M1	string	0	network_modules	261	TRUE	6.972366342641025e-5	75	10	4	0.4	0.05333333333333334	KEGG:03320	KEGG	PPAR signaling pathway	8484	236		1	1	75	8409	4	6	71	8403	8484	0.14355154501728623
M1	string	0	network_modules	261	TRUE	3.1162436744818634e-4	24	10	3	0.3	0.125	REAC:R-HSA-163560	REAC	Triglyceride catabolism	10916	2606		0	0.5	24	10892	3	7	21	10885	10916	0.19252984767093345
M1	string	0	network_modules	261	TRUE	8.374017749540045e-4	15	19	3	0.15789473684210525	0.2	GO:0010889	GO:BP	regulation of sequestering of triglyceride	16175	4475		0	0.16666666666666666	15	16160	3	16	12	16144	16175	0.17684682560957754
M1	string	0	network_modules	261	TRUE	0.0012901150622162208	38	10	3	0.3	0.07894736842105263	REAC:R-HSA-8979227	REAC	Triglyceride metabolism	10916	2607		1	1	38	10878	3	7	35	10871	10916	0.15244626667643107
M1	string	0	network_modules	261	TRUE	0.0014984612348917467	18	19	3	0.15789473684210525	0.16666666666666666	GO:0030730	GO:BP	sequestering of triglyceride	16175	6909		0.2	0.3333333333333333	18	16157	3	16	15	16141	16175	0.16126254114621588
M1	string	0	network_modules	261	TRUE	0.002436912122067516	21	19	3	0.15789473684210525	0.14285714285714285	GO:0019433	GO:BP	triglyceride catabolic process	16175	5785		0.4	0.5	21	16154	3	16	18	16138	16175	0.1491373278339042
M1	string	0	network_modules	261	TRUE	0.009014129295979612	32	19	3	0.15789473684210525	0.09375	GO:0046464	GO:BP	acylglycerol catabolic process	16175	12172		0.6	0.8333333333333334	32	16143	3	16	29	16127	16175	0.12033134874051403
M1	string	0	network_modules	261	TRUE	0.009014129295979612	32	19	3	0.15789473684210525	0.09375	GO:0046461	GO:BP	neutral lipid catabolic process	16175	12169		0.6	0.8333333333333334	32	16143	3	16	29	16127	16175	0.12033134874051403
M1	string	0	network_modules	261	TRUE	0.00990818471842332	33	19	3	0.15789473684210525	0.09090909090909091	GO:0034389	GO:BP	lipid droplet organization	16175	8610		1	1	33	16142	3	16	30	16126	16175	0.1184508047106856
M1	string	0	network_modules	262	TRUE	1.867619450568788e-31	25	16	13	0.8125	0.52	REAC:R-HSA-8854691	REAC	Interleukin-20 family signaling	10916	1242		0	0.5	25	10891	13	3	12	10888	10916	0.6493874171414381
M1	string	0	network_modules	262	TRUE	2.193351313493315e-20	162	14	13	0.9285714285714286	0.08024691358024691	KEGG:04630	KEGG	JAK-STAT signaling pathway	8484	332		0	0.3333333333333333	162	8322	13	1	149	8321	8484	0.27017376109254054
M1	string	0	network_modules	262	TRUE	1.0477173569110303e-14	291	14	12	0.8571428571428571	0.041237113402061855	KEGG:04060	KEGG	Cytokine-cytokine receptor interaction	8484	253		0.5	0.6666666666666666	291	8193	12	2	279	8191	8484	0.18381120356880576
M1	string	0	network_modules	262	TRUE	2.5072614407857435e-13	472	16	13	0.8125	0.02754237288135593	REAC:R-HSA-449147	REAC	Signaling by Interleukins	10916	2261		1	1	472	10444	13	3	459	10441	10916	0.1449036731518181
M1	string	0	network_modules	262	TRUE	3.206508529647224e-7	10	18	4	0.2222222222222222	0.4	GO:0038196	GO:BP	type III interferon-mediated signaling pathway	16175	9765		0	0.2222222222222222	10	16165	4	14	6	16151	16175	0.29757050992590606
M1	string	0	network_modules	262	TRUE	3.206508529647224e-7	10	18	4	0.2222222222222222	0.4	GO:0071358	GO:BP	cellular response to type III interferon	16175	16610		0	0.2222222222222222	10	16165	4	14	6	16151	16175	0.29757050992590606
M1	string	0	network_modules	262	TRUE	3.2720268055223446e-7	98	14	6	0.42857142857142855	0.061224489795918366	KEGG:04061	KEGG	Viral protein interaction with cytokine and cytokine receptor	8484	254		1	1	98	8386	6	8	92	8378	8484	0.15866811941302006
M1	string	0	network_modules	262	TRUE	5.035308782626105e-7	11	18	4	0.2222222222222222	0.36363636363636365	GO:0034342	GO:BP	response to type III interferon	16175	8580		0.25	0.3333333333333333	11	16164	4	14	7	16150	16175	0.2836519688724742
M1	string	0	network_modules	262	TRUE	9.447434201398162e-6	419	18	8	0.4444444444444444	0.01909307875894988	GO:0019221	GO:BP	cytokine-mediated signaling pathway	16175	5598		0.375	0.4444444444444444	419	15756	8	10	411	15746	16175	0.08794424672759246
M1	string	0	network_modules	262	TRUE	8.430966056392124e-5	555	18	8	0.4444444444444444	0.014414414414414415	GO:0071345	GO:BP	cellular response to cytokine stimulus	16175	16597		0.5	0.5555555555555556	555	15620	8	10	547	15610	16175	0.07520333093723965
M1	string	0	network_modules	262	TRUE	2.1078741733583114e-4	625	18	8	0.4444444444444444	0.0128	GO:1901652	GO:BP	response to peptide	16175	21619		0.625	0.7777777777777778	625	15550	8	10	617	15540	16175	0.07027678827878736
M1	string	0	network_modules	262	TRUE	2.1078741733583114e-4	625	18	8	0.4444444444444444	0.0128	GO:0034097	GO:BP	response to cytokine	16175	8408		0.625	0.7777777777777778	625	15550	8	10	617	15540	16175	0.07027678827878736
M1	string	0	network_modules	262	TRUE	9.345093467428133e-4	64	18	4	0.2222222222222222	0.0625	GO:0098586	GO:BP	cellular response to virus	16175	18801		0.875	0.8888888888888888	64	16111	4	14	60	16097	16175	0.11604703160543309
M1	string	0	network_modules	262	TRUE	0.004778617748471889	96	18	4	0.2222222222222222	0.041666666666666664	GO:0140888	GO:BP	interferon-mediated signaling pathway	16175	19923		1	1	96	16079	4	14	92	16065	16175	0.09398655639090372
M1	string	0	network_modules	263	TRUE	0.004362962984408936	76	8	3	0.375	0.039473684210526314	REAC:R-HSA-3000178	REAC	ECM proteoglycans	10916	812		NA	1	76	10840	3	5	73	10835	10916	0.11986899856129511
M1	string	0	network_modules	264	TRUE	8.199250886409371e-16	7	12	6	0.5	0.8571428571428571	REAC:R-HSA-5576894	REAC	Phase 1 - inactivation of fast Na+ channels	10916	1733		0	0.3333333333333333	7	10909	6	6	1	10903	10916	0.654383579109387
M1	string	0	network_modules	264	TRUE	1.3068113540409674e-8	183	18	8	0.4444444444444444	0.04371584699453552	GO:0071805	GO:BP	potassium ion transmembrane transport	16175	16918		0	0.0625	183	15992	8	10	175	15982	16175	0.13669171736016442
M1	string	0	network_modules	264	TRUE	2.4630960729288142e-8	198	18	8	0.4444444444444444	0.04040404040404041	GO:0006813	GO:BP	potassium ion transport	16175	2493		0.06666666666666667	0.125	198	15977	8	10	190	15967	16175	0.13119221873988113
M1	string	0	network_modules	264	TRUE	8.489707256969833e-8	65	18	6	0.3333333333333333	0.09230769230769231	GO:1901379	GO:BP	regulation of potassium ion transmembrane transport	16175	21429		0.13333333333333333	0.1875	65	16110	6	12	59	16098	16175	0.17374285823395108
M1	string	0	network_modules	264	TRUE	1.5116038825171656e-7	203	12	7	0.5833333333333334	0.034482758620689655	REAC:R-HSA-397014	REAC	Muscle contraction	10916	1496		0.5	0.6666666666666666	203	10713	7	5	196	10708	10916	0.13867677353478505
M1	string	0	network_modules	264	TRUE	1.8931497913891603e-7	74	18	6	0.3333333333333333	0.08108108108108109	GO:0043266	GO:BP	regulation of potassium ion transport	16175	10590		0.2	0.25	74	16101	6	12	68	16089	16175	0.16260530699067688
M1	string	0	network_modules	264	TRUE	6.589823769007604e-7	130	12	6	0.5	0.046153846153846156	REAC:R-HSA-5576891	REAC	Cardiac conduction	10916	306		1	1	130	10786	6	6	124	10780	10916	0.14926570400952008
M1	string	0	network_modules	264	TRUE	4.443904243684478e-6	575	18	9	0.5	0.01565217391304348	GO:0098662	GO:BP	inorganic cation transmembrane transport	16175	18818		0.26666666666666666	0.3125	575	15600	9	9	566	15591	16175	0.08372287889062427
M1	string	0	network_modules	264	TRUE	4.581243132377788e-6	577	18	9	0.5	0.01559792027729636	GO:0098655	GO:BP	monoatomic cation transmembrane transport	16175	18811		0.3333333333333333	0.375	577	15598	9	9	568	15589	16175	0.08356075896574741
M1	string	0	network_modules	264	TRUE	9.882603838405916e-6	630	18	9	0.5	0.014285714285714285	GO:0098660	GO:BP	inorganic ion transmembrane transport	16175	18816		0.4	0.4375	630	15545	9	9	621	15536	16175	0.0795396204329989
M1	string	0	network_modules	264	TRUE	1.7124338666317996e-5	671	18	9	0.5	0.013412816691505217	GO:0034220	GO:BP	monoatomic ion transmembrane transport	16175	8508		0.4666666666666667	0.5	671	15504	9	9	662	15495	16175	0.07674882780904502
M1	string	0	network_modules	264	TRUE	1.8504004809181832e-5	677	18	9	0.5	0.013293943870014771	GO:0030001	GO:BP	metal ion transport	16175	6646		0.5333333333333333	0.5625	677	15498	9	9	668	15489	16175	0.07636093527928325
M1	string	0	network_modules	264	TRUE	4.398096384441694e-5	748	18	9	0.5	0.012032085561497326	GO:0006812	GO:BP	monoatomic cation transport	16175	2492		0.6	0.625	748	15427	9	9	739	15418	16175	0.07211586651455634
M1	string	0	network_modules	264	TRUE	1.7351533373389011e-4	229	18	6	0.3333333333333333	0.026200873362445413	GO:1904062	GO:BP	regulation of monoatomic cation transmembrane transport	16175	23501		0.6666666666666666	0.6875	229	15946	6	12	223	15934	16175	0.09017504220570713
M1	string	0	network_modules	264	TRUE	3.8420356850983085e-4	262	18	6	0.3333333333333333	0.022900763358778626	GO:0034765	GO:BP	regulation of monoatomic ion transmembrane transport	16175	8734		0.7333333333333333	0.75	262	15913	6	12	256	15901	16175	0.08385295231259432
M1	string	0	network_modules	264	TRUE	6.172624816234677e-4	284	18	6	0.3333333333333333	0.02112676056338028	GO:0010959	GO:BP	regulation of metal ion transport	16175	4536		0.8	0.8125	284	15891	6	12	278	15879	16175	0.08024974352179699
M1	string	0	network_modules	264	TRUE	0.0017989394292845895	341	18	6	0.3333333333333333	0.017595307917888565	GO:0043269	GO:BP	regulation of monoatomic ion transport	16175	10593		0.8666666666666667	0.875	341	15834	6	12	335	15822	16175	0.07254910968723689
M1	string	0	network_modules	264	TRUE	0.002236536887897369	354	18	6	0.3333333333333333	0.01694915254237288	GO:0034762	GO:BP	regulation of transmembrane transport	16175	8731		0.9333333333333333	0.9375	354	15821	6	12	348	15809	16175	0.07105043176216416
M1	string	0	network_modules	264	TRUE	0.009325662102733978	253	18	5	0.2777777777777778	0.019762845849802372	GO:0072659	GO:BP	protein localization to plasma membrane	16175	17480		1	1	253	15922	5	13	248	15909	16175	0.0705128659540003
M1	string	0	network_modules	266	TRUE	2.378547622870071e-8	25	15	5	0.3333333333333333	0.2	GO:0014059	GO:BP	regulation of dopamine secretion	16175	4629		0	0.047619047619047616	25	16150	5	10	20	16140	16175	0.2573198591167833
M1	string	0	network_modules	266	TRUE	4.393038598280986e-8	28	15	5	0.3333333333333333	0.17857142857142858	GO:0014046	GO:BP	dopamine secretion	16175	4616		0.05	0.09523809523809523	28	16147	5	10	23	16137	16175	0.2430310667212381
M1	string	0	network_modules	266	TRUE	8.982789913657091e-8	32	15	5	0.3333333333333333	0.15625	GO:0017158	GO:BP	regulation of calcium ion-dependent exocytosis	16175	5288		0.1	0.14285714285714285	32	16143	5	10	27	16133	16175	0.22719335205403915
M1	string	0	network_modules	266	TRUE	1.9393973437450446e-7	37	15	5	0.3333333333333333	0.13513513513513514	GO:0050433	GO:BP	regulation of catecholamine secretion	16175	13187		0.15	0.19047619047619047	37	16138	5	10	32	16128	16175	0.21112111674280692
M1	string	0	network_modules	266	TRUE	2.9230861659980146e-7	40	15	5	0.3333333333333333	0.125	GO:0050432	GO:BP	catecholamine secretion	16175	13186		0.2	0.23809523809523808	40	16135	5	10	35	16125	16175	0.20295489293310112
M1	string	0	network_modules	266	TRUE	3.3273523954321143e-7	41	15	5	0.3333333333333333	0.12195121951219512	GO:0015872	GO:BP	dopamine transport	16175	4980		0.25	0.2857142857142857	41	16134	5	10	36	16124	16175	0.20043330742459464
M1	string	0	network_modules	266	TRUE	9.363755748384106e-7	50	15	5	0.3333333333333333	0.1	GO:0017156	GO:BP	calcium-ion regulated exocytosis	16175	5286		0.3	0.3333333333333333	50	16125	5	10	45	16115	16175	0.18124534906425374
M1	string	0	network_modules	266	TRUE	1.3947716965165973e-6	54	15	5	0.3333333333333333	0.09259259259259259	GO:0051937	GO:BP	catecholamine transport	16175	14007		0.35	0.38095238095238093	54	16121	5	10	49	16111	16175	0.17429443920476576
M1	string	0	network_modules	266	TRUE	2.2022873826949815e-6	59	15	5	0.3333333333333333	0.0847457627118644	GO:0051952	GO:BP	regulation of amine transport	16175	14022		0.4	0.42857142857142855	59	16116	5	10	54	16106	16175	0.16661525182772094
M1	string	0	network_modules	266	TRUE	3.3453374951632797e-6	64	15	5	0.3333333333333333	0.078125	GO:0015844	GO:BP	monoamine transport	16175	4954		0.45	0.47619047619047616	64	16111	5	10	59	16101	16175	0.15984930789336863
M1	string	0	network_modules	266	TRUE	4.564256560390924e-6	68	15	5	0.3333333333333333	0.07352941176470588	GO:0015837	GO:BP	amine transport	16175	4947		0.5	0.5238095238095238	68	16107	5	10	63	16097	16175	0.15497941619371805
M1	string	0	network_modules	266	TRUE	6.559756881345088e-6	73	15	5	0.3333333333333333	0.0684931506849315	GO:0071277	GO:BP	cellular response to calcium ion	16175	16534		0.55	0.5714285714285714	73	16102	5	10	68	16092	16175	0.14946048355568264
M1	string	0	network_modules	266	TRUE	1.602056137818483e-5	87	15	5	0.3333333333333333	0.05747126436781609	GO:1903305	GO:BP	regulation of regulated secretory pathway	16175	22892		0.6	0.6190476190476191	87	16088	5	10	82	16078	16175	0.13660682423858
M1	string	0	network_modules	266	TRUE	5.2438329885388695e-5	110	15	5	0.3333333333333333	0.045454545454545456	GO:0051592	GO:BP	response to calcium ion	16175	13809		0.65	0.6666666666666666	110	16065	5	10	105	16055	16175	0.12104844995224914
M1	string	0	network_modules	266	TRUE	1.7589386726795856e-4	140	15	5	0.3333333333333333	0.03571428571428571	GO:0071248	GO:BP	cellular response to metal ion	16175	16509		0.7	0.7142857142857143	140	16035	5	10	135	16025	16175	0.10678828309407738
M1	string	0	network_modules	266	TRUE	2.32183420553479e-4	148	15	5	0.3333333333333333	0.033783783783783786	GO:0017157	GO:BP	regulation of exocytosis	16175	5287		0.75	0.7619047619047619	148	16027	5	10	143	16017	16175	0.10372968319117161
M1	string	0	network_modules	266	TRUE	3.532983040474942e-4	161	15	5	0.3333333333333333	0.031055900621118012	GO:0045055	GO:BP	regulated exocytosis	16175	11253		0.8	0.8095238095238095	161	16014	5	10	156	16004	16175	0.0992474017465455
M1	string	0	network_modules	266	TRUE	0.0014154122406353673	213	15	5	0.3333333333333333	0.023474178403755867	GO:0010038	GO:BP	response to metal ion	16175	3847		0.85	0.8571428571428571	213	15962	5	10	208	15952	16175	0.08556762031907132
M1	string	0	network_modules	266	TRUE	0.0015871328652197953	218	15	5	0.3333333333333333	0.022935779816513763	GO:0015850	GO:BP	organic hydroxy compound transport	16175	4959		0.9	0.9047619047619048	218	15957	5	10	213	15947	16175	0.08451222313431057
M1	string	0	network_modules	266	TRUE	0.003993895777606852	263	15	5	0.3333333333333333	0.019011406844106463	GO:0006887	GO:BP	exocytosis	16175	2543		0.95	0.9523809523809523	263	15912	5	10	258	15902	16175	0.07638167279327282
M1	string	0	network_modules	266	TRUE	0.006064148868265934	56	11	3	0.2727272727272727	0.05357142857142857	REAC:R-HSA-6794361	REAC	Neurexins and neuroligins	10916	1587		NA	1	56	10860	3	8	53	10852	10916	0.11896512208716341
M1	string	0	network_modules	266	TRUE	0.009060119482670062	311	15	5	0.3333333333333333	0.01607717041800643	GO:0023061	GO:BP	signal release	16175	6645		1	1	311	15864	5	10	306	15854	16175	0.06968817779854032
M1	string	0	network_modules	267	TRUE	2.3076783747451852e-4	192	12	5	0.4166666666666667	0.026041666666666668	KEGG:05202	KEGG	Transcriptional misregulation in cancer	8484	454		NA	1	192	8292	5	7	187	8285	8484	0.09971345511338325
M1	string	0	network_modules	268	TRUE	4.919563098918384e-4	107	10	4	0.4	0.037383177570093455	REAC:R-HSA-8957275	REAC	Post-translational protein phosphorylation	10916	1777		0	0.5	107	10809	4	6	103	10803	10916	0.11993088338686964
M1	string	0	network_modules	268	TRUE	8.875991787303115e-4	124	10	4	0.4	0.03225806451612903	REAC:R-HSA-381426	REAC	Regulation of Insulin-like Growth Factor (IGF) transport and uptake by Insulin-like Growth Factor Binding Proteins (IGFBPs)	10916	1981		1	1	124	10792	4	6	120	10786	10916	0.1110496148206698
M1	string	0	network_modules	268	TRUE	0.0011148721588836801	2	15	2	0.13333333333333333	1	GO:0016256	GO:BP	N-glycan processing to lysosome	16175	5187		NA	1	2	16173	2	13	0	16160	16175	0.36500158742720296
M1	string	0	network_modules	269	TRUE	1.5267988951810592e-13	44	19	8	0.42105263157894735	0.18181818181818182	GO:0016339	GO:BP	calcium-dependent cell-cell adhesion via plasma membrane cell adhesion molecules	16175	5214		0	0.1	44	16131	8	11	36	16120	16175	0.27543471053769825
M1	string	0	network_modules	269	TRUE	1.8557925670803602e-13	45	19	8	0.42105263157894735	0.17777777777777778	GO:0034332	GO:BP	adherens junction organization	16175	8574		0.1111111111111111	0.2	45	16130	8	11	37	16119	16175	0.2723253216732329
M1	string	0	network_modules	269	TRUE	2.2451246466974928e-13	46	19	8	0.42105263157894735	0.17391304347826086	GO:0044331	GO:BP	cell-cell adhesion mediated by cadherin	16175	10957		0.2222222222222222	0.3	46	16129	8	11	38	16118	16175	0.269317535775804
M1	string	0	network_modules	269	TRUE	4.809208234022736e-13	55	15	8	0.5333333333333333	0.14545454545454545	REAC:R-HSA-418990	REAC	Adherens junctions interactions	10916	121		0	0.25	55	10861	8	7	47	10854	10916	0.2767809008407367
M1	string	0	network_modules	269	TRUE	2.2660841473195487e-11	87	15	8	0.5333333333333333	0.09195402298850575	REAC:R-HSA-421270	REAC	Cell-cell junction organization	10916	329		0.3333333333333333	0.5	87	10829	8	7	79	10822	10916	0.21917044111769035
M1	string	0	network_modules	269	TRUE	2.9624179318150536e-11	143	19	9	0.47368421052631576	0.06293706293706294	GO:0007043	GO:BP	cell-cell junction assembly	16175	2647		0.3333333333333333	0.4	143	16032	9	10	134	16022	16175	0.17029385316774398
M1	string	0	network_modules	269	TRUE	2.1013905542472272e-10	114	15	8	0.5333333333333333	0.07017543859649122	REAC:R-HSA-446728	REAC	Cell junction organization	10916	324		0.6666666666666666	0.75	114	10802	8	7	106	10795	10916	0.19080149234361854
M1	string	0	network_modules	269	TRUE	2.3085050015751084e-10	179	19	9	0.47368421052631576	0.05027932960893855	GO:0045216	GO:BP	cell-cell junction organization	16175	11328		0.4444444444444444	0.5	179	15996	9	10	170	15986	16175	0.15165063959793773
M1	string	0	network_modules	269	TRUE	1.9661970227296415e-9	150	15	8	0.5333333333333333	0.05333333333333334	REAC:R-HSA-1500931	REAC	Cell-Cell communication	10916	328		1	1	150	10766	8	7	142	10759	10916	0.16556390281313116
M1	string	0	network_modules	269	TRUE	3.6134236612694396e-9	533	19	11	0.5789473684210527	0.020637898686679174	GO:0034330	GO:BP	cell junction organization	16175	8572		0.5555555555555556	0.6	533	15642	11	8	522	15634	16175	0.10488981323440962
M1	string	0	network_modules	269	TRUE	3.144321672488018e-8	651	19	11	0.5789473684210527	0.016897081413210446	GO:0000902	GO:BP	cell morphogenesis	16175	240		0.6666666666666666	0.7	651	15524	11	8	640	15516	16175	0.09399589572851454
M1	string	0	network_modules	269	TRUE	3.243254157807555e-8	193	19	8	0.42105263157894735	0.04145077720207254	GO:0098742	GO:BP	cell-cell adhesion via plasma-membrane adhesion molecules	16175	18867		0.7777777777777778	0.8	193	15982	8	11	185	15971	16175	0.12921452564139407
M1	string	0	network_modules	269	TRUE	8.742300130684517e-8	346	19	9	0.47368421052631576	0.02601156069364162	GO:0034329	GO:BP	cell junction assembly	16175	8571		0.8888888888888888	0.9	346	15829	9	10	337	15819	16175	0.1072036107047839
M1	string	0	network_modules	269	TRUE	7.322594225955115e-5	745	19	9	0.47368421052631576	0.012080536912751677	GO:0098609	GO:BP	cell-cell adhesion	16175	18805		1	1	745	15430	9	10	736	15420	16175	0.06996110184302087
M1	string	0	network_modules	270	TRUE	1.7015310980682587e-6	36	8	4	0.5	0.1111111111111111	REAC:R-HSA-390522	REAC	Striated Muscle Contraction	10916	2356		0	0.5	36	10880	4	4	32	10876	10916	0.23462065562007145
M1	string	0	network_modules	270	TRUE	2.699298615643529e-4	144	16	5	0.3125	0.034722222222222224	GO:0006941	GO:BP	striated muscle contraction	16175	2579		0	0.16666666666666666	144	16031	5	11	139	16020	16175	0.10170293721792148
M1	string	0	network_modules	270	TRUE	4.181443356172001e-4	193	7	4	0.5714285714285714	0.02072538860103627	KEGG:04814	KEGG	Motor proteins	8484	366		0	0.2	193	8291	4	3	189	8288	8484	0.10574637817526407
M1	string	0	network_modules	270	TRUE	0.0017180840247532476	87	7	3	0.42857142857142855	0.034482758620689655	KEGG:04260	KEGG	Cardiac muscle contraction	8484	296		0.25	0.4	87	8397	3	4	84	8393	8484	0.1193197198114901
M1	string	0	network_modules	270	TRUE	0.0018885124749099336	203	8	4	0.5	0.019704433497536946	REAC:R-HSA-397014	REAC	Muscle contraction	10916	1496		1	1	203	10713	4	4	199	10709	10916	0.09650316960934188
M1	string	0	network_modules	270	TRUE	0.002381377134528591	97	7	3	0.42857142857142855	0.030927835051546393	KEGG:05410	KEGG	Hypertrophic cardiomyopathy	8484	489		0.5	0.6	97	8387	3	4	94	8383	8484	0.11275071443411114
M1	string	0	network_modules	270	TRUE	0.002768277736780933	102	7	3	0.42857142857142855	0.029411764705882353	KEGG:05414	KEGG	Dilated cardiomyopathy	8484	491		0.75	0.8	102	8382	3	4	99	8378	8484	0.10982989274011107
M1	string	0	network_modules	270	TRUE	0.004599309531320816	111	16	4	0.25	0.036036036036036036	GO:0060048	GO:BP	cardiac muscle contraction	16175	14311		0.2	0.3333333333333333	111	16064	4	12	107	16052	16175	0.09267460709403337
M1	string	0	network_modules	270	TRUE	0.004817340560511383	258	16	5	0.3125	0.01937984496124031	GO:0006936	GO:BP	muscle contraction	16175	2575		0.4	0.5	258	15917	5	11	253	15906	16175	0.07448240909226547
M1	string	0	network_modules	270	TRUE	0.005482424058129304	116	16	4	0.25	0.034482758620689655	GO:0006937	GO:BP	regulation of muscle contraction	16175	2576		0.6	0.6666666666666666	116	16059	4	12	112	16047	16175	0.090554147106604
M1	string	0	network_modules	270	TRUE	0.006536114093843217	35	16	3	0.1875	0.08571428571428572	GO:0055010	GO:BP	ventricular cardiac muscle tissue morphogenesis	16175	14199		0.8	0.8333333333333334	35	16140	3	13	32	16127	16175	0.1255080059505054
M1	string	0	network_modules	270	TRUE	0.007126006216376415	36	16	3	0.1875	0.08333333333333333	GO:0003009	GO:BP	skeletal muscle contraction	16175	1460		1	1	36	16139	3	13	33	16126	16175	0.12371511443697349
M1	string	0	network_modules	270	TRUE	0.009266053425802822	153	7	3	0.42857142857142855	0.0196078431372549	KEGG:04261	KEGG	Adrenergic signaling in cardiomyocytes	8484	297		1	1	153	8331	3	4	150	8327	8484	0.08865171063950138
M1	string	0	network_modules	271	TRUE	3.804950064085174e-13	92	10	8	0.8	0.08695652173913043	KEGG:04657	KEGG	IL-17 signaling pathway	8484	335		0	0.5	92	8392	8	2	84	8390	8484	0.26175360623085
M1	string	0	network_modules	271	TRUE	6.649597363258633e-10	4	15	4	0.26666666666666666	1	GO:0097398	GO:BP	cellular response to interleukin-17	16175	18645		0	0.42857142857142855	4	16171	4	11	0	16160	16175	0.516222114974699
M1	string	0	network_modules	271	TRUE	6.649597363258633e-10	4	15	4	0.26666666666666666	1	GO:0097400	GO:BP	interleukin-17-mediated signaling pathway	16175	18647		0	0.42857142857142855	4	16171	4	11	0	16160	16175	0.516222114974699
M1	string	0	network_modules	271	TRUE	6.649597363258633e-10	4	15	4	0.26666666666666666	1	GO:0097396	GO:BP	response to interleukin-17	16175	18643		0	0.42857142857142855	4	16171	4	11	0	16160	16175	0.516222114974699
M1	string	0	network_modules	271	TRUE	3.5271546053330133e-9	71	10	6	0.6	0.08450704225352113	REAC:R-HSA-448424	REAC	Interleukin-17 signaling	10916	1238		0	0.5	71	10845	6	4	65	10841	10916	0.22356533639731466
M1	string	0	network_modules	271	TRUE	3.5058122196335544e-7	291	10	7	0.7	0.024054982817869417	KEGG:04060	KEGG	Cytokine-cytokine receptor interaction	8484	253		1	1	291	8193	7	3	284	8190	8484	0.1256513350409663
M1	string	0	network_modules	271	TRUE	3.5825814060783034e-6	4	15	3	0.2	0.75	GO:2000338	GO:BP	regulation of chemokine (C-X-C motif) ligand 1 production	16175	25657		0.5	0.8571428571428571	4	16171	3	12	1	16159	16175	0.3870467945892449
M1	string	0	network_modules	271	TRUE	3.5825814060783034e-6	4	15	3	0.2	0.75	GO:2000340	GO:BP	positive regulation of chemokine (C-X-C motif) ligand 1 production	16175	25659		0.5	0.8571428571428571	4	16171	3	12	1	16159	16175	0.3870467945892449
M1	string	0	network_modules	271	TRUE	3.5825814060783034e-6	4	15	3	0.2	0.75	GO:0072566	GO:BP	chemokine (C-X-C motif) ligand 1 production	16175	17444		0.5	0.8571428571428571	4	16171	3	12	1	16159	16175	0.3870467945892449
M1	string	0	network_modules	271	TRUE	1.789297451922571e-5	6	15	3	0.2	0.5	GO:0038173	GO:BP	interleukin-17A-mediated signaling pathway	16175	9749		1	1	6	16169	3	12	3	16157	16175	0.3158462977623385
M1	string	0	network_modules	271	TRUE	3.221503109837012e-4	472	10	6	0.6	0.012711864406779662	REAC:R-HSA-449147	REAC	Signaling by Interleukins	10916	2261		1	1	472	10444	6	4	466	10440	10916	0.08288862508342904
M1	string	0	network_modules	273	TRUE	1.209371918769363e-4	57	13	4	0.3076923076923077	0.07017543859649122	GO:0001912	GO:BP	positive regulation of leukocyte mediated cytotoxicity	16175	529		0	0.047619047619047616	57	16118	4	9	53	16109	16175	0.14557588332643812
M1	string	0	network_modules	273	TRUE	1.5322158016119585e-4	91	9	4	0.4444444444444444	0.04395604395604396	REAC:R-HSA-163125	REAC	Post-translational modification: synthesis of GPI-anchored proteins	10916	1775		NA	1	91	10825	4	5	87	10820	10916	0.13778171531574637
M1	string	0	network_modules	273	TRUE	1.8188265996590304e-4	63	13	4	0.3076923076923077	0.06349206349206349	GO:0031343	GO:BP	positive regulation of cell killing	16175	7134		0.05	0.09523809523809523	63	16112	4	9	59	16103	16175	0.1383271653501201
M1	string	0	network_modules	273	TRUE	1.8359469679261236e-4	14	13	3	0.23076923076923078	0.21428571428571427	GO:0002486	GO:BP	antigen processing and presentation of endogenous peptide antigen via MHC class I via ER pathway, TAP-independent	16175	1009		0.1	0.19047619047619047	14	16161	3	10	11	16151	16175	0.22172580349903687
M1	string	0	network_modules	273	TRUE	1.8359469679261236e-4	14	13	3	0.23076923076923078	0.21428571428571427	GO:0002484	GO:BP	antigen processing and presentation of endogenous peptide antigen via MHC class I via ER pathway	16175	1007		0.1	0.19047619047619047	14	16161	3	10	11	16151	16175	0.22172580349903687
M1	string	0	network_modules	273	TRUE	2.2938691844307283e-4	15	13	3	0.23076923076923078	0.2	GO:0002428	GO:BP	antigen processing and presentation of peptide antigen via MHC class Ib	16175	951		0.2	0.2857142857142857	15	16160	3	10	12	16150	16175	0.21415649977466114
M1	string	0	network_modules	273	TRUE	2.2938691844307283e-4	15	13	3	0.23076923076923078	0.2	GO:0002476	GO:BP	antigen processing and presentation of endogenous peptide antigen via MHC class Ib	16175	999		0.2	0.2857142857142857	15	16160	3	10	12	16150	16175	0.21415649977466114
M1	string	0	network_modules	273	TRUE	4.326440296932305e-4	78	13	4	0.3076923076923077	0.05128205128205128	GO:0001910	GO:BP	regulation of leukocyte mediated cytotoxicity	16175	527		0.3	0.3333333333333333	78	16097	4	9	74	16088	16175	0.12399522807420847
M1	string	0	network_modules	273	TRUE	5.733958633881359e-4	20	13	3	0.23076923076923078	0.15	GO:0019885	GO:BP	antigen processing and presentation of endogenous peptide antigen via MHC class I	16175	6063		0.35	0.42857142857142855	20	16155	3	10	17	16145	16175	0.18524419362516745
M1	string	0	network_modules	273	TRUE	5.733958633881359e-4	20	13	3	0.23076923076923078	0.15	GO:0002475	GO:BP	antigen processing and presentation via MHC class Ib	16175	998		0.35	0.42857142857142855	20	16155	3	10	17	16145	16175	0.18524419362516745
M1	string	0	network_modules	273	TRUE	7.738688763867622e-4	22	13	3	0.23076923076923078	0.13636363636363635	GO:0002483	GO:BP	antigen processing and presentation of endogenous peptide antigen	16175	1006		0.45	0.47619047619047616	22	16153	3	10	19	16143	16175	0.17653919094160347
M1	string	0	network_modules	273	TRUE	8.059464230326704e-4	91	13	4	0.3076923076923077	0.04395604395604396	GO:0031341	GO:BP	regulation of cell killing	16175	7132		0.5	0.5238095238095238	91	16084	4	9	87	16075	16175	0.11453890365224777
M1	string	0	network_modules	273	TRUE	8.422041253254898e-4	92	13	4	0.3076923076923077	0.043478260869565216	GO:0002708	GO:BP	positive regulation of lymphocyte mediated immunity	16175	1226		0.55	0.5714285714285714	92	16083	4	9	88	16074	16175	0.11389493459830573
M1	string	0	network_modules	273	TRUE	0.0014880078016998727	106	13	4	0.3076923076923077	0.03773584905660377	GO:0001909	GO:BP	leukocyte mediated cytotoxicity	16175	526		0.6	0.6190476190476191	106	16069	4	9	102	16060	16175	0.10584931163745868
M1	string	0	network_modules	273	TRUE	0.0016416528689569573	28	13	3	0.23076923076923078	0.10714285714285714	GO:0019883	GO:BP	antigen processing and presentation of endogenous antigen	16175	6061		0.65	0.6666666666666666	28	16147	3	10	25	16137	16175	0.15626126299911722
M1	string	0	network_modules	273	TRUE	0.0017261952807409774	110	13	4	0.3076923076923077	0.03636363636363636	GO:0002705	GO:BP	positive regulation of leukocyte mediated immunity	16175	1223		0.7	0.7142857142857143	110	16065	4	9	106	16056	16175	0.10383455346160293
M1	string	0	network_modules	273	TRUE	0.0027277465238705304	33	13	3	0.23076923076923078	0.09090909090909091	GO:0002474	GO:BP	antigen processing and presentation of peptide antigen via MHC class I	16175	997		0.75	0.7619047619047619	33	16142	3	10	30	16132	16175	0.1437653050225394
M1	string	0	network_modules	273	TRUE	0.0028935462052620798	124	6	3	0.5	0.024193548387096774	KEGG:04650	KEGG	Natural killer cell mediated cytotoxicity	8484	334		NA	1	124	8360	3	3	121	8357	8484	0.1075972768568635
M1	string	0	network_modules	273	TRUE	0.0029903337715008207	34	13	3	0.23076923076923078	0.08823529411764706	GO:0001916	GO:BP	positive regulation of T cell mediated cytotoxicity	16175	533		0.8	0.8095238095238095	34	16141	3	10	31	16131	16175	0.14160143408526701
M1	string	0	network_modules	273	TRUE	0.004029434360799636	136	13	4	0.3076923076923077	0.029411764705882353	GO:0002706	GO:BP	regulation of lymphocyte mediated immunity	16175	1224		0.85	0.8571428571428571	136	16039	4	9	132	16030	16175	0.09295959195991686
M1	string	0	network_modules	273	TRUE	0.0057155402409709045	42	13	3	0.23076923076923078	0.07142857142857142	GO:0001914	GO:BP	regulation of T cell mediated cytotoxicity	16175	531		0.9	0.9047619047619048	42	16133	3	10	39	16123	16175	0.127159775498747
M1	string	0	network_modules	273	TRUE	0.007054934362525585	45	13	3	0.23076923076923078	0.06666666666666667	GO:0001913	GO:BP	T cell mediated cytotoxicity	16175	530		0.95	0.9523809523809523	45	16130	3	10	42	16120	16175	0.12275957091118188
M1	string	0	network_modules	273	TRUE	0.009328539384902784	168	13	4	0.3076923076923077	0.023809523809523808	GO:0001906	GO:BP	cell killing	16175	524		1	1	168	16007	4	9	164	15998	16175	0.08316916509891713
M1	string	0	network_modules	274	TRUE	1.0924419384723032e-6	14	17	4	0.23529411764705882	0.2857142857142857	GO:2001034	GO:BP	positive regulation of double-strand break repair via nonhomologous end joining	16175	26280		0	0.02631578947368421	14	16161	4	13	10	16148	16175	0.25857550423983405
M1	string	0	network_modules	274	TRUE	2.5924048635887183e-6	17	17	4	0.23529411764705882	0.23529411764705882	GO:0045830	GO:BP	positive regulation of isotype switching	16175	11648		0.02702702702702703	0.05263157894736842	17	16158	4	13	13	16145	16175	0.23448956262787324
M1	string	0	network_modules	274	TRUE	6.502375424086631e-6	21	17	4	0.23529411764705882	0.19047619047619047	GO:0045191	GO:BP	regulation of isotype switching	16175	11319		0.05405405405405406	0.07894736842105263	21	16154	4	13	17	16141	16175	0.21078192033344578
M1	string	0	network_modules	274	TRUE	9.608097856499435e-6	23	17	4	0.23529411764705882	0.17391304347826086	GO:0002714	GO:BP	positive regulation of B cell mediated immunity	16175	1232		0.08108108108108109	0.13157894736842105	23	16152	4	13	19	16139	16175	0.2013151332267259
M1	string	0	network_modules	274	TRUE	9.608097856499435e-6	23	17	4	0.23529411764705882	0.17391304347826086	GO:0002891	GO:BP	positive regulation of immunoglobulin mediated immune response	16175	1401		0.08108108108108109	0.13157894736842105	23	16152	4	13	19	16139	16175	0.2013151332267259
M1	string	0	network_modules	274	TRUE	1.1522298885043577e-5	24	17	4	0.23529411764705882	0.16666666666666666	GO:2001032	GO:BP	regulation of double-strand break repair via nonhomologous end joining	16175	26278		0.13513513513513514	0.15789473684210525	24	16151	4	13	20	16138	16175	0.19703044763732533
M1	string	0	network_modules	274	TRUE	4.411526538953344e-5	33	17	4	0.23529411764705882	0.12121212121212122	GO:0002204	GO:BP	somatic recombination of immunoglobulin genes involved in immune response	16175	742		0.16216216216216217	0.23684210526315788	33	16142	4	13	29	16129	16175	0.167674986670457
M1	string	0	network_modules	274	TRUE	4.411526538953344e-5	33	17	4	0.23529411764705882	0.12121212121212122	GO:0002208	GO:BP	somatic diversification of immunoglobulins involved in immune response	16175	746		0.16216216216216217	0.23684210526315788	33	16142	4	13	29	16129	16175	0.167674986670457
M1	string	0	network_modules	274	TRUE	4.411526538953344e-5	33	17	4	0.23529411764705882	0.12121212121212122	GO:0045190	GO:BP	isotype switching	16175	11318		0.16216216216216217	0.23684210526315788	33	16142	4	13	29	16129	16175	0.167674986670457
M1	string	0	network_modules	274	TRUE	5.637592885688868e-5	35	17	4	0.23529411764705882	0.11428571428571428	GO:0002381	GO:BP	immunoglobulin production involved in immunoglobulin-mediated immune response	16175	908		0.24324324324324326	0.2631578947368421	35	16140	4	13	31	16127	16175	0.1627375803989863
M1	string	0	network_modules	274	TRUE	7.101903895082965e-5	37	17	4	0.23529411764705882	0.10810810810810811	GO:0002889	GO:BP	regulation of immunoglobulin mediated immune response	16175	1399		0.2702702702702703	0.2894736842105263	37	16138	4	13	33	16125	16175	0.15820402268392175
M1	string	0	network_modules	274	TRUE	7.932313084641022e-5	38	17	4	0.23529411764705882	0.10526315789473684	GO:0002639	GO:BP	positive regulation of immunoglobulin production	16175	1160		0.2972972972972973	0.34210526315789475	38	16137	4	13	34	16124	16175	0.156071927886988
M1	string	0	network_modules	274	TRUE	7.932313084641022e-5	38	17	4	0.23529411764705882	0.10526315789473684	GO:0002712	GO:BP	regulation of B cell mediated immunity	16175	1230		0.2972972972972973	0.34210526315789475	38	16137	4	13	34	16124	16175	0.156071927886988
M1	string	0	network_modules	274	TRUE	8.833173884316078e-5	39	17	4	0.23529411764705882	0.10256410256410256	GO:0016447	GO:BP	somatic recombination of immunoglobulin gene segments	16175	5226		0.35135135135135137	0.3684210526315789	39	16136	4	13	35	16123	16175	0.15402189741998215
M1	string	0	network_modules	274	TRUE	1.4531832280223966e-4	44	17	4	0.23529411764705882	0.09090909090909091	GO:0002562	GO:BP	somatic diversification of immune receptors via germline recombination within a single locus	16175	1083		0.3783783783783784	0.42105263157894735	44	16131	4	13	40	16118	16175	0.14483678781608028
M1	string	0	network_modules	274	TRUE	1.4531832280223966e-4	44	17	4	0.23529411764705882	0.09090909090909091	GO:0016444	GO:BP	somatic cell DNA recombination	16175	5223		0.3783783783783784	0.42105263157894735	44	16131	4	13	40	16118	16175	0.14483678781608028
M1	string	0	network_modules	274	TRUE	1.5939304324218948e-4	45	17	4	0.23529411764705882	0.08888888888888889	GO:0002637	GO:BP	regulation of immunoglobulin production	16175	1158		0.43243243243243246	0.4473684210526316	45	16130	4	13	41	16117	16175	0.1431848161932483
M1	string	0	network_modules	274	TRUE	1.905671079165097e-4	47	17	4	0.23529411764705882	0.0851063829787234	GO:0016445	GO:BP	somatic diversification of immunoglobulins	16175	5224		0.4594594594594595	0.47368421052631576	47	16128	4	13	43	16115	16175	0.14003938848202985
M1	string	0	network_modules	274	TRUE	2.8831559882359133e-4	52	17	4	0.23529411764705882	0.07692307692307693	GO:0002200	GO:BP	somatic diversification of immune receptors	16175	738		0.4864864864864865	0.5	52	16123	4	13	48	16110	16175	0.13298011912064836
M1	string	0	network_modules	274	TRUE	3.363661047748498e-4	54	17	4	0.23529411764705882	0.07407407407407407	GO:0002312	GO:BP	B cell activation involved in immune response	16175	844		0.5135135135135135	0.5263157894736842	54	16121	4	13	50	16108	16175	0.13043285536525337
M1	string	0	network_modules	274	TRUE	4.193234683013493e-4	57	17	4	0.23529411764705882	0.07017543859649122	GO:0050871	GO:BP	positive regulation of B cell activation	16175	13319		0.5405405405405406	0.5789473684210527	57	16118	4	13	53	16105	16175	0.12686431150568964
M1	string	0	network_modules	274	TRUE	4.193234683013493e-4	57	17	4	0.23529411764705882	0.07017543859649122	GO:0045911	GO:BP	positive regulation of DNA recombination	16175	11705		0.5405405405405406	0.5789473684210527	57	16118	4	13	53	16105	16175	0.12686431150568964
M1	string	0	network_modules	274	TRUE	5.902768549969901e-4	62	17	4	0.23529411764705882	0.06451612903225806	GO:0006303	GO:BP	double-strand break repair via nonhomologous end joining	16175	2110		0.5945945945945946	0.6052631578947368	62	16113	4	13	58	16100	16175	0.12149790896395816
M1	string	0	network_modules	274	TRUE	0.0010221790280842819	71	17	4	0.23529411764705882	0.056338028169014086	GO:0002377	GO:BP	immunoglobulin production	16175	907		0.6216216216216216	0.631578947368421	71	16104	4	13	67	16091	16175	0.11329520505326621
M1	string	0	network_modules	274	TRUE	0.0019299916390394345	22	17	3	0.17647058823529413	0.13636363636363635	GO:2000042	GO:BP	negative regulation of double-strand break repair via homologous recombination	16175	25403		0.6486486486486487	0.6578947368421053	22	16153	3	14	19	16139	16175	0.15411649072490274
M1	string	0	network_modules	274	TRUE	0.0020129369438140992	84	17	4	0.23529411764705882	0.047619047619047616	GO:2000781	GO:BP	positive regulation of double-strand break repair	16175	26037		0.6756756756756757	0.6842105263157895	84	16091	4	13	80	16078	16175	0.10383939269628178
M1	string	0	network_modules	274	TRUE	0.002539010611670214	89	17	4	0.23529411764705882	0.0449438202247191	GO:0002824	GO:BP	positive regulation of adaptive immune response based on somatic recombination of immune receptors built from immunoglobulin superfamily domains	16175	1334		0.7027027027027027	0.7105263157894737	89	16086	4	13	85	16073	16175	0.10076052885292018
M1	string	0	network_modules	274	TRUE	0.0027756886617899454	91	17	4	0.23529411764705882	0.04395604395604396	GO:0050864	GO:BP	regulation of B cell activation	16175	13312		0.7297297297297297	0.7368421052631579	91	16084	4	13	87	16071	16175	0.09959969190432548
M1	string	0	network_modules	274	TRUE	0.002899986092636501	92	17	4	0.23529411764705882	0.043478260869565216	GO:0002708	GO:BP	positive regulation of lymphocyte mediated immunity	16175	1226		0.7567567567567568	0.7631578947368421	92	16083	4	13	88	16070	16175	0.09903332404239759
M1	string	0	network_modules	274	TRUE	0.0032977399033117688	95	17	4	0.23529411764705882	0.042105263157894736	GO:0002702	GO:BP	positive regulation of production of molecular mediator of immune response	16175	1220		0.7837837837837838	0.7894736842105263	95	16080	4	13	91	16067	16175	0.09738745573469543
M1	string	0	network_modules	274	TRUE	0.0034389018956682105	96	17	4	0.23529411764705882	0.041666666666666664	GO:0002821	GO:BP	positive regulation of adaptive immune response	16175	1331		0.8108108108108109	0.8157894736842105	96	16079	4	13	92	16066	16175	0.09685580660588186
M1	string	0	network_modules	274	TRUE	0.004556302998854571	103	17	4	0.23529411764705882	0.038834951456310676	GO:0002520	GO:BP	immune system development	16175	1042		0.8378378378378378	0.8421052631578947	103	16072	4	13	99	16059	16175	0.0933505752531376
M1	string	0	network_modules	274	TRUE	0.004558568921976426	29	17	3	0.17647058823529413	0.10344827586206896	GO:0043247	GO:BP	telomere maintenance in response to DNA damage	16175	10583		0.8648648648648649	0.868421052631579	29	16146	3	14	26	16132	16175	0.133930945548822
M1	string	0	network_modules	274	TRUE	0.005922702159977847	110	17	4	0.23529411764705882	0.03636363636363636	GO:0002705	GO:BP	positive regulation of leukocyte mediated immunity	16175	1223		0.8918918918918919	0.8947368421052632	110	16065	4	13	106	16052	16175	0.09018038594120213
M1	string	0	network_modules	274	TRUE	0.006592724498350086	113	17	4	0.23529411764705882	0.035398230088495575	GO:0000018	GO:BP	regulation of DNA recombination	16175	6		0.918918918918919	0.9210526315789473	113	16062	4	13	109	16049	16175	0.08891132829866415
M1	string	0	network_modules	274	TRUE	0.007441166122930399	34	17	3	0.17647058823529413	0.08823529411764706	GO:2000780	GO:BP	negative regulation of double-strand break repair	16175	26036		0.9459459459459459	0.9473684210526315	34	16141	3	14	31	16127	16175	0.12349190753907653
M1	string	0	network_modules	274	TRUE	0.008867136394876922	36	17	3	0.17647058823529413	0.08333333333333333	GO:0045738	GO:BP	negative regulation of DNA repair	16175	11578		0.972972972972973	0.9736842105263158	36	16139	3	14	33	16125	16175	0.11993488985794258
M1	string	0	network_modules	274	TRUE	0.009235972944955833	123	17	4	0.23529411764705882	0.032520325203252036	GO:0002700	GO:BP	regulation of production of molecular mediator of immune response	16175	1218		1	1	123	16052	4	13	119	16039	16175	0.08501613816867022
M1	string	0	network_modules	275	TRUE	5.744235143791002e-13	108	17	9	0.5294117647058824	0.08333333333333333	GO:0061640	GO:BP	cytoskeleton-dependent cytokinesis	16175	15599		0	0.3333333333333333	108	16067	9	8	99	16059	16175	0.20819825345127185
M1	string	0	network_modules	275	TRUE	4.904618697318113e-11	175	17	9	0.5294117647058824	0.05142857142857143	GO:0000910	GO:BP	cytokinesis	16175	243		0.5	0.6666666666666666	175	16000	9	8	166	15992	16175	0.16260063872821812
M1	string	0	network_modules	275	TRUE	2.0376921643322806e-9	77	9	6	0.6666666666666666	0.07792207792207792	KEGG:05100	KEGG	Bacterial invasion of epithelial cells	8484	423		0	0.5	77	8407	6	3	71	8404	8484	0.225965364448957
M1	string	0	network_modules	275	TRUE	2.1186318873983843e-9	265	17	9	0.5294117647058824	0.033962264150943396	GO:0051301	GO:BP	cell division	16175	13632		1	1	265	15910	9	8	256	15902	16175	0.1310866234448333
M1	string	0	network_modules	275	TRUE	1.2190342308184228e-4	246	9	5	0.5555555555555556	0.02032520325203252	KEGG:05131	KEGG	Shigellosis	8484	428		1	1	246	8238	5	4	241	8234	8484	0.10226365547940372
M1	string	0	network_modules	276	TRUE	4.7312243419048673e-7	13	15	4	0.26666666666666666	0.3076923076923077	GO:0006474	GO:BP	N-terminal protein amino acid acetylation	16175	2211		0	0.25	13	16162	4	11	9	16151	16175	0.28583002313189565
M1	string	0	network_modules	276	TRUE	8.316106340538119e-6	25	15	4	0.26666666666666666	0.16	GO:0031365	GO:BP	N-terminal protein amino acid modification	16175	7143		0.3333333333333333	0.5	25	16150	4	11	21	16139	16175	0.2056161482942495
M1	string	0	network_modules	276	TRUE	1.493508914798681e-4	50	15	4	0.26666666666666666	0.08	GO:0006473	GO:BP	protein acetylation	16175	2210		0.6666666666666666	0.75	50	16125	4	11	46	16114	16175	0.14465697438576008
M1	string	0	network_modules	276	TRUE	0.001170454323893178	83	15	4	0.26666666666666666	0.04819277108433735	GO:0043543	GO:BP	protein acylation	16175	10760		1	1	83	16092	4	11	79	16081	16175	0.11152069891948674
M1	string	0	network_modules	277	TRUE	1.7704810653207737e-4	83	10	4	0.4	0.04819277108433735	REAC:R-HSA-1483255	REAC	PI Metabolism	10916	1665		0	0.16666666666666666	83	10833	4	6	79	10827	10916	0.13678625768200342
M1	string	0	network_modules	277	TRUE	2.2417322157261422e-4	88	10	4	0.4	0.045454545454545456	REAC:R-HSA-8876198	REAC	RAB GEFs exchange GTP for GDP on RABs	10916	1834		0.2	0.3333333333333333	88	10828	4	6	84	10822	10916	0.13271902400133234
M1	string	0	network_modules	277	TRUE	7.785930482971669e-4	120	10	4	0.4	0.03333333333333333	REAC:R-HSA-9007101	REAC	Rab regulation of trafficking	10916	1939		0.4	0.5	120	10796	4	6	116	10790	10916	0.1129707712121339
M1	string	0	network_modules	277	TRUE	0.00211869482223381	5	10	2	0.2	0.4	REAC:R-HSA-1483248	REAC	Synthesis of PIPs at the ER membrane	10916	2391		0.6	0.6666666666666666	5	10911	2	8	3	10903	10916	0.2823889684611204
M1	string	0	network_modules	277	TRUE	0.0033570162093932666	52	10	3	0.3	0.057692307692307696	REAC:R-HSA-1660499	REAC	Synthesis of PIPs at the plasma membrane	10916	2395		0.8	0.8333333333333334	52	10864	3	7	49	10857	10916	0.12983866995739166
M1	string	0	network_modules	277	TRUE	0.007170601082481022	210	10	4	0.4	0.01904761904761905	REAC:R-HSA-1483257	REAC	Phospholipid metabolism	10916	1748		1	1	210	10706	4	6	206	10700	10916	0.0839385229186174
M1	string	0	network_modules	279	TRUE	3.712600738960171e-15	55	19	9	0.47368421052631576	0.16363636363636364	GO:0050853	GO:BP	B cell receptor signaling pathway	16175	13301		0	0.05555555555555555	55	16120	9	10	46	16110	16175	0.27704506371675214
M1	string	0	network_modules	279	TRUE	5.186526183674572e-15	158	19	11	0.5789473684210527	0.06962025316455696	GO:0050851	GO:BP	antigen receptor-mediated signaling pathway	16175	13299		0.058823529411764705	0.1111111111111111	158	16017	11	8	147	16009	16175	0.19846506149923168
M1	string	0	network_modules	279	TRUE	1.793417807005271e-14	265	19	12	0.631578947368421	0.045283018867924525	GO:0002429	GO:BP	immune response-activating cell surface receptor signaling pathway	16175	952		0.11764705882352941	0.16666666666666666	265	15910	12	7	253	15903	16175	0.16619172265455967
M1	string	0	network_modules	279	TRUE	4.720267270632659e-14	287	19	12	0.631578947368421	0.041811846689895474	GO:0002768	GO:BP	immune response-regulating cell surface receptor signaling pathway	16175	1279		0.17647058823529413	0.2222222222222222	287	15888	12	7	275	15881	16175	0.1594522370003392
M1	string	0	network_modules	279	TRUE	5.705462176051037e-14	416	19	13	0.6842105263157895	0.03125	GO:0002757	GO:BP	immune response-activating signaling pathway	16175	1268		0.23529411764705882	0.2777777777777778	416	15759	13	6	403	15753	16175	0.14265715606745002
M1	string	0	network_modules	279	TRUE	1.0841982489416373e-13	437	19	13	0.6842105263157895	0.029748283752860413	GO:0002764	GO:BP	immune response-regulating signaling pathway	16175	1275		0.29411764705882354	0.3333333333333333	437	15738	13	6	424	15732	16175	0.1390054904340537
M1	string	0	network_modules	279	TRUE	3.2088526615304845e-13	475	19	13	0.6842105263157895	0.02736842105263158	GO:0002253	GO:BP	activation of immune response	16175	785		0.35294117647058826	0.3888888888888889	475	15700	13	6	462	15694	16175	0.13301344304663235
M1	string	0	network_modules	279	TRUE	1.1692440056235918e-11	627	19	13	0.6842105263157895	0.02073365231259968	GO:0050778	GO:BP	positive regulation of immune response	16175	13252		0.4117647058823529	0.4444444444444444	627	15548	13	6	614	15542	16175	0.11466839118370194
M1	string	0	network_modules	279	TRUE	1.004584521415283e-10	83	18	8	0.4444444444444444	0.0963855421686747	REAC:R-HSA-2871809	REAC	FCERI mediated Ca+2 mobilization	10916	894		0	0.058823529411764705	83	10833	8	10	75	10823	10916	0.20437900462795033
M1	string	0	network_modules	279	TRUE	1.2985708727128847e-10	756	19	13	0.6842105263157895	0.017195767195767195	GO:0050776	GO:BP	regulation of immune response	16175	13250		0.47058823529411764	0.5	756	15419	13	6	743	15413	16175	0.10356812091906462
M1	string	0	network_modules	279	TRUE	1.0772463925370635e-9	182	18	9	0.5	0.04945054945054945	REAC:R-HSA-2454202	REAC	Fc epsilon receptor (FCERI) signaling	10916	938		0.0625	0.11764705882352941	182	10734	9	9	173	10725	10916	0.1534091092170562
M1	string	0	network_modules	279	TRUE	1.2162261607009283e-9	124	16	8	0.5	0.06451612903225806	KEGG:04650	KEGG	Natural killer cell mediated cytotoxicity	8484	334		0	0.07692307692307693	124	8360	8	8	116	8352	8484	0.17580933355228245
M1	string	0	network_modules	279	TRUE	3.7243280485806233e-9	81	16	7	0.4375	0.08641975308641975	KEGG:04662	KEGG	B cell receptor signaling pathway	8484	339		0.08333333333333333	0.15384615384615385	81	8403	7	9	74	8394	8484	0.19129614643728984
M1	string	0	network_modules	279	TRUE	5.6601769823533774e-8	23	19	5	0.2631578947368421	0.21739130434782608	GO:0038095	GO:BP	Fc-epsilon receptor signaling pathway	16175	9695		0.5294117647058824	0.5555555555555556	23	16152	5	14	18	16138	16175	0.2381992940954729
M1	string	0	network_modules	279	TRUE	9.126951876506531e-8	67	16	6	0.375	0.08955223880597014	KEGG:04664	KEGG	Fc epsilon RI signaling pathway	8484	340		0.16666666666666666	0.23076923076923078	67	8417	6	10	61	8407	8484	0.18027762871075165
M1	string	0	network_modules	279	TRUE	1.067341323330149e-7	25	18	5	0.2777777777777778	0.2	REAC:R-HSA-2424491	REAC	DAP12 signaling	10916	433		0.125	0.17647058823529413	25	10891	5	13	20	10878	10916	0.23422027653613356
M1	string	0	network_modules	279	TRUE	6.457068071909422e-7	35	18	5	0.2777777777777778	0.14285714285714285	REAC:R-HSA-2172127	REAC	DAP12 interactions	10916	432		0.1875	0.23529411764705882	35	10881	5	13	30	10868	10916	0.19738464612027548
M1	string	0	network_modules	279	TRUE	9.219118420305919e-7	84	18	6	0.3333333333333333	0.07142857142857142	REAC:R-HSA-983695	REAC	Antigen activates B Cell Receptor (BCR) leading to generation of second messengers	10916	152		0.25	0.29411764705882354	84	10832	6	12	78	10820	10916	0.15144947205806375
M1	string	0	network_modules	279	TRUE	2.535921442136887e-6	47	19	5	0.2631578947368421	0.10638297872340426	GO:0038093	GO:BP	Fc receptor signaling pathway	16175	9693		0.5882352941176471	0.6111111111111112	47	16128	5	14	42	16114	16175	0.16580947746604993
M1	string	0	network_modules	279	TRUE	2.594345803552967e-6	205	16	7	0.4375	0.03414634146341464	KEGG:05205	KEGG	Proteoglycans in cancer	8484	457		0.25	0.3076923076923077	205	8279	7	9	198	8270	8484	0.11700609909261817
M1	string	0	network_modules	279	TRUE	3.0098882030595463e-6	119	16	6	0.375	0.05042016806722689	KEGG:04660	KEGG	T cell receptor signaling pathway	8484	338		0.3333333333333333	0.38461538461538464	119	8365	6	10	113	8355	8484	0.13342561420223956
M1	string	0	network_modules	279	TRUE	3.6519680922544587e-6	114	19	6	0.3157894736842105	0.05263157894736842	GO:0050852	GO:BP	T cell receptor signaling pathway	16175	13300		0.6470588235294118	0.6666666666666666	114	16061	6	13	108	16048	16175	0.12656410297314746
M1	string	0	network_modules	279	TRUE	7.05860064262274e-6	569	19	9	0.47368421052631576	0.015817223198594025	GO:0046649	GO:BP	lymphocyte activation	16175	12286		0.7058823529411765	0.7222222222222222	569	15606	9	10	560	15596	16175	0.08162594755237038
M1	string	0	network_modules	279	TRUE	1.3870258968291297e-5	23	18	4	0.2222222222222222	0.17391304347826086	REAC:R-HSA-9006335	REAC	Signaling by Erythropoietin	10916	2238		0.3125	0.35294117647058826	23	10893	4	14	19	10879	10916	0.19509169753767955
M1	string	0	network_modules	279	TRUE	4.223761187546859e-5	699	19	9	0.47368421052631576	0.012875536480686695	GO:0045321	GO:BP	leukocyte activation	16175	11356		0.7647058823529411	0.7777777777777778	699	15476	9	10	690	15466	16175	0.07259863860305354
M1	string	0	network_modules	279	TRUE	4.993762669914147e-5	163	18	6	0.3333333333333333	0.03680981595092025	REAC:R-HSA-983705	REAC	Signaling by the B Cell Receptor (BCR)	10916	2328		0.375	0.4117647058823529	163	10753	6	12	157	10741	10916	0.10669457663806191
M1	string	0	network_modules	279	TRUE	5.505456864806176e-5	83	18	5	0.2777777777777778	0.060240963855421686	REAC:R-HSA-2871796	REAC	FCERI mediated MAPK activation	10916	895		0.4375	0.47058823529411764	83	10833	5	13	78	10820	10916	0.12640286878951665
M1	string	0	network_modules	279	TRUE	8.101014981361017e-5	35	18	4	0.2222222222222222	0.11428571428571428	REAC:R-HSA-114604	REAC	GPVI-mediated activation cascade	10916	1021		0.5	0.5882352941176471	35	10881	4	14	31	10867	10916	0.15744672587840472
M1	string	0	network_modules	279	TRUE	8.101014981361017e-5	35	18	4	0.2222222222222222	0.11428571428571428	REAC:R-HSA-202433	REAC	Generation of second messenger molecules	10916	1044		0.5	0.5882352941176471	35	10881	4	14	31	10867	10916	0.15744672587840472
M1	string	0	network_modules	279	TRUE	9.718596188582388e-5	197	19	6	0.3157894736842105	0.030456852791878174	GO:0042113	GO:BP	B cell activation	16175	9971		0.8235294117647058	0.8333333333333334	197	15978	6	13	191	15965	16175	0.09492403308613194
M1	string	0	network_modules	279	TRUE	9.780619774891389e-5	114	16	5	0.3125	0.043859649122807015	KEGG:04670	KEGG	Leukocyte transendothelial migration	8484	343		0.4166666666666667	0.46153846153846156	114	8370	5	11	109	8359	8484	0.11290616938684678
M1	string	0	network_modules	279	TRUE	2.0207481444312514e-4	132	16	5	0.3125	0.03787878787878788	KEGG:04380	KEGG	Osteoclast differentiation	8484	309		0.5	0.5384615384615384	132	8352	5	11	127	8341	8484	0.10429383216970829
M1	string	0	network_modules	279	TRUE	7.468955003772994e-4	140	18	5	0.2777777777777778	0.03571428571428571	REAC:R-HSA-2029480	REAC	Fcgamma receptor (FCGR) dependent phagocytosis	10916	939		0.625	0.6470588235294118	140	10776	5	13	135	10763	10916	0.09569774410986134
M1	string	0	network_modules	279	TRUE	0.0011997991255470292	190	16	5	0.3125	0.02631578947368421	KEGG:04062	KEGG	Chemokine signaling pathway	8484	255		0.5833333333333334	0.6153846153846154	190	8294	5	11	185	8283	8484	0.08522489597618513
M1	string	0	network_modules	279	TRUE	0.0014648625046904356	198	16	5	0.3125	0.025252525252525252	KEGG:05169	KEGG	Epstein-Barr virus infection	8484	450		0.6666666666666666	0.6923076923076923	198	8286	5	11	193	8275	8484	0.08325423116678915
M1	string	0	network_modules	279	TRUE	0.0015859027149432473	96	16	4	0.25	0.041666666666666664	KEGG:04666	KEGG	Fc gamma R-mediated phagocytosis	8484	341		0.75	0.7692307692307693	96	8388	4	12	92	8376	8484	0.09809113659446812
M1	string	0	network_modules	279	TRUE	0.00201493951519915	102	16	4	0.25	0.0392156862745098	KEGG:04064	KEGG	NF-kappa B signaling pathway	8484	256		0.8333333333333334	0.8461538461538461	102	8382	4	12	98	8370	8484	0.09491437044611137
M1	string	0	network_modules	279	TRUE	0.00217482312606413	179	19	5	0.2631578947368421	0.027932960893854747	GO:0007596	GO:BP	blood coagulation	16175	3055		0.8823529411764706	0.8888888888888888	179	15996	5	14	174	15982	16175	0.08263804670481684
M1	string	0	network_modules	279	TRUE	0.0024248932305351092	183	19	5	0.2631578947368421	0.0273224043715847	GO:0050817	GO:BP	coagulation	16175	13279		0.9411764705882353	0.9444444444444444	183	15992	5	14	178	15978	16175	0.08165994447984956
M1	string	0	network_modules	279	TRUE	0.002558150727165912	185	19	5	0.2631578947368421	0.02702702702702703	GO:0007599	GO:BP	hemostasis	16175	3058		1	1	185	15990	5	14	180	15976	16175	0.0811825413245174
M1	string	0	network_modules	279	TRUE	0.002583323692936051	37	16	3	0.1875	0.08108108108108109	KEGG:05340	KEGG	Primary immunodeficiency	8484	488		0.9166666666666666	0.9230769230769231	37	8447	3	13	34	8434	8484	0.12080880798354592
M1	string	0	network_modules	279	TRUE	0.002809636819090901	507	18	7	0.3888888888888889	0.013806706114398421	REAC:R-HSA-9006934	REAC	Signaling by Receptor Tyrosine Kinases	10916	2302		0.6875	0.7058823529411765	507	10409	7	11	500	10398	10916	0.06613122582622855
M1	string	0	network_modules	279	TRUE	0.0033158894576206213	27	18	3	0.16666666666666666	0.1111111111111111	REAC:R-HSA-5218920	REAC	VEGFR2 mediated vascular permeability	10916	2636		0.75	0.7647058823529411	27	10889	3	15	24	10874	10916	0.13434012607631576
M1	string	0	network_modules	279	TRUE	0.004440206448343073	94	18	4	0.2222222222222222	0.0425531914893617	REAC:R-HSA-4420097	REAC	VEGFA-VEGFR2 Pathway	10916	2634		0.8125	0.8235294117647058	94	10822	4	14	90	10808	10916	0.09395768727008302
M1	string	0	network_modules	279	TRUE	0.006070095868509142	215	18	5	0.2777777777777778	0.023255813953488372	REAC:R-HSA-9658195	REAC	Leishmania infection	10916	1310		0.875	0.9411764705882353	215	10701	5	13	210	10688	10916	0.07548358951213556
M1	string	0	network_modules	279	TRUE	0.006070095868509142	215	18	5	0.2777777777777778	0.023255813953488372	REAC:R-HSA-9824443	REAC	Parasitic Infection Pathways	10916	1717		0.875	0.9411764705882353	215	10701	5	13	210	10688	10916	0.07548358951213556
M1	string	0	network_modules	279	TRUE	0.006218887038763601	136	16	4	0.25	0.029411764705882353	KEGG:05135	KEGG	Yersinia infection	8484	432		1	1	136	8348	4	12	132	8336	8484	0.08097843949199907
M1	string	0	network_modules	279	TRUE	0.0066264593292855055	104	18	4	0.2222222222222222	0.038461538461538464	REAC:R-HSA-194138	REAC	Signaling by VEGF	10916	2313		1	1	104	10812	4	14	100	10798	10916	0.08898438695132935
M1	string	0	network_modules	280	TRUE	8.949097981927294e-4	630	15	7	0.4666666666666667	0.011111111111111112	GO:0010564	GO:BP	regulation of cell cycle process	16175	4217		0	0.5	630	15545	7	8	623	15537	16175	0.06735359736188343
M1	string	0	network_modules	280	TRUE	0.001569497534929302	23	15	3	0.2	0.13043478260869565	GO:0046599	GO:BP	regulation of centriole replication	16175	12249		1	1	23	16152	3	12	20	16140	16175	0.16055484548270105
M1	string	0	network_modules	281	TRUE	2.1149262401032814e-9	16	14	5	0.35714285714285715	0.3125	REAC:R-HSA-9671793	REAC	Diseases of hemostasis	10916	766		0	0.18181818181818182	16	10900	5	9	11	10891	10916	0.3331632906732642
M1	string	0	network_modules	281	TRUE	2.1149262401032814e-9	16	14	5	0.35714285714285715	0.3125	REAC:R-HSA-9651496	REAC	Defects of contact activation system (CAS) and kallikrein/kinin system (KKS)	10916	716		0	0.18181818181818182	16	10900	5	9	11	10891	10916	0.3331632906732642
M1	string	0	network_modules	281	TRUE	5.891352757089736e-8	28	16	5	0.3125	0.17857142857142858	GO:0050901	GO:BP	leukocyte tethering or rolling	16175	13343		0	0.047619047619047616	28	16147	5	11	23	16136	16175	0.2352392029948965
M1	string	0	network_modules	281	TRUE	4.0319376076363793e-7	12	16	4	0.25	0.3333333333333333	GO:0010572	GO:BP	positive regulation of platelet activation	16175	4225		0.05	0.09523809523809523	12	16163	4	12	8	16151	16175	0.2880678133321143
M1	string	0	network_modules	281	TRUE	5.058927716650824e-7	42	16	5	0.3125	0.11904761904761904	GO:0061756	GO:BP	leukocyte adhesion to vascular endothelial cell	16175	15650		0.1	0.14285714285714285	42	16133	5	11	37	16122	16175	0.1916201472250426
M1	string	0	network_modules	281	TRUE	2.948690651124168e-6	59	16	5	0.3125	0.0847457627118644	GO:0045123	GO:BP	cellular extravasation	16175	11289		0.15	0.19047619047619047	59	16116	5	11	54	16105	16175	0.16121052020432936
M1	string	0	network_modules	281	TRUE	1.0538988862205604e-5	6	14	3	0.21428571428571427	0.5	REAC:R-HSA-9673221	REAC	Defective F9 activation	10916	546		0.2	0.2727272727272727	6	10910	3	11	3	10899	10916	0.32678661498676614
M1	string	0	network_modules	281	TRUE	3.5547800982188e-5	7	16	3	0.1875	0.42857142857142855	GO:1903238	GO:BP	positive regulation of leukocyte tethering or rolling	16175	22850		0.2	0.23809523809523808	7	16168	3	13	4	16155	16175	0.28302030409478557
M1	string	0	network_modules	281	TRUE	4.4163432520017195e-5	9	14	3	0.21428571428571427	0.3333333333333333	REAC:R-HSA-9668250	REAC	Defective factor IX causes hemophilia B	10916	692		0.3	0.36363636363636365	9	10907	3	11	6	10896	10916	0.26651371644118677
M1	string	0	network_modules	281	TRUE	5.6842189822400436e-5	8	16	3	0.1875	0.375	GO:0007597	GO:BP	blood coagulation, intrinsic pathway	16175	3056		0.25	0.2857142857142857	8	16167	3	13	5	16154	16175	0.2646619434592659
M1	string	0	network_modules	281	TRUE	7.517497066509e-5	153	12	5	0.4166666666666667	0.032679738562091505	KEGG:04514	KEGG	Cell adhesion molecules	8484	315		NA	1	153	8331	5	7	148	8324	8484	0.11273972472949752
M1	string	0	network_modules	281	TRUE	8.66184679648183e-5	11	14	3	0.21428571428571427	0.2727272727272727	REAC:R-HSA-430116	REAC	GP1b-IX-V activation signalling	10916	1017		0.4	0.45454545454545453	11	10905	3	11	8	10894	10916	0.24088589845447983
M1	string	0	network_modules	281	TRUE	1.6717869738099942e-4	11	16	3	0.1875	0.2727272727272727	GO:0035855	GO:BP	megakaryocyte development	16175	9292		0.3	0.3333333333333333	11	16164	3	13	8	16151	16175	0.22550153409960236
M1	string	0	network_modules	281	TRUE	1.8339837639447153e-4	50	16	4	0.25	0.08	GO:0010543	GO:BP	regulation of platelet activation	16175	4202		0.35	0.38095238095238093	50	16125	4	12	46	16113	16175	0.1399583334636824
M1	string	0	network_modules	281	TRUE	2.2277053192107846e-4	12	16	3	0.1875	0.25	GO:1903236	GO:BP	regulation of leukocyte tethering or rolling	16175	22848		0.4	0.42857142857142855	12	16163	3	13	9	16150	16175	0.2158365105379345
M1	string	0	network_modules	281	TRUE	2.3167685478300582e-4	745	16	8	0.5	0.010738255033557046	GO:0098609	GO:BP	cell-cell adhesion	16175	18805		0.45	0.47619047619047616	745	15430	8	8	737	15422	16175	0.06814525274624086
M1	string	0	network_modules	281	TRUE	2.3813536645775487e-4	15	14	3	0.21428571428571427	0.2	REAC:R-HSA-75892	REAC	Platelet Adhesion to exposed collagen	10916	1760		0.5	0.5454545454545454	15	10901	3	11	12	10890	10916	0.2059657220886868
M1	string	0	network_modules	281	TRUE	3.6760588256394967e-4	304	16	6	0.375	0.019736842105263157	GO:0050900	GO:BP	leukocyte migration	16175	13342		0.5	0.5238095238095238	304	15871	6	10	298	15861	16175	0.08253892375080944
M1	string	0	network_modules	281	TRUE	4.5989707565052026e-4	15	16	3	0.1875	0.2	GO:0072378	GO:BP	blood coagulation, fibrin clot formation	16175	17375		0.55	0.5714285714285714	15	16160	3	13	12	16147	16175	0.19287622447182098
M1	string	0	network_modules	281	TRUE	5.346657434503655e-4	324	16	6	0.375	0.018518518518518517	GO:0007159	GO:BP	leukocyte cell-cell adhesion	16175	2723		0.6	0.6190476190476191	324	15851	6	10	318	15841	16175	0.07972356980357415
M1	string	0	network_modules	281	TRUE	5.656858780843739e-4	16	16	3	0.1875	0.1875	GO:0072376	GO:BP	protein activation cascade	16175	17373		0.65	0.6666666666666666	16	16159	3	13	13	16146	16175	0.18669549477071604
M1	string	0	network_modules	281	TRUE	8.232914002026105e-4	18	16	3	0.1875	0.16666666666666666	GO:1904996	GO:BP	positive regulation of leukocyte adhesion to vascular endothelial cell	16175	24281		0.7	0.7142857142857143	18	16157	3	13	15	16144	16175	0.17591239566271397
M1	string	0	network_modules	281	TRUE	8.620201411627886e-4	191	14	5	0.35714285714285715	0.02617801047120419	REAC:R-HSA-202733	REAC	Cell surface interactions at the vascular wall	10916	327		0.6	0.6363636363636364	191	10725	5	9	186	10716	10916	0.09282930985213407
M1	string	0	network_modules	281	TRUE	9.213032502611694e-4	23	14	3	0.21428571428571427	0.13043478260869565	REAC:R-HSA-140837	REAC	Intrinsic Pathway of Fibrin Clot Formation	10916	1269		0.7	0.7272727272727273	23	10893	3	11	20	10882	10916	0.16582064566761434
M1	string	0	network_modules	281	TRUE	0.0014399910723973813	3	14	2	0.14285714285714285	0.6666666666666666	REAC:R-HSA-9674519	REAC	Defective F8 sulfation at Y1699	10916	545		0.8	0.8181818181818182	3	10913	2	12	1	10901	10916	0.30825307569254096
M1	string	0	network_modules	281	TRUE	0.002310774502569948	25	16	3	0.1875	0.12	GO:1904994	GO:BP	regulation of leukocyte adhesion to vascular endothelial cell	16175	24279		0.75	0.7619047619047619	25	16150	3	13	22	16137	16175	0.14895231009052606
M1	string	0	network_modules	281	TRUE	0.0040667353911232025	30	16	3	0.1875	0.1	GO:0002691	GO:BP	regulation of cellular extravasation	16175	1209		0.8	0.8095238095238095	30	16145	3	13	27	16132	16175	0.1357692171589587
M1	string	0	network_modules	281	TRUE	0.004339013224915346	38	14	3	0.21428571428571427	0.07894736842105263	REAC:R-HSA-76009	REAC	Platelet Aggregation (Plug Formation)	10916	1761		0.9	0.9090909090909091	38	10878	3	11	35	10867	10916	0.12825909888923342
M1	string	0	network_modules	281	TRUE	0.004697041297270221	39	14	3	0.21428571428571427	0.07692307692307693	REAC:R-HSA-140877	REAC	Formation of Fibrin Clot (Clotting Cascade)	10916	945		1	1	39	10877	3	11	36	10866	10916	0.12655487266926044
M1	string	0	network_modules	281	TRUE	0.004726685560451098	257	16	5	0.3125	0.019455252918287938	GO:0022409	GO:BP	positive regulation of cell-cell adhesion	16175	6600		0.85	0.8571428571428571	257	15918	5	11	252	15907	16175	0.07464038924265136
M1	string	0	network_modules	281	TRUE	0.005296528527515366	115	16	4	0.25	0.034782608695652174	GO:0030168	GO:BP	platelet activation	16175	6695		0.9	0.9047619047619048	115	16060	4	12	111	16048	16175	0.09096733133974085
M1	string	0	network_modules	281	TRUE	0.008409314053970213	38	16	3	0.1875	0.07894736842105263	GO:0061515	GO:BP	myeloid cell development	16175	15516		0.95	0.9523809523809523	38	16137	3	13	35	16124	16175	0.12034254458480281
M1	string	0	network_modules	281	TRUE	0.008523513387347463	290	16	5	0.3125	0.017241379310344827	GO:0050867	GO:BP	positive regulation of cell activation	16175	13315		1	1	290	15885	5	11	285	15874	16175	0.06985452828737605
M1	string	0	network_modules	282	TRUE	1.9815979997341055e-8	51	8	5	0.625	0.09803921568627451	KEGG:04979	KEGG	Cholesterol metabolism	8484	410		NA	1	51	8433	5	3	46	8430	8484	0.24601226023430495
M1	string	0	network_modules	282	TRUE	1.678182512023436e-7	36	15	5	0.3333333333333333	0.1388888888888889	GO:0034381	GO:BP	plasma lipoprotein particle clearance	16175	8606		0	0.029411764705882353	36	16139	5	10	31	16129	16175	0.2140666087911083
M1	string	0	network_modules	282	TRUE	3.841329490903614e-7	19	10	4	0.4	0.21052631578947367	REAC:R-HSA-8964038	REAC	LDL clearance	10916	1295		0	0.16666666666666666	19	10897	4	6	15	10891	10916	0.28931208718369317
M1	string	0	network_modules	282	TRUE	1.5714427685311833e-6	17	15	4	0.26666666666666666	0.23529411764705882	GO:0010984	GO:BP	regulation of lipoprotein particle clearance	16175	4559		0.030303030303030304	0.058823529411764705	17	16158	4	11	13	16147	16175	0.249749517397495
M1	string	0	network_modules	282	TRUE	4.230835028018944e-6	67	15	5	0.3333333333333333	0.07462686567164178	GO:0097006	GO:BP	regulation of plasma lipoprotein particle levels	16175	18441		0.06060606060606061	0.08823529411764706	67	16108	5	10	62	16098	16175	0.1561561758381804
M1	string	0	network_modules	282	TRUE	5.794250168025207e-6	36	10	4	0.4	0.1111111111111111	REAC:R-HSA-8964043	REAC	Plasma lipoprotein clearance	10916	1757		0.2	0.3333333333333333	36	10880	4	6	32	10874	10916	0.20952197024869593
M1	string	0	network_modules	282	TRUE	5.82761886847385e-6	23	15	4	0.26666666666666666	0.17391304347826086	GO:0034383	GO:BP	low-density lipoprotein particle clearance	16175	8608		0.09090909090909091	0.11764705882352941	23	16152	4	11	19	16141	16175	0.21445635286507317
M1	string	0	network_modules	282	TRUE	7.03146655258975e-6	74	15	5	0.3333333333333333	0.06756756756756757	GO:0042632	GO:BP	cholesterol homeostasis	16175	10265		0.12121212121212122	0.14705882352941177	74	16101	5	10	69	16091	16175	0.14842387879396185
M1	string	0	network_modules	282	TRUE	7.529821351918792e-6	75	15	5	0.3333333333333333	0.06666666666666667	GO:0055092	GO:BP	sterol homeostasis	16175	14242		0.15151515151515152	0.17647058823529413	75	16100	5	10	70	16090	16175	0.14740791869265457
M1	string	0	network_modules	282	TRUE	1.789297451922571e-5	6	15	3	0.2	0.5	GO:0090118	GO:BP	receptor-mediated endocytosis involved in cholesterol transport	16175	18033		0.18181818181818182	0.20588235294117646	6	16169	3	12	3	16157	16175	0.3158462977623385
M1	string	0	network_modules	282	TRUE	2.1266947384120293e-5	92	15	5	0.3333333333333333	0.05434782608695652	GO:0030301	GO:BP	cholesterol transport	16175	6760		0.21212121212121213	0.23529411764705882	92	16083	5	10	87	16073	16175	0.13273824193487732
M1	string	0	network_modules	282	TRUE	2.3713411110574828e-5	94	15	5	0.3333333333333333	0.05319148936170213	GO:0008203	GO:BP	cholesterol metabolic process	16175	3130		0.24242424242424243	0.2647058823529412	94	16081	5	10	89	16071	16175	0.13127714622444203
M1	string	0	network_modules	282	TRUE	2.63788393787291e-5	96	15	5	0.3333333333333333	0.052083333333333336	GO:0015918	GO:BP	sterol transport	16175	5013		0.2727272727272727	0.29411764705882354	96	16079	5	10	91	16069	16175	0.12986151285978098
M1	string	0	network_modules	282	TRUE	3.081882442816269e-5	99	15	5	0.3333333333333333	0.050505050505050504	GO:0045834	GO:BP	positive regulation of lipid metabolic process	16175	11650		0.30303030303030304	0.3235294117647059	99	16076	5	10	94	16066	16175	0.12781825910839842
M1	string	0	network_modules	282	TRUE	3.129527869739496e-5	7	15	3	0.2	0.42857142857142855	GO:0010985	GO:BP	negative regulation of lipoprotein particle clearance	16175	4560		0.3333333333333333	0.35294117647058826	7	16168	3	12	4	16156	16175	0.29233533147126006
M1	string	0	network_modules	282	TRUE	3.764292978155025e-5	103	15	5	0.3333333333333333	0.04854368932038835	GO:1902652	GO:BP	secondary alcohol metabolic process	16175	22418		0.36363636363636365	0.38235294117647056	103	16072	5	10	98	16062	16175	0.12523265048986534
M1	string	0	network_modules	282	TRUE	4.5618399954535205e-5	107	15	5	0.3333333333333333	0.04672897196261682	GO:0016125	GO:BP	sterol metabolic process	16175	5143		0.3939393939393939	0.4117647058823529	107	16068	5	10	102	16058	16175	0.1227919086726298
M1	string	0	network_modules	282	TRUE	9.411121128302449e-5	71	10	4	0.4	0.056338028169014086	REAC:R-HSA-174824	REAC	Plasma lipoprotein assembly, remodeling, and clearance	10916	1756		0.4	0.5	71	10845	4	6	67	10839	10916	0.14822686166162835
M1	string	0	network_modules	282	TRUE	1.310260067104883e-4	132	15	5	0.3333333333333333	0.03787878787878788	GO:0055088	GO:BP	lipid homeostasis	16175	14238		0.42424242424242425	0.4411764705882353	132	16043	5	10	127	16033	16175	0.11011675768768188
M1	string	0	network_modules	282	TRUE	1.472067141840827e-4	11	15	3	0.2	0.2727272727272727	GO:0010988	GO:BP	regulation of low-density lipoprotein particle clearance	16175	4563		0.45454545454545453	0.47058823529411764	11	16164	3	12	8	16152	16175	0.23294276220709734
M1	string	0	network_modules	282	TRUE	1.9616637735068724e-4	12	15	3	0.2	0.25	GO:0032933	GO:BP	SREBP signaling pathway	16175	7923		0.48484848484848486	0.5294117647058824	12	16163	3	12	9	16151	16175	0.2229634354027391
M1	string	0	network_modules	282	TRUE	1.9616637735068724e-4	12	15	3	0.2	0.25	GO:0090205	GO:BP	positive regulation of cholesterol metabolic process	16175	18105		0.48484848484848486	0.5294117647058824	12	16163	3	12	9	16151	16175	0.2229634354027391
M1	string	0	network_modules	282	TRUE	2.548743538256362e-4	13	15	3	0.2	0.23076923076923078	GO:0071501	GO:BP	cellular response to sterol depletion	16175	16734		0.5454545454545454	0.5588235294117647	13	16162	3	12	10	16150	16175	0.21415649977466114
M1	string	0	network_modules	282	TRUE	3.2420499281561084e-4	14	15	3	0.2	0.21428571428571427	GO:0006991	GO:BP	response to sterol depletion	16175	2609		0.5757575757575758	0.5882352941176471	14	16161	3	12	11	16149	16175	0.20630870032228973
M1	string	0	network_modules	282	TRUE	6.59221487541735e-4	72	15	4	0.26666666666666666	0.05555555555555555	GO:0046889	GO:BP	positive regulation of lipid biosynthetic process	16175	12424		0.6060606060606061	0.6176470588235294	72	16103	4	11	68	16092	16175	0.12000731313053836
M1	string	0	network_modules	282	TRUE	0.0013655405893561465	22	15	3	0.2	0.13636363636363635	GO:0045940	GO:BP	positive regulation of steroid metabolic process	16175	11734		0.6363636363636364	0.6470588235294118	22	16153	3	12	19	16141	16175	0.16420929627491795
M1	string	0	network_modules	282	TRUE	0.0015871328652197953	218	15	5	0.3333333333333333	0.022935779816513763	GO:0015850	GO:BP	organic hydroxy compound transport	16175	4959		0.6666666666666666	0.6764705882352942	218	15957	5	10	213	15947	16175	0.08451222313431057
M1	string	0	network_modules	282	TRUE	0.001997335851560051	152	10	4	0.4	0.02631578947368421	REAC:R-HSA-8957322	REAC	Metabolism of steroids	10916	1438		0.6	0.6666666666666666	152	10764	4	6	148	10758	10916	0.09976871257754005
M1	string	0	network_modules	282	TRUE	0.00211869482223381	5	10	2	0.2	0.4	REAC:R-HSA-8964026	REAC	Chylomicron clearance	10916	359		0.8	0.8333333333333334	5	10911	2	8	3	10903	10916	0.2823889684611204
M1	string	0	network_modules	282	TRUE	0.0025864295500052786	27	15	3	0.2	0.1111111111111111	GO:0032367	GO:BP	intracellular cholesterol transport	16175	7521		0.696969696969697	0.7058823529411765	27	16148	3	12	24	16136	16175	0.14801920198550775
M1	string	0	network_modules	282	TRUE	0.0026545469140132967	242	15	5	0.3333333333333333	0.02066115702479339	GO:0008202	GO:BP	steroid metabolic process	16175	3129		0.7272727272727273	0.7352941176470589	242	15933	5	10	237	15923	16175	0.0799001525886763
M1	string	0	network_modules	282	TRUE	0.002708905253699117	243	15	5	0.3333333333333333	0.0205761316872428	GO:0019216	GO:BP	regulation of lipid metabolic process	16175	5593		0.7575757575757576	0.7647058823529411	243	15932	5	10	238	15922	16175	0.07972259770187407
M1	string	0	network_modules	282	TRUE	0.0032274510309279613	29	15	3	0.2	0.10344827586206896	GO:0090181	GO:BP	regulation of cholesterol metabolic process	16175	18087		0.7878787878787878	0.7941176470588235	29	16146	3	12	26	16134	16175	0.14274371530670452
M1	string	0	network_modules	282	TRUE	0.003556721848481315	53	10	3	0.3	0.05660377358490566	REAC:R-HSA-1655829	REAC	Regulation of cholesterol biosynthesis by SREBP (SREBF)	10916	2023		1	1	53	10863	3	7	50	10856	10916	0.12857395580116315
M1	string	0	network_modules	282	TRUE	0.0035665630987712148	257	15	5	0.3333333333333333	0.019455252918287938	GO:0006066	GO:BP	alcohol metabolic process	16175	1933		0.8181818181818182	0.8235294117647058	257	15918	5	10	252	15908	16175	0.07734395832016565
M1	string	0	network_modules	282	TRUE	0.0035840603632773596	30	15	3	0.2	0.1	GO:0032366	GO:BP	intracellular sterol transport	16175	7520		0.8484848484848485	0.8529411764705882	30	16145	3	12	27	16133	16175	0.1403050597743004
M1	string	0	network_modules	282	TRUE	0.006682065795610729	4	15	2	0.13333333333333333	0.5	GO:0010989	GO:BP	negative regulation of low-density lipoprotein particle clearance	16175	4564		0.8787878787878788	0.9117647058823529	4	16171	2	13	2	16158	16175	0.25787147420379075
M1	string	0	network_modules	282	TRUE	0.006682065795610729	4	15	2	0.13333333333333333	0.5	GO:1905600	GO:BP	regulation of receptor-mediated endocytosis involved in cholesterol transport	16175	24758		0.8787878787878788	0.9117647058823529	4	16171	2	13	2	16158	16175	0.25787147420379075
M1	string	0	network_modules	282	TRUE	0.007726101783467049	301	15	5	0.3333333333333333	0.016611295681063124	GO:0006869	GO:BP	lipid transport	16175	2530		0.9393939393939394	0.9411764705882353	301	15874	5	10	296	15864	16175	0.07095339428855477
M1	string	0	network_modules	282	TRUE	0.009199453548033885	139	15	4	0.26666666666666666	0.02877697841726619	GO:0046890	GO:BP	regulation of lipid biosynthetic process	16175	12425		0.9696969696969697	0.9705882352941176	139	16036	4	11	135	16025	16175	0.08518373006702001
M1	string	0	network_modules	282	TRUE	0.009352895688694907	41	15	3	0.2	0.07317073170731707	GO:0006984	GO:BP	ER-nucleus signaling pathway	16175	2607		1	1	41	16134	3	12	38	16122	16175	0.11964564862587004
M1	string	0	network_modules	284	TRUE	0.005842528161582084	131	7	3	0.42857142857142855	0.022900763358778626	KEGG:04142	KEGG	Lysosome	8484	279		NA	1	131	8353	3	4	128	8349	8484	0.09628509476989638
M1	string	0	network_modules	286	TRUE	0.0011541231779150886	49	8	3	0.375	0.061224489795918366	REAC:R-HSA-6811440	REAC	Retrograde transport at the Trans-Golgi-Network	10916	2096		0	0.5	49	10867	3	5	46	10862	10916	0.1501012797687379
M1	string	0	network_modules	286	TRUE	0.0011563708061067882	5	8	2	0.25	0.4	REAC:R-HSA-446205	REAC	Synthesis of GDP-mannose	10916	2378		1	1	5	10911	2	6	3	10905	10916	0.31583645181620407
M1	string	0	network_modules	286	TRUE	0.004998356014637327	34	4	2	0.5	0.058823529411764705	KEGG:00051	KEGG	Fructose and mannose metabolism	8484	6		0	0.5	34	8450	2	2	32	8448	8484	0.1705061262363346
M1	string	0	network_modules	286	TRUE	0.005931072934697145	37	4	2	0.5	0.05405405405405406	KEGG:01250	KEGG	Biosynthesis of nucleotide sugars	8484	191		1	1	37	8447	2	2	35	8445	8484	0.16336008869697982
M1	string	0	network_modules	288	TRUE	1.472067141840827e-4	11	15	3	0.2	0.2727272727272727	GO:0050665	GO:BP	hydrogen peroxide biosynthetic process	16175	13199		0	0.25	11	16164	3	12	8	16152	16175	0.23294276220709734
M1	string	0	network_modules	288	TRUE	0.002900310784456189	75	9	3	0.3333333333333333	0.04	KEGG:04918	KEGG	Thyroid hormone synthesis	8484	375		NA	1	75	8409	3	6	72	8403	8484	0.11296783475244793
M1	string	0	network_modules	288	TRUE	0.003342824188508391	3	15	2	0.13333333333333333	0.6666666666666666	GO:0010729	GO:BP	positive regulation of hydrogen peroxide biosynthetic process	16175	4354		0.3333333333333333	0.5	3	16172	2	13	1	16159	16175	0.29789344298100395
M1	string	0	network_modules	288	TRUE	0.006682065795610729	4	15	2	0.13333333333333333	0.5	GO:0010726	GO:BP	positive regulation of hydrogen peroxide metabolic process	16175	4351		0.6666666666666666	0.75	4	16171	2	13	2	16158	16175	0.25787147420379075
M1	string	0	network_modules	288	TRUE	0.008673366523155073	40	15	3	0.2	0.075	GO:1903409	GO:BP	reactive oxygen species biosynthetic process	16175	22985		1	1	40	16135	3	12	37	16123	16175	0.12116615688344903
M1	string	0	network_modules	288	TRUE	0.009510853417146718	10	10	2	0.2	0.2	REAC:R-HSA-209968	REAC	Thyroxine biosynthesis	10916	2508		NA	1	10	10906	2	8	8	10898	10916	0.19926645883000182
M1	string	0	network_modules	289	TRUE	1.0472049194018095e-5	11	8	3	0.375	0.2727272727272727	REAC:R-HSA-211999	REAC	CYP2E1 reactions	10916	293		0	0.3333333333333333	11	10905	3	5	8	10900	10916	0.31921952331311165
M1	string	0	network_modules	289	TRUE	1.3215112914448817e-5	6	14	3	0.21428571428571427	0.5	GO:0009698	GO:BP	phenylpropanoid metabolic process	16175	3601		0	0.5	6	16169	3	11	3	16158	16175	0.326962361414992
M1	string	0	network_modules	289	TRUE	1.3215112914448817e-5	6	14	3	0.21428571428571427	0.5	GO:0009804	GO:BP	coumarin metabolic process	16175	3688		0	0.5	6	16169	3	11	3	16158	16175	0.326962361414992
M1	string	0	network_modules	289	TRUE	1.1193707160488976e-4	23	8	3	0.375	0.13043478260869565	REAC:R-HSA-211981	REAC	Xenobiotics	10916	2677		0.5	0.6666666666666666	23	10893	3	5	20	10888	10916	0.22023306255217212
M1	string	0	network_modules	289	TRUE	5.358847493524973e-4	18	14	3	0.21428571428571427	0.16666666666666666	GO:0019373	GO:BP	epoxygenase P450 pathway	16175	5734		0.6666666666666666	0.75	18	16157	3	11	15	16146	16175	0.18818696645136737
M1	string	0	network_modules	289	TRUE	6.508136730022161e-4	6	8	2	0.25	0.3333333333333333	KEGG:00232	KEGG	Caffeine metabolism	8484	23		0	0.25	6	8478	2	6	4	8472	8484	0.2880962198495853
M1	string	0	network_modules	289	TRUE	0.0014318612955364013	67	8	3	0.375	0.04477611940298507	KEGG:05204	KEGG	Chemical carcinogenesis - DNA adducts	8484	456		0.3333333333333333	0.5	67	8417	3	5	64	8412	8484	0.12741536121058394
M1	string	0	network_modules	289	TRUE	0.0014972821113574703	68	8	3	0.375	0.04411764705882353	KEGG:00830	KEGG	Retinol metabolism	8484	127		0.6666666666666666	0.75	68	8416	3	5	65	8411	8484	0.12644191646765868
M1	string	0	network_modules	289	TRUE	0.0019315483293041071	74	8	3	0.375	0.04054054054054054	KEGG:00980	KEGG	Metabolism of xenobiotics by cytochrome P450	8484	154		1	1	74	8410	3	5	71	8405	8484	0.1210171160349497
M1	string	0	network_modules	289	TRUE	0.002596475945787909	64	8	3	0.375	0.046875	REAC:R-HSA-211897	REAC	Cytochrome P450 - arranged by substrate type	10916	423		1	1	64	10852	3	5	61	10847	10916	0.1309419214304975
M1	string	0	network_modules	289	TRUE	0.008582941931915012	44	14	3	0.21428571428571427	0.06818181818181818	GO:0019748	GO:BP	secondary metabolic process	16175	6032		1	1	44	16131	3	11	41	16120	16175	0.11955341584191301
M1	string	0	network_modules	290	TRUE	2.5623582168693623e-9	244	11	8	0.7272727272727273	0.03278688524590164	REAC:R-HSA-8951664	REAC	Neddylation	10916	1559		0	0.3333333333333333	244	10672	8	3	236	10669	10916	0.15144996577566594
M1	string	0	network_modules	290	TRUE	1.6654576213450582e-8	308	11	8	0.7272727272727273	0.025974025974025976	REAC:R-HSA-983168	REAC	Antigen processing: Ubiquitination & Proteasome degradation	10916	154		0.5	0.6666666666666666	308	10608	8	3	300	10605	10916	0.1340811337476353
M1	string	0	network_modules	290	TRUE	8.935822881737436e-8	380	11	8	0.7272727272727273	0.021052631578947368	REAC:R-HSA-983169	REAC	Class I MHC mediated antigen processing & presentation	10916	368		1	1	380	10536	8	3	372	10533	10916	0.11998113074289028
M1	string	0	network_modules	290	TRUE	1.3522789032641386e-4	590	18	8	0.4444444444444444	0.013559322033898305	GO:0016567	GO:BP	protein ubiquitination	16175	5254		0	0.25	590	15585	8	10	582	15575	16175	0.07263522677336424
M1	string	0	network_modules	290	TRUE	3.472921125604904e-4	667	18	8	0.4444444444444444	0.01199400299850075	GO:0032446	GO:BP	protein modification by small protein conjugation	16175	7568		0.3333333333333333	0.5	667	15508	8	10	659	15498	16175	0.06768438272572647
M1	string	0	network_modules	290	TRUE	8.419410837343549e-4	749	18	8	0.4444444444444444	0.010680907877169559	GO:0070647	GO:BP	protein modification by small protein conjugation or removal	16175	16231		0.6666666666666666	0.75	749	15426	8	10	741	15416	16175	0.06323633507098074
M1	string	0	network_modules	290	TRUE	0.0013623884608039095	798	18	8	0.4444444444444444	0.010025062656641603	GO:0043687	GO:BP	post-translational protein modification	16175	10838		1	1	798	15377	8	10	790	15367	16175	0.06089475734667062
M1	string	0	network_modules	292	TRUE	2.0207721506551077e-6	128	14	6	0.42857142857142855	0.046875	REAC:R-HSA-6809371	REAC	Formation of the cornified envelope	10916	969		0	0.25	128	10788	6	8	122	10780	10916	0.13876314754383443
M1	string	0	network_modules	292	TRUE	2.645721338593774e-6	4	14	3	0.21428571428571427	0.75	GO:0002803	GO:BP	positive regulation of antibacterial peptide production	16175	1314		0	0.26666666666666666	4	16171	3	11	1	16160	16175	0.4006521636101715
M1	string	0	network_modules	292	TRUE	2.645721338593774e-6	4	14	3	0.21428571428571427	0.75	GO:0002225	GO:BP	positive regulation of antimicrobial peptide production	16175	759		0	0.26666666666666666	4	16171	3	11	1	16160	16175	0.4006521636101715
M1	string	0	network_modules	292	TRUE	2.645721338593774e-6	4	14	3	0.21428571428571427	0.75	GO:0002786	GO:BP	regulation of antibacterial peptide production	16175	1297		0	0.26666666666666666	4	16171	3	11	1	16160	16175	0.4006521636101715
M1	string	0	network_modules	292	TRUE	2.645721338593774e-6	4	14	3	0.21428571428571427	0.75	GO:0002784	GO:BP	regulation of antimicrobial peptide production	16175	1295		0	0.26666666666666666	4	16171	3	11	1	16160	16175	0.4006521636101715
M1	string	0	network_modules	292	TRUE	6.610929067179114e-6	5	14	3	0.21428571428571427	0.6	GO:0002760	GO:BP	positive regulation of antimicrobial humoral response	16175	1271		0.2857142857142857	0.4666666666666667	5	16170	3	11	2	16159	16175	0.35826175812200534
M1	string	0	network_modules	292	TRUE	6.610929067179114e-6	5	14	3	0.21428571428571427	0.6	GO:0002775	GO:BP	antimicrobial peptide production	16175	1286		0.2857142857142857	0.4666666666666667	5	16170	3	11	2	16159	16175	0.35826175812200534
M1	string	0	network_modules	292	TRUE	6.610929067179114e-6	5	14	3	0.21428571428571427	0.6	GO:0002778	GO:BP	antibacterial peptide production	16175	1289		0.2857142857142857	0.4666666666666667	5	16170	3	11	2	16159	16175	0.35826175812200534
M1	string	0	network_modules	292	TRUE	1.3215112914448817e-5	6	14	3	0.21428571428571427	0.5	GO:0002759	GO:BP	regulation of antimicrobial humoral response	16175	1270		0.5	0.5333333333333333	6	16169	3	11	3	16158	16175	0.326962361414992
M1	string	0	network_modules	292	TRUE	4.507601713503655e-5	215	14	6	0.42857142857142855	0.027906976744186046	REAC:R-HSA-6805567	REAC	Keratinization	10916	1288		0.3333333333333333	0.5	215	10701	6	8	209	10693	10916	0.10544699450619598
M1	string	0	network_modules	292	TRUE	1.0874685394023878e-4	11	14	3	0.21428571428571427	0.2727272727272727	GO:1900426	GO:BP	positive regulation of defense response to bacterium	16175	20649		0.5714285714285714	0.6	11	16164	3	11	8	16153	16175	0.24116604956372267
M1	string	0	network_modules	292	TRUE	1.8830225312062814e-4	13	14	3	0.21428571428571427	0.23076923076923078	GO:0002922	GO:BP	positive regulation of humoral immune response	16175	1432		0.6428571428571429	0.7333333333333333	13	16162	3	11	10	16151	16175	0.22172580349903687
M1	string	0	network_modules	292	TRUE	1.8830225312062814e-4	13	14	3	0.21428571428571427	0.23076923076923078	GO:1900424	GO:BP	regulation of defense response to bacterium	16175	20647		0.6428571428571429	0.7333333333333333	13	16162	3	11	10	16151	16175	0.22172580349903687
M1	string	0	network_modules	292	TRUE	2.77625581835423e-4	64	14	4	0.2857142857142857	0.0625	GO:0019731	GO:BP	antibacterial humoral response	16175	6022		0.7857142857142857	0.8	64	16111	4	10	60	16101	16175	0.13209869813963582
M1	string	0	network_modules	292	TRUE	6.189602914188734e-4	78	14	4	0.2857142857142857	0.05128205128205128	GO:0061844	GO:BP	antimicrobial humoral immune response mediated by antimicrobial peptide	16175	15685		0.8571428571428571	0.8666666666666667	78	16097	4	10	74	16087	16175	0.11934214354939358
M1	string	0	network_modules	292	TRUE	0.002053641964772146	182	4	3	0.75	0.016483516483516484	KEGG:04621	KEGG	NOD-like receptor signaling pathway	8484	326		NA	1	182	8302	3	1	179	8301	8484	0.10921033885227414
M1	string	0	network_modules	292	TRUE	0.003234144197223559	32	14	3	0.21428571428571427	0.09375	GO:0002920	GO:BP	regulation of humoral immune response	16175	1430		0.9285714285714286	0.9333333333333333	32	16143	3	11	29	16132	16175	0.14062810170400844
M1	string	0	network_modules	292	TRUE	0.0038524310638327797	123	14	4	0.2857142857142857	0.032520325203252036	GO:0019730	GO:BP	antimicrobial humoral response	16175	6021		1	1	123	16052	4	10	119	16042	16175	0.09422661729226033
M1	string	0	network_modules	292	TRUE	0.004792936273151985	5	14	2	0.14285714285714285	0.4	REAC:R-HSA-112303	REAC	Electric Transmission Across Gap Junctions	10916	837		0.6666666666666666	1	5	10911	2	12	3	10899	10916	0.23848684005241802
M1	string	0	network_modules	292	TRUE	0.004792936273151985	5	14	2	0.14285714285714285	0.4	REAC:R-HSA-112307	REAC	Transmission across Electrical Synapses 	10916	2581		0.6666666666666666	1	5	10911	2	12	3	10899	10916	0.23848684005241802
M1	string	0	network_modules	293	TRUE	3.580944971703358e-8	71	7	5	0.7142857142857143	0.07042253521126761	KEGG:04622	KEGG	RIG-I-like receptor signaling pathway	8484	327		NA	1	71	8413	5	2	66	8411	8484	0.22267815930325902
M1	string	0	network_modules	293	TRUE	7.227929555356996e-7	82	9	5	0.5555555555555556	0.06097560975609756	REAC:R-HSA-168928	REAC	DDX58/IFIH1-mediated induction of interferon-alpha/beta	10916	436		0	0.5	82	10834	5	4	77	10830	10916	0.1823248775632444
M1	string	0	network_modules	293	TRUE	8.373082022114999e-7	110	16	6	0.375	0.05454545454545454	GO:0032479	GO:BP	regulation of type I interferon production	16175	7590		0	0.1111111111111111	110	16065	6	10	104	16055	16175	0.14097541691358578
M1	string	0	network_modules	293	TRUE	8.373082022114999e-7	110	16	6	0.375	0.05454545454545454	GO:0032606	GO:BP	type I interferon production	16175	7654		0	0.1111111111111111	110	16065	6	10	104	16055	16175	0.14097541691358578
M1	string	0	network_modules	293	TRUE	1.32781739411418e-6	228	16	7	0.4375	0.03070175438596491	GO:0051607	GO:BP	defense response to virus	16175	13823		0.11764705882352941	0.16666666666666666	228	15947	7	9	221	15938	16175	0.11301738483586504
M1	string	0	network_modules	293	TRUE	3.064241256460314e-6	35	9	4	0.4444444444444444	0.11428571428571428	REAC:R-HSA-936440	REAC	Negative regulators of DDX58/IFIH1 signaling	10916	1581		1	1	35	10881	4	5	31	10876	10916	0.22420058670599238
M1	string	0	network_modules	293	TRUE	7.320261318816063e-6	721	16	9	0.5625	0.012482662968099861	GO:0045087	GO:BP	innate immune response	16175	11270		0.17647058823529413	0.2222222222222222	721	15454	9	7	712	15447	16175	0.07897249536043269
M1	string	0	network_modules	293	TRUE	1.2076409386626549e-5	26	16	4	0.25	0.15384615384615385	GO:0039529	GO:BP	RIG-I signaling pathway	16175	9802		0.23529411764705882	0.2777777777777778	26	16149	4	12	22	16137	16175	0.19510849070082517
M1	string	0	network_modules	293	TRUE	1.8793201381577204e-5	334	16	7	0.4375	0.020958083832335328	GO:0009615	GO:BP	response to virus	16175	3541		0.29411764705882354	0.3333333333333333	334	15841	7	9	327	15832	16175	0.09223870591434781
M1	string	0	network_modules	293	TRUE	3.200113346910713e-4	149	16	5	0.3125	0.03355704697986577	GO:0002753	GO:BP	cytoplasmic pattern recognition receptor signaling pathway	16175	1264		0.35294117647058826	0.3888888888888889	149	16026	5	11	144	16015	16175	0.09989573047473559
M1	string	0	network_modules	293	TRUE	4.8798307751877606e-4	319	16	6	0.375	0.018808777429467086	GO:0045089	GO:BP	positive regulation of innate immune response	16175	11272		0.4117647058823529	0.4444444444444444	319	15856	6	10	313	15846	16175	0.08040322126616137
M1	string	0	network_modules	293	TRUE	5.685070698304506e-4	66	16	4	0.25	0.06060606060606061	GO:0032481	GO:BP	positive regulation of type I interferon production	16175	7592		0.47058823529411764	0.5	66	16109	4	12	62	16097	16175	0.12139029776784556
M1	string	0	network_modules	293	TRUE	6.972799137241919e-4	339	16	6	0.375	0.017699115044247787	GO:0002833	GO:BP	positive regulation of response to biotic stimulus	16175	1343		0.5294117647058824	0.5555555555555556	339	15836	6	10	333	15826	16175	0.07777300867209273
M1	string	0	network_modules	293	TRUE	0.0011487998552154855	20	16	3	0.1875	0.15	GO:0039535	GO:BP	regulation of RIG-I signaling pathway	16175	9808		0.5882352941176471	0.6111111111111112	20	16155	3	13	17	16142	16175	0.16678476462399863
M1	string	0	network_modules	293	TRUE	0.0014897250143943227	386	16	6	0.375	0.015544041450777202	GO:0045088	GO:BP	regulation of innate immune response	16175	11271		0.6470588235294118	0.6666666666666666	386	15789	6	10	380	15779	16175	0.07239381244564289
M1	string	0	network_modules	293	TRUE	0.0025377362145068035	423	16	6	0.375	0.014184397163120567	GO:0031349	GO:BP	positive regulation of defense response	16175	7140		0.7058823529411765	0.7222222222222222	423	15752	6	10	417	15742	16175	0.06878534253415877
M1	string	0	network_modules	293	TRUE	0.002571645630046992	227	16	5	0.3125	0.022026431718061675	GO:0002221	GO:BP	pattern recognition receptor signaling pathway	16175	755		0.7647058823529411	0.7777777777777778	227	15948	5	11	222	15937	16175	0.0798409799740762
M1	string	0	network_modules	293	TRUE	0.003592656899323013	243	16	5	0.3125	0.0205761316872428	GO:0002758	GO:BP	innate immune response-activating signaling pathway	16175	1269		0.8235294117647058	0.8333333333333334	243	15932	5	11	238	15921	16175	0.07695057671806389
M1	string	0	network_modules	293	TRUE	0.003680096490854939	451	16	6	0.375	0.013303769401330377	GO:0002831	GO:BP	regulation of response to biotic stimulus	16175	1341		0.8823529411764706	0.8888888888888888	451	15724	6	10	445	15714	16175	0.06634431546586139
M1	string	0	network_modules	293	TRUE	0.005291373842911343	263	16	5	0.3125	0.019011406844106463	GO:0002218	GO:BP	activation of innate immune response	16175	753		0.9411764705882353	0.9444444444444444	263	15912	5	11	258	15901	16175	0.07370568358571686
M1	string	0	network_modules	293	TRUE	0.009435152139720623	531	16	6	0.375	0.011299435028248588	GO:0032103	GO:BP	positive regulation of response to external stimulus	16175	7367		1	1	531	15644	6	10	525	15634	16175	0.0604254352209525
M1	string	0	network_modules	294	TRUE	2.730513072323077e-4	27	11	3	0.2727272727272727	0.1111111111111111	KEGG:00790	KEGG	Folate biosynthesis	8484	125		NA	1	27	8457	3	8	24	8449	8484	0.17243258086599866
M1	string	0	network_modules	294	TRUE	0.00173392044766401	6	8	2	0.25	0.3333333333333333	REAC:R-HSA-8964208	REAC	Phenylalanine metabolism	10916	1740		0	0.5	6	10910	2	6	4	10904	10916	0.2882252799722374
M1	string	0	network_modules	294	TRUE	0.006346064693349163	11	8	2	0.25	0.18181818181818182	REAC:R-HSA-8963691	REAC	Phenylalanine and tyrosine metabolism	10916	1739		1	1	11	10905	2	6	9	10899	10916	0.21252631092836188
M1	string	0	network_modules	295	TRUE	5.299029677139484e-10	116	10	7	0.7	0.0603448275862069	KEGG:03082	KEGG	ATP-dependent chromatin remodeling	8484	219		0	0.5	116	8368	7	3	109	8365	8484	0.20302420245894717
M1	string	0	network_modules	295	TRUE	2.03934152833444e-9	36	18	6	0.3333333333333333	0.16666666666666666	GO:0045023	GO:BP	G0 to G1 transition	16175	11235		0	0.027777777777777776	36	16139	6	12	30	16127	16175	0.23451999046091068
M1	string	0	network_modules	295	TRUE	1.0559396680981025e-7	27	18	5	0.2777777777777778	0.18518518518518517	GO:2000819	GO:BP	regulation of nucleotide-excision repair	16175	26073		0.02857142857142857	0.05555555555555555	27	16148	5	13	22	16135	16175	0.2257557178676144
M1	string	0	network_modules	295	TRUE	3.6225096402035034e-7	34	18	5	0.2777777777777778	0.14705882352941177	GO:0070316	GO:BP	regulation of G0 to G1 transition	16175	16055		0.05714285714285714	0.08333333333333333	34	16141	5	13	29	16128	16175	0.20090655005393296
M1	string	0	network_modules	295	TRUE	9.710417867430498e-7	41	18	5	0.2777777777777778	0.12195121951219512	GO:0045663	GO:BP	positive regulation of myoblast differentiation	16175	11514		0.08571428571428572	0.1111111111111111	41	16134	5	13	36	16121	16175	0.18270629483795606
M1	string	0	network_modules	295	TRUE	6.409184373654014e-6	59	18	5	0.2777777777777778	0.0847457627118644	GO:0045661	GO:BP	regulation of myoblast differentiation	16175	11512		0.11428571428571428	0.1388888888888889	59	16116	5	13	54	16103	16175	0.15177574911904962
M1	string	0	network_modules	295	TRUE	1.7691915875023104e-5	454	18	8	0.4444444444444444	0.01762114537444934	GO:0006338	GO:BP	chromatin remodeling	16175	2126		0.14285714285714285	0.16666666666666666	454	15721	8	10	446	15711	16175	0.0841430625544067
M1	string	0	network_modules	295	TRUE	2.8467595081939156e-5	79	18	5	0.2777777777777778	0.06329113924050633	GO:0006289	GO:BP	nucleotide-excision repair	16175	2102		0.17142857142857143	0.19444444444444445	79	16096	5	13	74	16083	16175	0.13065353290150133
M1	string	0	network_modules	295	TRUE	3.0345040140022384e-5	80	18	5	0.2777777777777778	0.0625	GO:0045445	GO:BP	myoblast differentiation	16175	11378		0.2	0.2222222222222222	80	16095	5	13	75	16082	16175	0.12980899896644638
M1	string	0	network_modules	295	TRUE	3.857007129645772e-5	166	10	5	0.5	0.030120481927710843	KEGG:05225	KEGG	Hepatocellular carcinoma	8484	476		1	1	166	8318	5	5	161	8313	8484	0.1191588884871079
M1	string	0	network_modules	295	TRUE	3.8864287290972336e-5	84	18	5	0.2777777777777778	0.05952380952380952	GO:2000781	GO:BP	positive regulation of double-strand break repair	16175	26037		0.22857142857142856	0.25	84	16091	5	13	79	16078	16175	0.12658151834391046
M1	string	0	network_modules	295	TRUE	4.3783391235229385e-5	86	18	5	0.2777777777777778	0.05813953488372093	GO:0030071	GO:BP	regulation of mitotic metaphase/anaphase transition	16175	6671		0.2571428571428571	0.2777777777777778	86	16089	5	13	81	16076	16175	0.12505200631651026
M1	string	0	network_modules	295	TRUE	4.918533745093176e-5	88	18	5	0.2777777777777778	0.056818181818181816	GO:1902099	GO:BP	regulation of metaphase/anaphase transition of cell cycle	16175	22013		0.2857142857142857	0.3055555555555556	88	16087	5	13	83	16074	16175	0.12357437228831408
M1	string	0	network_modules	295	TRUE	5.2068138342215935e-5	187	18	6	0.3333333333333333	0.03208556149732621	GO:0000082	GO:BP	G1/S transition of mitotic cell cycle	16175	31		0.3142857142857143	0.3333333333333333	187	15988	6	12	181	15976	16175	0.10046873574238395
M1	string	0	network_modules	295	TRUE	5.510438998504682e-5	90	18	5	0.2777777777777778	0.05555555555555555	GO:0007091	GO:BP	metaphase/anaphase transition of mitotic cell cycle	16175	2675		0.34285714285714286	0.3611111111111111	90	16085	5	13	85	16072	16175	0.1221457239602914
M1	string	0	network_modules	295	TRUE	5.813890222071343e-5	529	18	8	0.4444444444444444	0.015122873345935728	GO:0006325	GO:BP	chromatin organization	16175	2122		0.37142857142857144	0.3888888888888889	529	15646	8	10	521	15636	16175	0.07726687977212437
M1	string	0	network_modules	295	TRUE	6.157634616335919e-5	92	18	5	0.2777777777777778	0.05434782608695652	GO:0044784	GO:BP	metaphase/anaphase transition of cell cycle	16175	11156		0.4	0.4166666666666667	92	16083	5	13	87	16070	16175	0.12076339011962683
M1	string	0	network_modules	295	TRUE	8.913612333249199e-5	99	18	5	0.2777777777777778	0.050505050505050504	GO:0033045	GO:BP	regulation of sister chromatid segregation	16175	8000		0.42857142857142855	0.4444444444444444	99	16076	5	13	94	16063	16175	0.11625585581586018
M1	string	0	network_modules	295	TRUE	1.1613465260050904e-4	214	18	6	0.3333333333333333	0.028037383177570093	GO:0044843	GO:BP	cell cycle G1/S phase transition	16175	11189		0.45714285714285713	0.4722222222222222	214	15961	6	12	208	15949	16175	0.09350892022868816
M1	string	0	network_modules	295	TRUE	1.5134278692391267e-4	41	18	4	0.2222222222222222	0.0975609756097561	GO:1902459	GO:BP	positive regulation of stem cell population maintenance	16175	22297		0.4857142857142857	0.5	41	16134	4	14	37	16120	16175	0.14582851904145833
M1	string	0	network_modules	295	TRUE	2.720527866253793e-4	36	7	3	0.42857142857142855	0.08333333333333333	REAC:R-HSA-8939243	REAC	RUNX1 interacts with co-factors whose precise effect on RUNX1 targets is not known	10916	1916		0	0.5	36	10880	3	4	33	10876	10916	0.18789824213294584
M1	string	0	network_modules	295	TRUE	2.759158357001596e-4	124	18	5	0.2777777777777778	0.04032258064516129	GO:0051983	GO:BP	regulation of chromosome segregation	16175	14045		0.5142857142857142	0.5277777777777778	124	16051	5	13	119	16038	16175	0.10336691793237651
M1	string	0	network_modules	295	TRUE	3.109265056285534e-4	127	18	5	0.2777777777777778	0.03937007874015748	GO:0045739	GO:BP	positive regulation of DNA repair	16175	11579		0.5428571428571428	0.5555555555555556	127	16048	5	13	122	16035	16175	0.10207815910415412
M1	string	0	network_modules	295	TRUE	3.233481251140166e-4	128	18	5	0.2777777777777778	0.0390625	GO:2000779	GO:BP	regulation of double-strand break repair	16175	26035		0.5714285714285714	0.5833333333333334	128	16047	5	13	123	16034	16175	0.1016585133767516
M1	string	0	network_modules	295	TRUE	5.237400475985287e-4	141	18	5	0.2777777777777778	0.03546099290780142	GO:2000045	GO:BP	regulation of G1/S transition of mitotic cell cycle	16175	25406		0.6	0.6111111111111112	141	16034	5	13	136	16021	16175	0.09660949784658372
M1	string	0	network_modules	295	TRUE	6.432199718875158e-4	286	18	6	0.3333333333333333	0.02097902097902098	GO:1901990	GO:BP	regulation of mitotic cell cycle phase transition	16175	21923		0.6285714285714286	0.6388888888888888	286	15889	6	12	280	15877	16175	0.07994237538451894
M1	string	0	network_modules	295	TRUE	6.71724045309804e-4	59	18	4	0.2222222222222222	0.06779661016949153	GO:2000036	GO:BP	regulation of stem cell population maintenance	16175	25399		0.6571428571428571	0.6666666666666666	59	16116	4	14	55	16102	16175	0.12101669054462406
M1	string	0	network_modules	295	TRUE	0.001177551486539792	166	18	5	0.2777777777777778	0.030120481927710843	GO:1902806	GO:BP	regulation of cell cycle G1/S phase transition	16175	22525		0.6857142857142857	0.6944444444444444	166	16009	5	13	161	15996	16175	0.08859561249344654
M1	string	0	network_modules	295	TRUE	0.002865318251050871	78	7	3	0.42857142857142855	0.038461538461538464	REAC:R-HSA-3214858	REAC	RMTs methylate histone arginines	10916	1878		1	1	78	10838	3	4	75	10834	10916	0.12674168600267308
M1	string	0	network_modules	295	TRUE	0.0028912435019760674	370	18	6	0.3333333333333333	0.016216216216216217	GO:0044772	GO:BP	mitotic cell cycle phase transition	16175	11148		0.7142857142857143	0.7222222222222222	370	15805	6	12	364	15793	16175	0.06931155769835967
M1	string	0	network_modules	295	TRUE	0.003075998976787075	86	18	4	0.2222222222222222	0.046511627906976744	GO:0045582	GO:BP	positive regulation of T cell differentiation	16175	11433		0.7428571428571429	0.75	86	16089	4	14	82	16075	16175	0.09955354800887788
M1	string	0	network_modules	295	TRUE	0.0031739648121429775	376	18	6	0.3333333333333333	0.015957446808510637	GO:1901987	GO:BP	regulation of cell cycle phase transition	16175	21920		0.7714285714285715	0.7777777777777778	376	15799	6	12	370	15787	16175	0.0686872033796723
M1	string	0	network_modules	295	TRUE	0.003495850923236	207	18	5	0.2777777777777778	0.024154589371980676	GO:0006282	GO:BP	regulation of DNA repair	16175	2096		0.8	0.8055555555555556	207	15968	5	13	202	15955	16175	0.07868704775490785
M1	string	0	network_modules	295	TRUE	0.004406053730318867	217	18	5	0.2777777777777778	0.02304147465437788	GO:0000819	GO:BP	sister chromatid segregation	16175	237		0.8285714285714286	0.8333333333333334	217	15958	5	13	212	15945	16175	0.07669730992408476
M1	string	0	network_modules	295	TRUE	0.005403763399445836	99	18	4	0.2222222222222222	0.04040404040404041	GO:0019827	GO:BP	stem cell population maintenance	16175	6046		0.8571428571428571	0.8888888888888888	99	16076	4	14	95	16062	16175	0.09248082556259454
M1	string	0	network_modules	295	TRUE	0.005403763399445836	99	18	4	0.2222222222222222	0.04040404040404041	GO:0045621	GO:BP	positive regulation of lymphocyte differentiation	16175	11472		0.8571428571428571	0.8888888888888888	99	16076	4	14	95	16062	16175	0.09248082556259454
M1	string	0	network_modules	295	TRUE	0.0056250133561849755	100	18	4	0.2222222222222222	0.04	GO:0098727	GO:BP	maintenance of cell number	16175	18856		0.9142857142857143	0.9166666666666666	100	16075	4	14	96	16061	16175	0.09199379595810706
M1	string	0	network_modules	295	TRUE	0.005734206961739212	229	18	5	0.2777777777777778	0.021834061135371178	GO:0033044	GO:BP	regulation of chromosome organization	16175	7999		0.9428571428571428	0.9444444444444444	229	15946	5	13	224	15933	16175	0.0744792206268793
M1	string	0	network_modules	295	TRUE	0.006619246061460619	427	18	6	0.3333333333333333	0.01405152224824356	GO:0007346	GO:BP	regulation of mitotic cell cycle	16175	2855		0.9714285714285714	0.9722222222222222	427	15748	6	12	421	15736	16175	0.06390272001664192
M1	string	0	network_modules	295	TRUE	0.008134152361055469	246	18	5	0.2777777777777778	0.02032520325203252	GO:0051054	GO:BP	positive regulation of DNA metabolic process	16175	13464		1	1	246	15929	5	13	241	15916	16175	0.07161137660923615
M1	string	0	network_modules	296	TRUE	1.5535150601618157e-21	27	18	10	0.5555555555555556	0.37037037037037035	GO:2000819	GO:BP	regulation of nucleotide-excision repair	16175	26073		0	0.011363636363636364	27	16148	10	8	17	16140	16175	0.4528762652378182
M1	string	0	network_modules	296	TRUE	2.4070805639726788e-20	34	18	10	0.5555555555555556	0.29411764705882354	GO:0070316	GO:BP	regulation of G0 to G1 transition	16175	16055		0.011494252873563218	0.022727272727272728	34	16141	10	8	24	16133	16175	0.40334499909784893
M1	string	0	network_modules	296	TRUE	4.079618232990102e-20	116	17	13	0.7647058823529411	0.11206896551724138	KEGG:03082	KEGG	ATP-dependent chromatin remodeling	8484	219		0	0.3333333333333333	116	8368	13	4	103	8364	8484	0.28978745473880274
M1	string	0	network_modules	296	TRUE	4.661830035941387e-20	36	18	10	0.5555555555555556	0.2777777777777778	GO:0045023	GO:BP	G0 to G1 transition	16175	11235		0.022988505747126436	0.03409090909090909	36	16139	10	8	26	16131	16175	0.39191758991757053
M1	string	0	network_modules	296	TRUE	9.696306525958439e-18	36	14	9	0.6428571428571429	0.25	REAC:R-HSA-8939243	REAC	RUNX1 interacts with co-factors whose precise effect on RUNX1 targets is not known	10916	1916		0	0.2	36	10880	9	5	27	10875	10916	0.39975097340820726
M1	string	0	network_modules	296	TRUE	1.1491365713876258e-16	41	18	9	0.5	0.21951219512195122	GO:0045663	GO:BP	positive regulation of myoblast differentiation	16175	11514		0.034482758620689655	0.045454545454545456	41	16134	9	9	32	16125	16175	0.330217398023947
M1	string	0	network_modules	296	TRUE	2.591470997235843e-16	79	18	10	0.5555555555555556	0.12658227848101267	GO:0006289	GO:BP	nucleotide-excision repair	16175	2102		0.04597701149425287	0.056818181818181816	79	16096	10	8	69	16088	16175	0.2636454208529811
M1	string	0	network_modules	296	TRUE	2.960343777389764e-16	80	18	10	0.5555555555555556	0.125	GO:0045445	GO:BP	myoblast differentiation	16175	11378		0.05747126436781609	0.06818181818181818	80	16095	10	8	70	16087	16175	0.26197117925739305
M1	string	0	network_modules	296	TRUE	4.955280681838502e-16	84	18	10	0.5555555555555556	0.11904761904761904	GO:2000781	GO:BP	positive regulation of double-strand break repair	16175	26037		0.06896551724137931	0.07954545454545454	84	16091	10	8	74	16083	16175	0.25557462969383116
M1	string	0	network_modules	296	TRUE	6.188113812616126e-16	217	18	12	0.6666666666666666	0.055299539170506916	GO:0000819	GO:BP	sister chromatid segregation	16175	237		0.08045977011494253	0.09090909090909091	217	15958	12	6	205	15952	16175	0.18952264111137443
M1	string	0	network_modules	296	TRUE	6.349190554622491e-16	86	18	10	0.5555555555555556	0.11627906976744186	GO:0030071	GO:BP	regulation of mitotic metaphase/anaphase transition	16175	6671		0.09195402298850575	0.10227272727272728	86	16089	10	8	76	16081	16175	0.2525442978546721
M1	string	0	network_modules	296	TRUE	8.086163113966793e-16	88	18	10	0.5555555555555556	0.11363636363636363	GO:1902099	GO:BP	regulation of metaphase/anaphase transition of cell cycle	16175	22013		0.10344827586206896	0.11363636363636363	88	16087	10	8	78	16079	16175	0.249617395567342
M1	string	0	network_modules	296	TRUE	1.0239186018083297e-15	90	18	10	0.5555555555555556	0.1111111111111111	GO:0007091	GO:BP	metaphase/anaphase transition of mitotic cell cycle	16175	2675		0.11494252873563218	0.125	90	16085	10	8	80	16077	16175	0.24678814936296087
M1	string	0	network_modules	296	TRUE	1.2894462314958702e-15	92	18	10	0.5555555555555556	0.10869565217391304	GO:0044784	GO:BP	metaphase/anaphase transition of cell cycle	16175	11156		0.12643678160919541	0.13636363636363635	92	16083	10	8	82	16075	16175	0.24405122732944798
M1	string	0	network_modules	296	TRUE	2.7771603886688862e-15	99	18	10	0.5555555555555556	0.10101010101010101	GO:0033045	GO:BP	regulation of sister chromatid segregation	16175	8000		0.13793103448275862	0.14772727272727273	99	16076	10	8	89	16068	16175	0.23513100708218831
M1	string	0	network_modules	296	TRUE	3.045813597831793e-15	361	18	13	0.7222222222222222	0.036011080332409975	GO:0007059	GO:BP	chromosome segregation	16175	2658		0.14942528735632185	0.1590909090909091	361	15814	13	5	348	15809	16175	0.15814813729231755
M1	string	0	network_modules	296	TRUE	4.08448407213404e-15	59	18	9	0.5	0.15254237288135594	GO:0045661	GO:BP	regulation of myoblast differentiation	16175	11512		0.16091954022988506	0.17045454545454544	59	16116	9	9	50	16107	16175	0.2748119834167519
M1	string	0	network_modules	296	TRUE	5.246009619710023e-15	529	18	14	0.7777777777777778	0.026465028355387523	GO:0006325	GO:BP	chromatin organization	16175	2122		0.1724137931034483	0.18181818181818182	529	15646	14	4	515	15642	16175	0.13982006452566273
M1	string	0	network_modules	296	TRUE	1.2142183724767926e-14	277	18	12	0.6666666666666666	0.04332129963898917	GO:0098813	GO:BP	nuclear chromosome segregation	16175	18900		0.1839080459770115	0.19318181818181818	277	15898	12	6	265	15892	16175	0.16710749718359968
M1	string	0	network_modules	296	TRUE	1.8458740177870698e-14	78	14	9	0.6428571428571429	0.11538461538461539	REAC:R-HSA-3214858	REAC	RMTs methylate histone arginines	10916	1878		0.25	0.4	78	10838	9	5	69	10833	10916	0.27046605356421183
M1	string	0	network_modules	296	TRUE	2.876089108186091e-14	124	18	10	0.5555555555555556	0.08064516129032258	GO:0051983	GO:BP	regulation of chromosome segregation	16175	14045		0.19540229885057472	0.20454545454545456	124	16051	10	8	114	16043	16175	0.2096675357595315
M1	string	0	network_modules	296	TRUE	3.680908547077797e-14	127	18	10	0.5555555555555556	0.07874015748031496	GO:0045739	GO:BP	positive regulation of DNA repair	16175	11579		0.20689655172413793	0.2159090909090909	127	16048	10	8	117	16040	16175	0.207125571815201
M1	string	0	network_modules	296	TRUE	3.9910423505411725e-14	128	18	10	0.5555555555555556	0.078125	GO:2000779	GO:BP	regulation of double-strand break repair	16175	26035		0.21839080459770116	0.22727272727272727	128	16047	10	8	118	16039	16175	0.20629804029310478
M1	string	0	network_modules	296	TRUE	6.103771353221157e-14	454	18	13	0.7222222222222222	0.028634361233480177	GO:0006338	GO:BP	chromatin remodeling	16175	2126		0.22988505747126436	0.23863636363636365	454	15721	13	5	441	15716	16175	0.14027753795685202
M1	string	0	network_modules	296	TRUE	1.0799386475448861e-13	141	18	10	0.5555555555555556	0.07092198581560284	GO:2000045	GO:BP	regulation of G1/S transition of mitotic cell cycle	16175	25406		0.2413793103448276	0.25	141	16034	10	8	131	16026	16175	0.19634899691270138
M1	string	0	network_modules	296	TRUE	1.4746128259328219e-13	86	18	9	0.5	0.10465116279069768	GO:0045582	GO:BP	positive regulation of T cell differentiation	16175	11433		0.25287356321839083	0.26136363636363635	86	16089	9	9	77	16080	16175	0.22704583954703975
M1	string	0	network_modules	296	TRUE	1.5006660557025895e-13	229	18	11	0.6111111111111112	0.048034934497816595	GO:0033044	GO:BP	regulation of chromosome organization	16175	7999		0.26436781609195403	0.2727272727272727	229	15946	11	7	218	15939	16175	0.16865415009984627
M1	string	0	network_modules	296	TRUE	5.51466252092019e-13	99	18	9	0.5	0.09090909090909091	GO:0045621	GO:BP	positive regulation of lymphocyte differentiation	16175	11472		0.27586206896551724	0.2840909090909091	99	16076	9	9	90	16067	16175	0.21135597682892268
M1	string	0	network_modules	296	TRUE	5.743141338916106e-13	166	18	10	0.5555555555555556	0.060240963855421686	GO:1902806	GO:BP	regulation of cell cycle G1/S phase transition	16175	22525		0.28735632183908044	0.29545454545454547	166	16009	10	8	156	16001	16175	0.18059004237786228
M1	string	0	network_modules	296	TRUE	1.9322417195031514e-12	187	18	10	0.5555555555555556	0.053475935828877004	GO:0000082	GO:BP	G1/S transition of mitotic cell cycle	16175	31		0.2988505747126437	0.3068181818181818	187	15988	10	8	177	15980	16175	0.16985440674844945
M1	string	0	network_modules	296	TRUE	2.698206040065565e-12	297	18	11	0.6111111111111112	0.037037037037037035	GO:0030098	GO:BP	lymphocyte differentiation	16175	6676		0.3103448275862069	0.3181818181818182	297	15878	11	7	286	15871	16175	0.1473652922311859
M1	string	0	network_modules	296	TRUE	2.800491899447344e-12	298	18	11	0.6111111111111112	0.03691275167785235	GO:0006302	GO:BP	double-strand break repair	16175	2109		0.3218390804597701	0.32954545454545453	298	15877	11	7	287	15870	16175	0.1471071153444789
M1	string	0	network_modules	296	TRUE	5.417967721383638e-12	207	18	10	0.5555555555555556	0.04830917874396135	GO:0006282	GO:BP	regulation of DNA repair	16175	2096		0.3333333333333333	0.3409090909090909	207	15968	10	8	197	15960	16175	0.1611743773013462
M1	string	0	network_modules	296	TRUE	6.430462258666914e-12	129	18	9	0.5	0.06976744186046512	GO:0045580	GO:BP	regulation of T cell differentiation	16175	11431		0.3448275862068966	0.3522727272727273	129	16046	9	9	120	16037	16175	0.18463280241229255
M1	string	0	network_modules	296	TRUE	7.587041275723412e-12	214	18	10	0.5555555555555556	0.04672897196261682	GO:0044843	GO:BP	cell cycle G1/S phase transition	16175	11189		0.3563218390804598	0.36363636363636365	214	15961	10	8	204	15953	16175	0.1584247675515505
M1	string	0	network_modules	296	TRUE	1.2793356568924068e-11	139	18	9	0.5	0.06474820143884892	GO:1902107	GO:BP	positive regulation of leukocyte differentiation	16175	22021		0.367816091954023	0.38636363636363635	139	16036	9	9	130	16027	16175	0.17769927041604539
M1	string	0	network_modules	296	TRUE	1.2793356568924068e-11	139	18	9	0.5	0.06474820143884892	GO:1903708	GO:BP	positive regulation of hemopoiesis	16175	23222		0.367816091954023	0.38636363636363635	139	16036	9	9	130	16027	16175	0.17769927041604539
M1	string	0	network_modules	296	TRUE	1.744919247702801e-11	41	18	7	0.3888888888888889	0.17073170731707318	GO:1902459	GO:BP	positive regulation of stem cell population maintenance	16175	22297		0.39080459770114945	0.3977272727272727	41	16134	7	11	34	16123	16175	0.25646184643095155
M1	string	0	network_modules	296	TRUE	2.057756145511588e-11	357	18	11	0.6111111111111112	0.03081232492997199	GO:1903131	GO:BP	mononuclear cell differentiation	16175	22787		0.40229885057471265	0.4090909090909091	357	15818	11	7	346	15811	16175	0.13382433172699734
M1	string	0	network_modules	296	TRUE	2.871648838990757e-11	19	18	6	0.3333333333333333	0.3157894736842105	GO:0006337	GO:BP	nucleosome disassembly	16175	2125		0.41379310344827586	0.42045454545454547	19	16156	6	12	13	16144	16175	0.32366971398975253
M1	string	0	network_modules	296	TRUE	2.908083001811606e-11	152	18	9	0.5	0.05921052631578947	GO:0045619	GO:BP	regulation of lymphocyte differentiation	16175	11470		0.42528735632183906	0.4318181818181818	152	16023	9	9	143	16014	16175	0.169721349275666
M1	string	0	network_modules	296	TRUE	3.098682919551751e-11	246	18	10	0.5555555555555556	0.04065040650406504	GO:0051054	GO:BP	positive regulation of DNA metabolic process	16175	13464		0.4367816091954023	0.4431818181818182	246	15929	10	8	236	15921	16175	0.14737066190848888
M1	string	0	network_modules	296	TRUE	4.192570617262106e-11	545	18	12	0.6666666666666666	0.022018348623853212	GO:0051276	GO:BP	chromosome organization	16175	13613		0.4482758620689655	0.45454545454545453	545	15630	12	6	533	15624	16175	0.11708665927344701
M1	string	0	network_modules	296	TRUE	5.7359889154159825e-11	21	18	6	0.3333333333333333	0.2857142857142857	GO:0032986	GO:BP	protein-DNA complex disassembly	16175	7966		0.45977011494252873	0.4659090909090909	21	16154	6	12	15	16142	16175	0.30777575256789563
M1	string	0	network_modules	296	TRUE	1.4091147647854746e-10	286	18	10	0.5555555555555556	0.03496503496503497	GO:1901990	GO:BP	regulation of mitotic cell cycle phase transition	16175	21923		0.47126436781609193	0.4772727272727273	286	15889	10	8	276	15881	16175	0.13622267056175527
M1	string	0	network_modules	296	TRUE	1.7577518416159588e-10	434	18	11	0.6111111111111112	0.02534562211981567	GO:0002521	GO:BP	leukocyte differentiation	16175	1043		0.4827586206896552	0.48863636363636365	434	15741	11	7	423	15734	16175	0.12068682560917826
M1	string	0	network_modules	296	TRUE	1.802621198800549e-10	435	18	11	0.6111111111111112	0.02528735632183908	GO:0051052	GO:BP	regulation of DNA metabolic process	16175	13462		0.4942528735632184	0.5	435	15740	11	7	424	15733	16175	0.12053909876059996
M1	string	0	network_modules	296	TRUE	2.6195222039506557e-10	59	18	7	0.3888888888888889	0.11864406779661017	GO:2000036	GO:BP	regulation of stem cell population maintenance	16175	25399		0.5057471264367817	0.5113636363636364	59	16116	7	11	52	16105	16175	0.21329386626790076
M1	string	0	network_modules	296	TRUE	2.735506971970035e-10	638	18	12	0.6666666666666666	0.018808777429467086	GO:0030097	GO:BP	hemopoiesis	16175	6675		0.5172413793103449	0.5227272727272727	638	15537	12	6	626	15531	16175	0.10755442641759269
M1	string	0	network_modules	296	TRUE	2.827164005373486e-10	195	18	9	0.5	0.046153846153846156	GO:0050870	GO:BP	positive regulation of T cell activation	16175	13318		0.5287356321839081	0.5340909090909091	195	15980	9	9	186	15971	16175	0.1492329717717191
M1	string	0	network_modules	296	TRUE	4.402584256520105e-10	166	17	9	0.5294117647058824	0.05421686746987952	KEGG:05225	KEGG	Hepatocellular carcinoma	8484	476		0.5	0.6666666666666666	166	8318	9	8	157	8310	8484	0.16494359204857187
M1	string	0	network_modules	296	TRUE	4.654071254232626e-10	206	18	9	0.5	0.043689320388349516	GO:0030217	GO:BP	T cell differentiation	16175	6725		0.5402298850574713	0.5454545454545454	206	15969	9	9	197	15960	16175	0.14504150560954276
M1	string	0	network_modules	296	TRUE	4.704530987462767e-10	234	14	9	0.6428571428571429	0.038461538461538464	REAC:R-HSA-8878171	REAC	Transcriptional regulation by RUNX1	10916	2552		0.5	0.6	234	10682	9	5	225	10677	10916	0.1537538395360567
M1	string	0	network_modules	296	TRUE	6.858990650654593e-10	215	18	9	0.5	0.04186046511627907	GO:1903039	GO:BP	positive regulation of leukocyte cell-cell adhesion	16175	22719		0.5517241379310345	0.5568181818181818	215	15960	9	9	206	15951	16175	0.1418511581314485
M1	string	0	network_modules	296	TRUE	1.167139378510648e-9	228	18	9	0.5	0.039473684210526314	GO:1902105	GO:BP	regulation of leukocyte differentiation	16175	22019		0.5632183908045977	0.5681818181818182	228	15947	9	9	219	15938	16175	0.13757638313964934
M1	string	0	network_modules	296	TRUE	1.4957382929886477e-9	528	18	11	0.6111111111111112	0.020833333333333332	GO:0006281	GO:BP	DNA repair	16175	2095		0.5747126436781609	0.5795454545454546	528	15647	11	7	517	15640	16175	0.1086543514970936
M1	string	0	network_modules	296	TRUE	1.773657148420255e-9	271	14	9	0.6428571428571429	0.033210332103321034	REAC:R-HSA-3247509	REAC	Chromatin modifying enzymes	10916	355		0.75	1	271	10645	9	5	262	10640	10916	0.14234013626460754
M1	string	0	network_modules	296	TRUE	1.773657148420255e-9	271	14	9	0.6428571428571429	0.033210332103321034	REAC:R-HSA-4839726	REAC	Chromatin organization	10916	356		0.75	1	271	10645	9	5	262	10640	10916	0.14234013626460754
M1	string	0	network_modules	296	TRUE	1.846848372320301e-9	370	18	10	0.5555555555555556	0.02702702702702703	GO:0044772	GO:BP	mitotic cell cycle phase transition	16175	11148		0.5862068965517241	0.5909090909090909	370	15805	10	8	360	15797	16175	0.11892387967074458
M1	string	0	network_modules	296	TRUE	2.1674764243920505e-9	376	18	10	0.5555555555555556	0.026595744680851064	GO:1901987	GO:BP	regulation of cell cycle phase transition	16175	21920		0.5977011494252874	0.6022727272727273	376	15799	10	8	366	15791	16175	0.11791143477313717
M1	string	0	network_modules	296	TRUE	2.5870391136798037e-9	249	18	9	0.5	0.03614457831325301	GO:0051251	GO:BP	positive regulation of lymphocyte activation	16175	13598		0.6091954022988506	0.6136363636363636	249	15926	9	9	240	15917	16175	0.13138198630916612
M1	string	0	network_modules	296	TRUE	3.373940317701907e-9	569	18	11	0.6111111111111112	0.019332161687170474	GO:0046649	GO:BP	lymphocyte activation	16175	12286		0.6206896551724138	0.625	569	15606	11	7	558	15599	16175	0.1043447218649614
M1	string	0	network_modules	296	TRUE	3.4406717307082274e-9	257	18	9	0.5	0.03501945525291829	GO:0022409	GO:BP	positive regulation of cell-cell adhesion	16175	6600		0.632183908045977	0.6363636363636364	257	15918	9	9	248	15909	16175	0.1292214387354475
M1	string	0	network_modules	296	TRUE	3.868554086287319e-9	798	18	12	0.6666666666666666	0.015037593984962405	GO:0006974	GO:BP	DNA damage response	16175	2601		0.6436781609195402	0.6477272727272727	798	15377	12	6	786	15371	16175	0.09514395586130593
M1	string	0	network_modules	296	TRUE	5.640889788967903e-9	414	18	10	0.5555555555555556	0.024154589371980676	GO:0061061	GO:BP	muscle structure development	16175	15177		0.6551724137931034	0.6590909090909091	414	15761	10	8	404	15753	16175	0.11200866645899542
M1	string	0	network_modules	296	TRUE	6.329048877958403e-9	275	18	9	0.5	0.03272727272727273	GO:0002696	GO:BP	positive regulation of leukocyte activation	16175	1214		0.6666666666666666	0.6704545454545454	275	15900	9	9	266	15891	16175	0.12470418010297363
M1	string	0	network_modules	296	TRUE	7.664524643460465e-9	427	18	10	0.5555555555555556	0.0234192037470726	GO:0007346	GO:BP	regulation of mitotic cell cycle	16175	2855		0.6781609195402298	0.6818181818181818	427	15748	10	8	417	15740	16175	0.11016862110742494
M1	string	0	network_modules	296	TRUE	8.190249314955871e-9	283	18	9	0.5	0.03180212014134275	GO:0010720	GO:BP	positive regulation of cell development	16175	4346		0.6896551724137931	0.6931818181818182	283	15892	9	9	274	15883	16175	0.12283396733186508
M1	string	0	network_modules	296	TRUE	8.4539956669536e-9	284	18	9	0.5	0.03169014084507042	GO:0050863	GO:BP	regulation of T cell activation	16175	13311		0.7011494252873564	0.7045454545454546	284	15891	9	9	275	15882	16175	0.12260566603909342
M1	string	0	network_modules	296	TRUE	9.290922834185848e-9	287	18	9	0.5	0.0313588850174216	GO:1903037	GO:BP	regulation of leukocyte cell-cell adhesion	16175	22717		0.7126436781609196	0.7159090909090909	287	15888	9	9	278	15879	16175	0.12192780831388302
M1	string	0	network_modules	296	TRUE	9.640174965880603e-9	437	18	10	0.5555555555555556	0.02288329519450801	GO:0080135	GO:BP	regulation of cellular response to stress	16175	17817		0.7241379310344828	0.7272727272727273	437	15738	10	8	427	15730	16175	0.10880813404931582
M1	string	0	network_modules	296	TRUE	1.0183481323543685e-8	630	18	11	0.6111111111111112	0.01746031746031746	GO:0010564	GO:BP	regulation of cell cycle process	16175	4217		0.735632183908046	0.7386363636363636	630	15545	11	7	619	15538	16175	0.09870829269438762
M1	string	0	network_modules	296	TRUE	1.0200376771094529e-8	290	18	9	0.5	0.03103448275862069	GO:0050867	GO:BP	positive regulation of cell activation	16175	13315		0.7471264367816092	0.75	290	15885	9	9	281	15876	16175	0.1212603074294259
M1	string	0	network_modules	296	TRUE	1.1161101974190459e-8	99	18	7	0.3888888888888889	0.0707070707070707	GO:0019827	GO:BP	stem cell population maintenance	16175	6046		0.7586206896551724	0.7613636363636364	99	16076	7	11	92	16065	16175	0.16380591632239141
M1	string	0	network_modules	296	TRUE	1.1994010481478931e-8	100	18	7	0.3888888888888889	0.07	GO:0098727	GO:BP	maintenance of cell number	16175	18856		0.7701149425287356	0.7727272727272727	100	16075	7	11	93	16064	16175	0.1629635725696674
M1	string	0	network_modules	296	TRUE	1.5775002190939416e-8	656	18	11	0.6111111111111112	0.01676829268292683	GO:1903047	GO:BP	mitotic cell cycle process	16175	22727		0.7816091954022989	0.7840909090909091	656	15519	11	7	645	15512	16175	0.096541419023194
M1	string	0	network_modules	296	TRUE	1.7820866972450335e-8	465	18	10	0.5555555555555556	0.021505376344086023	GO:0044770	GO:BP	cell cycle phase transition	16175	11146		0.7931034482758621	0.7954545454545454	465	15710	10	8	455	15702	16175	0.10522951031788633
M1	string	0	network_modules	296	TRUE	1.8023620232996017e-8	309	18	9	0.5	0.02912621359223301	GO:1903706	GO:BP	regulation of hemopoiesis	16175	23220		0.8045977011494253	0.8068181818181818	309	15866	9	9	300	15857	16175	0.11725700075071105
M1	string	0	network_modules	296	TRUE	2.7554290759683697e-8	324	18	9	0.5	0.027777777777777776	GO:0007159	GO:BP	leukocyte cell-cell adhesion	16175	2723		0.8160919540229885	0.8181818181818182	324	15851	9	9	315	15842	16175	0.11434379690363719
M1	string	0	network_modules	296	TRUE	3.132181795548576e-8	699	18	11	0.6111111111111112	0.015736766809728183	GO:0045321	GO:BP	leukocyte activation	16175	11356		0.8275862068965517	0.8295454545454546	699	15476	11	7	688	15469	16175	0.09321831529636852
M1	string	0	network_modules	296	TRUE	8.801133084515605e-8	369	18	9	0.5	0.024390243902439025	GO:0051249	GO:BP	regulation of lymphocyte activation	16175	13596		0.8390804597701149	0.8409090909090909	369	15806	9	9	360	15797	16175	0.10667548515227336
M1	string	0	network_modules	296	TRUE	9.688470359481836e-8	373	18	9	0.5	0.024128686327077747	GO:0045785	GO:BP	positive regulation of cell adhesion	16175	11617		0.8505747126436781	0.8522727272727273	373	15802	9	9	364	15793	16175	0.10606039221088666
M1	string	0	network_modules	296	TRUE	1.2020562881760783e-7	792	18	11	0.6111111111111112	0.013888888888888888	GO:0000278	GO:BP	mitotic cell cycle	16175	76		0.8620689655172413	0.8636363636363636	792	15383	11	7	781	15376	16175	0.08694942274402483
M1	string	0	network_modules	296	TRUE	1.314348626950504e-7	386	18	9	0.5	0.023316062176165803	GO:0022407	GO:BP	regulation of cell-cell adhesion	16175	6598		0.8735632183908046	0.875	386	15789	9	9	377	15780	16175	0.1041262541021668
M1	string	0	network_modules	296	TRUE	2.0594094923856064e-7	406	18	9	0.5	0.022167487684729065	GO:0042110	GO:BP	T cell activation	16175	9970		0.8850574712643678	0.8863636363636364	406	15769	9	9	397	15760	16175	0.10132971743141746
M1	string	0	network_modules	296	TRUE	2.8418741509341545e-7	421	18	9	0.5	0.021377672209026127	GO:0002694	GO:BP	regulation of leukocyte activation	16175	1212		0.896551724137931	0.8977272727272727	421	15754	9	9	412	15745	16175	0.09936113907058798
M1	string	0	network_modules	296	TRUE	3.336079025002988e-7	232	17	8	0.47058823529411764	0.034482758620689655	KEGG:04714	KEGG	Thermogenesis	8484	349		1	1	232	8252	8	9	224	8243	8484	0.1217806464194587
M1	string	0	network_modules	296	TRUE	7.254283527091859e-7	468	18	9	0.5	0.019230769230769232	GO:0050865	GO:BP	regulation of cell activation	16175	13313		0.9080459770114943	0.9090909090909091	468	15707	9	9	459	15698	16175	0.09380215481046926
M1	string	0	network_modules	296	TRUE	1.7080713660584956e-6	106	18	6	0.3333333333333333	0.05660377358490566	GO:0034728	GO:BP	nucleosome organization	16175	8723		0.9195402298850575	0.9204545454545454	106	16069	6	12	100	16057	16175	0.13517871181699878
M1	string	0	network_modules	296	TRUE	4.18006512921204e-6	571	18	9	0.5	0.01576182136602452	GO:0060284	GO:BP	regulation of cell development	16175	14500		0.9310344827586207	0.9318181818181818	571	15604	9	9	562	15595	16175	0.08404957599939603
M1	string	0	network_modules	296	TRUE	8.006481484187848e-6	615	18	9	0.5	0.014634146341463415	GO:0045597	GO:BP	positive regulation of cell differentiation	16175	11448		0.9425287356321839	0.9431818181818182	615	15560	9	9	606	15551	16175	0.08062680671075646
M1	string	0	network_modules	296	TRUE	8.838844629554246e-6	622	18	9	0.5	0.014469453376205787	GO:0030155	GO:BP	regulation of cell adhesion	16175	6688		0.9540229885057471	0.9545454545454546	622	15553	9	9	613	15544	16175	0.0801147554819272
M1	string	0	network_modules	296	TRUE	4.247666505484553e-5	745	18	9	0.5	0.012080536912751677	GO:0098609	GO:BP	cell-cell adhesion	16175	18805		0.9655172413793104	0.9659090909090909	745	15430	9	9	736	15421	16175	0.07228342888350099
M1	string	0	network_modules	296	TRUE	9.262080376042347e-5	206	18	6	0.3333333333333333	0.02912621359223301	GO:0071824	GO:BP	protein-DNA complex organization	16175	16927		0.9770114942528736	0.9772727272727273	206	15969	6	12	200	15957	16175	0.09543067955624591
M1	string	0	network_modules	296	TRUE	1.1939201665609667e-4	215	18	6	0.3333333333333333	0.027906976744186046	GO:0032984	GO:BP	protein-containing complex disassembly	16175	7964		0.9885057471264368	0.9886363636363636	215	15960	6	12	209	15948	16175	0.09327610821557722
M1	string	0	network_modules	296	TRUE	0.0030773163359181263	374	18	6	0.3333333333333333	0.016042780748663103	GO:0022411	GO:BP	cellular component disassembly	16175	6602		1	1	374	15801	6	12	368	15789	16175	0.06889371582675839
M1	string	0	network_modules	297	TRUE	2.843362927601591e-12	71	17	8	0.47058823529411764	0.11267605633802817	GO:0045109	GO:BP	intermediate filament organization	16175	11280		0	0.08333333333333333	71	16104	8	9	63	16095	16175	0.22874414851075478
M1	string	0	network_modules	297	TRUE	1.2772411710297825e-11	85	17	8	0.47058823529411764	0.09411764705882353	GO:0045104	GO:BP	intermediate filament cytoskeleton organization	16175	11275		0.09090909090909091	0.16666666666666666	85	16090	8	9	77	16081	16175	0.20876203114234426
M1	string	0	network_modules	297	TRUE	1.407540755769989e-11	86	17	8	0.47058823529411764	0.09302325581395349	GO:0045103	GO:BP	intermediate filament-based process	16175	11274		0.18181818181818182	0.25	86	16089	8	9	78	16080	16175	0.20752362415430314
M1	string	0	network_modules	297	TRUE	5.415307315864955e-10	128	15	8	0.5333333333333333	0.0625	REAC:R-HSA-6809371	REAC	Formation of the cornified envelope	10916	969		0	0.5	128	10788	8	7	120	10781	10916	0.1797398185977225
M1	string	0	network_modules	297	TRUE	6.125225184089135e-10	231	17	9	0.5294117647058824	0.03896103896103896	GO:0008544	GO:BP	epidermis development	16175	3192		0.2727272727272727	0.3333333333333333	231	15944	9	8	222	15936	16175	0.14082752653540748
M1	string	0	network_modules	297	TRUE	3.3839974127450288e-9	168	17	8	0.47058823529411764	0.047619047619047616	GO:0043588	GO:BP	skin development	16175	10792		0.36363636363636365	0.4166666666666667	168	16007	8	9	160	15998	16175	0.1472358887790649
M1	string	0	network_modules	297	TRUE	3.5752721531527756e-8	215	15	8	0.5333333333333333	0.037209302325581395	REAC:R-HSA-6805567	REAC	Keratinization	10916	1288		1	1	215	10701	8	7	207	10694	10916	0.13712014892393665
M1	string	0	network_modules	297	TRUE	7.942234446340139e-6	22	17	4	0.23529411764705882	0.18181818181818182	GO:0018149	GO:BP	peptide cross-linking	16175	5337		0.45454545454545453	0.5	22	16153	4	13	18	16140	16175	0.2058876738254677
M1	string	0	network_modules	297	TRUE	9.279900062996465e-6	454	17	8	0.47058823529411764	0.01762114537444934	GO:0030855	GO:BP	epithelial cell differentiation	16175	6938		0.5454545454545454	0.5833333333333334	454	15721	8	9	446	15712	16175	0.08690406001064936
M1	string	0	network_modules	297	TRUE	1.1997285199409505e-5	701	17	9	0.5294117647058824	0.012838801711840228	GO:0060429	GO:BP	epithelium development	16175	14627		0.6363636363636364	0.6666666666666666	701	15474	9	8	692	15466	16175	0.07743127141699015
M1	string	0	network_modules	297	TRUE	3.731969852635454e-5	86	8	4	0.5	0.046511627906976744	KEGG:05150	KEGG	Staphylococcus aureus infection	8484	439		0	0.5	86	8398	4	4	82	8394	8484	0.15024080350644717
M1	string	0	network_modules	297	TRUE	6.925674921805332e-5	102	17	5	0.29411764705882354	0.049019607843137254	GO:0030216	GO:BP	keratinocyte differentiation	16175	6724		0.7272727272727273	0.75	102	16073	5	12	97	16061	16175	0.11793282794818509
M1	string	0	network_modules	297	TRUE	2.350845799422614e-4	136	8	4	0.5	0.029411764705882353	KEGG:04915	KEGG	Estrogen signaling pathway	8484	372		1	1	136	8348	4	4	132	8344	8484	0.11838802897879427
M1	string	0	network_modules	297	TRUE	3.6342767339753396e-4	142	17	5	0.29411764705882354	0.035211267605633804	GO:0009913	GO:BP	epidermal cell differentiation	16175	3769		0.8181818181818182	0.8333333333333334	142	16033	5	12	137	16021	16175	0.099216524056516
M1	string	0	network_modules	297	TRUE	4.4446335336173373e-4	748	17	8	0.47058823529411764	0.0106951871657754	GO:0097435	GO:BP	supramolecular fiber organization	16175	18657		0.9090909090909091	0.9166666666666666	748	15427	8	9	740	15418	16175	0.06553925605055536
M1	string	0	network_modules	297	TRUE	0.006789001328837138	33	17	3	0.17647058823529413	0.09090909090909091	GO:0031424	GO:BP	keratinization	16175	7162		1	1	33	16142	3	14	30	16128	16175	0.12538959230205957
M1	string	0	network_modules	298	TRUE	2.480682743162348e-23	10	18	9	0.5	0.9	REAC:R-HSA-2470946	REAC	Cohesin Loading onto Chromatin	10916	383		0	0.08333333333333333	10	10906	9	9	1	10897	10916	0.670451247187247
M1	string	0	network_modules	298	TRUE	1.7697388489456998e-21	13	18	9	0.5	0.6923076923076923	REAC:R-HSA-68884	REAC	Mitotic Telophase/Cytokinesis	10916	1487		0.09090909090909091	0.16666666666666666	13	10903	9	9	4	10894	10916	0.5877816892318828
M1	string	0	network_modules	298	TRUE	4.457185609620918e-19	11	18	8	0.4444444444444444	0.7272727272727273	REAC:R-HSA-2468052	REAC	Establishment of Sister Chromatid Cohesion	10916	864		0.18181818181818182	0.25	11	10905	8	10	3	10895	10916	0.5680007146862588
M1	string	0	network_modules	298	TRUE	3.304790901467258e-18	29	18	9	0.5	0.3103448275862069	GO:0007064	GO:BP	mitotic sister chromatid cohesion	16175	2662		0	0.06666666666666667	29	16146	9	9	20	16137	16175	0.3930779000895582
M1	string	0	network_modules	298	TRUE	3.548865224692362e-18	53	18	10	0.5555555555555556	0.18867924528301888	GO:0007062	GO:BP	sister chromatid cohesion	16175	2660		0.07142857142857142	0.13333333333333333	53	16122	10	8	43	16114	16175	0.3225605364340364
M1	string	0	network_modules	298	TRUE	5.2424744567304174e-14	157	13	10	0.7692307692307693	0.06369426751592357	KEGG:04110	KEGG	Cell cycle	8484	264		NA	1	157	8327	10	3	147	8324	8484	0.21821870094507528
M1	string	0	network_modules	298	TRUE	2.235408316713569e-13	10	18	6	0.3333333333333333	0.6	GO:0034085	GO:BP	establishment of sister chromatid cohesion	16175	8396		0.14285714285714285	0.2	10	16165	6	12	4	16153	16175	0.44677085084504836
M1	string	0	network_modules	298	TRUE	2.783856886241765e-11	7	18	5	0.2777777777777778	0.7142857142857143	GO:0034087	GO:BP	establishment of mitotic sister chromatid cohesion	16175	8398		0.21428571428571427	0.26666666666666666	7	16168	5	13	2	16155	16175	0.4450854193911863
M1	string	0	network_modules	298	TRUE	3.00049606872674e-11	123	18	9	0.5	0.07317073170731707	REAC:R-HSA-2500257	REAC	Resolution of Sister Chromatid Cohesion	10916	2079		0.2727272727272727	0.3333333333333333	123	10793	9	9	114	10784	10916	0.18818007196325418
M1	string	0	network_modules	298	TRUE	1.2809569093458585e-9	406	18	11	0.6111111111111112	0.027093596059113302	REAC:R-HSA-68886	REAC	M Phase	10916	1343		0.36363636363636365	0.4166666666666667	406	10510	11	7	395	10503	10916	0.12325707261566293
M1	string	0	network_modules	298	TRUE	1.4453062659419745e-9	188	18	9	0.5	0.047872340425531915	REAC:R-HSA-2467813	REAC	Separation of Sister Chromatids	10916	2204		0.45454545454545453	0.5	188	10728	9	9	179	10719	10916	0.1508117428648047
M1	string	0	network_modules	298	TRUE	2.1118178253899437e-9	545	18	11	0.6111111111111112	0.02018348623853211	GO:0051276	GO:BP	chromosome organization	16175	13613		0.2857142857142857	0.3333333333333333	545	15630	11	7	534	15623	16175	0.10681004787973056
M1	string	0	network_modules	298	TRUE	2.417430266947445e-9	199	18	9	0.5	0.04522613065326633	REAC:R-HSA-68877	REAC	Mitotic Prometaphase	10916	1484		0.5454545454545454	0.5833333333333334	199	10717	9	9	190	10708	10916	0.1463534174721274
M1	string	0	network_modules	298	TRUE	8.238614381212207e-9	228	18	9	0.5	0.039473684210526314	REAC:R-HSA-68882	REAC	Mitotic Anaphase	10916	1479		0.6363636363636364	0.6666666666666666	228	10688	9	9	219	10679	10916	0.13615979647188334
M1	string	0	network_modules	298	TRUE	8.569172692006487e-9	229	18	9	0.5	0.039301310043668124	REAC:R-HSA-2555396	REAC	Mitotic Metaphase and Anaphase	10916	1482		0.7272727272727273	0.75	229	10687	9	9	220	10678	10916	0.13584255666112255
M1	string	0	network_modules	298	TRUE	2.3559307658369412e-8	162	18	8	0.4444444444444444	0.04938271604938271	REAC:R-HSA-69242	REAC	S Phase	10916	2111		0.8181818181818182	0.8333333333333334	162	10754	8	10	154	10744	10916	0.14439495262592628
M1	string	0	network_modules	298	TRUE	5.240513121207847e-7	656	18	10	0.5555555555555556	0.01524390243902439	GO:1903047	GO:BP	mitotic cell cycle process	16175	22727		0.35714285714285715	0.4	656	15519	10	8	646	15511	16175	0.08714107196238648
M1	string	0	network_modules	298	TRUE	3.274383188074841e-6	792	18	10	0.5555555555555556	0.012626262626262626	GO:0000278	GO:BP	mitotic cell cycle	16175	76		0.42857142857142855	0.4666666666666667	792	15383	10	8	782	15375	16175	0.07835642765708349
M1	string	0	network_modules	298	TRUE	6.607677299343542e-6	4	18	3	0.16666666666666666	0.75	GO:0034089	GO:BP	establishment of meiotic sister chromatid cohesion	16175	8400		0.5	0.5333333333333333	4	16171	3	15	1	16156	16175	0.3532690761523664
M1	string	0	network_modules	298	TRUE	2.712421683296736e-4	11	18	3	0.16666666666666666	0.2727272727272727	GO:0051177	GO:BP	meiotic sister chromatid cohesion	16175	13557		0.5714285714285714	0.6	11	16164	3	15	8	16149	16175	0.21252129700939598
M1	string	0	network_modules	298	TRUE	0.0015322802939036876	72	18	4	0.2222222222222222	0.05555555555555555	REAC:R-HSA-3108214	REAC	SUMOylation of DNA damage response and repair proteins	10916	2168		0.9090909090909091	0.9166666666666666	72	10844	4	14	68	10830	10916	0.1082598214331884
M1	string	0	network_modules	298	TRUE	0.0016627323350748204	178	18	5	0.2777777777777778	0.028089887640449437	GO:0000070	GO:BP	mitotic sister chromatid segregation	16175	24		0.6428571428571429	0.6666666666666666	178	15997	5	13	173	15984	16175	0.08535186359518201
M1	string	0	network_modules	298	TRUE	0.0019030124672154995	76	18	4	0.2222222222222222	0.05263157894736842	REAC:R-HSA-1221632	REAC	Meiotic synapsis	10916	1412		1	1	76	10840	4	14	72	10826	10916	0.10521270970977877
M1	string	0	network_modules	298	TRUE	0.0033235874919248488	379	18	6	0.3333333333333333	0.0158311345646438	GO:0000280	GO:BP	nuclear division	16175	78		0.7142857142857143	0.7333333333333333	379	15796	6	12	373	15784	16175	0.06838038604762994
M1	string	0	network_modules	298	TRUE	0.004406053730318867	217	18	5	0.2777777777777778	0.02304147465437788	GO:0000819	GO:BP	sister chromatid segregation	16175	237		0.7857142857142857	0.8	217	15958	5	13	212	15945	16175	0.07669730992408476
M1	string	0	network_modules	298	TRUE	0.006355808925656792	424	18	6	0.3333333333333333	0.014150943396226415	GO:0048285	GO:BP	organelle fission	16175	12627		0.8571428571428571	0.8666666666666667	424	15751	6	12	418	15739	16175	0.0641610322944164
M1	string	0	network_modules	298	TRUE	0.008835513782225971	112	18	4	0.2222222222222222	0.03571428571428571	GO:0006275	GO:BP	regulation of DNA replication	16175	2090		0.9285714285714286	0.9333333333333333	112	16063	4	14	108	16049	16175	0.08665981266732836
M1	string	0	network_modules	298	TRUE	0.009147539815111376	252	18	5	0.2777777777777778	0.01984126984126984	GO:0140014	GO:BP	mitotic nuclear division	16175	19633		1	1	252	15923	5	13	247	15910	16175	0.07066707792161761
M1	string	0	network_modules	301	TRUE	6.900770940648072e-9	26	11	5	0.45454545454545453	0.19230769230769232	REAC:R-HSA-1187000	REAC	Fertilization	10916	940		0	0.25	26	10890	5	6	21	10884	10916	0.29460631182592095
M1	string	0	network_modules	301	TRUE	5.700685739904628e-7	110	15	6	0.4	0.05454545454545454	GO:0007338	GO:BP	single fertilization	16175	2848		0	0.14285714285714285	110	16065	6	9	104	16056	16175	0.145762349327164
M1	string	0	network_modules	301	TRUE	1.5002144563265996e-6	129	15	6	0.4	0.046511627906976744	GO:0009566	GO:BP	fertilization	16175	3514		0.16666666666666666	0.2857142857142857	129	16046	6	9	123	16037	16175	0.13427787365896335
M1	string	0	network_modules	301	TRUE	3.423445396154615e-5	35	15	4	0.26666666666666666	0.11428571428571428	GO:0035036	GO:BP	sperm-egg recognition	16175	8773		0.3333333333333333	0.42857142857142855	35	16140	4	11	31	16129	16175	0.17342583022297758
M1	string	0	network_modules	301	TRUE	3.700157756017234e-5	11	11	3	0.2727272727272727	0.2727272727272727	REAC:R-HSA-2534343	REAC	Interaction With Cumulus Cells And The Zona Pellucida	10916	1218		0.3333333333333333	0.5	11	10905	3	8	8	10897	10916	0.2719936642907757
M1	string	0	network_modules	301	TRUE	6.685360652423446e-5	154	11	5	0.45454545454545453	0.032467532467532464	REAC:R-HSA-1474165	REAC	Reproduction	10916	2064		0.6666666666666666	0.75	154	10762	5	6	149	10756	10916	0.11861092391965404
M1	string	0	network_modules	301	TRUE	1.493508914798681e-4	50	15	4	0.26666666666666666	0.08	GO:0009988	GO:BP	cell-cell recognition	16175	3812		0.5	0.5714285714285714	50	16125	4	11	46	16114	16175	0.14465697438576008
M1	string	0	network_modules	301	TRUE	0.001569497534929302	23	15	3	0.2	0.13043478260869565	GO:0007339	GO:BP	binding of sperm to zona pellucida	16175	2849		0.6666666666666666	0.7142857142857143	23	16152	3	12	20	16140	16175	0.16055484548270105
M1	string	0	network_modules	301	TRUE	0.0037567876927305397	111	15	4	0.26666666666666666	0.036036036036036036	GO:0008037	GO:BP	cell recognition	16175	3099		0.8333333333333334	0.8571428571428571	111	16064	4	11	107	16053	16175	0.0958797984212159
M1	string	0	network_modules	301	TRUE	0.004088129987132527	6	11	2	0.18181818181818182	0.3333333333333333	REAC:R-HSA-1300645	REAC	Acrosome Reaction and Sperm:Oocyte Membrane Binding	10916	57		1	1	6	10910	2	9	4	10901	10916	0.24563002182252458
M1	string	0	network_modules	301	TRUE	0.008673366523155073	40	15	3	0.2	0.075	GO:2000242	GO:BP	negative regulation of reproductive process	16175	25570		1	1	40	16135	3	12	37	16123	16175	0.12116615688344903
M1	string	0	network_modules	304	TRUE	2.150549446550115e-6	6	9	3	0.3333333333333333	0.5	REAC:R-HSA-9619229	REAC	Activation of RAC1 downstream of NMDARs	10916	95		0	0.14285714285714285	6	10910	3	6	3	10904	10916	0.40785533405486907
M1	string	0	network_modules	304	TRUE	1.4007926818587697e-4	89	9	4	0.4444444444444444	0.0449438202247191	REAC:R-HSA-442755	REAC	Activation of NMDA receptors and postsynaptic events	10916	89		0.16666666666666666	0.2857142857142857	89	10827	4	5	85	10822	10916	0.13936688115845627
M1	string	0	network_modules	304	TRUE	3.8587149584057143e-4	154	8	4	0.5	0.025974025974025976	KEGG:04921	KEGG	Oxytocin signaling pathway	8484	378		0	0.3333333333333333	154	8330	4	4	150	8326	8484	0.1108862114257136
M1	string	0	network_modules	304	TRUE	0.002011135762048371	75	8	3	0.375	0.04	KEGG:05214	KEGG	Glioma	8484	465		0.5	0.6666666666666666	75	8409	3	5	72	8404	8484	0.12017608989209605
M1	string	0	network_modules	304	TRUE	0.003288147855207258	196	9	4	0.4444444444444444	0.02040816326530612	REAC:R-HSA-112314	REAC	Neurotransmitter receptors and postsynaptic signal transmission	10916	1594		0.3333333333333333	0.42857142857142855	196	10720	4	5	192	10715	10916	0.09226026194519962
M1	string	0	network_modules	304	TRUE	0.004483871157320893	98	8	3	0.375	0.030612244897959183	KEGG:04925	KEGG	Aldosterone synthesis and secretion	8484	382		1	1	98	8386	3	5	95	8381	8484	0.1044968033890857
M1	string	0	network_modules	304	TRUE	0.0046879858427047475	8	9	2	0.2222222222222222	0.25	REAC:R-HSA-442729	REAC	CREB1 phosphorylation through the activation of CaMKII/CaMKK/CaMKIV cascasde	10916	285		0.5	0.5714285714285714	8	10908	2	7	6	10901	10916	0.23510800786592262
M1	string	0	network_modules	304	TRUE	0.0073436993999453784	76	9	3	0.3333333333333333	0.039473684210526314	REAC:R-HSA-438064	REAC	Post NMDA receptor activation events	10916	1772		0.6666666666666666	0.7142857142857143	76	10840	3	6	73	10834	10916	0.11275150598603523
M1	string	0	network_modules	304	TRUE	0.007527820621271228	10	9	2	0.2222222222222222	0.2	REAC:R-HSA-111932	REAC	CaMK IV-mediated phosphorylation of CREB	10916	298		0.8333333333333334	0.8571428571428571	10	10906	2	7	8	10899	10916	0.21013230935567795
M1	string	0	network_modules	304	TRUE	0.009867904463169604	259	9	4	0.4444444444444444	0.015444015444015444	REAC:R-HSA-112315	REAC	Transmission across Chemical Synapses	10916	2580		1	1	259	10657	4	5	255	10652	10916	0.0794064264598925
M1	string	0	network_modules	309	TRUE	1.1555705393446131e-14	8	16	6	0.375	0.75	GO:0097646	GO:BP	calcitonin family receptor signaling pathway	16175	18719		0	0.1	8	16167	6	10	2	16157	16175	0.5300238627179158
M1	string	0	network_modules	309	TRUE	8.42953107383563e-14	10	14	6	0.42857142857142855	0.6	REAC:R-HSA-419812	REAC	Calcitonin-like ligand receptors	10916	300		0	0.16666666666666666	10	10906	6	8	4	10898	10916	0.5065655025786313
M1	string	0	network_modules	309	TRUE	5.618509271327014e-9	19	14	5	0.35714285714285715	0.2631578947368421	REAC:R-HSA-210745	REAC	Regulation of gene expression in beta cells	10916	2034		0.2	0.3333333333333333	19	10897	5	9	14	10888	10916	0.30553741878796276
M1	string	0	network_modules	309	TRUE	1.238333377868725e-8	26	13	5	0.38461538461538464	0.19230769230769232	KEGG:04950	KEGG	Maturity onset diabetes of the young	8484	395		0	0.3333333333333333	26	8458	5	8	21	8450	8484	0.27041877469657033
M1	string	0	network_modules	309	TRUE	2.743939145266622e-7	39	14	5	0.35714285714285715	0.1282051282051282	REAC:R-HSA-186712	REAC	Regulation of beta-cell development	10916	2022		0.4	0.5	39	10877	5	9	34	10868	10916	0.2123553192289553
M1	string	0	network_modules	309	TRUE	2.9036706893405444e-7	93	14	6	0.42857142857142855	0.06451612903225806	REAC:R-HSA-373080	REAC	Class B/2 (Secretin family receptors)	10916	366		0.6	0.6666666666666666	93	10823	6	8	87	10815	10916	0.16378043781119067
M1	string	0	network_modules	309	TRUE	1.0181045070638464e-6	3	16	3	0.1875	1	GO:1990408	GO:BP	calcitonin gene-related peptide receptor signaling pathway	16175	25157		0.1111111111111111	0.2	3	16172	3	13	0	16159	16175	0.4328386264271376
M1	string	0	network_modules	309	TRUE	4.069962792305868e-6	4	16	3	0.1875	0.75	GO:1990410	GO:BP	adrenomedullin receptor signaling pathway	16175	25158		0.2222222222222222	0.4	4	16171	3	13	1	16158	16175	0.3747371121111108
M1	string	0	network_modules	309	TRUE	4.069962792305868e-6	4	16	3	0.1875	0.75	GO:0097647	GO:BP	amylin receptor signaling pathway	16175	18720		0.2222222222222222	0.4	4	16171	3	13	1	16158	16175	0.3747371121111108
M1	string	0	network_modules	309	TRUE	6.647678258738615e-6	156	14	6	0.42857142857142855	0.038461538461538464	REAC:R-HSA-418555	REAC	G alpha (s) signalling events	10916	989		0.8	0.8333333333333334	156	10760	6	8	150	10752	10916	0.12508363436668582
M1	string	0	network_modules	309	TRUE	5.028653281153892e-5	103	16	5	0.3125	0.04854368932038835	GO:0031623	GO:BP	receptor internalization	16175	7240		0.4444444444444444	0.5	103	16072	5	11	98	16061	16175	0.12110230385883153
M1	string	0	network_modules	309	TRUE	5.5593981347246e-5	133	13	5	0.38461538461538464	0.03759398496240601	KEGG:04270	KEGG	Vascular smooth muscle contraction	8484	298		0.5	0.6666666666666666	133	8351	5	8	128	8343	8484	0.11634943632709008
M1	string	0	network_modules	309	TRUE	2.3452455733191793e-4	140	16	5	0.3125	0.03571428571428571	GO:0007189	GO:BP	adenylate cyclase-activating G protein-coupled receptor signaling pathway	16175	2747		0.5555555555555556	0.6	140	16035	5	11	135	16024	16175	0.10321674503051433
M1	string	0	network_modules	309	TRUE	0.0015500165410193961	22	16	3	0.1875	0.13636363636363635	GO:0007263	GO:BP	nitric oxide mediated signal transduction	16175	2791		0.6666666666666666	0.7	22	16153	3	13	19	16140	16175	0.15892730697675234
M1	string	0	network_modules	309	TRUE	0.00206048291895763	217	16	5	0.3125	0.02304147465437788	GO:0007188	GO:BP	adenylate cyclase-modulating G protein-coupled receptor signaling pathway	16175	2746		0.7777777777777778	0.8	217	15958	5	11	212	15947	16175	0.0818034206677378
M1	string	0	network_modules	309	TRUE	0.0022349156341158224	46	13	3	0.23076923076923078	0.06521739130434782	KEGG:04930	KEGG	Type II diabetes mellitus	8484	387		1	1	46	8438	3	10	43	8428	8484	0.12021498334857682
M1	string	0	network_modules	309	TRUE	0.002254271363620597	221	16	5	0.3125	0.02262443438914027	GO:0006898	GO:BP	receptor-mediated endocytosis	16175	2552		0.8888888888888888	0.9	221	15954	5	11	216	15943	16175	0.08100286687297077
M1	string	0	network_modules	309	TRUE	0.0031542440856819048	101	16	4	0.25	0.039603960396039604	GO:0009743	GO:BP	response to carbohydrate	16175	3640		1	1	101	16074	4	12	97	16062	16175	0.09737093097712603
M1	string	0	network_modules	309	TRUE	0.003835297922073842	460	14	6	0.42857142857142855	0.013043478260869565	REAC:R-HSA-500792	REAC	GPCR ligand binding	10916	1019		1	1	460	10456	6	8	454	10448	10916	0.06892634000660738
M1	string	0	network_modules	311	TRUE	0.005522425550008051	12	7	2	0.2857142857142857	0.16666666666666666	REAC:R-HSA-196108	REAC	Pregnenolone biosynthesis	10916	1789		NA	1	12	10904	2	5	10	10899	10916	0.21756763404988302
M1	string	0	network_modules	312	TRUE	0.004933750718707183	6	12	2	0.16666666666666666	0.3333333333333333	REAC:R-HSA-9014826	REAC	Interleukin-36 pathway	10916	1249		NA	1	6	10910	2	10	4	10900	10916	0.23511879436218117
M1	string	0	network_modules	314	TRUE	0.001303629039930299	51	8	3	0.375	0.058823529411764705	REAC:R-HSA-194441	REAC	Metabolism of non-coding RNA	10916	1431		0	1	51	10865	3	5	48	10860	10916	0.14706946211759686
M1	string	0	network_modules	314	TRUE	0.001303629039930299	51	8	3	0.375	0.058823529411764705	REAC:R-HSA-191859	REAC	snRNP Assembly	10916	2736		0	1	51	10865	3	5	48	10860	10916	0.14706946211759686
M1	string	0	network_modules	314	TRUE	0.001303629039930299	51	8	3	0.375	0.058823529411764705	REAC:R-HSA-9754678	REAC	SARS-CoV-2 modulates host translation machinery	10916	2125		0	1	51	10865	3	5	48	10860	10916	0.14706946211759686
M1	string	0	network_modules	314	TRUE	0.005937783571117076	39	14	3	0.21428571428571427	0.07692307692307693	GO:0000387	GO:BP	spliceosomal snRNP assembly	16175	114		NA	1	39	16136	3	11	36	16125	16175	0.12715188792566942
M1	string	0	network_modules	315	TRUE	9.087007129108811e-6	54	8	4	0.5	0.07407407407407407	REAC:R-HSA-5620924	REAC	Intraflagellar transport	10916	1267		0	0.3333333333333333	54	10862	4	4	50	10858	10916	0.1910891330431836
M1	string	0	network_modules	315	TRUE	3.6813963209937937e-4	14	16	3	0.1875	0.21428571428571427	GO:0035721	GO:BP	intraciliary retrograde transport	16175	9191		NA	1	14	16161	3	13	11	16148	16175	0.1997058364840359
M1	string	0	network_modules	315	TRUE	0.0017801143316247083	200	8	4	0.5	0.02	REAC:R-HSA-5617833	REAC	Cilium Assembly	10916	361		0.5	0.6666666666666666	200	10716	4	4	196	10712	10916	0.09726613531026826
M1	string	0	network_modules	315	TRUE	0.007945158045721153	292	8	4	0.5	0.0136986301369863	REAC:R-HSA-1852241	REAC	Organelle biogenesis and maintenance	10916	1646		1	1	292	10624	4	4	288	10620	10916	0.0794312457785953
M1	string	0	network_modules	317	TRUE	1.5818128398420324e-5	59	3	3	1	0.05084745762711865	KEGG:04730	KEGG	Long-term depression	8484	359		0	0.1	59	8425	3	0	56	8425	8484	0.2247481081615847
M1	string	0	network_modules	317	TRUE	2.5493710028202487e-5	69	3	3	1	0.043478260869565216	KEGG:04924	KEGG	Renin secretion	8484	381		0.1111111111111111	0.2	69	8415	3	0	66	8415	8484	0.20770148926981566
M1	string	0	network_modules	317	TRUE	2.6127815099934484e-5	21	6	3	0.5	0.14285714285714285	REAC:R-HSA-392154	REAC	Nitric oxide stimulates guanylate cyclase	10916	1601		0	0.3333333333333333	21	10895	3	3	18	10892	10916	0.2665626628941163
M1	string	0	network_modules	317	TRUE	5.339500255095685e-5	88	3	3	1	0.03409090909090909	KEGG:04540	KEGG	Gap junction	8484	318		0.2222222222222222	0.3	88	8396	3	0	85	8396	8484	0.1837096520619767
M1	string	0	network_modules	317	TRUE	5.911179453327065e-5	91	3	3	1	0.03296703296703297	KEGG:04970	KEGG	Salivary secretion	8484	401		0.3333333333333333	0.4	91	8393	3	0	88	8393	8484	0.18062381511321282
M1	string	0	network_modules	317	TRUE	7.174089793789693e-5	97	3	3	1	0.030927835051546393	KEGG:04713	KEGG	Circadian entrainment	8484	348		0.4444444444444444	0.5	97	8387	3	0	94	8387	8484	0.17488580085664768
M1	string	0	network_modules	317	TRUE	1.5089917411891196e-4	124	3	3	1	0.024193548387096774	KEGG:04611	KEGG	Platelet activation	8484	321		0.5555555555555556	0.6	124	8360	3	0	121	8360	8484	0.15442918942025863
M1	string	0	network_modules	317	TRUE	1.583807805126524e-4	126	3	3	1	0.023809523809523808	KEGG:00230	KEGG	Purine metabolism	8484	22		0.6666666666666666	0.7	126	8358	3	0	123	8358	8484	0.1531803320459018
M1	string	0	network_modules	317	TRUE	1.8650784471638281e-4	133	3	3	1	0.022556390977443608	KEGG:04270	KEGG	Vascular smooth muscle contraction	8484	298		0.7777777777777778	0.8	133	8351	3	0	130	8351	8484	0.14903233884157802
M1	string	0	network_modules	317	TRUE	2.4133946622674216e-4	43	6	3	0.5	0.06976744186046512	REAC:R-HSA-445355	REAC	Smooth Muscle Contraction	10916	2336		0.5	0.6666666666666666	43	10873	3	3	40	10870	10916	0.1857174829762424
M1	string	0	network_modules	317	TRUE	2.9043969711558957e-4	154	3	3	1	0.01948051948051948	KEGG:04921	KEGG	Oxytocin signaling pathway	8484	378		0.8888888888888888	0.9	154	8330	3	0	151	8330	8484	0.13832454044704606
M1	string	0	network_modules	317	TRUE	3.511936886818243e-4	164	3	3	1	0.018292682926829267	KEGG:04022	KEGG	cGMP-PKG signaling pathway	8484	251		1	1	164	8320	3	0	161	8320	8484	0.13396052314226534
M1	string	0	network_modules	317	TRUE	8.721032248619976e-4	21	14	3	0.21428571428571427	0.14285714285714285	GO:0019934	GO:BP	cGMP-mediated signaling	16175	6071		0	0.3333333333333333	21	16154	3	11	18	16143	16175	0.17409185260561777
M1	string	0	network_modules	317	TRUE	0.0010092884492147647	22	14	3	0.21428571428571427	0.13636363636363635	GO:0007263	GO:BP	nitric oxide mediated signal transduction	16175	2791		0.5	0.6666666666666666	22	16153	3	11	19	16142	16175	0.17004509759073805
M1	string	0	network_modules	317	TRUE	0.0019148216972107392	85	6	3	0.5	0.03529411764705882	REAC:R-HSA-418346	REAC	Platelet homeostasis	10916	1765		1	1	85	10831	3	3	82	10828	10916	0.13132165570810064
M1	string	0	network_modules	317	TRUE	0.005346093569584706	4	14	2	0.14285714285714285	0.5	GO:0038060	GO:BP	nitric oxide-cGMP-mediated signaling	16175	9679		1	1	4	16171	2	12	2	16159	16175	0.26694714088648164
M1	string	0	network_modules	318	TRUE	1.3940540550280677e-12	15	15	6	0.4	0.4	GO:1904507	GO:BP	positive regulation of telomere maintenance in response to DNA damage	16175	23869		0	0.04	15	16160	6	9	9	16151	16175	0.39944306930693063
M1	string	0	network_modules	318	TRUE	3.4438256249176073e-12	17	15	6	0.4	0.35294117647058826	GO:0060382	GO:BP	regulation of DNA strand elongation	16175	14590		0.041666666666666664	0.08	17	16158	6	9	11	16149	16175	0.3751183883387467
M1	string	0	network_modules	318	TRUE	5.163272647952256e-12	18	15	6	0.4	0.3333333333333333	GO:1904505	GO:BP	regulation of telomere maintenance in response to DNA damage	16175	23867		0.08333333333333333	0.12	18	16157	6	9	12	16148	16175	0.36450433272993765
M1	string	0	network_modules	318	TRUE	2.724340958477333e-11	38	9	6	0.6666666666666666	0.15789473684210525	REAC:R-HSA-5696394	REAC	DNA Damage Recognition in GG-NER	10916	439		0	0.16666666666666666	38	10878	6	3	32	10875	10916	0.3234453014215203
M1	string	0	network_modules	318	TRUE	1.3142678978737728e-10	29	15	6	0.4	0.20689655172413793	GO:0043247	GO:BP	telomere maintenance in response to DNA damage	16175	10583		0.125	0.16	29	16146	6	9	23	16137	16175	0.2867786245447548
M1	string	0	network_modules	318	TRUE	6.407589005138244e-10	37	15	6	0.4	0.16216216216216217	GO:0022616	GO:BP	DNA strand elongation	16175	6623		0.16666666666666666	0.2	37	16138	6	9	31	16129	16175	0.253637103586867
M1	string	0	network_modules	318	TRUE	3.96787063404773e-9	84	9	6	0.6666666666666666	0.07142857142857142	REAC:R-HSA-5696399	REAC	Global Genome Nucleotide Excision Repair (GG-NER)	10916	1047		0.2	0.3333333333333333	84	10832	6	3	78	10829	10916	0.21662312420814941
M1	string	0	network_modules	318	TRUE	8.778815782768034e-9	116	8	6	0.75	0.05172413793103448	KEGG:03082	KEGG	ATP-dependent chromatin remodeling	8484	219		NA	1	116	8368	6	2	110	8366	8484	0.19479652045650928
M1	string	0	network_modules	318	TRUE	1.3088320956049935e-8	102	9	6	0.6666666666666666	0.058823529411764705	REAC:R-HSA-5689603	REAC	UCH proteinases	10916	2615		0.4	0.5	102	10814	6	3	96	10811	10916	0.1962535000648632
M1	string	0	network_modules	318	TRUE	1.9650333720425044e-8	109	9	6	0.6666666666666666	0.05504587155963303	REAC:R-HSA-5696398	REAC	Nucleotide Excision Repair	10916	1622		0.6	0.6666666666666666	109	10807	6	3	103	10804	10916	0.18972342911755347
M1	string	0	network_modules	318	TRUE	3.253897613238464e-8	69	15	6	0.4	0.08695652173913043	GO:0045995	GO:BP	regulation of embryonic development	16175	11787		0.20833333333333334	0.28	69	16106	6	9	63	16097	16175	0.18499261255785754
M1	string	0	network_modules	318	TRUE	3.253897613238464e-8	69	15	6	0.4	0.08695652173913043	GO:0032206	GO:BP	positive regulation of telomere maintenance	16175	7398		0.20833333333333334	0.28	69	16106	6	9	63	16097	16175	0.18499261255785754
M1	string	0	network_modules	318	TRUE	2.8177758541555627e-7	98	15	6	0.4	0.061224489795918366	GO:2001252	GO:BP	positive regulation of chromosome organization	16175	26441		0.2916666666666667	0.32	98	16077	6	9	92	16068	16175	0.1546625529825527
M1	string	0	network_modules	318	TRUE	4.050247625640779e-7	104	15	6	0.4	0.057692307692307696	GO:0032204	GO:BP	regulation of telomere maintenance	16175	7396		0.3333333333333333	0.36	104	16071	6	9	98	16062	16175	0.15002148684824085
M1	string	0	network_modules	318	TRUE	6.361455788615713e-7	112	15	6	0.4	0.05357142857142857	GO:0006275	GO:BP	regulation of DNA replication	16175	2090		0.375	0.4	112	16063	6	9	106	16054	16175	0.14441860108489768
M1	string	0	network_modules	318	TRUE	8.973088096894253e-7	231	15	7	0.4666666666666667	0.030303030303030304	GO:0006260	GO:BP	DNA replication	16175	2077		0.4166666666666667	0.44	231	15944	7	8	224	15936	16175	0.11616442787934401
M1	string	0	network_modules	318	TRUE	1.3646941995156064e-6	127	15	6	0.4	0.047244094488188976	GO:0045739	GO:BP	positive regulation of DNA repair	16175	11579		0.4583333333333333	0.48	127	16048	6	9	121	16039	16175	0.13536529822153334
M1	string	0	network_modules	318	TRUE	4.043241531427198e-6	152	15	6	0.4	0.039473684210526314	GO:0000723	GO:BP	telomere maintenance	16175	202		0.5	0.52	152	16023	6	9	146	16014	16175	0.12334196486715382
M1	string	0	network_modules	318	TRUE	8.575686108881606e-6	298	9	6	0.6666666666666666	0.020134228187919462	REAC:R-HSA-5688426	REAC	Deubiquitination	10916	736		0.8	0.8333333333333334	298	10618	6	3	292	10615	10916	0.11270755960905081
M1	string	0	network_modules	318	TRUE	1.1941516740281954e-5	182	15	6	0.4	0.03296703296703297	GO:0032200	GO:BP	telomere organization	16175	7392		0.5416666666666666	0.56	182	15993	6	9	176	15984	16175	0.11228889852319954
M1	string	0	network_modules	318	TRUE	1.5487537983215965e-5	329	9	6	0.6666666666666666	0.0182370820668693	REAC:R-HSA-73894	REAC	DNA Repair	10916	444		1	1	329	10587	6	3	323	10584	10916	0.10694607182536472
M1	string	0	network_modules	318	TRUE	2.5800918683880756e-5	207	15	6	0.4	0.028985507246376812	GO:0006282	GO:BP	regulation of DNA repair	16175	2096		0.5833333333333334	0.6	207	15968	6	9	201	15959	16175	0.10495350054453274
M1	string	0	network_modules	318	TRUE	4.713016294125864e-5	229	15	6	0.4	0.026200873362445413	GO:0033044	GO:BP	regulation of chromosome organization	16175	7999		0.625	0.64	229	15946	6	9	223	15937	16175	0.09950284832347482
M1	string	0	network_modules	318	TRUE	7.216623019461361e-5	246	15	6	0.4	0.024390243902439025	GO:0051054	GO:BP	positive regulation of DNA metabolic process	16175	13464		0.6666666666666666	0.68	246	15929	6	9	240	15920	16175	0.09579276864359312
M1	string	0	network_modules	318	TRUE	0.0016855241346687658	420	15	6	0.4	0.014285714285714285	GO:0010638	GO:BP	positive regulation of organelle organization	16175	4284		0.7083333333333334	0.72	420	15755	6	9	414	15746	16175	0.07165499615041811
M1	string	0	network_modules	318	TRUE	0.0020679833948914123	435	15	6	0.4	0.013793103448275862	GO:0051052	GO:BP	regulation of DNA metabolic process	16175	13462		0.75	0.76	435	15740	6	9	429	15731	16175	0.07026761825931654
M1	string	0	network_modules	318	TRUE	0.0021239622556240988	437	15	6	0.4	0.013729977116704805	GO:0080135	GO:BP	regulation of cellular response to stress	16175	17817		0.7916666666666666	0.8	437	15738	6	9	431	15729	16175	0.07008785803529746
M1	string	0	network_modules	318	TRUE	0.002651940436446021	454	15	6	0.4	0.013215859030837005	GO:0006338	GO:BP	chromatin remodeling	16175	2126		0.8333333333333334	0.84	454	15721	6	9	448	15712	16175	0.06860642172546316
M1	string	0	network_modules	318	TRUE	0.005323652895293898	512	15	6	0.4	0.01171875	GO:0009790	GO:BP	embryo development	16175	3677		0.875	0.88	512	15663	6	9	506	15654	16175	0.06409925703935995
M1	string	0	network_modules	318	TRUE	0.006359011282909778	528	15	6	0.4	0.011363636363636364	GO:0006281	GO:BP	DNA repair	16175	2095		0.9166666666666666	0.92	528	15647	6	9	522	15638	16175	0.06298325425067224
M1	string	0	network_modules	318	TRUE	0.006428823256184988	529	15	6	0.4	0.011342155009451797	GO:0006325	GO:BP	chromatin organization	16175	2122		0.9583333333333334	0.96	529	15646	6	9	523	15637	16175	0.06291511644041183
M1	string	0	network_modules	318	TRUE	0.007633886996908569	545	15	6	0.4	0.011009174311926606	GO:0051276	GO:BP	chromosome organization	16175	13613		1	1	545	15630	6	9	539	15621	16175	0.061849410672575836
M1	string	0	network_modules	320	TRUE	0.0012854533846714546	79	7	3	0.42857142857142855	0.0379746835443038	KEGG:03018	KEGG	RNA degradation	8484	211		NA	1	79	8405	3	4	76	8401	8484	0.12543807744566282
M1	string	0	network_modules	320	TRUE	0.0026743696454616496	3	14	2	0.14285714285714285	0.6666666666666666	GO:0060212	GO:BP	negative regulation of nuclear-transcribed mRNA poly(A) tail shortening	16175	14436		0	0.3333333333333333	3	16172	2	12	1	16160	16175	0.30836810188211866
M1	string	0	network_modules	320	TRUE	0.005346093569584706	4	14	2	0.14285714285714285	0.5	GO:0071076	GO:BP	RNA 3' uridylation	16175	16452		0.5	0.6666666666666666	4	16171	2	12	2	16159	16175	0.26694714088648164
M1	string	0	network_modules	320	TRUE	0.008905748663263038	5	14	2	0.14285714285714285	0.4	GO:1905870	GO:BP	positive regulation of 3'-UTR-mediated mRNA stabilization	16175	24978		1	1	5	16170	2	12	3	16158	16175	0.2386686524028136
M1	string	0	network_modules	322	TRUE	7.251724331179435e-4	18	15	3	0.2	0.16666666666666666	GO:0018022	GO:BP	peptidyl-lysine methylation	16175	5308		NA	1	18	16157	3	12	15	16145	16175	0.18174371332799277
M1	string	0	network_modules	324	TRUE	4.9308304033604393e-5	12	11	3	0.2727272727272727	0.25	REAC:R-HSA-8851680	REAC	Butyrophilin (BTN) family interactions	10916	260		0	0.3333333333333333	12	10904	3	8	9	10896	10916	0.2603382471740858
M1	string	0	network_modules	324	TRUE	7.502508893395722e-5	9	15	3	0.2	0.3333333333333333	GO:0019371	GO:BP	cyclooxygenase pathway	16175	5732		0	0.16666666666666666	9	16166	3	12	6	16154	16175	0.25767172946612876
M1	string	0	network_modules	324	TRUE	1.0181036454722539e-4	15	11	3	0.2727272727272727	0.2	REAC:R-HSA-2162123	REAC	Synthesis of Prostaglandins (PG) and Thromboxanes (TX)	10916	2398		0.5	0.6666666666666666	15	10901	3	8	12	10893	10916	0.232650018567167
M1	string	0	network_modules	324	TRUE	5.887836934159471e-4	61	7	3	0.42857142857142855	0.04918032786885246	KEGG:00590	KEGG	Arachidonic acid metabolism	8484	92		NA	1	61	8423	3	4	58	8419	8484	0.143319622875788
M1	string	0	network_modules	324	TRUE	0.001569497534929302	23	15	3	0.2	0.13043478260869565	GO:0001516	GO:BP	prostaglandin biosynthetic process	16175	326		0.2	0.5	23	16152	3	12	20	16140	16175	0.16055484548270105
M1	string	0	network_modules	324	TRUE	0.001569497534929302	23	15	3	0.2	0.13043478260869565	GO:0046457	GO:BP	prostanoid biosynthetic process	16175	12165		0.2	0.5	23	16152	3	12	20	16140	16175	0.16055484548270105
M1	string	0	network_modules	324	TRUE	0.005761687582763063	35	15	3	0.2	0.08571428571428572	GO:0006636	GO:BP	unsaturated fatty acid biosynthetic process	16175	2347		0.6	0.6666666666666666	35	16140	3	12	32	16128	16175	0.12971468407795753
M1	string	0	network_modules	324	TRUE	0.007100064629985672	59	11	3	0.2727272727272727	0.05084745762711865	REAC:R-HSA-2142753	REAC	Arachidonate metabolism	10916	165		1	1	59	10857	3	8	56	10849	10916	0.11579809117342912
M1	string	0	network_modules	324	TRUE	0.007413973931031235	38	15	3	0.2	0.07894736842105263	GO:0006693	GO:BP	prostaglandin metabolic process	16175	2401		0.8	0.8333333333333334	38	16137	3	12	35	16125	16175	0.1243839630022159
M1	string	0	network_modules	324	TRUE	0.0080273333449819	39	15	3	0.2	0.07692307692307693	GO:0006692	GO:BP	prostanoid metabolic process	16175	2400		1	1	39	16136	3	12	36	16124	16175	0.12274434022930093
M1	string	0	network_modules	325	TRUE	3.6686092016169044e-9	9	8	4	0.5	0.4444444444444444	REAC:R-HSA-428542	REAC	Regulation of commissural axon pathfinding by SLIT and ROBO	10916	2024		0	0.2	9	10907	4	4	5	10903	10916	0.47099394664022515
M1	string	0	network_modules	325	TRUE	2.8996943720746975e-8	181	7	6	0.8571428571428571	0.03314917127071823	KEGG:04360	KEGG	Axon guidance	8484	305		NA	1	181	8303	6	1	175	8302	8484	0.1662182124166981
M1	string	0	network_modules	325	TRUE	2.544794736031625e-7	4	8	3	0.375	0.75	REAC:R-HSA-8985801	REAC	Regulation of cortical dendrite branching	10916	2025		0.25	0.4	4	10912	3	5	1	10907	10916	0.5301032502751852
M1	string	0	network_modules	325	TRUE	1.820418162452763e-5	36	13	4	0.3076923076923077	0.1111111111111111	GO:0050919	GO:BP	negative chemotaxis	16175	13361		0	0.037037037037037035	36	16139	4	9	32	16130	16175	0.1838411196575415
M1	string	0	network_modules	325	TRUE	3.896077319290361e-5	217	8	5	0.625	0.02304147465437788	REAC:R-HSA-376176	REAC	Signaling by ROBO receptors	10916	2301		0.5	0.6	217	10699	5	3	212	10696	10916	0.11740231619854849
M1	string	0	network_modules	325	TRUE	7.014698084716427e-5	297	13	6	0.46153846153846156	0.020202020202020204	GO:0007409	GO:BP	axonogenesis	16175	2905		0.038461538461538464	0.07407407407407407	297	15878	6	7	291	15871	16175	0.09362014308853268
M1	string	0	network_modules	325	TRUE	1.5365584295553019e-4	339	13	6	0.46153846153846156	0.017699115044247787	GO:0061564	GO:BP	axon development	16175	15561		0.07692307692307693	0.1111111111111111	339	15836	6	7	333	15829	16175	0.0872309871271748
M1	string	0	network_modules	325	TRUE	1.5654649179478426e-4	165	13	5	0.38461538461538464	0.030303030303030304	GO:0097485	GO:BP	neuron projection guidance	16175	18673		0.11538461538461539	0.18518518518518517	165	16010	5	8	160	16002	16175	0.10567770812931777
M1	string	0	network_modules	325	TRUE	1.5654649179478426e-4	165	13	5	0.38461538461538464	0.030303030303030304	GO:0007411	GO:BP	axon guidance	16175	2906		0.11538461538461539	0.18518518518518517	165	16010	5	8	160	16002	16175	0.10567770812931777
M1	string	0	network_modules	325	TRUE	2.969484547064517e-4	379	13	6	0.46153846153846156	0.0158311345646438	GO:0048667	GO:BP	cell morphogenesis involved in neuron differentiation	16175	12925		0.19230769230769232	0.2222222222222222	379	15796	6	7	373	15789	16175	0.08214018516053403
M1	string	0	network_modules	325	TRUE	7.239898769575514e-4	441	13	6	0.46153846153846156	0.013605442176870748	GO:0048812	GO:BP	neuron projection morphogenesis	16175	13058		0.23076923076923078	0.25925925925925924	441	15734	6	7	435	15727	16175	0.07562990246849649
M1	string	0	network_modules	325	TRUE	7.453716719393749e-4	2	13	2	0.15384615384615385	1	GO:0050925	GO:BP	negative regulation of negative chemotaxis	16175	13367		0.2692307692307692	0.2962962962962963	2	16173	2	11	0	16162	16175	0.3920988599983004
M1	string	0	network_modules	325	TRUE	8.808699441797112e-4	456	13	6	0.46153846153846156	0.013157894736842105	GO:0120039	GO:BP	plasma membrane bounded cell projection morphogenesis	16175	19473		0.3076923076923077	0.3333333333333333	456	15719	6	7	450	15712	16175	0.07425216783530497
M1	string	0	network_modules	325	TRUE	9.271211518559972e-4	460	13	6	0.46153846153846156	0.013043478260869565	GO:0048858	GO:BP	cell projection morphogenesis	16175	13102		0.34615384615384615	0.37037037037037035	460	15715	6	7	454	15708	16175	0.07389584177175036
M1	string	0	network_modules	325	TRUE	0.0011541231779150886	49	8	3	0.375	0.061224489795918366	REAC:R-HSA-373752	REAC	Netrin-1 signaling	10916	1586		0.75	0.8	49	10867	3	5	46	10862	10916	0.1501012797687379
M1	string	0	network_modules	325	TRUE	0.0018302247745444942	29	13	3	0.23076923076923078	0.10344827586206896	GO:0060412	GO:BP	ventricular septum morphogenesis	16175	14613		0.38461538461538464	0.4074074074074074	29	16146	3	10	26	16136	16175	0.1535067763082632
M1	string	0	network_modules	325	TRUE	0.0022351010928117155	3	13	2	0.15384615384615385	0.6666666666666666	GO:0061364	GO:BP	apoptotic process involved in luteolysis	16175	15436		0.4230769230769231	0.5185185185185185	3	16172	2	11	1	16161	16175	0.32002851642455643
M1	string	0	network_modules	325	TRUE	0.0022351010928117155	3	13	2	0.15384615384615385	0.6666666666666666	GO:0050923	GO:BP	regulation of negative chemotaxis	16175	13365		0.4230769230769231	0.5185185185185185	3	16172	2	11	1	16161	16175	0.32002851642455643
M1	string	0	network_modules	325	TRUE	0.0022351010928117155	3	13	2	0.15384615384615385	0.6666666666666666	GO:0001554	GO:BP	luteolysis	16175	345		0.4230769230769231	0.5185185185185185	3	16172	2	11	1	16161	16175	0.32002851642455643
M1	string	0	network_modules	325	TRUE	0.0027277465238705304	33	13	3	0.23076923076923078	0.09090909090909091	GO:0008038	GO:BP	neuron recognition	16175	3100		0.5384615384615384	0.5555555555555556	33	16142	3	10	30	16132	16175	0.1437653050225394
M1	string	0	network_modules	325	TRUE	0.003234279216188246	8	8	2	0.25	0.25	REAC:R-HSA-428543	REAC	Inactivation of CDC42 and RAC1	10916	1177		1	1	8	10908	2	6	6	10902	10916	0.24944994499449946
M1	string	0	network_modules	325	TRUE	0.004207831499233815	38	13	3	0.23076923076923078	0.07894736842105263	GO:0003180	GO:BP	aortic valve morphogenesis	16175	1610		0.5769230769230769	0.5925925925925926	38	16137	3	10	35	16127	16175	0.1338132761058742
M1	string	0	network_modules	325	TRUE	0.004468175280053667	4	13	2	0.15384615384615385	0.5	GO:0021891	GO:BP	olfactory bulb interneuron development	16175	6455		0.6153846153846154	0.6666666666666666	4	16171	2	11	2	16160	16175	0.27704988141747466
M1	string	0	network_modules	325	TRUE	0.004468175280053667	4	13	2	0.15384615384615385	0.5	GO:0016199	GO:BP	axon midline choice point recognition	16175	5171		0.6153846153846154	0.6666666666666666	4	16171	2	11	2	16160	16175	0.27704988141747466
M1	string	0	network_modules	325	TRUE	0.004923518067838783	40	13	3	0.23076923076923078	0.075	GO:0003281	GO:BP	ventricular septum development	16175	1704		0.6923076923076923	0.7037037037037037	40	16135	3	10	37	16125	16175	0.13036252571258025
M1	string	0	network_modules	325	TRUE	0.00614135424712791	43	13	3	0.23076923076923078	0.06976744186046512	GO:0003176	GO:BP	aortic valve development	16175	1606		0.7307692307692307	0.7407407407407407	43	16132	3	10	40	16122	16175	0.12564231831947745
M1	string	0	network_modules	325	TRUE	0.006993151853079442	651	13	6	0.46153846153846156	0.009216589861751152	GO:0000902	GO:BP	cell morphogenesis	16175	240		0.7692307692307693	0.7777777777777778	651	15524	6	7	645	15517	16175	0.06079368317772354
M1	string	0	network_modules	325	TRUE	0.007443582190847047	5	13	2	0.15384615384615385	0.4	GO:0035385	GO:BP	Roundabout signaling pathway	16175	9014		0.8076923076923077	0.8888888888888888	5	16170	2	11	3	16159	16175	0.24770886606428522
M1	string	0	network_modules	325	TRUE	0.007443582190847047	5	13	2	0.15384615384615385	0.4	GO:0016198	GO:BP	axon choice point recognition	16175	5170		0.8076923076923077	0.8888888888888888	5	16170	2	11	3	16159	16175	0.24770886606428522
M1	string	0	network_modules	325	TRUE	0.007443582190847047	5	13	2	0.15384615384615385	0.4	GO:0051964	GO:BP	negative regulation of synapse assembly	16175	14033		0.8076923076923077	0.8888888888888888	5	16170	2	11	3	16159	16175	0.24770886606428522
M1	string	0	network_modules	325	TRUE	0.00805423515932434	47	13	3	0.23076923076923078	0.06382978723404255	GO:1905314	GO:BP	semi-lunar valve development	16175	24530		0.9230769230769231	0.9259259259259259	47	16128	3	10	44	16118	16175	0.1200615690755136
M1	string	0	network_modules	325	TRUE	0.008587196656471506	48	13	3	0.23076923076923078	0.0625	GO:0060411	GO:BP	cardiac septum morphogenesis	16175	14612		0.9615384615384616	0.9629629629629629	48	16127	3	10	45	16117	16175	0.11877579363882639
M1	string	0	network_modules	325	TRUE	0.009300859291365211	684	13	6	0.46153846153846156	0.008771929824561403	GO:0031175	GO:BP	neuron projection development	16175	7086		1	1	684	15491	6	7	678	15484	16175	0.059084657692235386
M1	string	0	network_modules	326	TRUE	4.2972336315357714e-19	41	16	10	0.625	0.24390243902439024	REAC:R-HSA-9772755	REAC	Formation of WDR5-containing histone-modifying complexes	10916	952		0	0.14285714285714285	41	10875	10	6	31	10869	10916	0.3891042256781574
M1	string	0	network_modules	326	TRUE	4.2972336315357714e-19	41	16	10	0.625	0.24390243902439024	REAC:R-HSA-9917777	REAC	Epigenetic regulation by WDR5-containing histone modifying complexes	10916	850		0	0.14285714285714285	41	10875	10	6	31	10869	10916	0.3891042256781574
M1	string	0	network_modules	326	TRUE	3.1980429914111656e-14	185	16	11	0.6875	0.05945945945945946	REAC:R-HSA-212165	REAC	Epigenetic regulation of gene expression	10916	852		0.15384615384615385	0.21428571428571427	185	10731	11	5	174	10726	10916	0.1990384720367976
M1	string	0	network_modules	326	TRUE	1.6980186754939557e-10	271	16	10	0.625	0.03690036900369004	REAC:R-HSA-3247509	REAC	Chromatin modifying enzymes	10916	355		0.23076923076923078	0.35714285714285715	271	10645	10	6	261	10639	10916	0.14778488207775284
M1	string	0	network_modules	326	TRUE	1.6980186754939557e-10	271	16	10	0.625	0.03690036900369004	REAC:R-HSA-4839726	REAC	Chromatin organization	10916	356		0.23076923076923078	0.35714285714285715	271	10645	10	6	261	10639	10916	0.14778488207775284
M1	string	0	network_modules	326	TRUE	2.639264002481529e-9	234	16	9	0.5625	0.038461538461538464	REAC:R-HSA-8878171	REAC	Transcriptional regulation by RUNX1	10916	2552		0.38461538461538464	0.42857142857142855	234	10682	9	7	225	10675	10916	0.14312791760398685
M1	string	0	network_modules	326	TRUE	3.366049678572717e-9	42	17	6	0.35294117647058826	0.14285714285714285	GO:0045815	GO:BP	transcription initiation-coupled chromatin remodeling	16175	11637		0	0.2222222222222222	42	16133	6	11	36	16122	16175	0.22329969772291636
M1	string	0	network_modules	326	TRUE	3.366049678572717e-9	42	17	6	0.35294117647058826	0.14285714285714285	GO:0141137	GO:BP	positive regulation of gene expression, epigenetic	16175	20039		0	0.2222222222222222	42	16133	6	11	36	16122	16175	0.22329969772291636
M1	string	0	network_modules	326	TRUE	1.0393826488800199e-8	95	16	7	0.4375	0.07368421052631578	REAC:R-HSA-8936459	REAC	RUNX1 regulates genes involved in megakaryocyte differentiation and platelet function	10916	1919		0.46153846153846156	0.5	95	10821	7	9	88	10812	10916	0.1768750954226866
M1	string	0	network_modules	326	TRUE	2.6805105855156008e-8	529	17	10	0.5882352941176471	0.01890359168241966	GO:0006325	GO:BP	chromatin organization	16175	2122		0.25	0.3333333333333333	529	15646	10	7	519	15639	16175	0.10131024348010526
M1	string	0	network_modules	326	TRUE	1.363589876906128e-7	70	16	6	0.375	0.08571428571428572	REAC:R-HSA-3214841	REAC	PKMTs methylate histone lysines	10916	1691		0.5384615384615384	0.5714285714285714	70	10846	6	10	64	10836	10916	0.17691592519970673
M1	string	0	network_modules	326	TRUE	2.618736414344601e-7	454	17	9	0.5294117647058824	0.019823788546255508	GO:0006338	GO:BP	chromatin remodeling	16175	2126		0.375	0.4444444444444444	454	15721	9	8	445	15713	16175	0.0984560822544673
M1	string	0	network_modules	326	TRUE	6.45899336021096e-6	143	17	6	0.35294117647058826	0.04195804195804196	GO:0006367	GO:BP	transcription initiation at RNA polymerase II promoter	16175	2142		0.5	0.5555555555555556	143	16032	6	11	137	16021	16175	0.1192334802055483
M1	string	0	network_modules	326	TRUE	2.027061374770767e-5	173	17	6	0.35294117647058826	0.03468208092485549	GO:0006352	GO:BP	DNA-templated transcription initiation	16175	2129		0.625	0.6666666666666666	173	16002	6	11	167	15991	16175	0.10792019253094155
M1	string	0	network_modules	326	TRUE	6.264582775436957e-5	209	17	6	0.35294117647058826	0.028708133971291867	GO:0040029	GO:BP	epigenetic regulation of gene expression	16175	9916		0.75	0.7777777777777778	209	15966	6	11	203	15955	16175	0.09765808592337817
M1	string	0	network_modules	326	TRUE	1.0678818553252491e-4	42	16	4	0.25	0.09523809523809523	REAC:R-HSA-3769402	REAC	Deactivation of the beta-catenin transactivating complex	10916	452		0.6153846153846154	0.6428571428571429	42	10874	4	12	38	10862	10916	0.15233338731847706
M1	string	0	network_modules	326	TRUE	1.8091615767167407e-4	231	16	6	0.375	0.025974025974025976	REAC:R-HSA-201681	REAC	TCF dependent signaling in response to WNT	10916	2421		0.6923076923076923	0.7142857142857143	231	10685	6	10	225	10675	10916	0.09419372709924537
M1	string	0	network_modules	326	TRUE	1.8093235815630203e-4	153	14	5	0.35714285714285715	0.032679738562091505	KEGG:04934	KEGG	Cushing syndrome	8484	391		0	0.5	153	8331	5	9	148	8322	8484	0.10360194096513603
M1	string	0	network_modules	326	TRUE	1.8765276605415212e-4	120	16	5	0.3125	0.041666666666666664	REAC:R-HSA-5617472	REAC	Activation of anterior HOX genes in hindbrain development during early embryogenesis	10916	99		0.7692307692307693	0.8571428571428571	120	10796	5	11	115	10785	10916	0.11078617125365203
M1	string	0	network_modules	326	TRUE	1.8765276605415212e-4	120	16	5	0.3125	0.041666666666666664	REAC:R-HSA-5619507	REAC	Activation of HOX genes during differentiation	10916	84		0.7692307692307693	0.8571428571428571	120	10796	5	11	115	10785	10916	0.11078617125365203
M1	string	0	network_modules	326	TRUE	3.605284575783738e-4	13	17	3	0.17647058823529413	0.23076923076923078	GO:0045064	GO:BP	T-helper 2 cell differentiation	16175	11262		0.875	0.8888888888888888	13	16162	3	14	10	16148	16175	0.20106922580473965
M1	string	0	network_modules	326	TRUE	4.787152842873928e-4	84	14	4	0.2857142857142857	0.047619047619047616	KEGG:03083	KEGG	Polycomb repressive complex	8484	220		1	1	84	8400	4	10	80	8390	8484	0.11325539106817116
M1	string	0	network_modules	326	TRUE	0.0013744923651676949	327	16	6	0.375	0.01834862385321101	REAC:R-HSA-195721	REAC	Signaling by WNT	10916	2314		0.9230769230769231	0.9285714285714286	327	10589	6	10	321	10579	10916	0.07755027882941364
M1	string	0	network_modules	326	TRUE	0.0023367254150905336	90	16	4	0.25	0.044444444444444446	REAC:R-HSA-201722	REAC	Formation of the beta-catenin:TCF transactivating complex	10916	968		1	1	90	10826	4	12	86	10814	10916	0.10243087119182194
M1	string	0	network_modules	326	TRUE	0.004558568921976426	29	17	3	0.17647058823529413	0.10344827586206896	GO:0042092	GO:BP	type 2 immune response	16175	9963		1	1	29	16146	3	14	26	16132	16175	0.133930945548822
M1	string	0	network_modules	327	TRUE	3.173729763574158e-9	14	17	5	0.29411764705882354	0.35714285714285715	REAC:R-HSA-177504	REAC	Retrograde neurotrophin signalling	10916	2095		0	0.03571428571428571	14	10902	5	12	9	10890	10916	0.32314744350057484
M1	string	0	network_modules	327	TRUE	4.7562294756485035e-9	15	17	5	0.29411764705882354	0.3333333333333333	REAC:R-HSA-5099900	REAC	WNT5A-dependent internalization of FZD4	10916	2672		0.037037037037037035	0.07142857142857142	15	10901	5	12	10	10889	10916	0.31210674088411905
M1	string	0	network_modules	327	TRUE	5.529280711228018e-9	144	17	8	0.47058823529411764	0.05555555555555555	REAC:R-HSA-8856828	REAC	Clathrin-mediated endocytosis	10916	372		0.07407407407407407	0.10714285714285714	144	10772	8	9	136	10763	10916	0.15832816030002683
M1	string	0	network_modules	327	TRUE	3.48243719690755e-8	104	17	7	0.4117647058823529	0.0673076923076923	REAC:R-HSA-8856825	REAC	Cargo recognition for clathrin-mediated endocytosis	10916	309		0.1111111111111111	0.14285714285714285	104	10812	7	10	97	10802	10916	0.16353376256598565
M1	string	0	network_modules	327	TRUE	5.288469703080404e-7	53	13	5	0.38461538461538464	0.09433962264150944	KEGG:04961	KEGG	Endocrine and other factor-regulated calcium reabsorption	8484	397		0	0.25	53	8431	5	8	48	8423	8484	0.1881231730647071
M1	string	0	network_modules	327	TRUE	6.590880412031898e-7	12	17	4	0.23529411764705882	0.3333333333333333	REAC:R-HSA-190873	REAC	Gap junction degradation	10916	1034		0.14814814814814814	0.17857142857142858	12	10904	4	13	8	10891	10916	0.2791183509245809
M1	string	0	network_modules	327	TRUE	9.360804010428428e-7	44	17	5	0.29411764705882354	0.11363636363636363	GO:0072583	GO:BP	clathrin-dependent endocytosis	16175	17454		0	0.0625	44	16131	5	12	39	16119	16175	0.18146949739396837
M1	string	0	network_modules	327	TRUE	9.511084474028334e-7	13	17	4	0.23529411764705882	0.3076923076923077	REAC:R-HSA-5140745	REAC	WNT5A-dependent internalization of FZD2, FZD5 and ROR2	10916	2671		0.18518518518518517	0.21428571428571427	13	10903	4	13	9	10890	10916	0.2680756323403227
M1	string	0	network_modules	327	TRUE	2.4140851668670772e-6	16	17	4	0.23529411764705882	0.25	REAC:R-HSA-8866427	REAC	VLDLR internalisation and degradation	10916	2639		0.2222222222222222	0.25	16	10900	4	13	12	10887	10916	0.24138964752167505
M1	string	0	network_modules	327	TRUE	2.9273430677573927e-6	49	17	5	0.29411764705882354	0.10204081632653061	REAC:R-HSA-3928665	REAC	EPH-ephrin mediated repulsion of cells	10916	819		0.25925925925925924	0.2857142857142857	49	10867	5	12	44	10855	10916	0.17111322149391534
M1	string	0	network_modules	327	TRUE	3.8143983828912965e-6	78	13	5	0.38461538461538464	0.0641025641025641	KEGG:04721	KEGG	Synaptic vesicle cycle	8484	351		0.3333333333333333	0.5	78	8406	5	8	73	8398	8484	0.1540927715590337
M1	string	0	network_modules	327	TRUE	5.126512662182518e-6	19	17	4	0.23529411764705882	0.21052631578947367	REAC:R-HSA-8964038	REAC	LDL clearance	10916	1295		0.2962962962962963	0.32142857142857145	19	10897	4	13	15	10884	10916	0.22128443376954463
M1	string	0	network_modules	327	TRUE	6.749082708851119e-6	123	17	6	0.35294117647058826	0.04878048780487805	REAC:R-HSA-2132295	REAC	MHC class II antigen presentation	10916	1371		0.3333333333333333	0.35714285714285715	123	10793	6	11	117	10782	10916	0.12784450785358098
M1	string	0	network_modules	327	TRUE	3.247341556051256e-5	533	17	8	0.47058823529411764	0.0150093808630394	GO:0006897	GO:BP	endocytosis	16175	2551		0.06666666666666667	0.125	533	15642	8	9	525	15633	16175	0.07952036967924564
M1	string	0	network_modules	327	TRUE	3.6463929993694826e-5	7	17	3	0.17647058823529413	0.42857142857142855	REAC:R-HSA-182218	REAC	Nef Mediated CD8 Down-regulation	10916	1561		0.37037037037037035	0.39285714285714285	7	10909	3	14	4	10895	10916	0.27431179754362783
M1	string	0	network_modules	327	TRUE	6.497099574868488e-5	90	17	5	0.29411764705882354	0.05555555555555555	REAC:R-HSA-2682334	REAC	EPH-Ephrin signaling	10916	818		0.4074074074074074	0.42857142857142855	90	10826	5	12	85	10814	10916	0.1248568388438155
M1	string	0	network_modules	327	TRUE	7.082261125472893e-5	8	17	3	0.17647058823529413	0.375	GO:0098884	GO:BP	postsynaptic neurotransmitter receptor internalization	16175	18929		0.13333333333333333	0.25	8	16167	3	14	5	16153	16175	0.25672530110168773
M1	string	0	network_modules	327	TRUE	7.082261125472893e-5	8	17	3	0.17647058823529413	0.375	GO:0140239	GO:BP	postsynaptic endocytosis	16175	19710		0.13333333333333333	0.25	8	16167	3	14	5	16153	16175	0.25672530110168773
M1	string	0	network_modules	327	TRUE	7.256564331930842e-5	92	17	5	0.29411764705882354	0.05434782608695652	REAC:R-HSA-4086400	REAC	PCP/CE pathway	10916	1659		0.4444444444444444	0.4642857142857143	92	10824	5	12	87	10812	10916	0.12342449675813538
M1	string	0	network_modules	327	TRUE	7.274508726603753e-5	103	17	5	0.29411764705882354	0.04854368932038835	GO:0031623	GO:BP	receptor internalization	16175	7240		0.26666666666666666	0.3125	103	16072	5	12	98	16060	16175	0.11733738290249662
M1	string	0	network_modules	327	TRUE	7.66557210772258e-5	36	17	4	0.23529411764705882	0.1111111111111111	REAC:R-HSA-8964043	REAC	Plasma lipoprotein clearance	10916	1757		0.48148148148148145	0.5	36	10880	4	13	32	10867	10916	0.15981216925385214
M1	string	0	network_modules	327	TRUE	8.7301849284332e-5	221	17	6	0.35294117647058826	0.027149321266968326	GO:0006898	GO:BP	receptor-mediated endocytosis	16175	2552		0.3333333333333333	0.375	221	15954	6	11	215	15943	16175	0.09479815074536567
M1	string	0	network_modules	327	TRUE	8.734510314481114e-5	9	17	3	0.17647058823529413	0.3333333333333333	REAC:R-HSA-167590	REAC	Nef Mediated CD4 Down-regulation	10916	1560		0.5185185185185185	0.5357142857142857	9	10907	3	14	6	10893	10916	0.24169033691262573
M1	string	0	network_modules	327	TRUE	1.7124072246267938e-4	11	17	3	0.17647058823529413	0.2727272727272727	REAC:R-HSA-196025	REAC	Formation of annular gap junctions	10916	954		0.5555555555555556	0.5714285714285714	11	10905	3	14	8	10891	10916	0.21840912037724391
M1	string	0	network_modules	327	TRUE	1.943417604004073e-4	112	17	5	0.29411764705882354	0.044642857142857144	REAC:R-HSA-187037	REAC	Signaling by NTRK1 (TRKA)	10916	2284		0.5925925925925926	0.6071428571428571	112	10804	5	12	107	10792	10916	0.11124838190158089
M1	string	0	network_modules	327	TRUE	2.503308965392079e-4	48	17	4	0.23529411764705882	0.08333333333333333	REAC:R-HSA-437239	REAC	Recycling pathway of L1	10916	1954		0.6296296296296297	0.6428571428571429	48	10868	4	13	44	10855	10916	0.13782161503165288
M1	string	0	network_modules	327	TRUE	2.7232232351444676e-4	49	17	4	0.23529411764705882	0.08163265306122448	REAC:R-HSA-190828	REAC	Gap junction trafficking	10916	1035		0.6666666666666666	0.6785714285714286	49	10867	4	13	45	10854	10916	0.1363601761922691
M1	string	0	network_modules	327	TRUE	2.9571995029651455e-4	50	17	4	0.23529411764705882	0.08	REAC:R-HSA-157858	REAC	Gap junction trafficking and regulation	10916	1036		0.7037037037037037	0.7142857142857143	50	10866	4	13	46	10853	10916	0.1349423177395553
M1	string	0	network_modules	327	TRUE	4.0933989729447005e-4	740	17	8	0.47058823529411764	0.010810810810810811	GO:0098657	GO:BP	import into cell	16175	18813		0.4	0.4375	740	15435	8	9	732	15426	16175	0.06595227220116584
M1	string	0	network_modules	327	TRUE	4.236315924188202e-4	131	17	5	0.29411764705882354	0.03816793893129771	REAC:R-HSA-166520	REAC	Signaling by NTRKs	10916	2287		0.7407407407407407	0.75	131	10785	5	12	126	10773	10916	0.10232413068791123
M1	string	0	network_modules	327	TRUE	4.5855646184380256e-4	14	17	3	0.17647058823529413	0.21428571428571427	GO:0099590	GO:BP	neurotransmitter receptor internalization	16175	19154		0.4666666666666667	0.5	14	16161	3	14	11	16147	16175	0.19369295667569836
M1	string	0	network_modules	327	TRUE	6.536499881146891e-4	143	17	5	0.29411764705882354	0.03496503496503497	REAC:R-HSA-3858494	REAC	Beta-catenin independent WNT signaling	10916	216		0.7777777777777778	0.7857142857142857	143	10773	5	12	138	10761	10916	0.09760944631227146
M1	string	0	network_modules	327	TRUE	0.0011846180470810616	248	13	5	0.38461538461538464	0.020161290322580645	KEGG:04144	KEGG	Endocytosis	8484	280		0.6666666666666666	0.75	248	8236	5	8	243	8228	8484	0.08264540696693702
M1	string	0	network_modules	327	TRUE	0.001208143194746109	74	17	4	0.23529411764705882	0.05405405405405406	GO:0006900	GO:BP	vesicle budding from membrane	16175	2553		0.5333333333333333	0.5625	74	16101	4	13	70	16088	16175	0.11089611149456367
M1	string	0	network_modules	327	TRUE	0.0012228572422141274	71	17	4	0.23529411764705882	0.056338028169014086	REAC:R-HSA-174824	REAC	Plasma lipoprotein assembly, remodeling, and clearance	10916	1756		0.8148148148148148	0.8214285714285714	71	10845	4	13	67	10832	10916	0.11240550064505722
M1	string	0	network_modules	327	TRUE	0.0012935529896569587	72	17	4	0.23529411764705882	0.05555555555555555	REAC:R-HSA-199992	REAC	trans-Golgi Network Vesicle Budding	10916	2749		0.8518518518518519	0.8571428571428571	72	10844	4	13	68	10831	10916	0.11158262796339741
M1	string	0	network_modules	327	TRUE	0.0013670792231844386	21	17	3	0.17647058823529413	0.14285714285714285	REAC:R-HSA-164938	REAC	Nef-mediates down modulation of cell surface receptors by recruiting them to clathrin adapters	10916	1565		0.8888888888888888	0.8928571428571429	21	10895	3	14	18	10881	10916	0.15731977059770746
M1	string	0	network_modules	327	TRUE	0.0021537328425371457	327	17	6	0.35294117647058826	0.01834862385321101	REAC:R-HSA-195721	REAC	Signaling by WNT	10916	2314		0.9259259259259259	0.9285714285714286	327	10589	6	11	321	10578	10916	0.0748300204900515
M1	string	0	network_modules	327	TRUE	0.0028768435353760946	25	17	3	0.17647058823529413	0.12	GO:1903077	GO:BP	negative regulation of protein localization to plasma membrane	16175	22752		0.6	0.625	25	16150	3	14	22	16136	16175	0.14443436822943198
M1	string	0	network_modules	327	TRUE	0.002989228395731254	27	17	3	0.17647058823529413	0.1111111111111111	REAC:R-HSA-164952	REAC	The role of Nef in HIV-1 replication and disease pathogenesis	10916	2504		0.9629629629629629	0.9642857142857143	27	10889	3	14	24	10875	10916	0.13834419067177614
M1	string	0	network_modules	327	TRUE	0.003208029768024045	305	13	5	0.38461538461538464	0.01639344262295082	KEGG:05016	KEGG	Huntington disease	8484	414		1	1	305	8179	5	8	300	8171	8484	0.07336919852001018
M1	string	0	network_modules	327	TRUE	0.0036538445614977405	27	17	3	0.17647058823529413	0.1111111111111111	GO:1904376	GO:BP	negative regulation of protein localization to cell periphery	16175	23763		0.6666666666666666	0.6875	27	16148	3	14	24	16134	16175	0.13889239510379298
M1	string	0	network_modules	327	TRUE	0.004101533137935027	3	17	2	0.11764705882352941	0.6666666666666666	GO:1900126	GO:BP	negative regulation of hyaluronan biosynthetic process	16175	20412		0.7333333333333333	0.75	3	16172	2	15	1	16157	16175	0.27978750803920066
M1	string	0	network_modules	327	TRUE	0.006789001328837138	33	17	3	0.17647058823529413	0.09090909090909091	GO:1905476	GO:BP	negative regulation of protein localization to membrane	16175	24662		0.8	0.8125	33	16142	3	14	30	16128	16175	0.12538959230205957
M1	string	0	network_modules	327	TRUE	0.007441166122930399	34	17	3	0.17647058823529413	0.08823529411764706	GO:0099072	GO:BP	regulation of postsynaptic membrane neurotransmitter receptor levels	16175	19029		0.8666666666666667	0.9375	34	16141	3	14	31	16127	16175	0.12349190753907653
M1	string	0	network_modules	327	TRUE	0.007441166122930399	34	17	3	0.17647058823529413	0.08823529411764706	GO:0035459	GO:BP	vesicle cargo loading	16175	9047		0.8666666666666667	0.9375	34	16141	3	14	31	16127	16175	0.12349190753907653
M1	string	0	network_modules	327	TRUE	0.008653804371080926	121	17	4	0.23529411764705882	0.03305785123966942	GO:0099003	GO:BP	vesicle-mediated transport in synapse	16175	18999		1	1	121	16054	4	13	117	16041	16175	0.08575707723801115
M1	string	0	network_modules	327	TRUE	0.009545348842643155	119	17	4	0.23529411764705882	0.03361344537815126	REAC:R-HSA-373760	REAC	L1CAM interactions	10916	1294		1	1	119	10797	4	13	115	10784	10916	0.08534504900290431
M1	string	0	network_modules	328	TRUE	5.764899831720738e-10	12	15	5	0.3333333333333333	0.4166666666666667	REAC:R-HSA-176974	REAC	Unwinding of DNA	10916	2625		0	0.06666666666666667	12	10904	5	10	7	10894	10916	0.37190888673019107
M1	string	0	network_modules	328	TRUE	6.96320806439034e-10	12	17	5	0.29411764705882354	0.4166666666666667	GO:0000727	GO:BP	double-strand break repair via break-induced replication	16175	205		0	0.043478260869565216	12	16163	5	12	7	16151	16175	0.3495003125221997
M1	string	0	network_modules	328	TRUE	1.1308213716437282e-9	13	17	5	0.29411764705882354	0.38461538461538464	GO:0030174	GO:BP	regulation of DNA-templated DNA replication initiation	16175	6696		0.045454545454545456	0.08695652173913043	13	16162	5	12	8	16150	16175	0.335728663010423
M1	string	0	network_modules	328	TRUE	1.16650928200143e-8	187	15	8	0.5333333333333333	0.0427807486631016	REAC:R-HSA-69306	REAC	DNA Replication	10916	445		0.07142857142857142	0.13333333333333333	187	10729	8	7	179	10722	10916	0.14756918472277564
M1	string	0	network_modules	328	TRUE	1.779132739674943e-8	21	17	5	0.29411764705882354	0.23809523809523808	GO:0006268	GO:BP	DNA unwinding involved in DNA replication	16175	2083		0.09090909090909091	0.13043478260869565	21	16154	5	12	16	16142	16175	0.26376977544423463
M1	string	0	network_modules	328	TRUE	4.6991740093484536e-8	36	12	5	0.4166666666666667	0.1388888888888889	KEGG:03030	KEGG	DNA replication	8484	214		0	0.5	36	8448	5	7	31	8441	8484	0.23878848985082615
M1	string	0	network_modules	328	TRUE	9.173107237334748e-8	71	15	6	0.4	0.08450704225352113	REAC:R-HSA-68949	REAC	Orc1 removal from chromatin	10916	1644		0.14285714285714285	0.2	71	10845	6	9	65	10836	10916	0.18158171766495138
M1	string	0	network_modules	328	TRUE	1.0080623948407057e-7	142	15	7	0.4666666666666667	0.04929577464788732	REAC:R-HSA-68867	REAC	Assembly of the pre-replicative complex	10916	181		0.21428571428571427	0.26666666666666666	142	10774	7	8	135	10766	10916	0.14851561952502806
M1	string	0	network_modules	328	TRUE	1.4435494077645238e-7	32	15	5	0.3333333333333333	0.15625	REAC:R-HSA-69190	REAC	DNA strand elongation	10916	449		0.2857142857142857	0.3333333333333333	32	10884	5	10	27	10874	10916	0.226698794148844
M1	string	0	network_modules	328	TRUE	1.7000247011633127e-7	33	15	5	0.3333333333333333	0.15151515151515152	REAC:R-HSA-68962	REAC	Activation of the pre-replicative complex	10916	107		0.35714285714285715	0.4	33	10883	5	10	28	10873	10916	0.22318589796482674
M1	string	0	network_modules	328	TRUE	1.748700763705996e-7	32	17	5	0.29411764705882354	0.15625	GO:0006270	GO:BP	DNA replication initiation	16175	2085		0.13636363636363635	0.17391304347826086	32	16143	5	12	27	16131	16175	0.2132543006184722
M1	string	0	network_modules	328	TRUE	2.2363160264367896e-7	159	15	7	0.4666666666666667	0.0440251572327044	REAC:R-HSA-69002	REAC	DNA Replication Pre-Initiation	10916	446		0.42857142857142855	0.4666666666666667	159	10757	7	8	152	10749	10916	0.13998039149430377
M1	string	0	network_modules	328	TRUE	3.112762500281869e-7	37	15	5	0.3333333333333333	0.13513513513513514	REAC:R-HSA-176187	REAC	Activation of ATR in response to replication stress	10916	75		0.5	0.5333333333333333	37	10879	5	10	32	10869	10916	0.21058169923597986
M1	string	0	network_modules	328	TRUE	3.1574512759664737e-7	167	15	7	0.4666666666666667	0.041916167664670656	REAC:R-HSA-69481	REAC	G2/M Checkpoints	10916	1005		0.5714285714285714	0.6	167	10749	7	8	160	10741	10916	0.13641574764940972
M1	string	0	network_modules	328	TRUE	3.776481909154367e-7	289	15	8	0.5333333333333333	0.02768166089965398	REAC:R-HSA-69620	REAC	Cell Cycle Checkpoints	10916	321		0.6428571428571429	0.6666666666666666	289	10627	8	7	281	10620	10916	0.1171138889296625
M1	string	0	network_modules	328	TRUE	4.4994995835702273e-7	92	15	6	0.4	0.06521739130434782	REAC:R-HSA-69052	REAC	Switching of origins to a post-replicative state	10916	2365		0.7142857142857143	0.7333333333333333	92	10824	6	9	86	10815	10916	0.1588911891789213
M1	string	0	network_modules	328	TRUE	8.302217502571813e-7	43	17	5	0.29411764705882354	0.11627906976744186	GO:0090329	GO:BP	regulation of DNA-templated DNA replication	16175	18209		0.18181818181818182	0.21739130434782608	43	16132	5	12	38	16120	16175	0.18360073577880467
M1	string	0	network_modules	328	TRUE	9.360804010428428e-7	44	17	5	0.29411764705882354	0.11363636363636363	GO:0032508	GO:BP	DNA duplex unwinding	16175	7615		0.22727272727272727	0.2608695652173913	44	16131	5	12	39	16119	16175	0.18146949739396837
M1	string	0	network_modules	328	TRUE	1.8102297167196575e-6	157	12	6	0.5	0.03821656050955414	KEGG:04110	KEGG	Cell cycle	8484	264		1	1	157	8327	6	6	151	8321	8484	0.13446077243413226
M1	string	0	network_modules	328	TRUE	2.2290878800288364e-6	52	17	5	0.29411764705882354	0.09615384615384616	GO:0032392	GO:BP	DNA geometric change	16175	7543		0.2727272727272727	0.30434782608695654	52	16123	5	12	47	16111	16175	0.16668566987244238
M1	string	0	network_modules	328	TRUE	2.37559770789502e-6	121	15	6	0.4	0.049586776859504134	REAC:R-HSA-69239	REAC	Synthesis of DNA	10916	2376		0.7857142857142857	0.8	121	10795	6	9	115	10786	10916	0.13779297181797837
M1	string	0	network_modules	328	TRUE	3.6624728596913716e-6	130	15	6	0.4	0.046153846153846156	REAC:R-HSA-69206	REAC	G1/S Transition	10916	1002		0.8571428571428571	0.8666666666666667	130	10786	6	9	124	10777	10916	0.1327111874032258
M1	string	0	network_modules	328	TRUE	4.6610884902433455e-6	60	17	5	0.29411764705882354	0.08333333333333333	GO:0071103	GO:BP	DNA conformation change	16175	16453		0.3181818181818182	0.34782608695652173	60	16115	5	12	55	16103	16175	0.15495053187531554
M1	string	0	network_modules	328	TRUE	7.668396568532868e-6	147	15	6	0.4	0.04081632653061224	REAC:R-HSA-453279	REAC	Mitotic G1 phase and G1/S transition	10916	1480		0.9285714285714286	0.9333333333333333	147	10769	6	9	141	10760	10916	0.12439897512697186
M1	string	0	network_modules	328	TRUE	1.3722760067905763e-5	162	15	6	0.4	0.037037037037037035	REAC:R-HSA-69242	REAC	S Phase	10916	2111		1	1	162	10754	6	9	156	10745	10916	0.11816094722092753
M1	string	0	network_modules	328	TRUE	1.1085798390766088e-4	112	17	5	0.29411764705882354	0.044642857142857144	GO:0006275	GO:BP	regulation of DNA replication	16175	2090		0.36363636363636365	0.391304347826087	112	16063	5	12	107	16051	16175	0.11233808954552592
M1	string	0	network_modules	328	TRUE	3.605284575783738e-4	13	17	3	0.17647058823529413	0.23076923076923078	GO:1902969	GO:BP	mitotic DNA replication	16175	22654		0.4090909090909091	0.43478260869565216	13	16162	3	14	10	16148	16175	0.20106922580473965
M1	string	0	network_modules	328	TRUE	4.3179284369847243e-4	147	17	5	0.29411764705882354	0.034013605442176874	GO:0006261	GO:BP	DNA-templated DNA replication	16175	2078		0.45454545454545453	0.4782608695652174	147	16028	5	12	142	16016	16175	0.09742412147076195
M1	string	0	network_modules	328	TRUE	5.72823393491153e-4	15	17	3	0.17647058823529413	0.2	GO:0006271	GO:BP	DNA strand elongation involved in DNA replication	16175	2086		0.5	0.5217391304347826	15	16160	3	14	12	16146	16175	0.1870650819268692
M1	string	0	network_modules	328	TRUE	7.308501335428657e-4	528	17	7	0.4117647058823529	0.013257575757575758	GO:0006281	GO:BP	DNA repair	16175	2095		0.5454545454545454	0.5652173913043478	528	15647	7	10	521	15637	16175	0.06920239620188212
M1	string	0	network_modules	328	TRUE	9.417923598252619e-4	172	17	5	0.29411764705882354	0.029069767441860465	GO:0000724	GO:BP	double-strand break repair via homologous recombination	16175	203		0.5909090909090909	0.6086956521739131	172	16003	5	12	167	15991	16175	0.08964756592736735
M1	string	0	network_modules	328	TRUE	0.0010553078840393672	176	17	5	0.29411764705882354	0.028409090909090908	GO:0000725	GO:BP	recombinational repair	16175	204		0.6363636363636364	0.6521739130434783	176	15999	5	12	171	15987	16175	0.08855674724437064
M1	string	0	network_modules	328	TRUE	0.00121675956579644	19	17	3	0.17647058823529413	0.15789473684210525	GO:0006337	GO:BP	nucleosome disassembly	16175	2125		0.6818181818181818	0.6956521739130435	19	16156	3	14	16	16142	16175	0.16599808314375786
M1	string	0	network_modules	328	TRUE	0.001667893992958556	21	17	3	0.17647058823529413	0.14285714285714285	GO:0032986	GO:BP	protein-DNA complex disassembly	16175	7966		0.7272727272727273	0.7391304347826086	21	16154	3	14	18	16140	16175	0.15779406522265696
M1	string	0	network_modules	328	TRUE	0.002212528031284492	86	17	4	0.23529411764705882	0.046511627906976744	GO:0006334	GO:BP	nucleosome assembly	16175	2123		0.7727272727272727	0.782608695652174	86	16089	4	13	82	16076	16175	0.10257608329245277
M1	string	0	network_modules	328	TRUE	0.004026810845309737	231	17	5	0.29411764705882354	0.021645021645021644	GO:0006260	GO:BP	DNA replication	16175	2077		0.8181818181818182	0.8260869565217391	231	15944	5	12	226	15932	16175	0.07650229097372736
M1	string	0	network_modules	328	TRUE	0.004627487702167593	435	17	6	0.35294117647058826	0.013793103448275862	GO:0051052	GO:BP	regulation of DNA metabolic process	16175	13462		0.8636363636363636	0.8695652173913043	435	15740	6	11	429	15729	16175	0.06537463239384822
M1	string	0	network_modules	328	TRUE	0.0051095107526758134	106	17	4	0.23529411764705882	0.03773584905660377	GO:0034728	GO:BP	nucleosome organization	16175	8723		0.9090909090909091	0.9130434782608695	106	16069	4	13	102	16056	16175	0.09195412487642704
M1	string	0	network_modules	328	TRUE	0.008133490203624773	35	17	3	0.17647058823529413	0.08571428571428572	GO:0033260	GO:BP	nuclear DNA replication	16175	8103		0.9545454545454546	0.9565217391304348	35	16140	3	14	32	16126	16175	0.1216755670934157
M1	string	0	network_modules	328	TRUE	0.009643264396870422	37	17	3	0.17647058823529413	0.08108108108108109	GO:0022616	GO:BP	DNA strand elongation	16175	6623		1	1	37	16138	3	14	34	16124	16175	0.1182647355350957
M1	string	0	network_modules	333	TRUE	1.6356727540971147e-5	37	4	3	0.75	0.08108108108108109	KEGG:05340	KEGG	Primary immunodeficiency	8484	488		0	0.3333333333333333	37	8447	3	1	34	8446	8484	0.24575883973771565
M1	string	0	network_modules	333	TRUE	1.0874685394023878e-4	11	14	3	0.21428571428571427	0.2727272727272727	GO:0045348	GO:BP	positive regulation of MHC class II biosynthetic process	16175	11371		0	0.3333333333333333	11	16164	3	11	8	16153	16175	0.24116604956372267
M1	string	0	network_modules	333	TRUE	1.0998222640527579e-4	69	4	3	0.75	0.043478260869565216	KEGG:04612	KEGG	Antigen processing and presentation	8484	322		0.5	0.6666666666666666	69	8415	3	1	66	8414	8484	0.17939370631665968
M1	string	0	network_modules	333	TRUE	2.992661472144097e-4	15	14	3	0.21428571428571427	0.2	GO:0045346	GO:BP	regulation of MHC class II biosynthetic process	16175	11369		0.5	0.6666666666666666	15	16160	3	11	12	16149	16175	0.20630870032228973
M1	string	0	network_modules	333	TRUE	3.6813963209937894e-4	16	14	3	0.21428571428571427	0.1875	GO:0045342	GO:BP	MHC class II biosynthetic process	16175	11365		1	1	16	16159	3	11	13	16148	16175	0.1997058364840359
M1	string	0	network_modules	333	TRUE	0.0018256130950379166	175	4	3	0.75	0.017142857142857144	KEGG:05152	KEGG	Tuberculosis	8484	440		1	1	175	8309	3	1	172	8308	8484	0.1114522834350581
M1	string	0	network_modules	335	TRUE	7.931850322434595e-10	16	12	5	0.4166666666666667	0.3125	REAC:R-HSA-399956	REAC	CRMPs in Sema3A signaling	10916	287		0	0.5	16	10900	5	7	11	10893	10916	0.3600363117900625
M1	string	0	network_modules	335	TRUE	1.34937181550096e-6	64	12	5	0.4166666666666667	0.078125	REAC:R-HSA-373755	REAC	Semaphorin interactions	10916	2193		1	1	64	10852	5	7	59	10845	10916	0.17850513323694395
M1	string	0	network_modules	337	TRUE	0.006364451016907484	276	8	4	0.5	0.014492753623188406	REAC:R-HSA-72203	REAC	Processing of Capped Intron-Containing Pre-mRNA	10916	1796		NA	1	276	10640	4	4	272	10636	10916	0.08189256658524519
M1	string	0	network_modules	338	TRUE	1.7796648125614234e-5	76	7	4	0.5714285714285714	0.05263157894736842	REAC:R-HSA-909733	REAC	Interferon alpha/beta signaling	10916	1228		0	0.5	76	10840	4	3	72	10837	10916	0.17196365545955106
M1	string	0	network_modules	338	TRUE	4.516999483852924e-5	49	12	4	0.3333333333333333	0.08163265306122448	GO:0140374	GO:BP	antiviral innate immune response	16175	19754		0	0.2	49	16126	4	8	45	16118	16175	0.16376698283078284
M1	string	0	network_modules	338	TRUE	7.711078489149158e-5	334	12	6	0.5	0.017964071856287425	GO:0009615	GO:BP	response to virus	16175	3541		0.25	0.4	334	15841	6	6	328	15835	16175	0.09184656050982878
M1	string	0	network_modules	338	TRUE	4.864873707793965e-4	228	12	5	0.4166666666666667	0.021929824561403508	GO:0051607	GO:BP	defense response to virus	16175	13823		0.5	0.6	228	15947	5	7	223	15940	16175	0.09304848766394672
M1	string	0	network_modules	338	TRUE	0.0025924794973274713	263	7	4	0.5714285714285714	0.015209125475285171	REAC:R-HSA-913531	REAC	Interferon Signaling	10916	1227		1	1	263	10653	4	3	259	10650	10916	0.09041903199722161
M1	string	0	network_modules	338	TRUE	0.0029873493188661243	37	12	3	0.25	0.08108108108108109	GO:0043330	GO:BP	response to exogenous dsRNA	16175	10636		0.75	0.8	37	16138	3	9	34	16129	16175	0.1412850353319482
M1	string	0	network_modules	338	TRUE	0.0040916305351758366	41	12	3	0.25	0.07317073170731707	GO:0043331	GO:BP	response to dsRNA	16175	10637		1	1	41	16134	3	9	38	16125	16175	0.13409887921903033
M1	string	0	network_modules	338	TRUE	0.0059630104934136965	158	6	3	0.5	0.0189873417721519	KEGG:05160	KEGG	Hepatitis C	8484	441		NA	1	158	8326	3	3	155	8323	8484	0.0947257179830611
M1	string	0	network_modules	339	TRUE	5.912302204720924e-16	8	11	6	0.5454545454545454	0.75	GO:0097104	GO:BP	postsynaptic membrane assembly	16175	18497		0	0.011494252873563218	8	16167	6	5	2	16162	16175	0.6393977281329828
M1	string	0	network_modules	339	TRUE	4.431876029735265e-15	10	11	6	0.5454545454545454	0.6	GO:0097105	GO:BP	presynaptic membrane assembly	16175	18498		0.011627906976744186	0.022988505747126436	10	16165	6	5	4	16160	16175	0.571800324449782
M1	string	0	network_modules	339	TRUE	9.747542418929074e-15	11	11	6	0.5454545454545454	0.5454545454545454	GO:0097090	GO:BP	presynaptic membrane organization	16175	18486		0.023255813953488372	0.034482758620689655	11	16164	6	5	5	16159	16175	0.5451452160806282
M1	string	0	network_modules	339	TRUE	1.0548642681203893e-13	15	11	6	0.5454545454545454	0.4	GO:0007158	GO:BP	neuron cell-cell adhesion	16175	2722		0.03488372093023256	0.04597701149425287	15	16160	6	5	9	16155	16175	0.4666803043100626
M1	string	0	network_modules	339	TRUE	1.6873352738264074e-13	16	11	6	0.5454545454545454	0.375	GO:0099068	GO:BP	postsynapse assembly	16175	19027		0.046511627906976744	0.05747126436781609	16	16159	6	5	10	16154	16175	0.45182393874464577
M1	string	0	network_modules	339	TRUE	1.5696420831680686e-12	22	11	6	0.5454545454545454	0.2727272727272727	GO:0001941	GO:BP	postsynaptic membrane organization	16175	553		0.05813953488372093	0.06896551724137931	22	16153	6	5	16	16148	16175	0.3851257415237738
M1	string	0	network_modules	339	TRUE	1.545227978062884e-11	31	11	6	0.5454545454545454	0.1935483870967742	GO:0099054	GO:BP	presynapse assembly	16175	19026		0.06976744186046512	0.08045977011494253	31	16144	6	5	25	16139	16175	0.3241975345034362
M1	string	0	network_modules	339	TRUE	1.901314345566034e-11	32	11	6	0.5454545454545454	0.1875	GO:0099172	GO:BP	presynapse organization	16175	19080		0.08139534883720931	0.09195402298850575	32	16143	6	5	26	16138	16175	0.31906532988965797
M1	string	0	network_modules	339	TRUE	2.2969363258936444e-11	56	7	6	0.8571428571428571	0.10714285714285714	REAC:R-HSA-6794361	REAC	Neurexins and neuroligins	10916	1587		0	0.3333333333333333	56	10860	6	1	50	10859	10916	0.30210454252844937
M1	string	0	network_modules	339	TRUE	3.318179330623419e-10	86	7	6	0.8571428571428571	0.06976744186046512	REAC:R-HSA-6794362	REAC	Protein-protein interactions at synapses	10916	1819		0.5	0.6666666666666666	86	10830	6	1	80	10829	10916	0.24333220951369575
M1	string	0	network_modules	339	TRUE	5.387324265637401e-10	54	11	6	0.5454545454545454	0.1111111111111111	GO:0071709	GO:BP	membrane assembly	16175	16873		0.09302325581395349	0.10344827586206896	54	16121	6	5	48	16116	16175	0.2451690338082045
M1	string	0	network_modules	339	TRUE	8.433841894410038e-10	58	11	6	0.5454545454545454	0.10344827586206896	GO:0044091	GO:BP	membrane biogenesis	16175	10913		0.10465116279069768	0.11494252873563218	58	16117	6	5	52	16112	16175	0.2364853429401743
M1	string	0	network_modules	339	TRUE	9.596549474732182e-9	31	11	5	0.45454545454545453	0.16129032258064516	GO:0098815	GO:BP	modulation of excitatory postsynaptic potential	16175	18902		0.11627906976744186	0.12643678160919541	31	16144	5	6	26	16138	16175	0.26997408973001197
M1	string	0	network_modules	339	TRUE	2.17012389602015e-8	98	11	6	0.5454545454545454	0.061224489795918366	GO:0099173	GO:BP	postsynapse organization	16175	19081		0.12790697674418605	0.13793103448275862	98	16077	6	5	92	16072	16175	0.18132523047470928
M1	string	0	network_modules	339	TRUE	4.7371353657875076e-8	153	8	6	0.75	0.0392156862745098	KEGG:04514	KEGG	Cell adhesion molecules	8484	315		NA	1	153	8331	6	2	147	8329	8484	0.16898448675689437
M1	string	0	network_modules	339	TRUE	6.109112488642289e-8	44	11	5	0.45454545454545453	0.11363636363636363	GO:0060079	GO:BP	excitatory postsynaptic potential	16175	14338		0.13953488372093023	0.14942528735632185	44	16131	5	6	39	16125	16175	0.2262974622292331
M1	string	0	network_modules	339	TRUE	6.415431438491835e-8	117	11	6	0.5454545454545454	0.05128205128205128	GO:0099504	GO:BP	synaptic vesicle cycle	16175	19100		0.1511627906976744	0.16091954022988506	117	16058	6	5	111	16053	16175	0.1656869569974326
M1	string	0	network_modules	339	TRUE	7.875157577760732e-8	121	11	6	0.5454545454545454	0.049586776859504134	GO:0099003	GO:BP	vesicle-mediated transport in synapse	16175	18999		0.16279069767441862	0.1724137931034483	121	16054	6	5	115	16049	16175	0.1628707419697249
M1	string	0	network_modules	339	TRUE	9.375156089210509e-8	13	11	4	0.36363636363636365	0.3076923076923077	GO:0071625	GO:BP	vocalization behavior	16175	16805		0.1744186046511628	0.1839080459770115	13	16162	4	7	9	16155	16175	0.3340052932212572
M1	string	0	network_modules	339	TRUE	9.601076720301942e-8	125	11	6	0.5454545454545454	0.048	GO:0007416	GO:BP	synapse assembly	16175	2911		0.18604651162790697	0.19540229885057472	125	16050	6	5	119	16045	16175	0.16018991928573367
M1	string	0	network_modules	339	TRUE	1.0710175801536815e-7	49	11	5	0.45454545454545453	0.10204081632653061	GO:0140238	GO:BP	presynaptic endocytosis	16175	19709		0.19767441860465115	0.21839080459770116	49	16126	5	6	44	16120	16175	0.21432758617156752
M1	string	0	network_modules	339	TRUE	1.0710175801536815e-7	49	11	5	0.45454545454545453	0.10204081632653061	GO:0048488	GO:BP	synaptic vesicle endocytosis	16175	12781		0.19767441860465115	0.21839080459770116	49	16126	5	6	44	16120	16175	0.21432758617156752
M1	string	0	network_modules	339	TRUE	1.3185520668839526e-7	51	11	5	0.45454545454545453	0.09803921568627451	GO:0099565	GO:BP	chemical synaptic transmission, postsynaptic	16175	19143		0.22093023255813954	0.22988505747126436	51	16124	5	6	46	16118	16175	0.21003854929516844
M1	string	0	network_modules	339	TRUE	2.803177925921045e-7	59	11	5	0.45454545454545453	0.0847457627118644	GO:0036465	GO:BP	synaptic vesicle recycling	16175	9613		0.23255813953488372	0.2413793103448276	59	16116	5	6	54	16110	16175	0.19511458770194023
M1	string	0	network_modules	339	TRUE	3.328984428534343e-7	61	11	5	0.45454545454545453	0.08196721311475409	GO:0060078	GO:BP	regulation of postsynaptic membrane potential	16175	14337		0.2441860465116279	0.25287356321839083	61	16114	5	6	56	16108	16175	0.19184861474405232
M1	string	0	network_modules	339	TRUE	5.07169721665124e-7	19	11	4	0.36363636363636365	0.21052631578947367	GO:2000311	GO:BP	regulation of AMPA receptor activity	16175	25633		0.2558139534883721	0.26436781609195403	19	16156	4	7	15	16149	16175	0.2760480127212956
M1	string	0	network_modules	339	TRUE	8.37376048926763e-7	73	11	5	0.45454545454545453	0.0684931506849315	GO:0031644	GO:BP	regulation of nervous system process	16175	7254		0.26744186046511625	0.27586206896551724	73	16102	5	6	68	16096	16175	0.17514936678747464
M1	string	0	network_modules	339	TRUE	9.561639088331897e-7	22	11	4	0.36363636363636365	0.18181818181818182	GO:2000463	GO:BP	positive regulation of excitatory postsynaptic potential	16175	25775		0.27906976744186046	0.28735632183908044	22	16153	4	7	18	16146	16175	0.2564295827528656
M1	string	0	network_modules	339	TRUE	1.1570604784591294e-6	23	11	4	0.36363636363636365	0.17391304347826086	GO:0051968	GO:BP	positive regulation of synaptic transmission, glutamatergic	16175	14037		0.29069767441860467	0.2988505747126437	23	16152	4	7	19	16145	16175	0.25075804274801294
M1	string	0	network_modules	339	TRUE	3.0970352123885975e-6	29	11	4	0.36363636363636365	0.13793103448275862	GO:0035176	GO:BP	social behavior	16175	8870		0.3023255813953488	0.3103448275862069	29	16146	4	7	25	16139	16175	0.22312872387251997
M1	string	0	network_modules	339	TRUE	3.7705729970779505e-6	400	7	6	0.8571428571428571	0.015	REAC:R-HSA-112316	REAC	Neuronal System	10916	1590		1	1	400	10516	6	1	394	10515	10916	0.11062239542934654
M1	string	0	network_modules	339	TRUE	4.1000660344516525e-6	31	11	4	0.36363636363636365	0.12903225806451613	GO:0051703	GO:BP	biological process involved in intraspecies interaction between organisms	16175	13903		0.313953488372093	0.3218390804597701	31	16144	4	7	27	16137	16175	0.2157506449565878
M1	string	0	network_modules	339	TRUE	5.311861182755614e-6	6	11	3	0.2727272727272727	0.5	GO:0097119	GO:BP	postsynaptic density protein 95 clustering	16175	18509		0.32558139534883723	0.3333333333333333	6	16169	3	8	3	16161	16175	0.36896611095097825
M1	string	0	network_modules	339	TRUE	5.328409449325695e-6	33	11	4	0.36363636363636365	0.12121212121212122	GO:0051965	GO:BP	positive regulation of synapse assembly	16175	14034		0.3372093023255814	0.3448275862068966	33	16142	4	7	29	16135	16175	0.20905203582645068
M1	string	0	network_modules	339	TRUE	8.367723677418085e-6	262	11	6	0.5454545454545454	0.022900763358778626	GO:0050804	GO:BP	modulation of chemical synaptic transmission	16175	13270		0.3488372093023256	0.3563218390804598	262	15913	6	5	256	15908	16175	0.1093719376426948
M1	string	0	network_modules	339	TRUE	8.560780846025139e-6	263	11	6	0.5454545454545454	0.022813688212927757	GO:0099177	GO:BP	regulation of trans-synaptic signaling	16175	19085		0.36046511627906974	0.367816091954023	263	15912	6	5	257	15907	16175	0.10915448625498417
M1	string	0	network_modules	339	TRUE	8.588148417771604e-6	37	11	4	0.36363636363636365	0.10810810810810811	GO:0099601	GO:BP	regulation of neurotransmitter receptor activity	16175	19157		0.37209302325581395	0.3793103448275862	37	16138	4	7	33	16131	16175	0.19731822949399735
M1	string	0	network_modules	339	TRUE	1.3272085940736223e-5	283	11	6	0.5454545454545454	0.02120141342756184	GO:0050808	GO:BP	synapse organization	16175	13274		0.38372093023255816	0.39080459770114945	283	15892	6	5	277	15887	16175	0.10504694505355192
M1	string	0	network_modules	339	TRUE	2.2284992121675394e-5	9	11	3	0.2727272727272727	0.3333333333333333	GO:0032230	GO:BP	positive regulation of synaptic transmission, GABAergic	16175	7419		0.3953488372093023	0.40229885057471265	9	16166	3	8	6	16158	16175	0.30108234664318256
M1	string	0	network_modules	339	TRUE	3.7866693354408684e-5	53	11	4	0.36363636363636365	0.07547169811320754	GO:0007612	GO:BP	learning	16175	3069		0.4069767441860465	0.41379310344827586	53	16122	4	7	49	16115	16175	0.16449588457988273
M1	string	0	network_modules	339	TRUE	4.4010414991859196e-5	346	11	6	0.5454545454545454	0.017341040462427744	GO:0034329	GO:BP	cell junction assembly	16175	8571		0.4186046511627907	0.42528735632183906	346	15829	6	5	340	15824	16175	0.09448988997495529
M1	string	0	network_modules	339	TRUE	4.407296365967013e-5	55	11	4	0.36363636363636365	0.07272727272727272	GO:0051966	GO:BP	regulation of synaptic transmission, glutamatergic	16175	14035		0.43023255813953487	0.4367816091954023	55	16120	4	7	51	16113	16175	0.1614319619375476
M1	string	0	network_modules	339	TRUE	5.476940491998577e-5	58	11	4	0.36363636363636365	0.06896551724137931	GO:0051963	GO:BP	regulation of synapse assembly	16175	14032		0.4418604651162791	0.4482758620689655	58	16117	4	7	54	16110	16175	0.15713525328209607
M1	string	0	network_modules	339	TRUE	7.57625318621478e-5	13	11	3	0.2727272727272727	0.23076923076923078	GO:0097106	GO:BP	postsynaptic density organization	16175	18499		0.45348837209302323	0.45977011494252873	13	16162	3	8	10	16154	16175	0.25031900640721944
M1	string	0	network_modules	339	TRUE	9.638925690157545e-5	14	11	3	0.2727272727272727	0.21428571428571427	GO:0099084	GO:BP	postsynaptic specialization organization	16175	19035		0.46511627906976744	0.47126436781609193	14	16161	3	8	11	16153	16175	0.24116604956372267
M1	string	0	network_modules	339	TRUE	1.0476542523697243e-4	68	11	4	0.36363636363636365	0.058823529411764705	GO:1901890	GO:BP	positive regulation of cell junction assembly	16175	21834		0.47674418604651164	0.4827586206896552	68	16107	4	7	64	16100	16175	0.14491774973950652
M1	string	0	network_modules	339	TRUE	1.6458870137756818e-4	76	11	4	0.36363636363636365	0.05263157894736842	GO:0035249	GO:BP	synaptic transmission, glutamatergic	16175	8924		0.4883720930232558	0.4942528735632184	76	16099	4	7	72	16092	16175	0.1369238513923815
M1	string	0	network_modules	339	TRUE	2.1576081571678606e-4	18	11	3	0.2727272727272727	0.16666666666666666	GO:0032228	GO:BP	regulation of synaptic transmission, GABAergic	16175	7417		0.5	0.5057471264367817	18	16157	3	8	15	16149	16175	0.21252129700939598
M1	string	0	network_modules	339	TRUE	2.3386905931512816e-4	806	11	7	0.6363636363636364	0.008684863523573201	GO:0050877	GO:BP	nervous system process	16175	13322		0.5116279069767442	0.5172413793103449	806	15369	7	4	799	15365	16175	0.07031837390671963
M1	string	0	network_modules	339	TRUE	2.561208743408719e-4	19	11	3	0.2727272727272727	0.15789473684210525	GO:1904861	GO:BP	excitatory synapse assembly	16175	24169		0.5232558139534884	0.5287356321839081	19	16156	3	8	16	16148	16175	0.20681235804441112
M1	string	0	network_modules	339	TRUE	3.3358882356853114e-4	487	11	6	0.5454545454545454	0.012320328542094456	GO:0098916	GO:BP	anterograde trans-synaptic signaling	16175	18949		0.5348837209302325	0.5517241379310345	487	15688	6	5	481	15683	16175	0.07867144873053028
M1	string	0	network_modules	339	TRUE	3.3358882356853114e-4	487	11	6	0.5454545454545454	0.012320328542094456	GO:0007268	GO:BP	chemical synaptic transmission	16175	2796		0.5348837209302325	0.5517241379310345	487	15688	6	5	481	15683	16175	0.07867144873053028
M1	string	0	network_modules	339	TRUE	3.543038551121827e-4	492	11	6	0.5454545454545454	0.012195121951219513	GO:0099537	GO:BP	trans-synaptic signaling	16175	19116		0.5581395348837209	0.5632183908045977	492	15683	6	5	486	15678	16175	0.07823619420496568
M1	string	0	network_modules	339	TRUE	3.887719485520323e-4	94	11	4	0.36363636363636365	0.0425531914893617	GO:0010469	GO:BP	regulation of signaling receptor activity	16175	4162		0.5697674418604651	0.5747126436781609	94	16081	4	7	90	16074	16175	0.12280508461597509
M1	string	0	network_modules	339	TRUE	4.412620067523063e-4	97	11	4	0.36363636363636365	0.041237113402061855	GO:0050806	GO:BP	positive regulation of synaptic transmission	16175	13272		0.5813953488372093	0.5862068965517241	97	16078	4	7	93	16071	16175	0.1208397326970171
M1	string	0	network_modules	339	TRUE	4.550003133564115e-4	255	11	5	0.45454545454545453	0.0196078431372549	GO:0007610	GO:BP	behavior	16175	3067		0.5930232558139535	0.5977011494252874	255	15920	5	6	250	15914	16175	0.0918907495320441
M1	string	0	network_modules	339	TRUE	4.6910767234021797e-4	516	11	6	0.5454545454545454	0.011627906976744186	GO:0099536	GO:BP	synaptic signaling	16175	19115		0.6046511627906976	0.6091954022988506	516	15659	6	5	510	15654	16175	0.07623335103390633
M1	string	0	network_modules	339	TRUE	4.7780235380729123e-4	2	11	2	0.18181818181818182	1	GO:0090125	GO:BP	cell-cell adhesion involved in synapse maturation	16175	18038		0.6162790697674418	0.6206896551724138	2	16173	2	9	0	16164	16175	0.426282773620928
M1	string	0	network_modules	339	TRUE	5.67721768869253e-4	533	11	6	0.5454545454545454	0.01125703564727955	GO:0006897	GO:BP	endocytosis	16175	2551		0.627906976744186	0.6436781609195402	533	15642	6	5	527	15637	16175	0.07489492999131876
M1	string	0	network_modules	339	TRUE	5.67721768869253e-4	533	11	6	0.5454545454545454	0.01125703564727955	GO:0034330	GO:BP	cell junction organization	16175	8572		0.627906976744186	0.6436781609195402	533	15642	6	5	527	15637	16175	0.07489492999131876
M1	string	0	network_modules	339	TRUE	7.490944909938521e-4	282	11	5	0.45454545454545453	0.01773049645390071	GO:0042391	GO:BP	regulation of membrane potential	16175	10141		0.6511627906976745	0.6551724137931034	282	15893	5	6	277	15887	16175	0.0871225528078366
M1	string	0	network_modules	339	TRUE	8.630062711246121e-4	28	11	3	0.2727272727272727	0.10714285714285714	GO:0034331	GO:BP	cell junction maintenance	16175	8573		0.6627906976744186	0.6666666666666666	28	16147	3	8	25	16139	16175	0.17006090420272324
M1	string	0	network_modules	339	TRUE	9.622265675760185e-4	29	11	3	0.2727272727272727	0.10344827586206896	GO:0021549	GO:BP	cerebellum development	16175	6133		0.6744186046511628	0.6896551724137931	29	16146	3	8	26	16138	16175	0.16707014900356779
M1	string	0	network_modules	339	TRUE	9.622265675760185e-4	29	11	3	0.2727272727272727	0.10344827586206896	GO:0022037	GO:BP	metencephalon development	16175	6589		0.6744186046511628	0.6896551724137931	29	16146	3	8	26	16138	16175	0.16707014900356779
M1	string	0	network_modules	339	TRUE	9.701857021411811e-4	118	11	4	0.36363636363636365	0.03389830508474576	GO:0007611	GO:BP	learning or memory	16175	3068		0.6976744186046512	0.7011494252873564	118	16057	4	7	114	16050	16175	0.10923428919565302
M1	string	0	network_modules	339	TRUE	0.0011835775908730834	124	11	4	0.36363636363636365	0.03225806451612903	GO:0050807	GO:BP	regulation of synapse organization	16175	13273		0.7093023255813954	0.7126436781609196	124	16051	4	7	120	16044	16175	0.10646772606457648
M1	string	0	network_modules	339	TRUE	0.001386574362820097	129	11	4	0.36363636363636365	0.031007751937984496	GO:0050803	GO:BP	regulation of synapse structure or activity	16175	13269		0.7209302325581395	0.7241379310344828	129	16046	4	7	125	16039	16175	0.10430960983503854
M1	string	0	network_modules	339	TRUE	0.001432875283621309	3	11	2	0.18181818181818182	0.6666666666666666	GO:1900073	GO:BP	regulation of neuromuscular synaptic transmission	16175	20370		0.7325581395348837	0.7701149425287356	3	16172	2	9	1	16163	16175	0.3479507533206276
M1	string	0	network_modules	339	TRUE	0.001432875283621309	3	11	2	0.18181818181818182	0.6666666666666666	GO:0097114	GO:BP	NMDA glutamate receptor clustering	16175	18504		0.7325581395348837	0.7701149425287356	3	16172	2	9	1	16163	16175	0.3479507533206276
M1	string	0	network_modules	339	TRUE	0.001432875283621309	3	11	2	0.18181818181818182	0.6666666666666666	GO:0072553	GO:BP	terminal button organization	16175	17439		0.7325581395348837	0.7701149425287356	3	16172	2	9	1	16163	16175	0.3479507533206276
M1	string	0	network_modules	339	TRUE	0.001432875283621309	3	11	2	0.18181818181818182	0.6666666666666666	GO:1900075	GO:BP	positive regulation of neuromuscular synaptic transmission	16175	20372		0.7325581395348837	0.7701149425287356	3	16172	2	9	1	16163	16175	0.3479507533206276
M1	string	0	network_modules	339	TRUE	0.0015728743775049814	34	11	3	0.2727272727272727	0.08823529411764706	GO:0051932	GO:BP	synaptic transmission, GABAergic	16175	14002		0.7790697674418605	0.7816091954022989	34	16141	3	8	31	16133	16175	0.15414515196616763
M1	string	0	network_modules	339	TRUE	0.0019354913925633318	657	11	6	0.5454545454545454	0.0091324200913242	GO:0061024	GO:BP	membrane organization	16175	15141		0.7906976744186046	0.7931034482758621	657	15518	6	5	651	15513	16175	0.06671388530424949
M1	string	0	network_modules	339	TRUE	0.0020932666816164	143	11	4	0.36363636363636365	0.027972027972027972	GO:1901888	GO:BP	regulation of cell junction assembly	16175	21832		0.8023255813953488	0.8045977011494253	143	16032	4	7	139	16025	16175	0.09887409387091625
M1	string	0	network_modules	339	TRUE	0.0025911445956611347	40	11	3	0.2727272727272727	0.075	GO:0030534	GO:BP	adult behavior	16175	6837		0.813953488372093	0.8160919540229885	40	16135	3	8	37	16127	16175	0.14194639798089617
M1	string	0	network_modules	339	TRUE	0.0027412208155109976	153	11	4	0.36363636363636365	0.026143790849673203	GO:0051962	GO:BP	positive regulation of nervous system development	16175	14031		0.8255813953488372	0.8275862068965517	153	16022	4	7	149	16015	16175	0.09545152725719137
M1	string	0	network_modules	339	TRUE	0.002864687406232981	4	11	2	0.18181818181818182	0.5	GO:0097116	GO:BP	gephyrin clustering involved in postsynaptic density assembly	16175	18506		0.8372093023255814	0.8390804597701149	4	16171	2	9	2	16162	16175	0.30124093787466694
M1	string	0	network_modules	339	TRUE	0.003008527446188761	42	11	3	0.2727272727272727	0.07142857142857142	GO:0035418	GO:BP	protein localization to synapse	16175	9025		0.8488372093023255	0.8505747126436781	42	16133	3	8	39	16125	16175	0.13847070379733314
M1	string	0	network_modules	339	TRUE	0.0031953000675008776	159	11	4	0.36363636363636365	0.025157232704402517	GO:0050890	GO:BP	cognition	16175	13334		0.8604651162790697	0.8620689655172413	159	16016	4	7	155	16009	16175	0.09355268958674479
M1	string	0	network_modules	339	TRUE	0.0032996270778462245	381	11	5	0.45454545454545453	0.013123359580052493	GO:0044057	GO:BP	regulation of system process	16175	10893		0.872093023255814	0.8735632183908046	381	15794	5	6	376	15788	16175	0.07413536675131938
M1	string	0	network_modules	339	TRUE	0.0034682359164210975	44	11	3	0.2727272727272727	0.06818181818181818	GO:0051489	GO:BP	regulation of filopodium assembly	16175	13744		0.8837209302325582	0.8850574712643678	44	16131	3	8	41	16123	16175	0.1352335010505478
M1	string	0	network_modules	339	TRUE	0.003714586992409312	45	11	3	0.2727272727272727	0.06666666666666667	GO:0030902	GO:BP	hindbrain development	16175	6958		0.8953488372093024	0.896551724137931	45	16130	3	8	42	16122	16175	0.13369599034230295
M1	string	0	network_modules	339	TRUE	0.0038727620861653263	740	11	6	0.5454545454545454	0.008108108108108109	GO:0098657	GO:BP	import into cell	16175	18813		0.9069767441860465	0.9080459770114943	740	15435	6	5	734	15430	16175	0.06238938002797424
M1	string	0	network_modules	339	TRUE	0.003972268392254585	46	11	3	0.2727272727272727	0.06521739130434782	GO:0043954	GO:BP	cellular component maintenance	16175	10881		0.9186046511627907	0.9195402298850575	46	16129	3	8	43	16121	16175	0.1322086015112548
M1	string	0	network_modules	339	TRUE	0.004027454380670631	745	11	6	0.5454545454545454	0.008053691275167786	GO:0098609	GO:BP	cell-cell adhesion	16175	18805		0.9302325581395349	0.9310344827586207	745	15430	6	5	739	15425	16175	0.06215127012767174
M1	string	0	network_modules	339	TRUE	0.004772707732796983	5	11	2	0.18181818181818182	0.4	GO:0002087	GO:BP	regulation of respiratory gaseous exchange by nervous system process	16175	673		0.9418604651162791	0.9425287356321839	5	16170	2	9	3	16161	16175	0.26935467227213133
M1	string	0	network_modules	339	TRUE	0.0048412093939553015	412	11	5	0.45454545454545453	0.012135922330097087	GO:0044089	GO:BP	positive regulation of cellular component biogenesis	16175	10911		0.9534883720930233	0.9540229885057471	412	15763	5	6	407	15757	16175	0.07104449194557211
M1	string	0	network_modules	339	TRUE	0.005467989236109752	182	11	4	0.36363636363636365	0.02197802197802198	GO:0032412	GO:BP	regulation of monoatomic ion transmembrane transporter activity	16175	7550		0.9651162790697675	0.9655172413793104	182	15993	4	7	178	15986	16175	0.08715298401649761
M1	string	0	network_modules	339	TRUE	0.0064856801144054215	190	11	4	0.36363636363636365	0.021052631578947368	GO:0022898	GO:BP	regulation of transmembrane transporter activity	16175	6629		0.9767441860465116	0.9770114942528736	190	15985	4	7	186	15978	16175	0.08520004409617808
M1	string	0	network_modules	339	TRUE	0.008430332267514114	203	11	4	0.36363636363636365	0.019704433497536946	GO:0032409	GO:BP	regulation of transporter activity	16175	7547		0.9883720930232558	0.9885057471264368	203	15972	4	7	199	15965	16175	0.08227203052877942
M1	string	0	network_modules	339	TRUE	0.009365442617159088	61	11	3	0.2727272727272727	0.04918032786885246	GO:0046847	GO:BP	filopodium assembly	16175	12400		1	1	61	16114	3	8	58	16106	16175	0.11446715388212408
M1	string	0	network_modules	344	TRUE	5.541856854006838e-5	9	14	3	0.21428571428571427	0.3333333333333333	GO:0043312	GO:BP	neutrophil degranulation	16175	10620		0	0.1111111111111111	9	16166	3	11	6	16155	16175	0.26675693181223653
M1	string	0	network_modules	344	TRUE	5.7189714616272025e-5	34	6	3	0.5	0.08823529411764706	KEGG:05330	KEGG	Allograft rejection	8484	486		0	0.1	34	8450	3	3	31	8447	8484	0.20885113377256662
M1	string	0	network_modules	344	TRUE	7.419947191966246e-5	37	6	3	0.5	0.08108108108108109	KEGG:05332	KEGG	Graft-versus-host disease	8484	487		0.1111111111111111	0.2	37	8447	3	3	34	8444	8484	0.20009802867881232
M1	string	0	network_modules	344	TRUE	9.427360429473956e-5	40	6	3	0.5	0.075	KEGG:04940	KEGG	Type I diabetes mellitus	8484	394		0.2222222222222222	0.3	40	8444	3	3	37	8441	8484	0.19234498132802474
M1	string	0	network_modules	344	TRUE	1.2623798191553306e-4	44	6	3	0.5	0.06818181818181818	KEGG:04672	KEGG	Intestinal immune network for IgA production	8484	344		0.3333333333333333	0.4	44	8440	3	3	41	8437	8484	0.18326257807019658
M1	string	0	network_modules	344	TRUE	1.7537865154600813e-4	49	6	3	0.5	0.061224489795918366	KEGG:05320	KEGG	Autoimmune thyroid disease	8484	482		0.4444444444444444	0.5	49	8435	3	3	46	8432	8484	0.173505480756963
M1	string	0	network_modules	344	TRUE	2.395351351615083e-4	14	14	3	0.21428571428571427	0.21428571428571427	GO:0002283	GO:BP	neutrophil activation involved in immune response	16175	815		0.125	0.2222222222222222	14	16161	3	11	11	16150	16175	0.21360506333589682
M1	string	0	network_modules	344	TRUE	3.7660306408677705e-4	63	6	3	0.5	0.047619047619047616	KEGG:05416	KEGG	Viral myocarditis	8484	493		0.5555555555555556	0.6	63	8421	3	3	60	8418	8484	0.15263326058556978
M1	string	0	network_modules	344	TRUE	9.435123238091033e-4	216	14	5	0.35714285714285715	0.023148148148148147	GO:0002366	GO:BP	leukocyte activation involved in immune response	16175	898		0.25	0.3333333333333333	216	15959	5	9	211	15950	16175	0.08815284834964929
M1	string	0	network_modules	344	TRUE	0.0010337734064538302	88	6	3	0.5	0.03409090909090909	KEGG:05323	KEGG	Rheumatoid arthritis	8484	485		0.6666666666666666	0.7	88	8396	3	3	85	8393	8484	0.12856355125386823
M1	string	0	network_modules	344	TRUE	0.001056538839207285	221	14	5	0.35714285714285715	0.02262443438914027	GO:0002263	GO:BP	cell activation involved in immune response	16175	795		0.375	0.4444444444444444	221	15954	5	9	216	15945	16175	0.0870852210851155
M1	string	0	network_modules	344	TRUE	0.0017005179442463247	26	14	3	0.21428571428571427	0.11538461538461539	GO:0002446	GO:BP	neutrophil mediated immunity	16175	969		0.5	0.5555555555555556	26	16149	3	11	23	16138	16175	0.15625642062334155
M1	string	0	network_modules	344	TRUE	0.002386224746333355	29	14	3	0.21428571428571427	0.10344827586206896	GO:0002495	GO:BP	antigen processing and presentation of peptide antigen via MHC class II	16175	1018		0.625	0.6666666666666666	29	16146	3	11	26	16135	16175	0.1478383093304823
M1	string	0	network_modules	344	TRUE	0.00293243977894383	31	14	3	0.21428571428571427	0.0967741935483871	GO:0002504	GO:BP	antigen processing and presentation of peptide or polysaccharide antigen via MHC class II	16175	1027		0.75	0.7777777777777778	31	16144	3	11	28	16133	16175	0.14291547382459283
M1	string	0	network_modules	344	TRUE	0.00348820215572911	132	6	3	0.5	0.022727272727272728	KEGG:05322	KEGG	Systemic lupus erythematosus	8484	484		0.7777777777777778	0.8	132	8352	3	3	129	8349	8484	0.1041330364994339
M1	string	0	network_modules	344	TRUE	0.003555742953386264	33	14	3	0.21428571428571427	0.09090909090909091	GO:0042119	GO:BP	neutrophil activation	16175	9975		0.875	0.8888888888888888	33	16142	3	11	30	16131	16175	0.13844494424757176
M1	string	0	network_modules	344	TRUE	0.005022934335235676	67	9	3	0.3333333333333333	0.04477611940298507	REAC:R-HSA-388841	REAC	Regulation of T cell activation by CD28 family	10916	2007		NA	1	67	10849	3	6	64	10843	10916	0.12033923957713503
M1	string	0	network_modules	344	TRUE	0.005418500791758325	153	6	3	0.5	0.0196078431372549	KEGG:04514	KEGG	Cell adhesion molecules	8484	315		0.8888888888888888	0.9	153	8331	3	3	150	8328	8484	0.09635000621076628
M1	string	0	network_modules	344	TRUE	0.006918937818048657	41	14	3	0.21428571428571427	0.07317073170731707	GO:0036230	GO:BP	granulocyte activation	16175	9504		1	1	41	16134	3	11	38	16123	16175	0.12394716022273836
M1	string	0	network_modules	344	TRUE	0.007115936584634223	27	6	2	0.3333333333333333	0.07407407407407407	KEGG:05310	KEGG	Asthma	8484	481		1	1	27	8457	2	4	25	8453	8484	0.1559380074309423
M1	string	0	network_modules	346	TRUE	3.5269038398169826e-9	21	13	5	0.38461538461538464	0.23809523809523808	GO:0015701	GO:BP	bicarbonate transport	16175	4821		0	0.2	21	16154	5	8	16	16146	16175	0.3019095870959138
M1	string	0	network_modules	346	TRUE	3.1301001970289675e-8	9	12	4	0.3333333333333333	0.4444444444444444	REAC:R-HSA-1247673	REAC	Erythrocytes take up oxygen and release carbon dioxide	10916	856		0	0.25	9	10907	4	8	5	10899	10916	0.3843178298824492
M1	string	0	network_modules	346	TRUE	1.7720428564568168e-7	13	12	4	0.3333333333333333	0.3076923076923077	REAC:R-HSA-1237044	REAC	Erythrocytes take up carbon dioxide and release oxygen	10916	855		0.3333333333333333	0.75	13	10903	4	8	9	10895	10916	0.3194779530919822
M1	string	0	network_modules	346	TRUE	1.7720428564568168e-7	13	12	4	0.3333333333333333	0.3076923076923077	REAC:R-HSA-1480926	REAC	O2/CO2 exchange in erythrocytes	10916	1633		0.3333333333333333	0.75	13	10903	4	8	9	10895	10916	0.3194779530919822
M1	string	0	network_modules	346	TRUE	2.936615958832972e-5	23	7	3	0.42857142857142855	0.13043478260869565	KEGG:04964	KEGG	Proximal tubule bicarbonate reclamation	8484	399		0	0.3333333333333333	23	8461	3	4	20	8457	8484	0.23535375105684478
M1	string	0	network_modules	346	TRUE	3.609637224586049e-5	10	12	3	0.25	0.3	REAC:R-HSA-425381	REAC	Bicarbonate transporters	10916	221		1	1	10	10906	3	9	7	10897	10916	0.2731329922270871
M1	string	0	network_modules	346	TRUE	4.792754356877163e-4	80	13	4	0.3076923076923077	0.05	GO:0051453	GO:BP	regulation of intracellular pH	16175	13714		0.25	0.4	80	16095	4	9	76	16086	16175	0.12239309663996023
M1	string	0	network_modules	346	TRUE	5.295548155212795e-4	82	13	4	0.3076923076923077	0.04878048780487805	GO:0030641	GO:BP	regulation of cellular pH	16175	6868		0.5	0.6	82	16093	4	9	78	16084	16175	0.12084941833149984
M1	string	0	network_modules	346	TRUE	6.122141911773669e-4	85	13	4	0.3076923076923077	0.047058823529411764	GO:0006885	GO:BP	regulation of pH	16175	2541		0.75	0.8	85	16090	4	9	81	16081	16175	0.1186359355429739
M1	string	0	network_modules	346	TRUE	0.003830095035117686	17	7	2	0.2857142857142857	0.11764705882352941	KEGG:00910	KEGG	Nitrogen metabolism	8484	139		0.5	0.6666666666666666	17	8467	2	5	15	8462	8484	0.18231179964996866
M1	string	0	network_modules	346	TRUE	0.00454329868686108	326	13	5	0.38461538461538464	0.015337423312883436	GO:0015711	GO:BP	organic anion transport	16175	4831		1	1	326	15849	5	8	321	15841	16175	0.07355454876951441
M1	string	0	network_modules	346	TRUE	0.009846216659474495	27	7	2	0.2857142857142857	0.07407407407407407	KEGG:04966	KEGG	Collecting duct acid secretion	8484	400		1	1	27	8457	2	5	25	8452	8484	0.14414710184470317
M1	string	0	network_modules	347	TRUE	0.003913616195208495	244	8	4	0.5	0.01639344262295082	REAC:R-HSA-8951664	REAC	Neddylation	10916	1559		NA	1	244	10672	4	4	240	10668	10916	0.0875035422681269
M1	string	0	network_modules	348	TRUE	8.469097482092624e-8	84	7	5	0.7142857142857143	0.05952380952380952	KEGG:03083	KEGG	Polycomb repressive complex	8484	220		NA	1	84	8400	5	2	79	8398	8484	0.20443687378483064
M1	string	0	network_modules	348	TRUE	4.40221179895204e-6	102	10	5	0.5	0.049019607843137254	REAC:R-HSA-5689603	REAC	UCH proteinases	10916	2615		0	0.5	102	10814	5	5	97	10809	10916	0.15442391306063047
M1	string	0	network_modules	348	TRUE	9.276345487672582e-4	298	10	5	0.5	0.016778523489932886	REAC:R-HSA-5688426	REAC	Deubiquitination	10916	736		1	1	298	10618	5	5	293	10613	10916	0.08783901607682146
M1	string	0	network_modules	348	TRUE	0.004260098100507562	543	14	6	0.42857142857142855	0.011049723756906077	GO:0009887	GO:BP	animal organ morphogenesis	16175	3747		0	0.25	543	15632	6	8	537	15624	16175	0.064545402520687
M1	string	0	network_modules	348	TRUE	0.005346093569584706	4	14	2	0.14285714285714285	0.5	GO:0051891	GO:BP	positive regulation of cardioblast differentiation	16175	13975		0.3333333333333333	0.5	4	16171	2	12	2	16159	16175	0.26694714088648164
M1	string	0	network_modules	348	TRUE	0.008905748663263038	5	14	2	0.14285714285714285	0.4	GO:0051890	GO:BP	regulation of cardioblast differentiation	16175	13974		0.6666666666666666	1	5	16170	2	12	3	16158	16175	0.2386686524028136
M1	string	0	network_modules	348	TRUE	0.008905748663263038	5	14	2	0.14285714285714285	0.4	GO:0003166	GO:BP	bundle of His development	16175	1596		0.6666666666666666	1	5	16170	2	12	3	16158	16175	0.2386686524028136
M1	string	0	network_modules	349	TRUE	1.6320045954288259e-25	24	15	11	0.7333333333333333	0.4583333333333333	REAC:R-HSA-379716	REAC	Cytosolic tRNA aminoacylation	10916	430		0	0.2	24	10892	11	4	13	10888	10916	0.5790471935142317
M1	string	0	network_modules	349	TRUE	2.7817551459407703e-22	42	15	11	0.7333333333333333	0.2619047619047619	REAC:R-HSA-379724	REAC	tRNA Aminoacylation	10916	2740		0.25	0.4	42	10874	11	4	31	10870	10916	0.4370926482066508
M1	string	0	network_modules	349	TRUE	1.6070030815685122e-15	38	14	8	0.5714285714285714	0.21052631578947367	GO:0006418	GO:BP	tRNA aminoacylation for protein translation	16175	2175		0	0.09090909090909091	38	16137	8	6	30	16131	16175	0.3459742349465152
M1	string	0	network_modules	349	TRUE	3.136671120402896e-15	41	14	8	0.5714285714285714	0.1951219512195122	GO:0043038	GO:BP	amino acid activation	16175	10488		0.1	0.2727272727272727	41	16134	8	6	33	16128	16175	0.332998620734802
M1	string	0	network_modules	349	TRUE	3.136671120402896e-15	41	14	8	0.5714285714285714	0.1951219512195122	GO:0043039	GO:BP	tRNA aminoacylation	16175	10489		0.1	0.2727272727272727	41	16134	8	6	33	16128	16175	0.332998620734802
M1	string	0	network_modules	349	TRUE	7.660858855158862e-15	44	12	8	0.6666666666666666	0.18181818181818182	KEGG:00970	KEGG	Aminoacyl-tRNA biosynthesis	8484	153		NA	1	44	8440	8	4	36	8436	8484	0.3465913744194759
M1	string	0	network_modules	349	TRUE	1.2216244023638641e-14	117	15	10	0.6666666666666666	0.08547008547008547	REAC:R-HSA-2408522	REAC	Selenoamino acid metabolism	10916	2187		0.5	0.6	117	10799	10	5	107	10794	10916	0.2362985184194319
M1	string	0	network_modules	349	TRUE	1.4299245283886506e-14	292	15	12	0.8	0.0410958904109589	REAC:R-HSA-72766	REAC	Translation	10916	2565		0.75	0.8	292	10624	12	3	280	10621	10916	0.17777087620739754
M1	string	0	network_modules	349	TRUE	2.228527897161157e-11	370	15	11	0.7333333333333333	0.02972972972972973	REAC:R-HSA-71291	REAC	Metabolism of amino acids and derivatives	10916	1421		1	1	370	10546	11	4	359	10542	10916	0.14337734950362102
M1	string	0	network_modules	349	TRUE	9.375915450350613e-11	247	14	9	0.6428571428571429	0.03643724696356275	GO:0006520	GO:BP	amino acid metabolic process	16175	2241		0.3	0.36363636363636365	247	15928	9	5	238	15923	16175	0.15063253958138753
M1	string	0	network_modules	349	TRUE	9.542545256573314e-10	186	14	8	0.5714285714285714	0.043010752688172046	GO:0006399	GO:BP	tRNA metabolic process	16175	2160		0.4	0.45454545454545453	186	15989	8	6	178	15983	16175	0.15457537075671327
M1	string	0	network_modules	349	TRUE	1.621653694276846e-7	566	14	9	0.6428571428571429	0.015901060070671377	GO:0006412	GO:BP	translation	16175	2170		0.5	0.5454545454545454	566	15609	9	5	557	15604	16175	0.09736110222722232
M1	string	0	network_modules	349	TRUE	8.918977271069437e-4	2	14	2	0.14285714285714285	1	GO:0009785	GO:BP	blue light signaling pathway	16175	3672		0.6	1	2	16173	2	12	0	16161	16175	0.377824226446696
M1	string	0	network_modules	349	TRUE	8.918977271069437e-4	2	14	2	0.14285714285714285	1	GO:0015960	GO:BP	diadenosine polyphosphate biosynthetic process	16175	5041		0.6	1	2	16173	2	12	0	16161	16175	0.377824226446696
M1	string	0	network_modules	349	TRUE	8.918977271069437e-4	2	14	2	0.14285714285714285	1	GO:0015965	GO:BP	diadenosine tetraphosphate metabolic process	16175	5046		0.6	1	2	16173	2	12	0	16161	16175	0.377824226446696
M1	string	0	network_modules	349	TRUE	8.918977271069437e-4	2	14	2	0.14285714285714285	1	GO:0015966	GO:BP	diadenosine tetraphosphate biosynthetic process	16175	5047		0.6	1	2	16173	2	12	0	16161	16175	0.377824226446696
M1	string	0	network_modules	349	TRUE	8.918977271069437e-4	2	14	2	0.14285714285714285	1	GO:0071483	GO:BP	cellular response to blue light	16175	16716		0.6	1	2	16173	2	12	0	16161	16175	0.377824226446696
M1	string	0	network_modules	350	TRUE	1.6274539937767135e-5	790	16	9	0.5625	0.01139240506329114	GO:0007167	GO:BP	enzyme-linked receptor protein signaling pathway	16175	2731		0	0.125	790	15385	9	7	781	15378	16175	0.0749911152138415
M1	string	0	network_modules	350	TRUE	4.418389921243977e-5	301	11	6	0.5454545454545454	0.019933554817275746	KEGG:04010	KEGG	MAPK signaling pathway	8484	243		0	0.5	301	8183	6	5	295	8178	8484	0.0993318701233904
M1	string	0	network_modules	350	TRUE	3.40654240728571e-4	510	16	7	0.4375	0.013725490196078431	GO:0007169	GO:BP	cell surface receptor protein tyrosine kinase signaling pathway	16175	2733		0.14285714285714285	0.25	510	15665	7	9	503	15656	16175	0.07310389979134585
M1	string	0	network_modules	350	TRUE	9.661843839516553e-4	595	16	7	0.4375	0.011764705882352941	GO:0000165	GO:BP	MAPK cascade	16175	55		0.2857142857142857	0.375	595	15580	7	9	588	15571	16175	0.0669869577472881
M1	string	0	network_modules	350	TRUE	0.001655255470834646	86	16	4	0.25	0.046511627906976744	GO:0090263	GO:BP	positive regulation of canonical Wnt signaling pathway	16175	18152		0.42857142857142855	0.5	86	16089	4	12	82	16077	16175	0.10587352111077508
M1	string	0	network_modules	350	TRUE	0.0031542440856819048	101	16	4	0.25	0.039603960396039604	GO:0010976	GO:BP	positive regulation of neuron projection development	16175	4552		0.5714285714285714	0.625	101	16074	4	12	97	16062	16175	0.09737093097712603
M1	string	0	network_modules	350	TRUE	0.003684159268659424	105	16	4	0.25	0.0380952380952381	GO:0006470	GO:BP	protein dephosphorylation	16175	2209		0.7142857142857143	0.75	105	16070	4	12	101	16058	16175	0.09541322581693153
M1	string	0	network_modules	350	TRUE	0.004956544238623312	70	11	3	0.2727272727272727	0.04285714285714286	KEGG:05230	KEGG	Central carbon metabolism in cancer	8484	478		1	1	70	8414	3	8	67	8406	8484	0.10534529129174183
M1	string	0	network_modules	350	TRUE	0.005296528527515366	115	16	4	0.25	0.034782608695652174	GO:0030177	GO:BP	positive regulation of Wnt signaling pathway	16175	6697		0.8571428571428571	0.875	115	16060	4	12	111	16048	16175	0.09096733133974085
M1	string	0	network_modules	350	TRUE	0.009333600842592396	530	16	6	0.375	0.011320754716981131	GO:0043408	GO:BP	regulation of MAPK cascade	16175	10676		1	1	530	15645	6	10	524	15635	16175	0.0604914081471519
M1	string	0	network_modules	351	TRUE	1.6829261704169044e-6	56	15	5	0.3333333333333333	0.08928571428571429	GO:0043299	GO:BP	leukocyte degranulation	16175	10607		0	0.022222222222222223	56	16119	5	10	51	16109	16175	0.1711002248957157
M1	string	0	network_modules	351	TRUE	6.113617244428359e-6	72	15	5	0.3333333333333333	0.06944444444444445	GO:0002444	GO:BP	myeloid leukocyte mediated immunity	16175	967		0.022727272727272728	0.044444444444444446	72	16103	5	10	67	16093	16175	0.1505184462629882
M1	string	0	network_modules	351	TRUE	1.4236657168226948e-5	85	15	5	0.3333333333333333	0.058823529411764705	GO:0034109	GO:BP	homotypic cell-cell adhesion	16175	8417		0.045454545454545456	0.06666666666666667	85	16090	5	10	80	16080	16175	0.13824813302725267
M1	string	0	network_modules	351	TRUE	1.779199090926017e-5	96	14	5	0.35714285714285715	0.052083333333333336	KEGG:04666	KEGG	Fc gamma R-mediated phagocytosis	8484	341		0	0.2	96	8388	5	9	91	8379	8484	0.13292834410732707
M1	string	0	network_modules	351	TRUE	1.9881732084218552e-5	35	13	4	0.3076923076923077	0.11428571428571428	REAC:R-HSA-114604	REAC	GPVI-mediated activation cascade	10916	1021		NA	1	35	10881	4	9	31	10872	10916	0.18597779996168648
M1	string	0	network_modules	351	TRUE	2.6783824775235827e-5	33	15	4	0.26666666666666666	0.12121212121212122	GO:0034110	GO:BP	regulation of homotypic cell-cell adhesion	16175	8418		0.06818181818181818	0.08888888888888889	33	16142	4	11	29	16131	16175	0.17867627965303068
M1	string	0	network_modules	351	TRUE	3.0338468909847257e-5	34	15	4	0.26666666666666666	0.11764705882352941	GO:0043300	GO:BP	regulation of leukocyte degranulation	16175	10608		0.09090909090909091	0.1111111111111111	34	16141	4	11	30	16130	16175	0.1759934037257069
M1	string	0	network_modules	351	TRUE	3.1643686159610706e-5	386	15	7	0.4666666666666667	0.018134715025906734	GO:0022407	GO:BP	regulation of cell-cell adhesion	16175	6598		0.11363636363636363	0.13333333333333333	386	15789	7	8	379	15781	16175	0.08839109534354242
M1	string	0	network_modules	351	TRUE	3.218320555001659e-5	622	15	8	0.5333333333333333	0.012861736334405145	GO:0030155	GO:BP	regulation of cell adhesion	16175	6688		0.13636363636363635	0.15555555555555556	622	15553	8	7	614	15546	16175	0.0784090017124683
M1	string	0	network_modules	351	TRUE	4.818352141491114e-5	38	15	4	0.26666666666666666	0.10526315789473684	GO:0002886	GO:BP	regulation of myeloid leukocyte mediated immunity	16175	1396		0.1590909090909091	0.17777777777777778	38	16137	4	11	34	16126	16175	0.16633809920408937
M1	string	0	network_modules	351	TRUE	6.392017209252825e-5	124	14	5	0.35714285714285715	0.04032258064516129	KEGG:04611	KEGG	Platelet activation	8484	321		0.25	0.4	124	8360	5	9	119	8351	8484	0.11603899034056711
M1	string	0	network_modules	351	TRUE	7.755591045343873e-5	249	15	6	0.4	0.024096385542168676	GO:0050878	GO:BP	regulation of body fluid levels	16175	13323		0.18181818181818182	0.2	249	15926	6	9	243	15917	16175	0.0951770244985796
M1	string	0	network_modules	351	TRUE	1.307727967796295e-4	745	15	8	0.5333333333333333	0.010738255033557046	GO:0098609	GO:BP	cell-cell adhesion	16175	18805		0.20454545454545456	0.2222222222222222	745	15430	8	7	737	15423	16175	0.07082423879969722
M1	string	0	network_modules	351	TRUE	2.2057417694512212e-4	55	15	4	0.26666666666666666	0.07272727272727272	GO:0050853	GO:BP	B cell receptor signaling pathway	16175	13301		0.22727272727272727	0.24444444444444444	55	16120	4	11	51	16109	16175	0.13778461971517778
M1	string	0	network_modules	351	TRUE	3.532983040474942e-4	161	15	5	0.3333333333333333	0.031055900621118012	GO:0045055	GO:BP	regulated exocytosis	16175	11253		0.25	0.26666666666666666	161	16014	5	10	156	16004	16175	0.0992474017465455
M1	string	0	network_modules	351	TRUE	3.59406906031334e-4	62	15	4	0.26666666666666666	0.06451612903225806	GO:0070527	GO:BP	platelet aggregation	16175	16166		0.2727272727272727	0.28888888888888886	62	16113	4	11	58	16102	16175	0.129588380063352
M1	string	0	network_modules	351	TRUE	3.8356428429046056e-4	63	15	4	0.26666666666666666	0.06349206349206349	GO:0002275	GO:BP	myeloid cell activation involved in immune response	16175	807		0.29545454545454547	0.3111111111111111	63	16112	4	11	59	16101	16175	0.12852953638209216
M1	string	0	network_modules	351	TRUE	4.139549519370891e-4	81	14	4	0.2857142857142857	0.04938271604938271	KEGG:04662	KEGG	B cell receptor signaling pathway	8484	339		0.5	0.6	81	8403	4	10	77	8393	8484	0.11546089245629873
M1	string	0	network_modules	351	TRUE	4.2386776150290964e-4	167	15	5	0.3333333333333333	0.029940119760479042	GO:0002274	GO:BP	myeloid leukocyte activation	16175	806		0.3181818181818182	0.3333333333333333	167	16008	5	10	162	15998	16175	0.09735466476181356
M1	string	0	network_modules	351	TRUE	5.98389164904356e-4	179	15	5	0.3333333333333333	0.027932960893854747	GO:0007596	GO:BP	blood coagulation	16175	3055		0.3409090909090909	0.35555555555555557	179	15996	5	10	174	15986	16175	0.09385397956611004
M1	string	0	network_modules	351	TRUE	6.04646915351773e-4	17	15	3	0.2	0.17647058823529413	GO:0050855	GO:BP	regulation of B cell receptor signaling pathway	16175	13303		0.36363636363636365	0.4	17	16158	3	12	14	16146	16175	0.1870650819268692
M1	string	0	network_modules	351	TRUE	6.04646915351773e-4	17	15	3	0.2	0.17647058823529413	GO:0002862	GO:BP	negative regulation of inflammatory response to antigenic stimulus	16175	1372		0.36363636363636365	0.4	17	16158	3	12	14	16146	16175	0.1870650819268692
M1	string	0	network_modules	351	TRUE	6.677467416566472e-4	183	15	5	0.3333333333333333	0.0273224043715847	GO:0050817	GO:BP	coagulation	16175	13279		0.4090909090909091	0.4222222222222222	183	15992	5	10	178	15982	16175	0.09276295635340238
M1	string	0	network_modules	351	TRUE	7.047336085150355e-4	185	15	5	0.3333333333333333	0.02702702702702703	GO:0007599	GO:BP	hemostasis	16175	3058		0.4318181818181818	0.4444444444444444	185	15990	5	10	180	15980	16175	0.09223051423168709
M1	string	0	network_modules	351	TRUE	0.0012587298613800087	208	15	5	0.3333333333333333	0.02403846153846154	GO:0046651	GO:BP	lymphocyte proliferation	16175	12287		0.45454545454545453	0.4666666666666667	208	15967	5	10	203	15957	16175	0.08666000062539521
M1	string	0	network_modules	351	TRUE	0.0013509909899711025	211	15	5	0.3333333333333333	0.023696682464454975	GO:0032943	GO:BP	mononuclear cell proliferation	16175	7928		0.4772727272727273	0.4888888888888889	211	15964	5	10	206	15954	16175	0.08600001242880032
M1	string	0	network_modules	351	TRUE	0.0014146716400874949	87	15	4	0.26666666666666666	0.04597701149425287	GO:1903305	GO:BP	regulation of regulated secretory pathway	16175	22892		0.5	0.5111111111111111	87	16088	4	11	83	16077	16175	0.10883737115250446
M1	string	0	network_modules	351	TRUE	0.00151657501507535	216	15	5	0.3333333333333333	0.023148148148148147	GO:0002366	GO:BP	leukocyte activation involved in immune response	16175	898		0.5227272727272727	0.5333333333333333	216	15959	5	10	211	15949	16175	0.08493008068142911
M1	string	0	network_modules	351	TRUE	0.001694916923573971	91	15	4	0.26666666666666666	0.04395604395604396	GO:0050864	GO:BP	regulation of B cell activation	16175	13312		0.5454545454545454	0.5555555555555556	91	16084	4	11	87	16073	16175	0.1063309609490873
M1	string	0	network_modules	351	TRUE	0.0016978106077437192	221	15	5	0.3333333333333333	0.02262443438914027	GO:0002263	GO:BP	cell activation involved in immune response	16175	795		0.5681818181818182	0.5777777777777777	221	15954	5	10	216	15944	16175	0.08389586612084654
M1	string	0	network_modules	351	TRUE	0.0018020920667734732	699	15	7	0.4666666666666667	0.010014306151645207	GO:0045321	GO:BP	leukocyte activation	16175	11356		0.5909090909090909	0.6	699	15476	7	8	692	15468	16175	0.06344615461679795
M1	string	0	network_modules	351	TRUE	0.0020360398401146227	25	15	3	0.2	0.12	GO:0002861	GO:BP	regulation of inflammatory response to antigenic stimulus	16175	1371		0.6136363636363636	0.6222222222222222	25	16150	3	12	22	16138	16175	0.15391243747171574
M1	string	0	network_modules	351	TRUE	0.0023003290226343157	26	15	3	0.2	0.11538461538461539	GO:0090330	GO:BP	regulation of platelet aggregation	16175	18210		0.6363636363636364	0.6444444444444445	26	16149	3	12	23	16137	16175	0.15088121656469844
M1	string	0	network_modules	351	TRUE	0.0023462094634617617	236	15	5	0.3333333333333333	0.0211864406779661	GO:0070661	GO:BP	leukocyte proliferation	16175	16242		0.6590909090909091	0.6666666666666666	236	15939	5	10	231	15929	16175	0.0809884794701507
M1	string	0	network_modules	351	TRUE	0.0025864295500052786	27	15	3	0.2	0.1111111111111111	GO:0038094	GO:BP	Fc-gamma receptor signaling pathway	16175	9694		0.6818181818181818	0.6888888888888889	27	16148	3	12	24	16136	16175	0.14801920198550775
M1	string	0	network_modules	351	TRUE	0.0031635595265677406	468	15	6	0.4	0.01282051282051282	GO:0050865	GO:BP	regulation of cell activation	16175	13313		0.7045454545454546	0.7111111111111111	468	15707	6	9	462	15698	16175	0.06744525391026672
M1	string	0	network_modules	351	TRUE	0.0035665630987712148	257	15	5	0.3333333333333333	0.019455252918287938	GO:0022409	GO:BP	positive regulation of cell-cell adhesion	16175	6600		0.7272727272727273	0.7333333333333333	257	15918	5	10	252	15908	16175	0.07734395832016565
M1	string	0	network_modules	351	TRUE	0.003993895777606852	263	15	5	0.3333333333333333	0.019011406844106463	GO:0006887	GO:BP	exocytosis	16175	2543		0.75	0.7555555555555555	263	15912	5	10	258	15902	16175	0.07638167279327282
M1	string	0	network_modules	351	TRUE	0.004327144012510869	115	15	4	0.26666666666666666	0.034782608695652174	GO:0030168	GO:BP	platelet activation	16175	6695		0.7727272727272727	0.7777777777777778	115	16060	4	11	111	16049	16175	0.09411962275114966
M1	string	0	network_modules	351	TRUE	0.004373682735449354	32	15	3	0.2	0.09375	GO:0043303	GO:BP	mast cell degranulation	16175	10611		0.7954545454545454	0.8	32	16143	3	12	29	16131	16175	0.135773426201086
M1	string	0	network_modules	351	TRUE	0.004808372626516765	33	15	3	0.2	0.09090909090909091	GO:0002279	GO:BP	mast cell activation involved in immune response	16175	811		0.8181818181818182	0.8666666666666667	33	16142	3	12	30	16130	16175	0.13366282550790537
M1	string	0	network_modules	351	TRUE	0.004808372626516765	33	15	3	0.2	0.09090909090909091	GO:0002448	GO:BP	mast cell mediated immunity	16175	971		0.8181818181818182	0.8666666666666667	33	16142	3	12	30	16130	16175	0.13366282550790537
M1	string	0	network_modules	351	TRUE	0.004808372626516765	33	15	3	0.2	0.09090909090909091	GO:0042119	GO:BP	neutrophil activation	16175	9975		0.8181818181818182	0.8666666666666667	33	16142	3	12	30	16130	16175	0.13366282550790537
M1	string	0	network_modules	351	TRUE	0.005058365078886247	276	15	5	0.3333333333333333	0.018115942028985508	GO:0002697	GO:BP	regulation of immune effector process	16175	1215		0.8863636363636364	0.8888888888888888	276	15899	5	10	271	15889	16175	0.07440253691441596
M1	string	0	network_modules	351	TRUE	0.006935267581397705	536	15	6	0.4	0.011194029850746268	GO:0002252	GO:BP	immune effector process	16175	784		0.9090909090909091	0.9111111111111111	536	15639	6	9	530	15630	16175	0.06244326578767309
M1	string	0	network_modules	351	TRUE	0.008590318728663018	175	14	4	0.2857142857142857	0.022857142857142857	KEGG:05152	KEGG	Tuberculosis	8484	440		0.75	0.8	175	8309	4	10	171	8299	8484	0.07582603801777509
M1	string	0	network_modules	351	TRUE	0.009286679312582806	67	14	3	0.21428571428571427	0.04477611940298507	KEGG:04664	KEGG	Fc epsilon RI signaling pathway	8484	340		1	1	67	8417	3	11	64	8406	8484	0.09479651983172357
M1	string	0	network_modules	351	TRUE	0.009352895688694907	41	15	3	0.2	0.07317073170731707	GO:0045576	GO:BP	mast cell activation	16175	11427		0.9318181818181818	0.9777777777777777	41	16134	3	12	38	16122	16175	0.11964564862587004
M1	string	0	network_modules	351	TRUE	0.009352895688694907	41	15	3	0.2	0.07317073170731707	GO:0036230	GO:BP	granulocyte activation	16175	9504		0.9318181818181818	0.9777777777777777	41	16134	3	12	38	16122	16175	0.11964564862587004
M1	string	0	network_modules	351	TRUE	0.009352895688694907	41	15	3	0.2	0.07317073170731707	GO:0033628	GO:BP	regulation of cell adhesion mediated by integrin	16175	8329		0.9318181818181818	0.9777777777777777	41	16134	3	12	38	16122	16175	0.11964564862587004
M1	string	0	network_modules	351	TRUE	0.009782529892186014	569	15	6	0.4	0.01054481546572935	GO:0046649	GO:BP	lymphocyte activation	16175	12286		1	1	569	15606	6	9	563	15597	16175	0.06033212628981022
M1	string	0	network_modules	352	TRUE	3.079316495345114e-11	157	10	8	0.8	0.050955414012738856	KEGG:04390	KEGG	Hippo signaling pathway	8484	310		0	0.5	157	8327	8	2	149	8325	8484	0.19919952143866845
M1	string	0	network_modules	352	TRUE	2.8581664071732767e-9	44	16	6	0.375	0.13636363636363635	GO:0035329	GO:BP	hippo signaling	16175	8973		0	0.1111111111111111	44	16131	6	10	38	16121	16175	0.22491036641624298
M1	string	0	network_modules	352	TRUE	4.959368519572764e-9	29	10	5	0.5	0.1724137931034483	KEGG:04392	KEGG	Hippo signaling pathway - multiple species	8484	312		1	1	29	8455	5	5	24	8450	8484	0.29227483524827186
M1	string	0	network_modules	352	TRUE	9.96501567494904e-5	118	16	5	0.3125	0.0423728813559322	GO:0090090	GO:BP	negative regulation of canonical Wnt signaling pathway	16175	18011		0.125	0.2222222222222222	118	16057	5	11	113	16046	16175	0.11285353830370536
M1	string	0	network_modules	352	TRUE	2.89154249177342e-4	146	16	5	0.3125	0.03424657534246575	GO:0030178	GO:BP	negative regulation of Wnt signaling pathway	16175	6698		0.25	0.3333333333333333	146	16029	5	11	141	16018	16175	0.10096910186353164
M1	string	0	network_modules	352	TRUE	2.8985905863507597e-4	19	12	3	0.25	0.15789473684210525	REAC:R-HSA-2028269	REAC	Signaling by Hippo	10916	2259		0	0.5	19	10897	3	9	16	10888	10916	0.19757715000289244
M1	string	0	network_modules	352	TRUE	8.232914002026105e-4	18	16	3	0.1875	0.16666666666666666	GO:0035278	GO:BP	miRNA-mediated gene silencing by inhibition of translation	16175	8938		0.375	0.4444444444444444	18	16157	3	13	15	16144	16175	0.17591239566271397
M1	string	0	network_modules	352	TRUE	9.661843839516553e-4	595	16	7	0.4375	0.011764705882352941	GO:0051248	GO:BP	negative regulation of protein metabolic process	16175	13595		0.5	0.5555555555555556	595	15580	7	9	588	15571	16175	0.0669869577472881
M1	string	0	network_modules	352	TRUE	0.0018370108669239706	212	16	5	0.3125	0.02358490566037736	GO:0060828	GO:BP	regulation of canonical Wnt signaling pathway	16175	14976		0.625	0.6666666666666666	212	15963	5	11	207	15952	16175	0.08283502513697319
M1	string	0	network_modules	352	TRUE	0.0033854734483685666	42	12	3	0.25	0.07142857142857142	REAC:R-HSA-9696264	REAC	RND3 GTPase cycle	10916	1907		1	1	42	10874	3	9	39	10865	10916	0.13190038357704287
M1	string	0	network_modules	352	TRUE	0.004436209638382162	110	16	4	0.25	0.03636363636363636	GO:0017148	GO:BP	negative regulation of translation	16175	5285		0.75	0.7777777777777778	110	16065	4	12	106	16053	16175	0.09311567573240728
M1	string	0	network_modules	352	TRUE	0.004726685560451098	257	16	5	0.3125	0.019455252918287938	GO:0060070	GO:BP	canonical Wnt signaling pathway	16175	14332		0.875	0.8888888888888888	257	15918	5	11	252	15907	16175	0.07464038924265136
M1	string	0	network_modules	352	TRUE	0.006816340922384554	277	16	5	0.3125	0.018050541516245487	GO:0030111	GO:BP	regulation of Wnt signaling pathway	16175	6681		1	1	277	15898	5	11	272	15887	16175	0.0716406239925133
M1	string	0	network_modules	353	TRUE	2.7755589711870587e-25	43	14	12	0.8571428571428571	0.27906976744186046	KEGG:03022	KEGG	Basal transcription factors	8484	213		0	0.3333333333333333	43	8441	12	2	31	8439	8484	0.48783096035412365
M1	string	0	network_modules	353	TRUE	9.291761939923173e-25	46	15	12	0.8	0.2608695652173913	REAC:R-HSA-76042	REAC	RNA Polymerase II Transcription Initiation And Promoter Clearance	10916	1893		0	0.13333333333333333	46	10870	12	3	34	10867	10916	0.4556995445208534
M1	string	0	network_modules	353	TRUE	9.291761939923173e-25	46	15	12	0.8	0.2608695652173913	REAC:R-HSA-167161	REAC	HIV Transcription Initiation	10916	1105		0	0.13333333333333333	46	10870	12	3	34	10867	10916	0.4556995445208534
M1	string	0	network_modules	353	TRUE	9.291761939923173e-25	46	15	12	0.8	0.2608695652173913	REAC:R-HSA-167162	REAC	RNA Polymerase II HIV Promoter Escape	10916	1887		0	0.13333333333333333	46	10870	12	3	34	10867	10916	0.4556995445208534
M1	string	0	network_modules	353	TRUE	9.291761939923173e-25	46	15	12	0.8	0.2608695652173913	REAC:R-HSA-73776	REAC	RNA Polymerase II Promoter Escape	10916	1889		0	0.13333333333333333	46	10870	12	3	34	10867	10916	0.4556995445208534
M1	string	0	network_modules	353	TRUE	9.291761939923173e-25	46	15	12	0.8	0.2608695652173913	REAC:R-HSA-75953	REAC	RNA Polymerase II Transcription Initiation	10916	1892		0	0.13333333333333333	46	10870	12	3	34	10867	10916	0.4556995445208534
M1	string	0	network_modules	353	TRUE	9.291761939923173e-25	46	15	12	0.8	0.2608695652173913	REAC:R-HSA-73779	REAC	RNA Polymerase II Transcription Pre-Initiation And Promoter Opening	10916	1894		0	0.13333333333333333	46	10870	12	3	34	10867	10916	0.4556995445208534
M1	string	0	network_modules	353	TRUE	2.0927130490596859e-22	69	15	12	0.8	0.17391304347826086	REAC:R-HSA-167172	REAC	Transcription of the HIV genome	10916	2540		0.13636363636363635	0.15555555555555556	69	10847	12	3	57	10844	10916	0.3714851969044934
M1	string	0	network_modules	353	TRUE	1.4262523333684163e-21	80	15	12	0.8	0.15	REAC:R-HSA-674695	REAC	RNA Polymerase II Pre-transcription Events	10916	1888		0.1590909090909091	0.17777777777777778	80	10836	12	3	68	10833	10916	0.34473837775111843
M1	string	0	network_modules	353	TRUE	8.067331057534272e-19	26	15	9	0.6	0.34615384615384615	REAC:R-HSA-77075	REAC	RNA Pol II CTD phosphorylation and interaction with CE	10916	1879		0.18181818181818182	0.2222222222222222	26	10890	9	6	17	10884	10916	0.45477770938893636
M1	string	0	network_modules	353	TRUE	8.067331057534272e-19	26	15	9	0.6	0.34615384615384615	REAC:R-HSA-167160	REAC	RNA Pol II CTD phosphorylation and interaction with CE during HIV infection	10916	1880		0.18181818181818182	0.2222222222222222	26	10890	9	6	17	10884	10916	0.45477770938893636
M1	string	0	network_modules	353	TRUE	8.152480504836706e-19	132	15	12	0.8	0.09090909090909091	REAC:R-HSA-162599	REAC	Late Phase of HIV Life Cycle	10916	1304		0.22727272727272727	0.24444444444444444	132	10784	12	3	120	10781	10916	0.2674080046326517
M1	string	0	network_modules	353	TRUE	1.7815369642376705e-18	28	15	9	0.6	0.32142857142857145	REAC:R-HSA-72086	REAC	mRNA Capping	10916	2702		0.25	0.26666666666666666	28	10888	9	6	19	10882	10916	0.43814064770144195
M1	string	0	network_modules	353	TRUE	2.630206756506573e-18	145	15	12	0.8	0.08275862068965517	REAC:R-HSA-162587	REAC	HIV Life Cycle	10916	1103		0.2727272727272727	0.28888888888888886	145	10771	12	3	133	10768	10916	0.2549073554035443
M1	string	0	network_modules	353	TRUE	7.220450422174354e-18	32	15	9	0.6	0.28125	REAC:R-HSA-113418	REAC	Formation of the Early Elongation Complex	10916	963		0.29545454545454547	0.3333333333333333	32	10884	9	6	23	10878	10916	0.40966692996612913
M1	string	0	network_modules	353	TRUE	7.220450422174354e-18	32	15	9	0.6	0.28125	REAC:R-HSA-167158	REAC	Formation of the HIV-1 Early Elongation Complex	10916	965		0.29545454545454547	0.3333333333333333	32	10884	9	6	23	10878	10916	0.40966692996612913
M1	string	0	network_modules	353	TRUE	1.1421526552071545e-16	42	15	9	0.6	0.21428571428571427	REAC:R-HSA-167169	REAC	HIV Transcription Elongation	10916	1104		0.3409090909090909	0.4	42	10874	9	6	33	10868	10916	0.35720209770142164
M1	string	0	network_modules	353	TRUE	1.1421526552071545e-16	42	15	9	0.6	0.21428571428571427	REAC:R-HSA-167246	REAC	Tat-mediated elongation of the HIV-1 transcript	10916	2485		0.3409090909090909	0.4	42	10874	9	6	33	10868	10916	0.35720209770142164
M1	string	0	network_modules	353	TRUE	1.1421526552071545e-16	42	15	9	0.6	0.21428571428571427	REAC:R-HSA-167200	REAC	Formation of HIV-1 elongation complex containing HIV-1 Tat	10916	947		0.3409090909090909	0.4	42	10874	9	6	33	10868	10916	0.35720209770142164
M1	string	0	network_modules	353	TRUE	1.4437701700124643e-16	43	15	9	0.6	0.20930232558139536	REAC:R-HSA-5696395	REAC	Formation of Incision Complex in GG-NER	10916	948		0.4090909090909091	0.4222222222222222	43	10873	9	6	34	10867	10916	0.35298613479764634
M1	string	0	network_modules	353	TRUE	1.8141243472949699e-16	44	15	9	0.6	0.20454545454545456	REAC:R-HSA-167152	REAC	Formation of HIV elongation complex in the absence of HIV Tat	10916	946		0.4318181818181818	0.4444444444444444	44	10872	9	6	35	10866	10916	0.34891428995817036
M1	string	0	network_modules	353	TRUE	5.947187247857699e-16	225	15	12	0.8	0.05333333333333334	REAC:R-HSA-162906	REAC	HIV Infection	10916	1102		0.45454545454545453	0.4666666666666667	225	10691	12	3	213	10688	10916	0.20348355099344986
M1	string	0	network_modules	353	TRUE	2.2873374252259573e-15	57	15	9	0.6	0.15789473684210525	REAC:R-HSA-75955	REAC	RNA Polymerase II Transcription Elongation	10916	1891		0.4772727272727273	0.5111111111111111	57	10859	9	6	48	10853	10916	0.30612497504366976
M1	string	0	network_modules	353	TRUE	2.2873374252259573e-15	57	15	9	0.6	0.15789473684210525	REAC:R-HSA-112382	REAC	Formation of RNA Pol II elongation complex 	10916	949		0.4772727272727273	0.5111111111111111	57	10859	9	6	48	10853	10916	0.30612497504366976
M1	string	0	network_modules	353	TRUE	3.1166151766286272e-15	61	14	9	0.6428571428571429	0.14754098360655737	KEGG:03420	KEGG	Nucleotide excision repair	8484	238		0.5	0.6666666666666666	61	8423	9	5	52	8418	8484	0.30588234790828106
M1	string	0	network_modules	353	TRUE	3.1590068483177003e-15	31	15	8	0.5333333333333333	0.25806451612903225	REAC:R-HSA-73863	REAC	RNA Polymerase I Transcription Termination	10916	1886		0.5227272727272727	0.5333333333333333	31	10885	8	7	23	10878	10916	0.36979493771925603
M1	string	0	network_modules	353	TRUE	4.400358827841223e-15	61	15	9	0.6	0.14754098360655737	REAC:R-HSA-6796648	REAC	TP53 Regulates Transcription of DNA Repair Genes	10916	2456		0.5454545454545454	0.5555555555555556	61	10855	9	6	52	10849	10916	0.29579009748889556
M1	string	0	network_modules	353	TRUE	6.97782520026479e-15	64	15	9	0.6	0.140625	REAC:R-HSA-6782135	REAC	Dual incision in TC-NER	10916	808		0.5681818181818182	0.5777777777777777	64	10852	9	6	55	10846	10916	0.28868069366112575
M1	string	0	network_modules	353	TRUE	4.0609972836416945e-14	77	15	9	0.6	0.11688311688311688	REAC:R-HSA-6781827	REAC	Transcription-Coupled Nucleotide Excision Repair (TC-NER)	10916	2541		0.5909090909090909	0.6	77	10839	9	6	68	10833	10916	0.2628156712341033
M1	string	0	network_modules	353	TRUE	9.234914936260924e-14	84	15	9	0.6	0.10714285714285714	REAC:R-HSA-5696399	REAC	Global Genome Nucleotide Excision Repair (GG-NER)	10916	1047		0.6136363636363636	0.6222222222222222	84	10832	9	6	75	10826	10916	0.25143592187900177
M1	string	0	network_modules	353	TRUE	1.24776183738582e-13	47	15	8	0.5333333333333333	0.1702127659574468	REAC:R-HSA-73762	REAC	RNA Polymerase I Transcription Initiation	10916	1885		0.6363636363636364	0.6444444444444445	47	10869	8	7	39	10862	10916	0.29971653134154047
M1	string	0	network_modules	353	TRUE	2.977524944887647e-13	52	15	8	0.5333333333333333	0.15384615384615385	REAC:R-HSA-6781823	REAC	Formation of TC-NER Pre-Incision Complex	10916	951		0.6590909090909091	0.6666666666666666	52	10864	8	7	44	10857	10916	0.2847617719953899
M1	string	0	network_modules	353	TRUE	1.0562538635072548e-12	109	15	9	0.6	0.08256880733944955	REAC:R-HSA-5696398	REAC	Nucleotide Excision Repair	10916	1622		0.6818181818181818	0.6888888888888889	109	10807	9	6	100	10801	10916	0.22012682150822335
M1	string	0	network_modules	353	TRUE	1.5227430559674932e-12	63	15	8	0.5333333333333333	0.12698412698412698	REAC:R-HSA-6782210	REAC	Gap-filling DNA repair synthesis and ligation in TC-NER	10916	1038		0.7045454545454546	0.7111111111111111	63	10853	8	7	55	10846	10916	0.25834752602334404
M1	string	0	network_modules	353	TRUE	3.000920171090113e-11	90	15	8	0.5333333333333333	0.08888888888888889	REAC:R-HSA-73772	REAC	RNA Polymerase I Promoter Escape	10916	1882		0.7272727272727273	0.7333333333333333	90	10826	8	7	82	10819	10916	0.2154037565779884
M1	string	0	network_modules	353	TRUE	1.0701527581817833e-10	105	15	8	0.5333333333333333	0.0761904761904762	REAC:R-HSA-427413	REAC	NoRC negatively regulates rRNA expression	10916	1602		0.75	0.7555555555555555	105	10811	8	7	97	10804	10916	0.19904118099337945
M1	string	0	network_modules	353	TRUE	1.348804364780139e-10	108	15	8	0.5333333333333333	0.07407407407407407	REAC:R-HSA-5250941	REAC	Negative epigenetic regulation of rRNA expression	10916	1566		0.7727272727272727	0.7777777777777778	108	10808	8	7	100	10801	10916	0.19618148419935655
M1	string	0	network_modules	353	TRUE	1.4548037173460805e-10	109	15	8	0.5333333333333333	0.07339449541284404	REAC:R-HSA-73854	REAC	RNA Polymerase I Promoter Clearance	10916	1881		0.7954545454545454	0.8	109	10807	8	7	101	10800	10916	0.19525435223948268
M1	string	0	network_modules	353	TRUE	1.5680041646239319e-10	110	15	8	0.5333333333333333	0.07272727272727272	REAC:R-HSA-73864	REAC	RNA Polymerase I Transcription	10916	1884		0.8181818181818182	0.8222222222222222	110	10806	8	7	102	10799	10916	0.19433977544728137
M1	string	0	network_modules	353	TRUE	4.464315922511433e-10	329	15	10	0.6666666666666666	0.030395136778115502	REAC:R-HSA-73894	REAC	DNA Repair	10916	444		0.8409090909090909	0.8444444444444444	329	10587	10	5	319	10582	10916	0.1381047763603404
M1	string	0	network_modules	353	TRUE	4.761296331158656e-10	143	16	8	0.5	0.055944055944055944	GO:0006367	GO:BP	transcription initiation at RNA polymerase II promoter	16175	2142		0	0.14285714285714285	143	16032	8	8	135	16024	16175	0.16510394460740555
M1	string	0	network_modules	353	TRUE	2.232878732794754e-9	173	16	8	0.5	0.046242774566473986	GO:0006352	GO:BP	DNA-templated transcription initiation	16175	2129		0.16666666666666666	0.2857142857142857	173	16002	8	8	165	15994	16175	0.14968078414892177
M1	string	0	network_modules	353	TRUE	2.9418822158020623e-9	41	15	6	0.4	0.14634146341463414	REAC:R-HSA-5696400	REAC	Dual Incision in GG-NER	10916	807		0.8636363636363636	0.8666666666666667	41	10875	6	9	35	10866	10916	0.24028805078717635
M1	string	0	network_modules	353	TRUE	1.069815780943333e-8	185	15	8	0.5333333333333333	0.043243243243243246	REAC:R-HSA-212165	REAC	Epigenetic regulation of gene expression	10916	852		0.8863636363636364	0.8888888888888888	185	10731	8	7	177	10724	10916	0.14840353987066804
M1	string	0	network_modules	353	TRUE	5.388502329502644e-8	359	15	9	0.6	0.025069637883008356	REAC:R-HSA-3700989	REAC	Transcriptional Regulation by TP53	10916	2546		0.9090909090909091	0.9111111111111111	359	10557	9	6	350	10551	10916	0.11795808626755341
M1	string	0	network_modules	353	TRUE	1.1047104566357821e-7	79	16	6	0.375	0.0759493670886076	GO:0006289	GO:BP	nucleotide-excision repair	16175	2102		0.3333333333333333	0.42857142857142855	79	16096	6	10	73	16086	16175	0.1670560769523349
M1	string	0	network_modules	353	TRUE	1.0434282086917104e-5	73	15	5	0.3333333333333333	0.0684931506849315	REAC:R-HSA-6807505	REAC	RNA polymerase II transcribes snRNA genes	10916	1904		0.9318181818181818	0.9333333333333333	73	10843	5	10	68	10833	10916	0.1486678435084579
M1	string	0	network_modules	353	TRUE	1.6023017730278517e-5	528	16	8	0.5	0.015151515151515152	GO:0006281	GO:BP	DNA repair	16175	2095		0.5	0.5714285714285714	528	15647	8	8	520	15639	16175	0.082758635146134
M1	string	0	network_modules	353	TRUE	8.521187764943848e-5	9	16	3	0.1875	0.3333333333333333	GO:0006283	GO:BP	transcription-coupled nucleotide-excision repair	16175	2097		0.6666666666666666	0.7142857142857143	9	16166	3	13	6	16153	16175	0.24945089525338424
M1	string	0	network_modules	353	TRUE	3.928437302966889e-4	798	16	8	0.5	0.010025062656641603	GO:0006974	GO:BP	DNA damage response	16175	2601		0.8333333333333334	0.8571428571428571	798	15377	8	8	790	15369	16175	0.06548068866824666
M1	string	0	network_modules	353	TRUE	6.890477787619285e-4	201	14	5	0.35714285714285715	0.024875621890547265	KEGG:05203	KEGG	Viral carcinogenesis	8484	455		1	1	201	8283	5	9	196	8274	8484	0.0891381057435332
M1	string	0	network_modules	353	TRUE	0.0014911034402193993	25	15	3	0.2	0.12	REAC:R-HSA-69273	REAC	Cyclin A/B1/B2 associated events during G2/M transition	10916	418		0.9545454545454546	0.9555555555555556	25	10891	3	12	22	10879	10916	0.15342645994579163
M1	string	0	network_modules	353	TRUE	0.007966039481662454	286	16	5	0.3125	0.017482517482517484	GO:1901990	GO:BP	regulation of mitotic cell cycle phase transition	16175	21923		1	1	286	15889	5	11	281	15878	16175	0.07039151543760677
M1	string	0	network_modules	353	TRUE	0.00967214551340109	46	15	3	0.2	0.06521739130434782	REAC:R-HSA-69236	REAC	G1 Phase	10916	1000		0.9772727272727273	1	46	10870	3	12	43	10858	10916	0.11211505578003038
M1	string	0	network_modules	353	TRUE	0.00967214551340109	46	15	3	0.2	0.06521739130434782	REAC:R-HSA-69231	REAC	Cyclin D associated events in G1	10916	420		0.9772727272727273	1	46	10870	3	12	43	10858	10916	0.11211505578003038
M1	string	0	network_modules	355	TRUE	0.003598437294558145	60	9	3	0.3333333333333333	0.05	REAC:R-HSA-163841	REAC	Gamma carboxylation, hypusinylation, hydroxylation, and arylsulfatase activation	10916	1030		NA	1	60	10856	3	6	57	10850	10916	0.12737356485076975
M1	string	0	network_modules	357	TRUE	8.747917031875426e-4	504	12	6	0.5	0.011904761904761904	GO:0072657	GO:BP	protein localization to membrane	16175	17478		0	0.125	504	15671	6	6	498	15665	16175	0.07352511359072289
M1	string	0	network_modules	357	TRUE	0.0012913909892113356	112	12	4	0.3333333333333333	0.03571428571428571	GO:1904375	GO:BP	regulation of protein localization to cell periphery	16175	23762		0.14285714285714285	0.25	112	16063	4	8	108	16055	16175	0.10725407448676738
M1	string	0	network_modules	357	TRUE	0.0014670628346592658	285	12	5	0.4166666666666667	0.017543859649122806	GO:1990778	GO:BP	protein localization to cell periphery	16175	25286		0.2857142857142857	0.375	285	15890	5	7	280	15883	16175	0.08264440745025722
M1	string	0	network_modules	357	TRUE	0.0022869173401203376	594	12	6	0.5	0.010101010101010102	GO:0051668	GO:BP	localization within membrane	16175	13880		0.42857142857142855	0.5	594	15581	6	6	588	15575	16175	0.06711559766352702
M1	string	0	network_modules	357	TRUE	0.0035267809544591794	144	12	4	0.3333333333333333	0.027777777777777776	GO:1905475	GO:BP	regulation of protein localization to membrane	16175	24661		0.5714285714285714	0.625	144	16031	4	8	140	16023	16175	0.0941096859567921
M1	string	0	network_modules	357	TRUE	0.003922781218889589	292	7	4	0.5714285714285714	0.0136986301369863	REAC:R-HSA-9694516	REAC	SARS-CoV-2 Infection	10916	2122		0	0.3333333333333333	292	10624	4	3	288	10621	10916	0.08551161884302425
M1	string	0	network_modules	357	TRUE	0.006299194917464988	5	12	2	0.16666666666666666	0.4	GO:0098696	GO:BP	regulation of neurotransmitter receptor localization to postsynaptic specialization membrane	16175	18831		0.7142857142857143	0.75	5	16170	2	10	3	16160	16175	0.2578555143451957
M1	string	0	network_modules	357	TRUE	0.007609601569052462	14	7	2	0.2857142857142857	0.14285714285714285	REAC:R-HSA-3656237	REAC	Defective EXT2 causes exostoses 2	10916	539		0.5	1	14	10902	2	5	12	10897	10916	0.20131728516787525
M1	string	0	network_modules	357	TRUE	0.007609601569052462	14	7	2	0.2857142857142857	0.14285714285714285	REAC:R-HSA-3656253	REAC	Defective EXT1 causes exostoses 1, TRPS2 and CHDS	10916	538		0.5	1	14	10902	2	5	12	10897	10916	0.20131728516787525
M1	string	0	network_modules	357	TRUE	0.00944489755346404	6	12	2	0.16666666666666666	0.3333333333333333	GO:0099633	GO:BP	protein localization to postsynaptic specialization membrane	16175	19175		0.8571428571428571	1	6	16169	2	10	4	16159	16175	0.2353086011396884
M1	string	0	network_modules	357	TRUE	0.00944489755346404	6	12	2	0.16666666666666666	0.3333333333333333	GO:0099645	GO:BP	neurotransmitter receptor localization to postsynaptic specialization membrane	16175	19185		0.8571428571428571	1	6	16169	2	10	4	16159	16175	0.2353086011396884
M1	string	0	network_modules	358	TRUE	4.196456612751151e-4	2	13	2	0.15384615384615385	1	REAC:R-HSA-5683177	REAC	Defective ABCC8 can cause hypo- and hyper-glycemias	10916	467		0	0.5	2	10914	2	11	0	10903	10916	0.3920345589579044
M1	string	0	network_modules	358	TRUE	0.0025144915113140508	4	13	2	0.15384615384615385	0.5	REAC:R-HSA-1296025	REAC	ATP sensitive Potassium channels	10916	39		1	1	4	10912	2	11	2	10901	10916	0.2769051410026544
M1	string	0	network_modules	359	TRUE	3.9453663570137573e-4	23	11	3	0.2727272727272727	0.13043478260869565	REAC:R-HSA-2453902	REAC	The canonical retinoid cycle in rods (twilight vision)	10916	2499		NA	1	23	10893	3	8	20	10885	10916	0.18744320176274912
M1	string	0	network_modules	359	TRUE	0.0026743696454616496	3	14	2	0.14285714285714285	0.6666666666666666	GO:0048252	GO:BP	lauric acid metabolic process	16175	12608		0	0.5	3	16172	2	12	1	16160	16175	0.30836810188211866
M1	string	0	network_modules	359	TRUE	0.00451563721718892	128	14	4	0.2857142857142857	0.03125	GO:0120254	GO:BP	olefinic compound metabolic process	16175	19583		1	1	128	16047	4	10	124	16037	16175	0.09227962776590955
M1	string	0	network_modules	360	TRUE	2.2099516112255715e-21	67	12	11	0.9166666666666666	0.16417910447761194	KEGG:05204	KEGG	Chemical carcinogenesis - DNA adducts	8484	456		0	0.08333333333333333	67	8417	11	1	56	8416	8484	0.38639897223658537
M1	string	0	network_modules	360	TRUE	2.63614653526408e-21	68	12	11	0.9166666666666666	0.16176470588235295	KEGG:00830	KEGG	Retinol metabolism	8484	127		0.09090909090909091	0.25	68	8416	11	1	57	8415	8484	0.383520316761535
M1	string	0	network_modules	360	TRUE	2.63614653526408e-21	68	12	11	0.9166666666666666	0.16176470588235295	KEGG:00982	KEGG	Drug metabolism - cytochrome P450	8484	156		0.09090909090909091	0.25	68	8416	11	1	57	8415	8484	0.383520316761535
M1	string	0	network_modules	360	TRUE	7.182655259592726e-21	74	12	11	0.9166666666666666	0.14864864864864866	KEGG:00980	KEGG	Metabolism of xenobiotics by cytochrome P450	8484	154		0.2727272727272727	0.3333333333333333	74	8410	11	1	63	8409	8484	0.3674884462939984
M1	string	0	network_modules	360	TRUE	2.6438627181504098e-20	43	13	10	0.7692307692307693	0.23255813953488372	REAC:R-HSA-9749641	REAC	Aspirin ADME	10916	171		0	0.07692307692307693	43	10873	10	3	33	10870	10916	0.4218715321884368
M1	string	0	network_modules	360	TRUE	7.27826584624845e-19	116	14	11	0.7857142857142857	0.09482758620689655	GO:0006805	GO:BP	xenobiotic metabolic process	16175	2487		0	0.020833333333333332	116	16059	11	3	105	16056	16175	0.2715616251563432
M1	string	0	network_modules	360	TRUE	1.1659941557314025e-18	107	13	11	0.8461538461538461	0.102803738317757	REAC:R-HSA-9748784	REAC	Drug ADME	10916	796		0.08333333333333333	0.15384615384615385	107	10809	11	2	96	10807	10916	0.29313420950887914
M1	string	0	network_modules	360	TRUE	6.724477306381635e-18	21	14	8	0.5714285714285714	0.38095238095238093	GO:0052695	GO:BP	cellular glucuronidation	16175	14152		0.02127659574468085	0.041666666666666664	21	16154	8	6	13	16148	16175	0.46601361619085
M1	string	0	network_modules	360	TRUE	8.61506075989394e-18	144	14	11	0.7857142857142857	0.0763888888888889	GO:0071466	GO:BP	cellular response to xenobiotic stimulus	16175	16699		0.0425531914893617	0.0625	144	16031	11	3	133	16028	16175	0.24340437142185467
M1	string	0	network_modules	360	TRUE	1.0271305343469967e-17	215	13	12	0.9230769230769231	0.05581395348837209	REAC:R-HSA-211859	REAC	Biological oxidations	10916	227		0.16666666666666666	0.23076923076923078	215	10701	12	1	203	10700	10916	0.22449246464868133
M1	string	0	network_modules	360	TRUE	1.61920922198391e-17	23	14	8	0.5714285714285714	0.34782608695652173	GO:0006063	GO:BP	uronic acid metabolic process	16175	1930		0.06382978723404255	0.10416666666666667	23	16152	8	6	15	16146	16175	0.4452224176828742
M1	string	0	network_modules	360	TRUE	1.61920922198391e-17	23	14	8	0.5714285714285714	0.34782608695652173	GO:0019585	GO:BP	glucuronate metabolic process	16175	5912		0.06382978723404255	0.10416666666666667	23	16152	8	6	15	16146	16175	0.4452224176828742
M1	string	0	network_modules	360	TRUE	8.883752875724293e-17	25	13	8	0.6153846153846154	0.32	REAC:R-HSA-156588	REAC	Glucuronidation	10916	1054		0.25	0.3076923076923077	25	10891	8	5	17	10886	10916	0.4428795860127143
M1	string	0	network_modules	360	TRUE	2.1075632764185602e-16	191	14	11	0.7857142857142857	0.05759162303664921	GO:0009410	GO:BP	response to xenobiotic stimulus	16175	3475		0.10638297872340426	0.125	191	15984	11	3	180	15981	16175	0.21086424863955097
M1	string	0	network_modules	360	TRUE	2.5448674184371645e-16	30	12	8	0.6666666666666666	0.26666666666666666	KEGG:00053	KEGG	Ascorbate and aldarate metabolism	8484	8		0.36363636363636365	0.4166666666666667	30	8454	8	4	22	8450	8484	0.4204415497176698
M1	string	0	network_modules	360	TRUE	4.1307532793631853e-16	62	12	9	0.75	0.14516129032258066	KEGG:00140	KEGG	Steroid hormone biosynthesis	8484	17		0.45454545454545453	0.5	62	8422	9	3	53	8419	8484	0.32817361858457794
M1	string	0	network_modules	360	TRUE	1.3124113741994546e-15	36	12	8	0.6666666666666666	0.2222222222222222	KEGG:00040	KEGG	Pentose and glucuronate interconversions	8484	5		0.5454545454545454	0.5833333333333334	36	8448	8	4	28	8444	8484	0.3835356710379088
M1	string	0	network_modules	360	TRUE	4.16794840439542e-15	79	12	9	0.75	0.11392405063291139	KEGG:00983	KEGG	Drug metabolism - other enzymes	8484	157		0.6363636363636364	0.6666666666666666	79	8405	9	3	70	8402	8484	0.29023609442024706
M1	string	0	network_modules	360	TRUE	6.270615180265365e-15	43	12	8	0.6666666666666666	0.18604651162790697	KEGG:00860	KEGG	Porphyrin metabolism	8484	128		0.7272727272727273	0.75	43	8441	8	4	35	8437	8484	0.3506400453126913
M1	string	0	network_modules	360	TRUE	1.283100188013974e-14	89	12	9	0.75	0.10112359550561797	KEGG:04976	KEGG	Bile secretion	8484	407		0.8181818181818182	0.8333333333333334	89	8395	9	3	80	8392	8484	0.2731723949903357
M1	string	0	network_modules	360	TRUE	8.122521654602421e-14	504	14	12	0.8571428571428571	0.023809523809523808	GO:0032787	GO:BP	monocarboxylic acid metabolic process	16175	7822		0.1276595744680851	0.14583333333333334	504	15671	12	2	492	15669	16175	0.13992071796908426
M1	string	0	network_modules	360	TRUE	9.39407752600038e-13	80	14	8	0.5714285714285714	0.1	GO:0006721	GO:BP	terpenoid metabolic process	16175	2427		0.14893617021276595	0.16666666666666666	80	16095	8	6	72	16089	16175	0.23766779353201714
M1	string	0	network_modules	360	TRUE	1.669350611006824e-12	6	14	5	0.35714285714285715	0.8333333333333334	GO:0051552	GO:BP	flavone metabolic process	16175	13783		0.1702127659574468	0.1875	6	16169	5	9	1	16160	16175	0.5453152523911278
M1	string	0	network_modules	360	TRUE	4.657204793198476e-12	97	14	8	0.5714285714285714	0.08247422680412371	GO:0006720	GO:BP	isoprenoid metabolic process	16175	2426		0.19148936170212766	0.20833333333333334	97	16078	8	6	89	16072	16175	0.21555218863940417
M1	string	0	network_modules	360	TRUE	4.977449670782665e-12	179	14	9	0.6428571428571429	0.05027932960893855	GO:0042445	GO:BP	hormone metabolic process	16175	10185		0.2127659574468085	0.22916666666666666	179	15996	9	5	170	15991	16175	0.17775228628204734
M1	string	0	network_modules	360	TRUE	8.54316588581289e-12	742	14	12	0.8571428571428571	0.016172506738544475	GO:0019752	GO:BP	carboxylic acid metabolic process	16175	6036		0.23404255319148937	0.25	742	15433	12	2	730	15431	16175	0.11413327031280072
M1	string	0	network_modules	360	TRUE	1.157120178646e-11	761	14	12	0.8571428571428571	0.01576872536136662	GO:0043436	GO:BP	oxoacid metabolic process	16175	10693		0.2553191489361702	0.2708333333333333	761	15414	12	2	749	15412	16175	0.11260563080897038
M1	string	0	network_modules	360	TRUE	1.2714335794242383e-11	767	14	12	0.8571428571428571	0.01564537157757497	GO:0006082	GO:BP	organic acid metabolic process	16175	1947		0.2765957446808511	0.2916666666666667	767	15408	12	2	755	15406	16175	0.11213479346689047
M1	string	0	network_modules	360	TRUE	2.396305187151217e-11	106	13	8	0.6153846153846154	0.07547169811320754	REAC:R-HSA-156580	REAC	Phase II - Conjugation of compounds	10916	1738		0.3333333333333333	0.38461538461538464	106	10810	8	5	98	10805	10916	0.21327277470916445
M1	string	0	network_modules	360	TRUE	3.7289867967745465e-11	211	12	9	0.75	0.04265402843601896	KEGG:05207	KEGG	Chemical carcinogenesis - receptor activation	8484	459		0.9090909090909091	0.9166666666666666	211	8273	9	3	202	8270	8484	0.1752432248210662
M1	string	0	network_modules	360	TRUE	7.28791012951878e-11	29	14	6	0.42857142857142855	0.20689655172413793	GO:0042573	GO:BP	retinoic acid metabolic process	16175	10249		0.2978723404255319	0.3125	29	16146	6	8	23	16138	16175	0.2969239919145271
M1	string	0	network_modules	360	TRUE	8.972052938528428e-11	70	14	7	0.5	0.1	GO:0001523	GO:BP	retinoid metabolic process	16175	329		0.3191489361702128	0.3333333333333333	70	16105	7	7	63	16098	16175	0.22224883171958934
M1	string	0	network_modules	360	TRUE	1.1016894787343932e-10	72	14	7	0.5	0.09722222222222222	GO:0016101	GO:BP	diterpenoid metabolic process	16175	5119		0.3404255319148936	0.3541666666666667	72	16103	7	7	65	16096	16175	0.2190992427099245
M1	string	0	network_modules	360	TRUE	1.28242139643128e-10	11	14	5	0.35714285714285715	0.45454545454545453	GO:0009812	GO:BP	flavonoid metabolic process	16175	3696		0.3617021276595745	0.375	11	16164	5	9	6	16155	16175	0.40245528698669153
M1	string	0	network_modules	360	TRUE	1.6963826232713317e-10	33	14	6	0.42857142857142855	0.18181818181818182	GO:0008210	GO:BP	estrogen metabolic process	16175	3137		0.3829787234042553	0.3958333333333333	33	16142	6	8	27	16134	16175	0.27822067442699083
M1	string	0	network_modules	360	TRUE	2.552058578387385e-10	153	12	8	0.6666666666666666	0.05228758169934641	KEGG:01240	KEGG	Biosynthesis of cofactors	8484	190		1	1	153	8331	8	4	145	8327	8484	0.18344373305334855
M1	string	0	network_modules	360	TRUE	9.49745379239683e-10	319	14	9	0.6428571428571429	0.02821316614420063	GO:0006631	GO:BP	fatty acid metabolic process	16175	2343		0.40425531914893614	0.4166666666666667	319	15856	9	5	310	15851	16175	0.1319059606239679
M1	string	0	network_modules	360	TRUE	2.2495195368838633e-9	5	14	4	0.2857142857142857	0.8	GO:0052696	GO:BP	flavonoid glucuronidation	16175	14153		0.425531914893617	0.4375	5	16170	4	10	1	16160	16175	0.47785486384119713
M1	string	0	network_modules	360	TRUE	2.8952489166150744e-9	361	14	9	0.6428571428571429	0.024930747922437674	GO:0010817	GO:BP	regulation of hormone levels	16175	4429		0.44680851063829785	0.4583333333333333	361	15814	9	5	352	15809	16175	0.12364274280250977
M1	string	0	network_modules	360	TRUE	7.970244020026486e-9	242	14	8	0.5714285714285714	0.03305785123966942	GO:0008202	GO:BP	steroid metabolic process	16175	3129		0.46808510638297873	0.4791666666666667	242	15933	8	6	234	15927	16175	0.13491409065731377
M1	string	0	network_modules	360	TRUE	1.2480189446378793e-8	65	14	6	0.42857142857142855	0.09230769230769231	GO:0042440	GO:BP	pigment metabolic process	16175	10180		0.48936170212765956	0.5	65	16110	6	8	59	16102	16175	0.19751566090418093
M1	string	0	network_modules	360	TRUE	1.573105976594096e-8	7	14	4	0.2857142857142857	0.5714285714285714	GO:0052697	GO:BP	xenobiotic glucuronidation	16175	14154		0.5106382978723404	0.5208333333333334	7	16168	4	10	3	16158	16175	0.40371107187287486
M1	string	0	network_modules	360	TRUE	6.617679295914984e-7	3	14	3	0.21428571428571427	1	GO:2001030	GO:BP	negative regulation of cellular glucuronidation	16175	26276		0.5319148936170213	0.5416666666666666	3	16172	3	11	0	16161	16175	0.46275259018047415
M1	string	0	network_modules	360	TRUE	2.645721338593774e-6	4	14	3	0.21428571428571427	0.75	GO:2001029	GO:BP	regulation of cellular glucuronidation	16175	26275		0.5531914893617021	0.5625	4	16171	3	11	1	16160	16175	0.4006521636101715
M1	string	0	network_modules	360	TRUE	3.389121126741434e-6	23	13	4	0.3076923076923077	0.17391304347826086	REAC:R-HSA-211981	REAC	Xenobiotics	10916	2677		0.4166666666666667	0.46153846153846156	23	10893	4	9	19	10884	10916	0.23012139534049625
M1	string	0	network_modules	360	TRUE	7.810659455603646e-6	28	13	4	0.3076923076923077	0.14285714285714285	REAC:R-HSA-9753281	REAC	Paracetamol ADME	10916	1714		0.5	0.5384615384615384	28	10888	4	9	24	10879	10916	0.20830041844774547
M1	string	0	network_modules	360	TRUE	8.441618566825986e-6	6	13	3	0.23076923076923078	0.5	REAC:R-HSA-9027307	REAC	Biosynthesis of maresin-like SPMs	10916	245		0.5833333333333334	0.6153846153846154	6	10910	3	10	3	10900	10916	0.33916923495392937
M1	string	0	network_modules	360	TRUE	1.055946639235188e-5	29	14	4	0.2857142857142857	0.13793103448275862	GO:0045922	GO:BP	negative regulation of fatty acid metabolic process	16175	11716		0.574468085106383	0.5833333333333334	29	16146	4	10	25	16136	16175	0.19753353685849726
M1	string	0	network_modules	360	TRUE	1.3215112914448817e-5	6	14	3	0.21428571428571427	0.5	GO:0009698	GO:BP	phenylpropanoid metabolic process	16175	3601		0.5957446808510638	0.6458333333333334	6	16169	3	11	3	16158	16175	0.326962361414992
M1	string	0	network_modules	360	TRUE	1.3215112914448817e-5	6	14	3	0.21428571428571427	0.5	GO:0009804	GO:BP	coumarin metabolic process	16175	3688		0.5957446808510638	0.6458333333333334	6	16169	3	11	3	16158	16175	0.326962361414992
M1	string	0	network_modules	360	TRUE	1.3215112914448817e-5	6	14	3	0.21428571428571427	0.5	GO:0016098	GO:BP	monoterpenoid metabolic process	16175	5116		0.5957446808510638	0.6458333333333334	6	16169	3	11	3	16158	16175	0.326962361414992
M1	string	0	network_modules	360	TRUE	2.3604051444141078e-5	8	13	3	0.23076923076923078	0.375	REAC:R-HSA-9018682	REAC	Biosynthesis of maresins	10916	246		0.6666666666666666	0.6923076923076923	8	10908	3	10	5	10898	10916	0.29352231826464087
M1	string	0	network_modules	360	TRUE	5.990683314440681e-5	44	14	4	0.2857142857142857	0.09090909090909091	GO:0019748	GO:BP	secondary metabolic process	16175	6032		0.6595744680851063	0.6666666666666666	44	16131	4	10	40	16121	16175	0.1599169488157372
M1	string	0	network_modules	360	TRUE	6.57188340176621e-5	45	14	4	0.2857142857142857	0.08888888888888889	GO:0001889	GO:BP	liver development	16175	515		0.6808510638297872	0.6875	45	16130	4	10	41	16120	16175	0.15810046615427484
M1	string	0	network_modules	360	TRUE	7.194211721291941e-5	46	14	4	0.2857142857142857	0.08695652173913043	GO:0061008	GO:BP	hepaticobiliary system development	16175	15132		0.7021276595744681	0.7083333333333334	46	16129	4	10	42	16119	16175	0.1563432176287119
M1	string	0	network_modules	360	TRUE	7.912899234516401e-5	10	14	3	0.21428571428571427	0.3	GO:0070989	GO:BP	oxidative demethylation	16175	16419		0.723404255319149	0.7291666666666666	10	16165	3	11	7	16154	16175	0.25300246815630156
M1	string	0	network_modules	360	TRUE	2.3474557319989682e-4	16	13	3	0.23076923076923078	0.1875	REAC:R-HSA-9018677	REAC	Biosynthesis of DHA-derived SPMs	10916	230		0.75	0.7692307692307693	16	10900	3	10	13	10890	10916	0.2069662954184636
M1	string	0	network_modules	360	TRUE	2.3667599156884005e-4	64	13	4	0.3076923076923077	0.0625	REAC:R-HSA-211897	REAC	Cytochrome P450 - arranged by substrate type	10916	423		0.8333333333333334	0.8461538461538461	64	10852	4	9	60	10843	10916	0.1365145029349966
M1	string	0	network_modules	360	TRUE	2.992661472144097e-4	15	14	3	0.21428571428571427	0.2	GO:0070988	GO:BP	demethylation	16175	16418		0.7446808510638298	0.75	15	16160	3	11	12	16149	16175	0.20630870032228973
M1	string	0	network_modules	360	TRUE	3.4158766214651315e-4	18	13	3	0.23076923076923078	0.16666666666666666	REAC:R-HSA-9018678	REAC	Biosynthesis of specialized proresolving mediators (SPMs)	10916	249		0.9166666666666666	0.9230769230769231	18	10898	3	10	15	10888	10916	0.1949916727240632
M1	string	0	network_modules	360	TRUE	4.2308202411938566e-4	71	14	4	0.2857142857142857	0.056338028169014086	GO:0019217	GO:BP	regulation of fatty acid metabolic process	16175	5594		0.7659574468085106	0.7708333333333334	71	16104	4	10	67	16094	16175	0.12525242674251139
M1	string	0	network_modules	360	TRUE	6.856053775428322e-4	80	14	4	0.2857142857142857	0.05	GO:0045833	GO:BP	negative regulation of lipid metabolic process	16175	11649		0.7872340425531915	0.7916666666666666	80	16095	4	10	76	16085	16175	0.11779636975963245
M1	string	0	network_modules	360	TRUE	7.478986833986569e-4	20	14	3	0.21428571428571427	0.15	GO:0042178	GO:BP	xenobiotic catabolic process	16175	10006		0.8085106382978723	0.8125	20	16155	3	11	17	16144	16175	0.17843732284698927
M1	string	0	network_modules	360	TRUE	7.574551742917172e-4	82	14	4	0.2857142857142857	0.04878048780487805	GO:0062014	GO:BP	negative regulation of small molecule metabolic process	16175	15783		0.8297872340425532	0.8333333333333334	82	16093	4	10	78	16083	16175	0.11630694748558497
M1	string	0	network_modules	360	TRUE	8.918977271069437e-4	2	14	2	0.14285714285714285	1	GO:0006789	GO:BP	bilirubin conjugation	16175	2475		0.851063829787234	0.8541666666666666	2	16173	2	12	0	16161	16175	0.377824226446696
M1	string	0	network_modules	360	TRUE	0.001505072393870592	25	14	3	0.21428571428571427	0.12	GO:0042759	GO:BP	long-chain fatty acid biosynthetic process	16175	10351		0.8723404255319149	0.875	25	16150	3	11	22	16139	16175	0.15939229457778828
M1	string	0	network_modules	360	TRUE	0.001604901634062212	103	13	4	0.3076923076923077	0.038834951456310676	REAC:R-HSA-211945	REAC	Phase I - Functionalization of compounds	10916	1737		1	1	103	10813	4	9	99	10804	10916	0.10652721440356532
M1	string	0	network_modules	360	TRUE	0.0016165240521516663	99	14	4	0.2857142857142857	0.04040404040404041	GO:0001676	GO:BP	long-chain fatty acid metabolic process	16175	380		0.8936170212765957	0.8958333333333334	99	16076	4	10	95	16066	16175	0.10551034008129602
M1	string	0	network_modules	360	TRUE	0.0017515780912377838	101	14	4	0.2857142857142857	0.039603960396039604	GO:0010565	GO:BP	regulation of ketone metabolic process	16175	4218		0.9148936170212766	0.9166666666666666	101	16074	4	10	97	16064	16175	0.10442075885895082
M1	string	0	network_modules	360	TRUE	0.0026743696454616496	3	14	2	0.14285714285714285	0.6666666666666666	GO:0009822	GO:BP	alkaloid catabolic process	16175	3701		0.9361702127659575	0.9375	3	16172	2	12	1	16160	16175	0.30836810188211866
M1	string	0	network_modules	360	TRUE	0.00451563721718892	128	14	4	0.2857142857142857	0.03125	GO:0120254	GO:BP	olefinic compound metabolic process	16175	19583		0.9574468085106383	0.9583333333333334	128	16047	4	10	124	16037	16175	0.09227962776590955
M1	string	0	network_modules	360	TRUE	0.007415005266768546	145	14	4	0.2857142857142857	0.027586206896551724	GO:0048732	GO:BP	gland development	16175	12989		0.9787234042553191	0.9791666666666666	145	16030	4	10	141	16020	16175	0.08641931099363281
M1	string	0	network_modules	360	TRUE	0.007447360449651994	42	14	3	0.21428571428571427	0.07142857142857142	GO:0045912	GO:BP	negative regulation of carbohydrate metabolic process	16175	11706		1	1	42	16133	3	11	39	16122	16175	0.12243074899806905
M1	string	0	network_modules	361	TRUE	9.013636705400476e-10	14	15	5	0.3333333333333333	0.35714285714285715	GO:0046512	GO:BP	sphingosine biosynthetic process	16175	12211		0	0.09090909090909091	14	16161	5	10	9	16151	16175	0.3444456444478423
M1	string	0	network_modules	361	TRUE	9.013636705400476e-10	14	15	5	0.3333333333333333	0.35714285714285715	GO:0046520	GO:BP	sphingoid biosynthetic process	16175	12218		0	0.09090909090909091	14	16161	5	10	9	16151	16175	0.3444456444478423
M1	string	0	network_modules	361	TRUE	5.221811074985603e-9	19	15	5	0.3333333333333333	0.2631578947368421	GO:0034312	GO:BP	diol biosynthetic process	16175	8566		0.09523809523809523	0.13636363636363635	19	16156	5	10	14	16146	16175	0.2954412453539771
M1	string	0	network_modules	361	TRUE	6.958824710193631e-9	20	15	5	0.3333333333333333	0.25	GO:0006670	GO:BP	sphingosine metabolic process	16175	2379		0.14285714285714285	0.18181818181818182	20	16155	5	10	15	16145	16175	0.287915819259218
M1	string	0	network_modules	361	TRUE	1.1807581540631192e-8	22	15	5	0.3333333333333333	0.22727272727272727	GO:0046519	GO:BP	sphingoid metabolic process	16175	12217		0.19047619047619047	0.22727272727272727	22	16153	5	10	17	16143	16175	0.274431741227581
M1	string	0	network_modules	361	TRUE	2.1067608475613015e-8	32	11	5	0.45454545454545453	0.15625	REAC:R-HSA-1660661	REAC	Sphingolipid de novo biosynthesis	10916	2348		0	0.5	32	10884	5	6	27	10878	10916	0.2653048284957788
M1	string	0	network_modules	361	TRUE	3.6104296493595306e-8	27	15	5	0.3333333333333333	0.18518518518518517	GO:0034311	GO:BP	diol metabolic process	16175	8565		0.23809523809523808	0.2727272727272727	27	16148	5	10	22	16138	16175	0.24752920165780984
M1	string	0	network_modules	361	TRUE	6.789677251760082e-7	47	15	5	0.3333333333333333	0.10638297872340426	GO:0046173	GO:BP	polyol biosynthetic process	16175	11943		0.2857142857142857	0.3181818181818182	47	16128	5	10	42	16118	16175	0.18702789654994387
M1	string	0	network_modules	361	TRUE	3.0855767092028735e-6	63	15	5	0.3333333333333333	0.07936507936507936	GO:0046513	GO:BP	ceramide biosynthetic process	16175	12212		0.3333333333333333	0.36363636363636365	63	16112	5	10	58	16102	16175	0.1611381984631892
M1	string	0	network_modules	361	TRUE	4.230074956273092e-6	89	11	5	0.45454545454545453	0.056179775280898875	REAC:R-HSA-428157	REAC	Sphingolipid metabolism	10916	2349		1	1	89	10827	5	6	84	10821	10916	0.15765750264014414
M1	string	0	network_modules	361	TRUE	7.608591541333184e-6	120	10	5	0.5	0.041666666666666664	KEGG:04071	KEGG	Sphingolipid signaling pathway	8484	260		0	0.5	120	8364	5	5	115	8359	8484	0.14134033701267354
M1	string	0	network_modules	361	TRUE	1.26146727507245e-5	83	15	5	0.3333333333333333	0.060240963855421686	GO:0019751	GO:BP	polyol metabolic process	16175	6035		0.38095238095238093	0.4090909090909091	83	16092	5	10	78	16082	16175	0.1399478883454216
M1	string	0	network_modules	361	TRUE	2.63788393787291e-5	96	15	5	0.3333333333333333	0.052083333333333336	GO:0006672	GO:BP	ceramide metabolic process	16175	2381		0.42857142857142855	0.45454545454545453	96	16079	5	10	91	16069	16175	0.12986151285978098
M1	string	0	network_modules	361	TRUE	3.081882442816269e-5	99	15	5	0.3333333333333333	0.050505050505050504	GO:0030148	GO:BP	sphingolipid biosynthetic process	16175	6682		0.47619047619047616	0.5	99	16076	5	10	94	16066	16175	0.12781825910839842
M1	string	0	network_modules	361	TRUE	5.2438329885388695e-5	110	15	5	0.3333333333333333	0.045454545454545456	GO:0046165	GO:BP	alcohol biosynthetic process	16175	11935		0.5238095238095238	0.5454545454545454	110	16065	5	10	105	16055	16175	0.12104844995224914
M1	string	0	network_modules	361	TRUE	1.2137701290671976e-4	130	15	5	0.3333333333333333	0.038461538461538464	GO:0046467	GO:BP	membrane lipid biosynthetic process	16175	12175		0.5714285714285714	0.5909090909090909	130	16045	5	10	125	16035	16175	0.11099585117587787
M1	string	0	network_modules	361	TRUE	1.310260067104883e-4	132	15	5	0.3333333333333333	0.03787878787878788	GO:0007601	GO:BP	visual perception	16175	3060		0.6190476190476191	0.6363636363636364	132	16043	5	10	127	16033	16175	0.11011675768768188
M1	string	0	network_modules	361	TRUE	1.6969984814231543e-4	139	15	5	0.3333333333333333	0.03597122302158273	GO:0050953	GO:BP	sensory perception of light stimulus	16175	13395		0.6666666666666666	0.6818181818181818	139	16036	5	10	134	16026	16175	0.10718879009790795
M1	string	0	network_modules	361	TRUE	1.8226608700253654e-4	141	15	5	0.3333333333333333	0.03546099290780142	GO:0006665	GO:BP	sphingolipid metabolic process	16175	2374		0.7142857142857143	0.7272727272727273	141	16034	5	10	136	16024	16175	0.10639198303528156
M1	string	0	network_modules	361	TRUE	1.9556021624219866e-4	143	15	5	0.3333333333333333	0.03496503496503497	GO:0043604	GO:BP	amide biosynthetic process	16175	10796		0.7619047619047619	0.7727272727272727	143	16032	5	10	138	16022	16175	0.10561170960120325
M1	string	0	network_modules	361	TRUE	6.151666901016489e-4	180	15	5	0.3333333333333333	0.027777777777777776	GO:0006643	GO:BP	membrane lipid metabolic process	16175	2354		0.8095238095238095	0.8181818181818182	180	15995	5	10	175	15985	16175	0.09357788115236457
M1	string	0	network_modules	361	TRUE	8.043313768187119e-4	190	15	5	0.3333333333333333	0.02631578947368421	GO:1901617	GO:BP	organic hydroxy compound biosynthetic process	16175	21599		0.8571428571428571	0.8636363636363636	190	15985	5	10	185	15975	16175	0.09093568630051749
M1	string	0	network_modules	361	TRUE	0.0017389412143112818	54	10	3	0.3	0.05555555555555555	KEGG:00600	KEGG	Sphingolipid metabolism	8484	95		1	1	54	8430	3	7	51	8423	8484	0.12683925957561537
M1	string	0	network_modules	361	TRUE	0.0035665630987712148	257	15	5	0.3333333333333333	0.019455252918287938	GO:0006066	GO:BP	alcohol metabolic process	16175	1933		0.9047619047619048	0.9090909090909091	257	15918	5	10	252	15908	16175	0.07734395832016565
M1	string	0	network_modules	361	TRUE	0.006682065795610729	4	15	2	0.13333333333333333	0.5	GO:1904504	GO:BP	positive regulation of lipophagy	16175	23866		0.9523809523809523	1	4	16171	2	13	2	16158	16175	0.25787147420379075
M1	string	0	network_modules	361	TRUE	0.006682065795610729	4	15	2	0.13333333333333333	0.5	GO:1904502	GO:BP	regulation of lipophagy	16175	23864		0.9523809523809523	1	4	16171	2	13	2	16158	16175	0.25787147420379075
M1	string	0	network_modules	364	TRUE	1.8857902250976187e-5	9	11	3	0.2727272727272727	0.3333333333333333	REAC:R-HSA-1296052	REAC	Ca2+ activated K+ channels	10916	295		0	0.3333333333333333	9	10907	3	8	6	10899	10916	0.3008754792622259
M1	string	0	network_modules	364	TRUE	1.0181036454722539e-4	15	11	3	0.2727272727272727	0.2	REAC:R-HSA-418457	REAC	cGMP effects	10916	2691		0.5	0.6666666666666666	15	10901	3	8	12	10893	10916	0.232650018567167
M1	string	0	network_modules	364	TRUE	2.966186295934519e-4	21	11	3	0.2727272727272727	0.14285714285714285	REAC:R-HSA-392154	REAC	Nitric oxide stimulates guanylate cyclase	10916	1601		1	1	21	10895	3	8	18	10887	10916	0.19628089464160198
M1	string	0	network_modules	364	TRUE	6.132050791417095e-4	198	14	5	0.35714285714285715	0.025252525252525252	GO:0006813	GO:BP	potassium ion transport	16175	2493		NA	1	198	15977	5	9	193	15968	16175	0.09231863406751015
M1	string	0	network_modules	365	TRUE	0.002101188779641699	33	12	3	0.25	0.09090909090909091	GO:0045494	GO:BP	photoreceptor cell maintenance	16175	11413		0	0.5	33	16142	3	9	30	16133	16175	0.14973371066642668
M1	string	0	network_modules	365	TRUE	0.004404530672923121	42	12	3	0.25	0.07142857142857142	GO:0001895	GO:BP	retina homeostasis	16175	520		1	1	42	16133	3	9	39	16124	16175	0.13246385140552264
M1	string	0	network_modules	365	TRUE	0.007033520697877822	86	10	3	0.3	0.03488372093023256	KEGG:04610	KEGG	Complement and coagulation cascades	8484	320		0	0.5	86	8398	3	7	83	8391	8484	0.09940596818089718
M1	string	0	network_modules	365	TRUE	0.00859858539968798	92	10	3	0.3	0.03260869565217391	KEGG:04640	KEGG	Hematopoietic cell lineage	8484	333		1	1	92	8392	3	7	89	8385	8484	0.09590959893737619
M1	string	0	network_modules	367	TRUE	2.927810168010638e-4	2	9	2	0.2222222222222222	1	GO:1905551	GO:BP	negative regulation of protein localization to endoplasmic reticulum	16175	24719		0	0.5	2	16173	2	7	0	16166	16175	0.47130249306639116
M1	string	0	network_modules	367	TRUE	0.002925276442811189	5	9	2	0.2222222222222222	0.4	GO:1905550	GO:BP	regulation of protein localization to endoplasmic reticulum	16175	24718		1	1	5	16170	2	7	3	16163	16175	0.2978565749868409
M1	string	0	network_modules	368	TRUE	7.738688763867622e-4	22	13	3	0.23076923076923078	0.13636363636363635	GO:0045880	GO:BP	positive regulation of smoothened signaling pathway	16175	11684		NA	1	22	16153	3	10	19	16143	16175	0.17653919094160347
M1	string	0	network_modules	371	TRUE	0.008905748663263038	5	14	2	0.14285714285714285	0.4	GO:0030238	GO:BP	male sex determination	16175	6735		NA	1	5	16170	2	12	3	16158	16175	0.2386686524028136
M1	string	0	network_modules	371	TRUE	0.009196735098244528	11	9	2	0.2222222222222222	0.18181818181818182	REAC:R-HSA-9690406	REAC	Transcriptional regulation of testis differentiation	10916	2561		NA	1	11	10905	2	7	9	10898	10916	0.20027954273656026
M1	string	0	network_modules	373	TRUE	7.453716719393749e-4	2	13	2	0.15384615384615385	1	GO:0099044	GO:BP	vesicle tethering to endoplasmic reticulum	16175	19017		NA	1	2	16173	2	11	0	16162	16175	0.3920988599983004
M1	string	0	network_modules	373	TRUE	0.0011563708061067882	5	8	2	0.25	0.4	REAC:R-HSA-390648	REAC	Muscarinic acetylcholine receptors	10916	1495		0	0.5	5	10911	2	6	3	10905	10916	0.31583645181620407
M1	string	0	network_modules	373	TRUE	0.007612486045548108	12	8	2	0.25	0.16666666666666666	REAC:R-HSA-196108	REAC	Pregnenolone biosynthesis	10916	1789		1	1	12	10904	2	6	10	10898	10916	0.20341291469682457
M1	string	0	network_modules	374	TRUE	1.7823300274910142e-20	13	13	8	0.6153846153846154	0.6153846153846154	GO:0001682	GO:BP	tRNA 5'-leader removal	16175	384		0	0.2	13	16162	8	5	5	16157	16175	0.6150752477320972
M1	string	0	network_modules	374	TRUE	8.906749628068846e-20	15	13	8	0.6153846153846154	0.5333333333333333	GO:0099116	GO:BP	tRNA 5'-end processing	16175	19047		0.25	0.4	15	16160	8	5	7	16155	16175	0.5725241165608337
M1	string	0	network_modules	374	TRUE	3.239737435811647e-16	35	13	8	0.6153846153846154	0.22857142857142856	GO:0000966	GO:BP	RNA 5'-end processing	16175	274		0.5	0.6	35	16140	8	5	27	16135	16175	0.3742824742344496
M1	string	0	network_modules	374	TRUE	1.8487075316126053e-12	55	10	7	0.7	0.12727272727272726	REAC:R-HSA-6784531	REAC	tRNA processing in the nucleus	10916	2745		0	0.2	55	10861	7	3	48	10858	10916	0.29721812481705073
M1	string	0	network_modules	374	TRUE	1.1298187759710414e-11	120	13	8	0.6153846153846154	0.06666666666666667	GO:0008033	GO:BP	tRNA processing	16175	3098		0.75	0.8	120	16055	8	5	112	16050	16175	0.2009332258576812
M1	string	0	network_modules	374	TRUE	1.3226562598851627e-11	139	7	7	1	0.050359712230215826	KEGG:03008	KEGG	Ribosome biogenesis in eukaryotes	8484	207		NA	1	139	8345	7	0	132	8345	8484	0.22265563911025998
M1	string	0	network_modules	374	TRUE	1.7841990358228326e-10	103	10	7	0.7	0.06796116504854369	REAC:R-HSA-72306	REAC	tRNA processing	10916	2743		0.25	0.4	103	10813	7	3	96	10810	10916	0.2162933639964552
M1	string	0	network_modules	374	TRUE	4.0268166266611546e-10	186	13	8	0.6153846153846154	0.043010752688172046	GO:0006399	GO:BP	tRNA metabolic process	16175	2160		1	1	186	15989	8	5	178	15984	16175	0.16064078299569204
M1	string	0	network_modules	374	TRUE	8.06844464031193e-5	182	10	5	0.5	0.027472527472527472	REAC:R-HSA-6791226	REAC	Major pathway of rRNA processing in the nucleolus and cytosol	10916	1389		0.5	0.6	182	10734	5	5	177	10729	10916	0.114302453003284
M1	string	0	network_modules	374	TRUE	1.0532290146902491e-4	192	10	5	0.5	0.026041666666666668	REAC:R-HSA-8868773	REAC	rRNA processing in the nucleus and cytosol	10916	2734		0.75	0.8	192	10724	5	5	187	10719	10916	0.11112687227939007
M1	string	0	network_modules	374	TRUE	1.355907774016977e-4	202	10	5	0.5	0.024752475247524754	REAC:R-HSA-72312	REAC	rRNA processing	10916	2732		1	1	202	10714	5	5	197	10709	10916	0.10818601005667475
M1	string	0	network_modules	379	TRUE	0.002864687406232981	4	11	2	0.18181818181818182	0.5	GO:0019388	GO:BP	galactose catabolic process	16175	5748		NA	1	4	16171	2	9	2	16162	16175	0.30124093787466694
M1	string	0	network_modules	379	TRUE	0.005354728583105831	96	7	3	0.42857142857142855	0.03125	REAC:R-HSA-6803157	REAC	Antimicrobial peptides	10916	156		NA	1	96	10820	3	4	93	10816	10916	0.11389101594457168
M1	string	0	network_modules	381	TRUE	0.001821772121577674	43	13	3	0.23076923076923078	0.06976744186046512	KEGG:00071	KEGG	Fatty acid degradation	8484	11		0	0.25	43	8441	3	10	40	8431	8484	0.12451080591406993
M1	string	0	network_modules	381	TRUE	0.00254194069603498	48	13	3	0.23076923076923078	0.0625	KEGG:00280	KEGG	Valine, leucine and isoleucine degradation	8484	31		0.3333333333333333	0.5	48	8436	3	10	45	8426	8484	0.11757468272249719
M1	string	0	network_modules	381	TRUE	0.003485361388430074	153	13	4	0.3076923076923077	0.026143790849673203	KEGG:01240	KEGG	Biosynthesis of cofactors	8484	190		0.6666666666666666	0.75	153	8331	4	9	149	8322	8484	0.08527010192171068
M1	string	0	network_modules	381	TRUE	0.004266090814270048	57	13	3	0.23076923076923078	0.05263157894736842	KEGG:01212	KEGG	Fatty acid metabolism	8484	186		1	1	57	8427	3	10	54	8417	8484	0.10744281513963352
M1	string	0	network_modules	382	TRUE	5.539050054148442e-4	96	13	4	0.3076923076923077	0.041666666666666664	KEGG:04666	KEGG	Fc gamma R-mediated phagocytosis	8484	341		0	0.3333333333333333	96	8388	4	9	92	8379	8484	0.10977021247639066
M1	string	0	network_modules	382	TRUE	6.012848017595759e-4	98	13	4	0.3076923076923077	0.04081632653061224	KEGG:05231	KEGG	Choline metabolism in cancer	8484	479		0.5	0.6666666666666666	98	8386	4	9	94	8377	8484	0.10857086315967221
M1	string	0	network_modules	382	TRUE	0.0012168844279940012	27	13	3	0.23076923076923078	0.1111111111111111	REAC:R-HSA-5218920	REAC	VEGFR2 mediated vascular permeability	10916	2636		0	0.3333333333333333	27	10889	3	10	24	10879	10916	0.15870266976772543
M1	string	0	network_modules	382	TRUE	0.002013815583301079	449	13	6	0.46153846153846156	0.013363028953229399	REAC:R-HSA-9012999	REAC	RHO GTPase cycle	10916	1847		0.5	0.6666666666666666	449	10467	6	7	443	10460	10916	0.07309657104150095
M1	string	0	network_modules	382	TRUE	0.002980429093050818	147	13	4	0.3076923076923077	0.027210884353741496	KEGG:04072	KEGG	Phospholipase D signaling pathway	8484	261		1	1	147	8337	4	9	143	8328	8484	0.08717391551872344
M1	string	0	network_modules	382	TRUE	0.0035840603632773596	30	15	3	0.2	0.1	GO:0002431	GO:BP	Fc receptor mediated stimulatory signaling pathway	16175	954		0	0.3333333333333333	30	16145	3	12	27	16133	16175	0.1403050597743004
M1	string	0	network_modules	382	TRUE	0.0040545758692752355	507	13	6	0.46153846153846156	0.011834319526627219	REAC:R-HSA-9006934	REAC	Signaling by Receptor Tyrosine Kinases	10916	2302		1	1	507	10409	6	7	501	10402	10916	0.06810813594143393
M1	string	0	network_modules	382	TRUE	0.004144968510892373	265	15	5	0.3333333333333333	0.018867924528301886	GO:0002429	GO:BP	immune response-activating cell surface receptor signaling pathway	16175	952		0.5	0.6666666666666666	265	15910	5	10	260	15900	16175	0.0760680013036661
M1	string	0	network_modules	382	TRUE	0.006123436275414117	287	15	5	0.3333333333333333	0.017421602787456445	GO:0002768	GO:BP	immune response-regulating cell surface receptor signaling pathway	16175	1279		1	1	287	15888	5	10	282	15878	16175	0.07283108424638236
M1	string	0	network_modules	384	TRUE	0.0013431345488938823	96	6	3	0.5	0.03125	KEGG:03015	KEGG	mRNA surveillance pathway	8484	210		NA	1	96	8388	3	3	93	8385	8484	0.12291174639928515
M1	string	0	network_modules	384	TRUE	0.005588758144257042	19	5	2	0.4	0.10526315789473684	REAC:R-HSA-77595	REAC	Processing of Intronless Pre-mRNAs	10916	1799		NA	1	19	10897	2	3	17	10894	10916	0.2045276598933455
M1	string	0	network_modules	387	TRUE	9.693978144542767e-4	39	9	3	0.3333333333333333	0.07692307692307693	REAC:R-HSA-420499	REAC	Class C/3 (Metabotropic glutamate/pheromone receptors)	10916	367		NA	1	39	10877	3	6	36	10871	10916	0.158761069843413
M1	string	0	network_modules	388	TRUE	6.051594010743584e-19	18	13	8	0.6153846153846154	0.4444444444444444	GO:0051923	GO:BP	sulfation	16175	13996		0	0.037037037037037035	18	16157	8	5	10	16152	16175	0.5225313698733953
M1	string	0	network_modules	388	TRUE	6.886660847064853e-13	16	13	6	0.46153846153846156	0.375	GO:0034035	GO:BP	purine ribonucleoside bisphosphate metabolic process	16175	8379		0.038461538461538464	0.2222222222222222	16	16159	6	7	10	16152	16175	0.41550599172553854
M1	string	0	network_modules	388	TRUE	6.886660847064853e-13	16	13	6	0.46153846153846156	0.375	GO:0034032	GO:BP	purine nucleoside bisphosphate metabolic process	16175	8376		0.038461538461538464	0.2222222222222222	16	16159	6	7	10	16152	16175	0.41550599172553854
M1	string	0	network_modules	388	TRUE	6.886660847064853e-13	16	13	6	0.46153846153846156	0.375	GO:0033875	GO:BP	ribonucleoside bisphosphate metabolic process	16175	8366		0.038461538461538464	0.2222222222222222	16	16159	6	7	10	16152	16175	0.41550599172553854
M1	string	0	network_modules	388	TRUE	6.886660847064853e-13	16	13	6	0.46153846153846156	0.375	GO:0050427	GO:BP	3'-phosphoadenosine 5'-phosphosulfate metabolic process	16175	13184		0.038461538461538464	0.2222222222222222	16	16159	6	7	10	16152	16175	0.41550599172553854
M1	string	0	network_modules	388	TRUE	6.886660847064853e-13	16	13	6	0.46153846153846156	0.375	GO:0033865	GO:BP	nucleoside bisphosphate metabolic process	16175	8363		0.038461538461538464	0.2222222222222222	16	16159	6	7	10	16152	16175	0.41550599172553854
M1	string	0	network_modules	388	TRUE	9.99716878557277e-13	23	9	6	0.6666666666666666	0.2608695652173913	REAC:R-HSA-156584	REAC	Cytosolic sulfonation of small molecules	10916	429		0	0.25	23	10893	6	3	17	10890	10916	0.4163211127423718
M1	string	0	network_modules	388	TRUE	1.0957186341743137e-8	7	13	4	0.3076923076923077	0.5714285714285714	GO:0006068	GO:BP	ethanol catabolic process	16175	1935		0.23076923076923078	0.2962962962962963	7	16168	4	9	3	16159	16175	0.4189832117669571
M1	string	0	network_modules	388	TRUE	1.0957186341743137e-8	7	13	4	0.3076923076923077	0.5714285714285714	GO:0006067	GO:BP	ethanol metabolic process	16175	1934		0.23076923076923078	0.2962962962962963	7	16168	4	9	3	16159	16175	0.4189832117669571
M1	string	0	network_modules	388	TRUE	1.4041774128908258e-8	289	13	8	0.6153846153846154	0.02768166089965398	GO:0006790	GO:BP	sulfur compound metabolic process	16175	2476		0.3076923076923077	0.3333333333333333	289	15886	8	5	281	15881	16175	0.1279271927331453
M1	string	0	network_modules	388	TRUE	1.6565484443691358e-8	106	9	6	0.6666666666666666	0.05660377358490566	REAC:R-HSA-156580	REAC	Phase II - Conjugation of compounds	10916	1738		0.3333333333333333	0.5	106	10810	6	3	100	10807	10916	0.1924432701233329
M1	string	0	network_modules	388	TRUE	6.565533088350978e-8	10	13	4	0.3076923076923077	0.4	GO:0034310	GO:BP	primary alcohol catabolic process	16175	8564		0.34615384615384615	0.37037037037037035	10	16165	4	9	6	16156	16175	0.35036741145491396
M1	string	0	network_modules	388	TRUE	1.2097531731727525e-6	215	9	6	0.6666666666666666	0.027906976744186046	REAC:R-HSA-211859	REAC	Biological oxidations	10916	227		0.6666666666666666	0.75	215	10701	6	3	209	10698	10916	0.13374741533145057
M1	string	0	network_modules	388	TRUE	3.301502797657407e-6	24	13	4	0.3076923076923077	0.16666666666666666	GO:0046164	GO:BP	alcohol catabolic process	16175	11934		0.38461538461538464	0.4074074074074074	24	16151	4	9	20	16142	16175	0.22562144616358287
M1	string	0	network_modules	388	TRUE	2.6728131385759276e-5	116	13	5	0.38461538461538464	0.04310344827586207	GO:0006805	GO:BP	xenobiotic metabolic process	16175	2487		0.4230769230769231	0.4444444444444444	116	16059	5	8	111	16051	16175	0.12686227452872673
M1	string	0	network_modules	388	TRUE	2.9657752445003722e-5	257	13	6	0.46153846153846156	0.023346303501945526	GO:0006066	GO:BP	alcohol metabolic process	16175	1933		0.46153846153846156	0.48148148148148145	257	15918	6	7	251	15911	16175	0.10107674881867461
M1	string	0	network_modules	388	TRUE	3.64108794454811e-5	266	13	6	0.46153846153846156	0.022556390977443608	GO:0009150	GO:BP	purine ribonucleotide metabolic process	16175	3317		0.5	0.5185185185185185	266	15909	6	7	260	15902	16175	0.09925610790602747
M1	string	0	network_modules	388	TRUE	3.80201588773853e-5	43	13	4	0.3076923076923077	0.09302325581395349	GO:1901616	GO:BP	organic hydroxy compound catabolic process	16175	21598		0.5384615384615384	0.5555555555555556	43	16132	4	9	39	16123	16175	0.16801117331713306
M1	string	0	network_modules	388	TRUE	4.535900573014391e-5	276	13	6	0.46153846153846156	0.021739130434782608	GO:0009259	GO:BP	ribonucleotide metabolic process	16175	3424		0.5769230769230769	0.5925925925925926	276	15899	6	7	270	15892	16175	0.09733665044914218
M1	string	0	network_modules	388	TRUE	5.2647348043285184e-5	283	13	6	0.46153846153846156	0.02120141342756184	GO:0019693	GO:BP	ribose phosphate metabolic process	16175	6010		0.6153846153846154	0.6296296296296297	283	15892	6	7	277	15885	16175	0.09605285693928486
M1	string	0	network_modules	388	TRUE	7.923282500437497e-5	144	13	5	0.38461538461538464	0.034722222222222224	GO:0071466	GO:BP	cellular response to xenobiotic stimulus	16175	16699		0.6538461538461539	0.6666666666666666	144	16031	5	8	139	16023	16175	0.11343910795101743
M1	string	0	network_modules	388	TRUE	8.333878504836279e-5	11	13	3	0.23076923076923078	0.2727272727272727	GO:0009812	GO:BP	flavonoid metabolic process	16175	3696		0.6923076923076923	0.7037037037037037	11	16164	3	10	8	16154	16175	0.25031900640721944
M1	string	0	network_modules	388	TRUE	1.8248307939212088e-4	349	13	6	0.46153846153846156	0.017191977077363897	GO:0006163	GO:BP	purine nucleotide metabolic process	16175	1998		0.7307692307692307	0.7407407407407407	349	15826	6	7	343	15819	16175	0.0858786567463505
M1	string	0	network_modules	388	TRUE	2.4811326981821866e-4	68	13	4	0.3076923076923077	0.058823529411764705	GO:0034308	GO:BP	primary alcohol metabolic process	16175	8562		0.7692307692307693	0.7777777777777778	68	16107	4	9	64	16098	16175	0.1330296859985443
M1	string	0	network_modules	388	TRUE	3.245979024687493e-4	191	13	5	0.38461538461538464	0.02617801047120419	GO:0009410	GO:BP	response to xenobiotic stimulus	16175	3475		0.8076923076923077	0.8148148148148148	191	15984	5	8	186	15976	16175	0.09787980562307819
M1	string	0	network_modules	388	TRUE	3.410062393863423e-4	388	13	6	0.46153846153846156	0.015463917525773196	GO:0009117	GO:BP	nucleotide metabolic process	16175	3286		0.8461538461538461	0.8518518518518519	388	15787	6	7	382	15780	16175	0.0811019423237936
M1	string	0	network_modules	388	TRUE	3.4907622460499425e-4	28	9	3	0.3333333333333333	0.10714285714285714	REAC:R-HSA-9753281	REAC	Paracetamol ADME	10916	1714		1	1	28	10888	3	6	25	10882	10916	0.18784642015723546
M1	string	0	network_modules	388	TRUE	3.903212677619114e-4	397	13	6	0.46153846153846156	0.015113350125944584	GO:1901615	GO:BP	organic hydroxy compound metabolic process	16175	21597		0.8846153846153846	0.8888888888888888	397	15778	6	7	391	15771	16175	0.0800982575610363
M1	string	0	network_modules	388	TRUE	0.0010385286485064377	469	13	6	0.46153846153846156	0.01279317697228145	GO:0072521	GO:BP	purine-containing compound metabolic process	16175	17423		0.9230769230769231	0.9259259259259259	469	15706	6	7	463	15699	16175	0.07311030288935125
M1	string	0	network_modules	388	TRUE	0.0019196832250301446	521	13	6	0.46153846153846156	0.011516314779270634	GO:0006753	GO:BP	nucleoside phosphate metabolic process	16175	2450		0.9615384615384616	0.9629629629629629	521	15654	6	7	515	15647	16175	0.06896462274153002
M1	string	0	network_modules	388	TRUE	0.0028623918164899505	558	13	6	0.46153846153846156	0.010752688172043012	GO:0055086	GO:BP	nucleobase-containing small molecule metabolic process	16175	14237		1	1	558	15617	6	7	552	15610	16175	0.0663623656743837
M1	string	0	network_modules	390	TRUE	0.0037675917744648623	10	7	2	0.2857142857142857	0.2	REAC:R-HSA-9758881	REAC	Uptake of dietary cobalamins into enterocytes	10916	2629		0	0.5	10	10906	2	5	8	10901	10916	0.23846495752727878
M1	string	0	network_modules	390	TRUE	0.00505280484570442	102	8	3	0.375	0.029411764705882353	KEGG:04972	KEGG	Pancreatic secretion	8484	403		0	0.5	102	8382	3	5	99	8377	8484	0.10231888851409128
M1	string	0	network_modules	390	TRUE	0.005202073004669291	103	8	3	0.375	0.02912621359223301	KEGG:04974	KEGG	Protein digestion and absorption	8484	405		1	1	103	8381	3	5	100	8376	8484	0.1017939916561269
M1	string	0	network_modules	390	TRUE	0.005522425550008051	12	7	2	0.2857142857142857	0.16666666666666666	REAC:R-HSA-71384	REAC	Ethanol oxidation	10916	869		1	1	12	10904	2	5	10	10899	10916	0.21756763404988302
M1	string	0	network_modules	391	TRUE	7.832596608936799e-13	283	13	10	0.7692307692307693	0.0353356890459364	GO:0050808	GO:BP	synapse organization	16175	13274		0	0.25	283	15892	10	3	273	15889	16175	0.16261120850424327
M1	string	0	network_modules	391	TRUE	4.5450547098014993e-10	533	13	10	0.7692307692307693	0.01876172607879925	GO:0034330	GO:BP	cell junction organization	16175	8572		0.3333333333333333	0.5	533	15642	10	3	523	15639	16175	0.11697711215363195
M1	string	0	network_modules	391	TRUE	6.34444672629781e-10	19	10	5	0.5	0.2631578947368421	REAC:R-HSA-388844	REAC	Receptor-type tyrosine-protein phosphatases	10916	1945		0	0.1111111111111111	19	10897	5	5	14	10892	10916	0.36195621341309914
M1	string	0	network_modules	391	TRUE	1.0957186341743137e-8	7	13	4	0.3076923076923077	0.5714285714285714	GO:1990709	GO:BP	presynaptic active zone organization	16175	25263		0.6666666666666666	0.75	7	16168	4	9	3	16159	16175	0.4189832117669571
M1	string	0	network_modules	391	TRUE	1.8061044170027135e-7	16	10	4	0.4	0.25	REAC:R-HSA-264642	REAC	Acetylcholine Neurotransmitter Release Cycle	10916	53		0.125	0.2222222222222222	16	10900	4	6	12	10894	10916	0.3154446770056638
M1	string	0	network_modules	391	TRUE	2.3607892016705685e-7	17	10	4	0.4	0.23529411764705882	REAC:R-HSA-181430	REAC	Norepinephrine Neurotransmitter Release Cycle	10916	1609		0.25	0.4444444444444444	17	10899	4	6	13	10893	10916	0.30596997884760413
M1	string	0	network_modules	391	TRUE	2.3607892016705685e-7	17	10	4	0.4	0.23529411764705882	REAC:R-HSA-181429	REAC	Serotonin Neurotransmitter Release Cycle	10916	2206		0.25	0.4444444444444444	17	10899	4	6	13	10893	10916	0.30596997884760413
M1	string	0	network_modules	391	TRUE	7.239996362516712e-7	22	10	4	0.4	0.18181818181818182	REAC:R-HSA-212676	REAC	Dopamine Neurotransmitter Release Cycle	10916	781		0.5	0.5555555555555556	22	10894	4	6	18	10888	10916	0.26871507580137693
M1	string	0	network_modules	391	TRUE	8.760346871632186e-7	23	10	4	0.4	0.17391304347826086	REAC:R-HSA-210500	REAC	Glutamate Neurotransmitter Release Cycle	10916	1055		0.625	0.6666666666666666	23	10893	4	6	19	10887	10916	0.2627600951804227
M1	string	0	network_modules	391	TRUE	1.8520246223704255e-6	86	10	5	0.5	0.05813953488372093	REAC:R-HSA-6794362	REAC	Protein-protein interactions at synapses	10916	1819		0.75	0.7777777777777778	86	10830	5	5	81	10825	10916	0.16855428722068036
M1	string	0	network_modules	391	TRUE	2.2514271889927756e-5	50	10	4	0.4	0.08	REAC:R-HSA-112310	REAC	Neurotransmitter release cycle	10916	1595		0.875	0.8888888888888888	50	10866	4	6	46	10860	10916	0.17732463912054586
M1	string	0	network_modules	391	TRUE	0.0022351010928117155	3	13	2	0.15384615384615385	0.6666666666666666	GO:1904071	GO:BP	presynaptic active zone assembly	16175	23509		1	1	3	16172	2	11	1	16161	16175	0.32002851642455643
M1	string	0	network_modules	391	TRUE	0.003917640481764774	400	10	5	0.5	0.0125	REAC:R-HSA-112316	REAC	Neuronal System	10916	1590		1	1	400	10516	5	5	395	10511	10916	0.07467767598064688
M1	string	0	network_modules	394	TRUE	0.004603427647900035	11	7	2	0.2857142857142857	0.18181818181818182	REAC:R-HSA-1660517	REAC	Synthesis of PIPs at the late endosome membrane	10916	2394		NA	1	11	10905	2	5	9	10900	10916	0.22730470180250678
M1	string	0	network_modules	396	TRUE	6.347726486088788e-6	124	10	5	0.5	0.04032258064516129	GO:0031109	GO:BP	microtubule polymerization or depolymerization	16175	7034		0	0.3333333333333333	124	16051	5	5	119	16046	16175	0.14039584011357834
M1	string	0	network_modules	396	TRUE	4.3497281037061593e-4	586	10	6	0.6	0.010238907849829351	GO:0000226	GO:BP	microtubule cytoskeleton organization	16175	61		0.5	0.6666666666666666	586	15589	6	4	580	15585	16175	0.07504148585850627
M1	string	0	network_modules	396	TRUE	0.0019061118938717937	41	10	3	0.3	0.07317073170731707	GO:0007019	GO:BP	microtubule depolymerization	16175	2627		1	1	41	16134	3	7	38	16127	16175	0.14713963724018406
M1	string	0	network_modules	400	TRUE	0.0010687437124711026	30	11	3	0.2727272727272727	0.1	GO:0007528	GO:BP	neuromuscular junction development	16175	3010		NA	1	30	16145	3	8	27	16137	16175	0.16422965067086123
M1	string	0	network_modules	401	TRUE	7.958666656058374e-4	684	14	7	0.5	0.01023391812865497	GO:0032880	GO:BP	regulation of protein localization	16175	7877		0	0.25	684	15491	7	7	677	15484	16175	0.06694208048178173
M1	string	0	network_modules	401	TRUE	0.0018637136731700058	776	14	7	0.5	0.00902061855670103	GO:0060341	GO:BP	regulation of cellular localization	16175	14553		0.3333333333333333	0.5	776	15399	7	7	769	15392	16175	0.06225285404844185
M1	string	0	network_modules	401	TRUE	0.008905748663263038	5	14	2	0.14285714285714285	0.4	GO:0048312	GO:BP	intracellular distribution of mitochondria	16175	12649		0.6666666666666666	1	5	16170	2	12	3	16158	16175	0.2386686524028136
M1	string	0	network_modules	401	TRUE	0.008905748663263038	5	14	2	0.14285714285714285	0.4	GO:0022614	GO:BP	membrane to membrane docking	16175	6621		0.6666666666666666	1	5	16170	2	12	3	16158	16175	0.2386686524028136
M1	string	0	network_modules	402	TRUE	1.4234293003435474e-17	19	14	8	0.5714285714285714	0.42105263157894735	REAC:R-HSA-77595	REAC	Processing of Intronless Pre-mRNAs	10916	1799		0	0.125	19	10897	8	6	11	10891	10916	0.48975768226456556
M1	string	0	network_modules	402	TRUE	5.827730449008036e-16	28	14	8	0.5714285714285714	0.2857142857142857	REAC:R-HSA-75067	REAC	Processing of Capped Intronless Pre-mRNA	10916	1797		0.14285714285714285	0.25	28	10888	8	6	20	10882	10916	0.403022669752365
M1	string	0	network_modules	402	TRUE	6.558434564219626e-15	96	11	9	0.8181818181818182	0.09375	KEGG:03015	KEGG	mRNA surveillance pathway	8484	210		0	0.5	96	8388	9	2	87	8386	8484	0.2748623169146973
M1	string	0	network_modules	402	TRUE	7.316408041109528e-14	33	12	7	0.5833333333333334	0.21212121212121213	GO:0031124	GO:BP	mRNA 3'-end processing	16175	7049		0	0.1111111111111111	33	16142	7	5	26	16137	16175	0.35102131440051226
M1	string	0	network_modules	402	TRUE	2.627125882693045e-13	56	14	8	0.5714285714285714	0.14285714285714285	REAC:R-HSA-72187	REAC	mRNA 3'-end processing	10916	2701		0.2857142857142857	0.375	56	10860	8	6	48	10854	10916	0.28406055502795635
M1	string	0	network_modules	402	TRUE	9.293695018973825e-13	65	14	8	0.5714285714285714	0.12307692307692308	REAC:R-HSA-73856	REAC	RNA Polymerase II Transcription Termination	10916	1895		0.42857142857142855	0.5	65	10851	8	6	57	10845	10916	0.26338773301603524
M1	string	0	network_modules	402	TRUE	5.371583999741203e-11	80	12	7	0.5833333333333334	0.0875	GO:0031123	GO:BP	RNA 3'-end processing	16175	7048		0.125	0.2222222222222222	80	16095	7	5	73	16090	16175	0.2246478606974339
M1	string	0	network_modules	402	TRUE	1.2503562470819056e-7	276	14	8	0.5714285714285714	0.028985507246376812	REAC:R-HSA-72203	REAC	Processing of Capped Intron-Containing Pre-mRNA	10916	1796		0.5714285714285714	0.625	276	10640	8	6	268	10634	10916	0.12466849958649484
M1	string	0	network_modules	402	TRUE	1.559230472361209e-6	4	12	3	0.25	0.75	GO:0110104	GO:BP	mRNA alternative polyadenylation	16175	19416		0.25	0.3333333333333333	4	16171	3	9	1	16162	16175	0.4327984452304239
M1	string	0	network_modules	402	TRUE	1.9638600035521564e-6	352	12	7	0.5833333333333334	0.019886363636363636	GO:0006397	GO:BP	mRNA processing	16175	2158		0.375	0.4444444444444444	352	15823	7	5	345	15818	16175	0.10487286365701885
M1	string	0	network_modules	402	TRUE	3.83274374012187e-5	38	14	4	0.2857142857142857	0.10526315789473684	REAC:R-HSA-159231	REAC	Transport of Mature mRNA Derived from an Intronless Transcript	10916	2585		0.7142857142857143	0.75	38	10878	4	10	34	10868	10916	0.1717181355006958
M1	string	0	network_modules	402	TRUE	4.267635665684065e-5	39	14	4	0.2857142857142857	0.10256410256410256	REAC:R-HSA-159234	REAC	Transport of Mature mRNAs Derived from Intronless Transcripts	10916	2587		0.8571428571428571	0.875	39	10877	4	10	35	10867	10916	0.16945509594910788
M1	string	0	network_modules	402	TRUE	7.001427754808858e-5	590	12	7	0.5833333333333334	0.011864406779661017	GO:0016071	GO:BP	mRNA metabolic process	16175	5098		0.5	0.5555555555555556	590	15585	7	5	583	15580	16175	0.07948195169630388
M1	string	0	network_modules	402	TRUE	1.1106683966943732e-4	13	12	3	0.25	0.23076923076923078	GO:0051290	GO:BP	protein heterotetramerization	16175	13622		0.625	0.6666666666666666	13	16162	3	9	10	16153	16175	0.23960521810067908
M1	string	0	network_modules	402	TRUE	4.4142174778287143e-4	20	12	3	0.25	0.15	GO:0051291	GO:BP	protein heterooligomerization	16175	13623		0.75	0.7777777777777778	20	16155	3	9	17	16146	16175	0.1928821983633001
M1	string	0	network_modules	402	TRUE	7.962426160528568e-4	80	14	4	0.2857142857142857	0.05	REAC:R-HSA-72202	REAC	Transport of Mature Transcript to Cytoplasm	10916	2584		1	1	80	10836	4	10	76	10826	10916	0.11696117474094567
M1	string	0	network_modules	402	TRUE	0.003443989024760321	62	11	3	0.2727272727272727	0.04838709677419355	KEGG:03250	KEGG	Viral life cycle - HIV-1	8484	223		1	1	62	8422	3	8	59	8414	8484	0.1122813427185093
M1	string	0	network_modules	402	TRUE	0.00944489755346404	6	12	2	0.16666666666666666	0.3333333333333333	GO:0180010	GO:BP	co-transcriptional mRNA 3'-end processing, cleavage and polyadenylation pathway	16175	20295		0.875	1	6	16169	2	10	4	16159	16175	0.2353086011396884
M1	string	0	network_modules	402	TRUE	0.00944489755346404	6	12	2	0.16666666666666666	0.3333333333333333	GO:0006398	GO:BP	mRNA 3'-end processing by stem-loop binding and cleavage	16175	2159		0.875	1	6	16169	2	10	4	16159	16175	0.2353086011396884
M1	string	0	network_modules	403	TRUE	3.0886044604704614e-15	590	14	13	0.9285714285714286	0.022033898305084745	GO:0016567	GO:BP	protein ubiquitination	16175	5254		0	0.047619047619047616	590	15585	13	1	577	15584	16175	0.14005740510081385
M1	string	0	network_modules	403	TRUE	1.538324455370943e-14	667	14	13	0.9285714285714286	0.019490254872563718	GO:0032446	GO:BP	protein modification by small protein conjugation	16175	7568		0.05	0.09523809523809523	667	15508	13	1	654	15507	16175	0.1313472449745265
M1	string	0	network_modules	403	TRUE	1.729461296292521e-14	673	14	13	0.9285714285714286	0.019316493313521546	GO:0051603	GO:BP	proteolysis involved in protein catabolic process	16175	13820		0.1	0.14285714285714285	673	15502	13	1	660	15501	16175	0.13073106269267032
M1	string	0	network_modules	403	TRUE	7.001180134903071e-14	749	14	13	0.9285714285714286	0.017356475300400534	GO:0070647	GO:BP	protein modification by small protein conjugation or removal	16175	16231		0.15	0.19047619047619047	749	15426	13	1	736	15425	16175	0.12356795740533259
M1	string	0	network_modules	403	TRUE	1.601305181084205e-13	798	14	13	0.9285714285714286	0.016290726817042606	GO:0043687	GO:BP	post-translational protein modification	16175	10838		0.2	0.23809523809523808	798	15377	13	1	785	15376	16175	0.11949298715585863
M1	string	0	network_modules	403	TRUE	2.1812848122944795e-13	547	14	12	0.8571428571428571	0.021937842778793418	GO:0006511	GO:BP	ubiquitin-dependent protein catabolic process	16175	2235		0.25	0.2857142857142857	547	15628	12	2	535	15626	16175	0.13406032120985795
M1	string	0	network_modules	403	TRUE	2.1942690214617648e-13	140	11	9	0.8181818181818182	0.06428571428571428	KEGG:04120	KEGG	Ubiquitin mediated proteolysis	8484	270		NA	1	140	8344	9	2	131	8342	8484	0.22674012087082973
M1	string	0	network_modules	403	TRUE	2.5985847529354864e-13	555	14	12	0.8571428571428571	0.021621621621621623	GO:0019941	GO:BP	modification-dependent protein catabolic process	16175	6072		0.3	0.3333333333333333	555	15620	12	2	543	15618	16175	0.13304472024540548
M1	string	0	network_modules	403	TRUE	2.8335621738669266e-13	559	14	12	0.8571428571428571	0.02146690518783542	GO:0043632	GO:BP	modification-dependent macromolecule catabolic process	16175	10812		0.35	0.38095238095238093	559	15616	12	2	547	15614	16175	0.13254498597511222
M1	string	0	network_modules	403	TRUE	9.726240366354069e-11	248	14	9	0.6428571428571429	0.036290322580645164	GO:0000209	GO:BP	protein polyubiquitination	16175	59		0.4	0.42857142857142855	248	15927	9	5	239	15922	16175	0.1503184480204482
M1	string	0	network_modules	403	TRUE	6.139358931942713e-10	308	12	9	0.75	0.02922077922077922	REAC:R-HSA-983168	REAC	Antigen processing: Ubiquitination & Proteasome degradation	10916	154		0	0.05555555555555555	308	10608	9	3	299	10605	10916	0.14460279529097236
M1	string	0	network_modules	403	TRUE	4.083603332478052e-9	380	12	9	0.75	0.02368421052631579	REAC:R-HSA-983169	REAC	Class I MHC mediated antigen processing & presentation	10916	368		0.058823529411764705	0.1111111111111111	380	10536	9	3	371	10533	10916	0.129435141162935
M1	string	0	network_modules	403	TRUE	3.708217947578934e-6	78	12	5	0.4166666666666667	0.0641025641025641	REAC:R-HSA-8852135	REAC	Protein ubiquitination	10916	1818		0.11764705882352941	0.16666666666666666	78	10838	5	7	73	10831	10916	0.16129307984483632
M1	string	0	network_modules	403	TRUE	5.831360624159515e-6	29	12	4	0.3333333333333333	0.13793103448275862	REAC:R-HSA-2173795	REAC	Downregulation of SMAD2/3:SMAD4 transcriptional activity	10916	787		0.17647058823529413	0.2222222222222222	29	10887	4	8	25	10879	10916	0.21311385751454878
M1	string	0	network_modules	403	TRUE	6.0613938618107085e-6	79	14	5	0.35714285714285715	0.06329113924050633	GO:0070936	GO:BP	protein K48-linked ubiquitination	16175	16380		0.45	0.47619047619047616	79	16096	5	9	74	16087	16175	0.1487179832498973
M1	string	0	network_modules	403	TRUE	6.724541576945125e-6	30	12	4	0.3333333333333333	0.13333333333333333	REAC:R-HSA-8866652	REAC	Synthesis of active ubiquitin: roles of E1 and E2 enzymes	10916	2400		0.23529411764705882	0.2777777777777778	30	10886	4	8	26	10878	10916	0.2094834305013368
M1	string	0	network_modules	403	TRUE	7.716235537016371e-6	31	12	4	0.3333333333333333	0.12903225806451613	REAC:R-HSA-201451	REAC	Signaling by BMP	10916	2224		0.29411764705882354	0.3333333333333333	31	10885	4	8	27	10877	10916	0.2060293259706044
M1	string	0	network_modules	403	TRUE	8.283636067048174e-6	84	14	5	0.35714285714285715	0.05952380952380952	GO:0090288	GO:BP	negative regulation of cellular response to growth factor stimulus	16175	18172		0.5	0.5238095238095238	84	16091	5	9	79	16082	16175	0.14411977612664623
M1	string	0	network_modules	403	TRUE	1.2810223240273932e-5	35	12	4	0.3333333333333333	0.11428571428571428	REAC:R-HSA-936440	REAC	Negative regulators of DDX58/IFIH1 signaling	10916	1581		0.35294117647058826	0.3888888888888889	35	10881	4	8	31	10873	10916	0.19371974420402327
M1	string	0	network_modules	403	TRUE	5.5849792670449034e-5	50	12	4	0.3333333333333333	0.08	REAC:R-HSA-2173793	REAC	Transcriptional activity of SMAD2/SMAD3:SMAD4 heterotrimer	10916	2550		0.4117647058823529	0.4444444444444444	50	10866	4	8	46	10858	10916	0.16151429640411902
M1	string	0	network_modules	403	TRUE	5.990683314440681e-5	44	14	4	0.2857142857142857	0.09090909090909091	GO:0030514	GO:BP	negative regulation of BMP signaling pathway	16175	6830		0.55	0.5714285714285714	44	16131	4	10	40	16121	16175	0.1599169488157372
M1	string	0	network_modules	403	TRUE	1.0240622818894919e-4	58	12	4	0.3333333333333333	0.06896551724137931	REAC:R-HSA-8866654	REAC	E3 ubiquitin ligases ubiquitinate target proteins	10916	811		0.47058823529411764	0.5	58	10858	4	8	54	10850	10916	0.14968306914704715
M1	string	0	network_modules	403	TRUE	4.05414992224524e-4	363	14	6	0.42857142857142855	0.01652892561983471	GO:0043161	GO:BP	proteasome-mediated ubiquitin-dependent protein catabolic process	16175	10561		0.6	0.6190476190476191	363	15812	6	8	357	15804	16175	0.0807034115292147
M1	string	0	network_modules	403	TRUE	4.1624874398443426e-4	82	12	4	0.3333333333333333	0.04878048780487805	REAC:R-HSA-168928	REAC	DDX58/IFIH1-mediated induction of interferon-alpha/beta	10916	436		0.5294117647058824	0.5555555555555556	82	10834	4	8	78	10826	10916	0.12518131935133153
M1	string	0	network_modules	403	TRUE	6.189602914188734e-4	78	14	4	0.2857142857142857	0.05128205128205128	GO:0030510	GO:BP	regulation of BMP signaling pathway	16175	6826		0.65	0.6666666666666666	78	16097	4	10	74	16087	16175	0.11934214354939358
M1	string	0	network_modules	403	TRUE	6.610584859308048e-4	92	12	4	0.3333333333333333	0.043478260869565216	REAC:R-HSA-170834	REAC	Signaling by TGF-beta Receptor Complex	10916	2308		0.5882352941176471	0.6111111111111112	92	10824	4	8	88	10816	10916	0.11790446972351569
M1	string	0	network_modules	403	TRUE	0.0013346460423407458	31	12	3	0.25	0.0967741935483871	REAC:R-HSA-5675482	REAC	Regulation of necroptotic cell death	10916	2045		0.6470588235294118	0.7222222222222222	31	10885	3	9	28	10876	10916	0.15407940168216502
M1	string	0	network_modules	403	TRUE	0.0013346460423407458	31	12	3	0.25	0.0967741935483871	REAC:R-HSA-5213460	REAC	RIPK1-mediated regulated necrosis	10916	1877		0.6470588235294118	0.7222222222222222	31	10885	3	9	28	10876	10916	0.15407940168216502
M1	string	0	network_modules	403	TRUE	0.0018411440466878726	470	14	6	0.42857142857142855	0.01276595744680851	GO:0010498	GO:BP	proteasomal protein catabolic process	16175	4177		0.7	0.7142857142857143	470	15705	6	8	464	15697	16175	0.07000653103390858
M1	string	0	network_modules	403	TRUE	0.0020415833627190363	122	12	4	0.3333333333333333	0.03278688524590164	REAC:R-HSA-9006936	REAC	Signaling by TGFB family members	10916	2310		0.7647058823529411	0.7777777777777778	122	10794	4	8	118	10786	10916	0.10166179751203493
M1	string	0	network_modules	403	TRUE	0.002181362057480958	256	14	5	0.35714285714285715	0.01953125	GO:0090287	GO:BP	regulation of cellular response to growth factor stimulus	16175	18171		0.75	0.7619047619047619	256	15919	5	9	251	15910	16175	0.08049203720987581
M1	string	0	network_modules	403	TRUE	0.00293243977894383	31	14	3	0.21428571428571427	0.0967741935483871	GO:0070979	GO:BP	protein K11-linked ubiquitination	16175	16411		0.8	0.8095238095238095	31	16144	3	11	28	16133	16175	0.14291547382459283
M1	string	0	network_modules	403	TRUE	0.0031553233409691455	117	14	4	0.2857142857142857	0.03418803418803419	GO:0030509	GO:BP	BMP signaling pathway	16175	6825		0.85	0.8571428571428571	117	16058	4	10	113	16048	16175	0.09672326530730387
M1	string	0	network_modules	403	TRUE	0.0038524310638327797	123	14	4	0.2857142857142857	0.032520325203252036	GO:0071773	GO:BP	cellular response to BMP stimulus	16175	16902		0.9	0.9523809523809523	123	16052	4	10	119	16042	16175	0.09422661729226033
M1	string	0	network_modules	403	TRUE	0.0038524310638327797	123	14	4	0.2857142857142857	0.032520325203252036	GO:0071772	GO:BP	response to BMP	16175	16901		0.9	0.9523809523809523	123	16052	4	10	119	16042	16175	0.09422661729226033
M1	string	0	network_modules	403	TRUE	0.004240954163039658	126	14	4	0.2857142857142857	0.031746031746031744	GO:0090101	GO:BP	negative regulation of transmembrane receptor protein serine/threonine kinase signaling pathway	16175	18019		1	1	126	16049	4	10	122	16039	16175	0.09304472210102999
M1	string	0	network_modules	403	TRUE	0.004465530732383172	46	12	3	0.25	0.06521739130434782	REAC:R-HSA-5357905	REAC	Regulation of TNFR1 signaling	10916	2011		0.8235294117647058	0.8333333333333334	46	10870	3	9	43	10861	10916	0.12587071129438526
M1	string	0	network_modules	403	TRUE	0.00767468224298628	55	12	3	0.25	0.05454545454545454	REAC:R-HSA-75893	REAC	TNF signaling	10916	2446		0.8823529411764706	0.8888888888888888	55	10861	3	9	52	10852	10916	0.1147738243609102
M1	string	0	network_modules	403	TRUE	0.009009723903064717	58	12	3	0.25	0.05172413793103448	REAC:R-HSA-5218859	REAC	Regulated Necrosis	10916	1959		0.9411764705882353	0.9444444444444444	58	10858	3	9	55	10849	10916	0.11165615649555843
M1	string	0	network_modules	403	TRUE	0.009198420638370638	8	12	2	0.16666666666666666	0.25	REAC:R-HSA-1253288	REAC	Downregulation of ERBB4 signaling	10916	786		1	1	8	10908	2	10	6	10898	10916	0.20341291469682457
M1	string	0	network_modules	404	TRUE	5.069615032049175e-7	3	13	3	0.23076923076923078	1	GO:0070681	GO:BP	glutaminyl-tRNAGln biosynthesis via transamidation	16175	16257		0	0.14285714285714285	3	16172	3	10	0	16162	16175	0.4802359149317893
M1	string	0	network_modules	404	TRUE	1.1841135100906794e-5	44	11	4	0.36363636363636365	0.09090909090909091	KEGG:00970	KEGG	Aminoacyl-tRNA biosynthesis	8484	153		NA	1	44	8440	4	7	40	8433	8484	0.1798082361422202
M1	string	0	network_modules	404	TRUE	3.1227101940053076e-5	41	13	4	0.3076923076923077	0.0975609756097561	GO:0043039	GO:BP	tRNA aminoacylation	16175	10489		0.16666666666666666	0.42857142857142855	41	16134	4	9	37	16125	16175	0.17211929286660982
M1	string	0	network_modules	404	TRUE	3.1227101940053076e-5	41	13	4	0.3076923076923077	0.0975609756097561	GO:0043038	GO:BP	amino acid activation	16175	10488		0.16666666666666666	0.42857142857142855	41	16134	4	9	37	16125	16175	0.17211929286660982
M1	string	0	network_modules	404	TRUE	2.844622788979212e-4	186	13	5	0.38461538461538464	0.026881720430107527	GO:0006399	GO:BP	tRNA metabolic process	16175	2160		0.5	0.5714285714285714	186	15989	5	8	181	15981	16175	0.09925338954728237
M1	string	0	network_modules	404	TRUE	0.0011608444830456034	247	13	5	0.38461538461538464	0.020242914979757085	GO:0006520	GO:BP	amino acid metabolic process	16175	2241		0.6666666666666666	0.7142857142857143	247	15928	5	8	242	15920	16175	0.08542233274798279
M1	string	0	network_modules	404	TRUE	0.003066683006724606	127	13	4	0.3076923076923077	0.031496062992125984	GO:0032543	GO:BP	mitochondrial translation	16175	7635		0.8333333333333334	0.8571428571428571	127	16048	4	9	123	16039	16175	0.09634887699942779
M1	string	0	network_modules	404	TRUE	0.007313968202432957	158	13	4	0.3076923076923077	0.02531645569620253	GO:0140053	GO:BP	mitochondrial gene expression	16175	19653		1	1	158	16017	4	9	154	16008	16175	0.08591222910349319
M1	string	0	network_modules	409	TRUE	6.857988764500795e-11	27	13	6	0.46153846153846156	0.2222222222222222	REAC:R-HSA-3000170	REAC	Syndecan interactions	10916	2367		0	0.038461538461538464	27	10889	6	7	21	10882	10916	0.3191247776651688
M1	string	0	network_modules	409	TRUE	1.025635289915954e-8	59	13	6	0.46153846153846156	0.1016949152542373	REAC:R-HSA-3000171	REAC	Non-integrin membrane-ECM interactions	10916	1603		0.04	0.07692307692307693	59	10857	6	7	53	10850	10916	0.2148192968507034
M1	string	0	network_modules	409	TRUE	1.0296703328813459e-7	298	13	8	0.6153846153846154	0.026845637583892617	REAC:R-HSA-1474244	REAC	Extracellular matrix organization	10916	889		0.08	0.11538461538461539	298	10618	8	5	290	10613	10916	0.12461576352697716
M1	string	0	network_modules	409	TRUE	3.854022446852707e-7	14	13	4	0.3076923076923077	0.2857142857142857	REAC:R-HSA-3656237	REAC	Defective EXT2 causes exostoses 2	10916	539		0.12	0.19230769230769232	14	10902	4	9	10	10893	10916	0.2956294686627167
M1	string	0	network_modules	409	TRUE	3.854022446852707e-7	14	13	4	0.3076923076923077	0.2857142857142857	REAC:R-HSA-3656253	REAC	Defective EXT1 causes exostoses 1, TRPS2 and CHDS	10916	538		0.12	0.19230769230769232	14	10902	4	9	10	10893	10916	0.2956294686627167
M1	string	0	network_modules	409	TRUE	1.4874070233022496e-6	19	13	4	0.3076923076923077	0.21052631578947367	REAC:R-HSA-9694614	REAC	Attachment and Entry	10916	187		0.2	0.23076923076923078	19	10897	4	9	15	10888	10916	0.25344565688490506
M1	string	0	network_modules	409	TRUE	1.8580310968626937e-6	20	13	4	0.3076923076923077	0.2	REAC:R-HSA-3560783	REAC	Defective B4GALT7 causes EDS, progeroid type	10916	495		0.24	0.34615384615384615	20	10896	4	9	16	10887	10916	0.24696563593173385
M1	string	0	network_modules	409	TRUE	1.8580310968626937e-6	20	13	4	0.3076923076923077	0.2	REAC:R-HSA-3560801	REAC	Defective B3GAT3 causes JDSSDHD	10916	492		0.24	0.34615384615384615	20	10896	4	9	16	10887	10916	0.24696563593173385
M1	string	0	network_modules	409	TRUE	1.8580310968626937e-6	20	13	4	0.3076923076923077	0.2	REAC:R-HSA-4420332	REAC	Defective B3GALT6 causes EDSP2 and SEMDJL1	10916	490		0.24	0.34615384615384615	20	10896	4	9	16	10887	10916	0.24696563593173385
M1	string	0	network_modules	409	TRUE	2.623589398745162e-6	153	13	6	0.46153846153846156	0.0392156862745098	KEGG:04514	KEGG	Cell adhesion molecules	8484	315		0	0.25	153	8331	6	7	147	8324	8484	0.13055958417067262
M1	string	0	network_modules	409	TRUE	4.064259394234297e-6	24	13	4	0.3076923076923077	0.16666666666666666	REAC:R-HSA-2024096	REAC	HS-GAG degradation	10916	1108		0.36	0.38461538461538464	24	10892	4	9	20	10883	10916	0.225218996265265
M1	string	0	network_modules	409	TRUE	5.7105629099018055e-6	26	13	4	0.3076923076923077	0.15384615384615385	REAC:R-HSA-1971475	REAC	A tetrasaccharide linker sequence is required for GAG synthesis	10916	6		0.4	0.4230769230769231	26	10890	4	9	22	10881	10916	0.21627349538800306
M1	string	0	network_modules	409	TRUE	1.1979274623326824e-5	31	13	4	0.3076923076923077	0.12903225806451613	REAC:R-HSA-2022928	REAC	HS-GAG biosynthesis	10916	1107		0.44	0.46153846153846156	31	10885	4	9	27	10876	10916	0.1978139013611731
M1	string	0	network_modules	409	TRUE	1.9471230834890828e-5	97	13	5	0.38461538461538464	0.05154639175257732	REAC:R-HSA-2187338	REAC	Visual phototransduction	10916	2654		0.48	0.5	97	10819	5	8	92	10811	10916	0.13824769080580585
M1	string	0	network_modules	409	TRUE	2.504495968889233e-5	37	13	4	0.3076923076923077	0.10810810810810811	REAC:R-HSA-9772572	REAC	Early SARS-CoV-2 Infection Events	10916	832		0.52	0.5384615384615384	37	10879	4	9	33	10870	10916	0.1807893226600633
M1	string	0	network_modules	409	TRUE	3.830122470967559e-5	41	13	4	0.3076923076923077	0.0975609756097561	REAC:R-HSA-3560782	REAC	Diseases associated with glycosaminoglycan metabolism	10916	750		0.56	0.5769230769230769	41	10875	4	9	37	10866	10916	0.17156878830195396
M1	string	0	network_modules	409	TRUE	5.1240497266649804e-5	44	13	4	0.3076923076923077	0.09090909090909091	REAC:R-HSA-975634	REAC	Retinoid metabolism and transport	10916	2093		0.6	0.6153846153846154	44	10872	4	9	40	10863	10916	0.16548967721319324
M1	string	0	network_modules	409	TRUE	7.325201312144162e-5	48	13	4	0.3076923076923077	0.08333333333333333	REAC:R-HSA-6806667	REAC	Metabolism of fat-soluble vitamins	10916	1424		0.64	0.6538461538461539	48	10868	4	9	44	10859	10916	0.15828222511422715
M1	string	0	network_modules	409	TRUE	7.971056044178949e-5	49	13	4	0.3076923076923077	0.08163265306122448	REAC:R-HSA-1793185	REAC	Chondroitin sulfate/dermatan sulfate metabolism	10916	353		0.68	0.6923076923076923	49	10867	4	9	45	10858	10916	0.15661866248500494
M1	string	0	network_modules	409	TRUE	1.4782352001338386e-4	57	13	4	0.3076923076923077	0.07017543859649122	REAC:R-HSA-1638091	REAC	Heparan sulfate/heparin (HS-GAG) metabolism	10916	1119		0.72	0.7307692307692307	57	10859	4	9	53	10850	10916	0.14491490008410982
M1	string	0	network_modules	409	TRUE	4.691504395728343e-4	205	13	5	0.38461538461538464	0.024390243902439025	KEGG:05205	KEGG	Proteoglycans in cancer	8484	457		0.3333333333333333	0.5	205	8279	5	8	200	8271	8484	0.09195743925657895
M1	string	0	network_modules	409	TRUE	5.729295827294633e-4	191	13	5	0.38461538461538464	0.02617801047120419	REAC:R-HSA-202733	REAC	Cell surface interactions at the vascular wall	10916	327		0.76	0.7692307692307693	191	10725	5	8	186	10717	10916	0.09668357463033556
M1	string	0	network_modules	409	TRUE	0.0012168844279940012	27	13	3	0.23076923076923078	0.1111111111111111	REAC:R-HSA-114508	REAC	Effects of PIP2 hydrolysis	10916	833		0.8	0.8076923076923077	27	10889	3	10	24	10879	10916	0.15870266976772543
M1	string	0	network_modules	409	TRUE	0.0023264791779495954	138	13	4	0.3076923076923077	0.028985507246376812	KEGG:05418	KEGG	Fluid shear stress and atherosclerosis	8484	495		0.6666666666666666	0.75	138	8346	4	9	134	8337	8484	0.09025164913321543
M1	string	0	network_modules	409	TRUE	0.002553833575359617	259	13	5	0.38461538461538464	0.019305019305019305	REAC:R-HSA-76002	REAC	Platelet activation, signaling and aggregation	10916	1762		0.84	0.8461538461538461	259	10657	5	8	254	10649	10916	0.08187817800143245
M1	string	0	network_modules	409	TRUE	0.0027053211664397397	49	13	3	0.23076923076923078	0.061224489795918366	KEGG:05144	KEGG	Malaria	8484	436		1	1	49	8435	3	10	46	8425	8484	0.11631471985796052
M1	string	0	network_modules	409	TRUE	0.0034669397614021415	125	13	4	0.3076923076923077	0.032	REAC:R-HSA-1630316	REAC	Glycosaminoglycan metabolism	10916	1076		0.88	0.8846153846153846	125	10791	4	9	121	10782	10916	0.09614392364361116
M1	string	0	network_modules	409	TRUE	0.004408473803311874	324	13	5	0.38461538461538464	0.015432098765432098	GO:0007159	GO:BP	leukocyte cell-cell adhesion	16175	2723		0	0.5	324	15851	5	8	319	15843	16175	0.07380159446324973
M1	string	0	network_modules	409	TRUE	0.004468175280053667	4	13	2	0.15384615384615385	0.5	GO:1903553	GO:BP	positive regulation of extracellular exosome assembly	16175	23100		1	1	4	16171	2	11	2	16160	16175	0.27704988141747466
M1	string	0	network_modules	409	TRUE	0.004577402495498298	292	13	5	0.38461538461538464	0.017123287671232876	REAC:R-HSA-9694516	REAC	SARS-CoV-2 Infection	10916	2122		0.92	0.9230769230769231	292	10624	5	8	287	10616	10916	0.07658553775231466
M1	string	0	network_modules	409	TRUE	0.005429571576600341	140	13	4	0.3076923076923077	0.02857142857142857	REAC:R-HSA-3781865	REAC	Diseases of glycosylation	10916	765		0.96	0.9615384615384616	140	10776	4	9	136	10767	10916	0.09048898191622338
M1	string	0	network_modules	409	TRUE	0.007092401240875461	48	13	3	0.23076923076923078	0.0625	REAC:R-HSA-418597	REAC	G alpha (z) signalling events	10916	990		1	1	48	10868	3	10	45	10858	10916	0.11813796932085115
M1	string	0	network_modules	410	TRUE	2.914813274284115e-8	89	11	6	0.5454545454545454	0.06741573033707865	KEGG:04512	KEGG	ECM-receptor interaction	8484	314		0	0.1111111111111111	89	8395	6	5	83	8390	8484	0.18918982444075122
M1	string	0	network_modules	410	TRUE	1.0559506811783468e-7	101	13	6	0.46153846153846156	0.0594059405940594	GO:0007229	GO:BP	integrin-mediated signaling pathway	16175	2779		0	0.05263157894736842	101	16074	6	7	95	16067	16175	0.16392225435929203
M1	string	0	network_modules	410	TRUE	3.4533366073822875e-6	92	11	5	0.45454545454545453	0.05434782608695652	KEGG:04640	KEGG	Hematopoietic cell lineage	8484	333		0.125	0.2222222222222222	92	8392	5	6	87	8386	8484	0.15436280352911164
M1	string	0	network_modules	410	TRUE	5.1784957741962344e-6	192	13	6	0.46153846153846156	0.03125	GO:0007160	GO:BP	cell-matrix adhesion	16175	2724		0.05555555555555555	0.10526315789473684	192	15983	6	7	186	15976	16175	0.1177554223486787
M1	string	0	network_modules	410	TRUE	5.405295209984543e-6	84	12	5	0.4166666666666667	0.05952380952380952	REAC:R-HSA-216083	REAC	Integrin cell surface interactions	10916	1216		0	0.1	84	10832	5	7	79	10825	10916	0.1552602735577639
M1	string	0	network_modules	410	TRUE	6.724541576945125e-6	30	12	4	0.3333333333333333	0.13333333333333333	REAC:R-HSA-3000157	REAC	Laminin interactions	10916	1303		0.1111111111111111	0.2	30	10886	4	8	26	10878	10916	0.2094834305013368
M1	string	0	network_modules	410	TRUE	4.8372858562923213e-5	279	13	6	0.46153846153846156	0.021505376344086023	GO:0031589	GO:BP	cell-substrate adhesion	16175	7233		0.1111111111111111	0.15789473684210525	279	15896	6	7	273	15889	16175	0.09678065414223451
M1	string	0	network_modules	410	TRUE	7.32513553113107e-5	533	13	7	0.5384615384615384	0.013133208255159476	GO:0006897	GO:BP	endocytosis	16175	2551		0.16666666666666666	0.21052631578947367	533	15642	7	6	526	15636	16175	0.08031338845171174
M1	string	0	network_modules	410	TRUE	8.948591681581211e-5	2	11	2	0.18181818181818182	1	KEGG:03271	KEGG	Virion - Rotavirus	8484	235		0.25	0.3333333333333333	2	8482	2	9	0	8473	8484	0.42617515167907616
M1	string	0	network_modules	410	TRUE	9.428394692107895e-5	298	12	6	0.5	0.020134228187919462	REAC:R-HSA-1474244	REAC	Extracellular matrix organization	10916	889		0.2222222222222222	0.3	298	10618	6	6	292	10612	10916	0.09623164520744303
M1	string	0	network_modules	410	TRUE	9.996445500585097e-5	150	12	5	0.4166666666666667	0.03333333333333333	REAC:R-HSA-1500931	REAC	Cell-Cell communication	10916	328		0.3333333333333333	0.4	150	10766	5	7	145	10759	10916	0.11481880543147219
M1	string	0	network_modules	410	TRUE	1.6389708708762585e-4	84	11	4	0.36363636363636365	0.047619047619047616	KEGG:05412	KEGG	Arrhythmogenic right ventricular cardiomyopathy	8484	490		0.375	0.4444444444444444	84	8400	4	7	80	8393	8484	0.12872935837103705
M1	string	0	network_modules	410	TRUE	2.3608478677863425e-4	92	11	4	0.36363636363636365	0.043478260869565216	KEGG:05222	KEGG	Small cell lung cancer	8484	473		0.5	0.5555555555555556	92	8392	4	7	88	8385	8484	0.12273572602860489
M1	string	0	network_modules	410	TRUE	2.917810495646966e-4	97	11	4	0.36363636363636365	0.041237113402061855	KEGG:05410	KEGG	Hypertrophic cardiomyopathy	8484	489		0.625	0.6666666666666666	97	8387	4	7	93	8380	8484	0.11936647170775842
M1	string	0	network_modules	410	TRUE	3.308655747210595e-4	73	13	4	0.3076923076923077	0.0547945205479452	GO:0033627	GO:BP	cell adhesion mediated by integrin	16175	8328		0.2222222222222222	0.2631578947368421	73	16102	4	9	69	16093	16175	0.12828220992395806
M1	string	0	network_modules	410	TRUE	3.3209487882909024e-4	191	12	5	0.4166666666666667	0.02617801047120419	REAC:R-HSA-202733	REAC	Cell surface interactions at the vascular wall	10916	327		0.4444444444444444	0.5	191	10725	5	7	186	10718	10916	0.10099576241745041
M1	string	0	network_modules	410	TRUE	3.5667714108525856e-4	102	11	4	0.36363636363636365	0.0392156862745098	KEGG:05414	KEGG	Dilated cardiomyopathy	8484	491		0.75	0.7777777777777778	102	8382	4	7	98	8375	8484	0.11624393791893836
M1	string	0	network_modules	410	TRUE	4.8761268824471437e-4	19	13	3	0.23076923076923078	0.15789473684210525	GO:0048333	GO:BP	mesodermal cell differentiation	16175	12670		0.2777777777777778	0.3157894736842105	19	16156	3	10	16	16146	16175	0.19010183994272611
M1	string	0	network_modules	410	TRUE	6.854530980930727e-4	25	12	3	0.25	0.12	REAC:R-HSA-210991	REAC	Basigin interactions	10916	207		0.5555555555555556	0.6	25	10891	3	9	22	10882	10916	0.17190974872371378
M1	string	0	network_modules	410	TRUE	6.871166198796659e-4	740	13	7	0.5384615384615384	0.00945945945945946	GO:0098657	GO:BP	import into cell	16175	18813		0.3333333333333333	0.3684210526315789	740	15435	7	6	733	15429	16175	0.06687939117421239
M1	string	0	network_modules	410	TRUE	7.192065490990857e-4	745	13	7	0.5384615384615384	0.009395973154362415	GO:0098609	GO:BP	cell-cell adhesion	16175	18805		0.3888888888888889	0.42105263157894735	745	15430	7	6	738	15424	16175	0.06662355978002173
M1	string	0	network_modules	410	TRUE	8.706387220533925e-4	27	12	3	0.25	0.1111111111111111	REAC:R-HSA-3000170	REAC	Syndecan interactions	10916	2367		0.6666666666666666	0.7	27	10889	3	9	24	10880	10916	0.16531306015909594
M1	string	0	network_modules	410	TRUE	0.0011541703171685156	25	13	3	0.23076923076923078	0.12	GO:0071404	GO:BP	cellular response to low-density lipoprotein particle stimulus	16175	16656		0.4444444444444444	0.47368421052631576	25	16150	3	10	22	16140	16175	0.16548991892696704
M1	string	0	network_modules	410	TRUE	0.0012062334803919997	30	12	3	0.25	0.1	REAC:R-HSA-8874081	REAC	MET activates PTK2 signaling	10916	1362		0.7777777777777778	0.8	30	10886	3	9	27	10877	10916	0.15667719718911177
M1	string	0	network_modules	410	TRUE	0.0013041089454955365	26	13	3	0.23076923076923078	0.11538461538461539	GO:0055094	GO:BP	response to lipoprotein particle	16175	14244		0.5	0.5263157894736842	26	16149	3	10	23	16139	16175	0.16223747198685623
M1	string	0	network_modules	410	TRUE	0.001326112555300808	103	13	4	0.3076923076923077	0.038834951456310676	GO:0031623	GO:BP	receptor internalization	16175	7240		0.5555555555555556	0.5789473684210527	103	16072	4	9	99	16063	16175	0.10743584929366501
M1	string	0	network_modules	410	TRUE	0.0014664418752610858	27	13	3	0.23076923076923078	0.1111111111111111	GO:0071402	GO:BP	cellular response to lipoprotein particle stimulus	16175	16654		0.6111111111111112	0.631578947368421	27	16148	3	10	24	16138	16175	0.15916670598500132
M1	string	0	network_modules	410	TRUE	0.0024809207458409864	32	13	3	0.23076923076923078	0.09375	GO:0001707	GO:BP	mesoderm formation	16175	399		0.6666666666666666	0.6842105263157895	32	16143	3	10	29	16133	16175	0.14602929542180088
M1	string	0	network_modules	410	TRUE	0.0027277465238705304	33	13	3	0.23076923076923078	0.09090909090909091	GO:0048332	GO:BP	mesoderm morphogenesis	16175	12669		0.7222222222222222	0.7368421052631579	33	16142	3	10	30	16132	16175	0.1437653050225394
M1	string	0	network_modules	410	TRUE	0.0027875165644243543	124	13	4	0.3076923076923077	0.03225806451612903	GO:0045807	GO:BP	positive regulation of endocytosis	16175	11631		0.7777777777777778	0.7894736842105263	124	16051	4	9	120	16042	16175	0.09755861864459163
M1	string	0	network_modules	410	TRUE	0.00291724244643804	40	12	3	0.25	0.075	REAC:R-HSA-8875878	REAC	MET promotes cell motility	10916	1368		0.8888888888888888	0.9	40	10876	3	9	37	10867	10916	0.1352458378530985
M1	string	0	network_modules	410	TRUE	0.0032260297476823124	304	13	5	0.38461538461538464	0.01644736842105263	GO:0050900	GO:BP	leukocyte migration	16175	13342		0.8333333333333334	0.8421052631578947	304	15871	5	8	299	15863	16175	0.07640082502723902
M1	string	0	network_modules	410	TRUE	0.005286396682272369	202	11	4	0.36363636363636365	0.019801980198019802	KEGG:04510	KEGG	Focal adhesion	8484	313		0.875	0.8888888888888888	202	8282	4	7	198	8275	8484	0.08031428146266886
M1	string	0	network_modules	410	TRUE	0.00550094831431532	339	13	5	0.38461538461538464	0.014749262536873156	GO:0042060	GO:BP	wound healing	16175	9947		0.8888888888888888	0.8947368421052632	339	15836	5	8	334	15828	16175	0.07200089724685947
M1	string	0	network_modules	410	TRUE	0.00658766283619541	44	13	3	0.23076923076923078	0.06818181818181818	GO:0045428	GO:BP	regulation of nitric oxide biosynthetic process	16175	11372		0.9444444444444444	0.9473684210526315	44	16131	3	10	41	16121	16175	0.12417654470808295
M1	string	0	network_modules	410	TRUE	0.0075436362832566545	46	13	3	0.23076923076923078	0.06521739130434782	GO:0080164	GO:BP	regulation of nitric oxide metabolic process	16175	17838		1	1	46	16129	3	10	43	16119	16175	0.12138873368526018
M1	string	0	network_modules	410	TRUE	0.008317923457145705	227	11	4	0.36363636363636365	0.01762114537444934	KEGG:04810	KEGG	Regulation of actin cytoskeleton	8484	365		1	1	227	8257	4	7	223	8250	8484	0.07521937266131999
M1	string	0	network_modules	410	TRUE	0.009486506111647216	59	12	3	0.25	0.05084745762711865	REAC:R-HSA-3000171	REAC	Non-integrin membrane-ECM interactions	10916	1603		1	1	59	10857	3	9	56	10848	10916	0.11066952303953095
M1	string	0	network_modules	411	TRUE	3.862191745023879e-5	92	7	4	0.5714285714285714	0.043478260869565216	REAC:R-HSA-141444	REAC	Amplification  of signal from unattached  kinetochores via a MAD2  inhibitory signal	10916	143		0	0.16666666666666666	92	10824	4	3	88	10821	10916	0.15600593104210558
M1	string	0	network_modules	411	TRUE	3.862191745023879e-5	92	7	4	0.5714285714285714	0.043478260869565216	REAC:R-HSA-141424	REAC	Amplification of signal from the kinetochores	10916	144		0	0.16666666666666666	92	10824	4	3	88	10821	10916	0.15600593104210558
M1	string	0	network_modules	411	TRUE	7.660858606065568e-5	109	7	4	0.5714285714285714	0.03669724770642202	REAC:R-HSA-69618	REAC	Mitotic Spindle Checkpoint	10916	1486		0.18181818181818182	0.25	109	10807	4	3	105	10804	10916	0.14304085582975976
M1	string	0	network_modules	411	TRUE	9.507347361621e-5	115	7	4	0.5714285714285714	0.034782608695652174	REAC:R-HSA-9648025	REAC	EML4 and NUDC in mitotic spindle formation	10916	817		0.2727272727272727	0.3333333333333333	115	10801	4	3	111	10798	10916	0.1391616724987346
M1	string	0	network_modules	411	TRUE	1.2462971516623734e-4	123	7	4	0.5714285714285714	0.032520325203252036	REAC:R-HSA-2500257	REAC	Resolution of Sister Chromatid Cohesion	10916	2079		0.36363636363636365	0.4166666666666667	123	10793	4	3	119	10790	10916	0.13443398545984467
M1	string	0	network_modules	411	TRUE	1.8662368540492264e-4	136	7	4	0.5714285714285714	0.029411764705882353	REAC:R-HSA-5663220	REAC	RHO GTPases Activate Formins	10916	1848		0.45454545454545453	0.5	136	10780	4	3	132	10777	10916	0.127652575753892
M1	string	0	network_modules	411	TRUE	2.2283033262096845e-4	361	13	6	0.46153846153846156	0.01662049861495845	GO:0007059	GO:BP	chromosome segregation	16175	2658		0	0.2	361	15814	6	7	355	15807	16175	0.08432883913245773
M1	string	0	network_modules	411	TRUE	6.820263295373049e-4	188	7	4	0.5714285714285714	0.02127659574468085	REAC:R-HSA-2467813	REAC	Separation of Sister Chromatids	10916	2204		0.5454545454545454	0.5833333333333334	188	10728	4	3	184	10725	10916	0.1079078666239322
M1	string	0	network_modules	411	TRUE	8.556442765369511e-4	199	7	4	0.5714285714285714	0.020100502512562814	REAC:R-HSA-68877	REAC	Mitotic Prometaphase	10916	1484		0.6363636363636364	0.6666666666666666	199	10717	4	3	195	10714	10916	0.10474610377636591
M1	string	0	network_modules	411	TRUE	0.001326112555300808	103	13	4	0.3076923076923077	0.038834951456310676	GO:0051303	GO:BP	establishment of chromosome localization	16175	13634		0.25	0.4	103	16072	4	9	99	16063	16175	0.10743584929366501
M1	string	0	network_modules	411	TRUE	0.0014706000636626252	228	7	4	0.5714285714285714	0.017543859649122806	REAC:R-HSA-68882	REAC	Mitotic Anaphase	10916	1479		0.7272727272727273	0.75	228	10688	4	3	224	10685	10916	0.09752023256178688
M1	string	0	network_modules	411	TRUE	0.0014964098470093064	229	7	4	0.5714285714285714	0.017467248908296942	REAC:R-HSA-2555396	REAC	Mitotic Metaphase and Anaphase	10916	1482		0.8181818181818182	0.8333333333333334	229	10687	4	3	225	10684	10916	0.09729543342476693
M1	string	0	network_modules	411	TRUE	0.0016038142005587838	108	13	4	0.3076923076923077	0.037037037037037035	GO:0050000	GO:BP	chromosome localization	16175	13183		0.5	0.6	108	16067	4	9	104	16058	16175	0.10482811190173316
M1	string	0	network_modules	411	TRUE	0.0037657619199703363	289	7	4	0.5714285714285714	0.01384083044982699	REAC:R-HSA-69620	REAC	Cell Cycle Checkpoints	10916	321		0.9090909090909091	0.9166666666666666	289	10627	4	3	285	10624	10916	0.08598553502503399
M1	string	0	network_modules	411	TRUE	0.005495049136128299	318	7	4	0.5714285714285714	0.012578616352201259	REAC:R-HSA-195258	REAC	RHO GTPase Effectors	10916	1846		1	1	318	10598	4	3	314	10595	10916	0.08168301838523656
M1	string	0	network_modules	411	TRUE	0.006437468297501887	153	13	4	0.3076923076923077	0.026143790849673203	GO:1902850	GO:BP	microtubule cytoskeleton organization involved in mitosis	16175	22560		0.75	0.8	153	16022	4	9	149	16013	16175	0.08738168593276369
M1	string	0	network_modules	411	TRUE	0.009478289890182923	379	13	5	0.38461538461538464	0.013192612137203167	GO:0000280	GO:BP	nuclear division	16175	78		1	1	379	15796	5	8	374	15788	16175	0.06771797252121879
M1	string	0	network_modules	412	TRUE	1.4120225936768148e-10	147	14	8	0.5714285714285714	0.05442176870748299	GO:0070507	GO:BP	regulation of microtubule cytoskeleton organization	16175	16162		0	0.038461538461538464	147	16028	8	6	139	16022	16175	0.1744115329631797
M1	string	0	network_modules	412	TRUE	4.718911366519296e-10	88	14	7	0.5	0.07954545454545454	GO:0031110	GO:BP	regulation of microtubule polymerization or depolymerization	16175	7035		0.04	0.07692307692307693	88	16087	7	7	81	16080	16175	0.19788545711697125
M1	string	0	network_modules	412	TRUE	4.067844728323149e-9	586	14	10	0.7142857142857143	0.017064846416382253	GO:0000226	GO:BP	microtubule cytoskeleton organization	16175	61		0.08	0.11538461538461539	586	15589	10	4	576	15585	16175	0.10680275060666111
M1	string	0	network_modules	412	TRUE	5.519258786108176e-9	124	14	7	0.5	0.056451612903225805	GO:0031109	GO:BP	microtubule polymerization or depolymerization	16175	7034		0.12	0.15384615384615385	124	16051	7	7	117	16044	16175	0.16613915495383813
M1	string	0	network_modules	412	TRUE	5.676620145451803e-9	232	14	8	0.5714285714285714	0.034482758620689655	GO:0032886	GO:BP	regulation of microtubule-based process	16175	7882		0.16	0.19230769230769232	232	15943	8	6	224	15937	16175	0.13790086542857374
M1	string	0	network_modules	412	TRUE	9.39041576598058e-7	440	14	8	0.5714285714285714	0.01818181818181818	GO:0051493	GO:BP	regulation of cytoskeleton organization	16175	13748		0.2	0.23076923076923078	440	15735	8	6	432	15729	16175	0.09846771155874845
M1	string	0	network_modules	412	TRUE	1.2444409176642254e-6	58	14	5	0.35714285714285715	0.08620689655172414	GO:0031113	GO:BP	regulation of microtubule polymerization	16175	7038		0.24	0.2692307692307692	58	16117	5	9	53	16108	16175	0.17409152378781473
M1	string	0	network_modules	412	TRUE	1.0492158725394892e-5	88	14	5	0.35714285714285715	0.056818181818181816	GO:0046785	GO:BP	microtubule polymerization	16175	12369		0.28	0.3076923076923077	88	16087	5	9	83	16078	16175	0.1407247904883961
M1	string	0	network_modules	412	TRUE	1.2177967450158837e-5	30	14	4	0.2857142857142857	0.13333333333333333	GO:0031116	GO:BP	positive regulation of microtubule polymerization	16175	7041		0.32	0.34615384615384615	30	16145	4	10	26	16135	16175	0.19417713236751138
M1	string	0	network_modules	412	TRUE	1.8156635596488283e-5	33	14	4	0.2857142857142857	0.12121212121212122	GO:0031112	GO:BP	positive regulation of microtubule polymerization or depolymerization	16175	7037		0.36	0.38461538461538464	33	16142	4	10	29	16132	16175	0.18503685430737812
M1	string	0	network_modules	412	TRUE	7.194211721291941e-5	46	14	4	0.2857142857142857	0.08695652173913043	GO:0007020	GO:BP	microtubule nucleation	16175	2628		0.4	0.4230769230769231	46	16129	4	10	42	16119	16175	0.1563432176287119
M1	string	0	network_modules	412	TRUE	1.8572568035760524e-4	318	14	6	0.42857142857142855	0.018867924528301886	GO:1902903	GO:BP	regulation of supramolecular fiber organization	16175	22602		0.44	0.46153846153846156	318	15857	6	8	312	15849	16175	0.0866920754929908
M1	string	0	network_modules	412	TRUE	2.1917354351879098e-4	161	14	5	0.35714285714285715	0.031055900621118012	GO:0032271	GO:BP	regulation of protein polymerization	16175	7452		0.48	0.5	161	16014	5	9	156	16005	16175	0.10293843952088068
M1	string	0	network_modules	412	TRUE	6.51648232621917e-4	79	14	4	0.2857142857142857	0.05063291139240506	GO:0032273	GO:BP	positive regulation of protein polymerization	16175	7454		0.52	0.5384615384615384	79	16096	4	10	75	16086	16175	0.11856199058273226
M1	string	0	network_modules	412	TRUE	8.556442765369511e-4	199	7	4	0.5714285714285714	0.020100502512562814	REAC:R-HSA-68877	REAC	Mitotic Prometaphase	10916	1484		0	0.16666666666666666	199	10717	4	3	195	10714	10916	0.10474610377636591
M1	string	0	network_modules	412	TRUE	0.0010092884492147647	22	14	3	0.21428571428571427	0.13636363636363635	GO:0007026	GO:BP	negative regulation of microtubule depolymerization	16175	2631		0.56	0.5769230769230769	22	16153	3	11	19	16142	16175	0.17004509759073805
M1	string	0	network_modules	412	TRUE	0.0015232648929661985	238	14	5	0.35714285714285715	0.02100840336134454	GO:0051258	GO:BP	protein polymerization	16175	13605		0.6	0.6153846153846154	238	15937	5	9	233	15928	16175	0.08370525065934326
M1	string	0	network_modules	412	TRUE	0.0017005179442463247	26	14	3	0.21428571428571427	0.11538461538461539	GO:0031114	GO:BP	regulation of microtubule depolymerization	16175	7039		0.64	0.6538461538461539	26	16149	3	11	23	16138	16175	0.15625642062334155
M1	string	0	network_modules	412	TRUE	0.002345712237647435	8	7	2	0.2857142857142857	0.25	REAC:R-HSA-428890	REAC	Role of ABL in ROBO-SLIT signaling	10916	2107		0.2	0.3333333333333333	8	10908	2	5	6	10903	10916	0.26675898657003766
M1	string	0	network_modules	412	TRUE	0.0038978567232688917	34	14	3	0.21428571428571427	0.08823529411764706	GO:0031111	GO:BP	negative regulation of microtubule polymerization or depolymerization	16175	7036		0.68	0.6923076923076923	34	16141	3	11	31	16130	16175	0.13635828904223973
M1	string	0	network_modules	412	TRUE	0.004711579257946325	92	7	3	0.42857142857142855	0.03260869565217391	REAC:R-HSA-141424	REAC	Amplification of signal from the kinetochores	10916	144		0.4	0.6666666666666666	92	10824	3	4	89	10820	10916	0.11642060460659594
M1	string	0	network_modules	412	TRUE	0.004711579257946325	92	7	3	0.42857142857142855	0.03260869565217391	REAC:R-HSA-141444	REAC	Amplification  of signal from unattached  kinetochores via a MAD2  inhibitory signal	10916	143		0.4	0.6666666666666666	92	10824	3	4	89	10820	10916	0.11642060460659594
M1	string	0	network_modules	412	TRUE	0.0054838300145612084	38	14	3	0.21428571428571427	0.07894736842105263	GO:0010634	GO:BP	positive regulation of epithelial cell migration	16175	4280		0.72	0.7307692307692307	38	16137	3	11	35	16126	16175	0.1288476693809798
M1	string	0	network_modules	412	TRUE	0.006918937818048657	41	14	3	0.21428571428571427	0.07317073170731707	GO:0007019	GO:BP	microtubule depolymerization	16175	2627		0.76	0.7692307692307693	41	16134	3	11	38	16123	16175	0.12394716022273836
M1	string	0	network_modules	412	TRUE	0.007839494632886612	109	7	3	0.42857142857142855	0.027522935779816515	REAC:R-HSA-69618	REAC	Mitotic Spindle Checkpoint	10916	1486		0.8	0.8333333333333334	109	10807	3	4	106	10803	10916	0.10664464170333712
M1	string	0	network_modules	412	TRUE	0.008482696310310877	150	14	4	0.2857142857142857	0.02666666666666667	GO:1902905	GO:BP	positive regulation of supramolecular fiber organization	16175	22604		0.8	0.8076923076923077	150	16025	4	10	146	16015	16175	0.0848851170041399
M1	string	0	network_modules	412	TRUE	0.008905748663263038	5	14	2	0.14285714285714285	0.4	GO:1903690	GO:BP	negative regulation of wound healing, spreading of epidermal cells	16175	23207		0.84	0.9615384615384616	5	16170	2	12	3	16158	16175	0.2386686524028136
M1	string	0	network_modules	412	TRUE	0.008905748663263038	5	14	2	0.14285714285714285	0.4	GO:1904259	GO:BP	regulation of basement membrane assembly involved in embryonic body morphogenesis	16175	23653		0.84	0.9615384615384616	5	16170	2	12	3	16158	16175	0.2386686524028136
M1	string	0	network_modules	412	TRUE	0.008905748663263038	5	14	2	0.14285714285714285	0.4	GO:1904261	GO:BP	positive regulation of basement membrane assembly involved in embryonic body morphogenesis	16175	23655		0.84	0.9615384615384616	5	16170	2	12	3	16158	16175	0.2386686524028136
M1	string	0	network_modules	412	TRUE	0.008905748663263038	5	14	2	0.14285714285714285	0.4	GO:2001197	GO:BP	basement membrane assembly involved in embryonic body morphogenesis	16175	26397		0.84	0.9615384615384616	5	16170	2	12	3	16158	16175	0.2386686524028136
M1	string	0	network_modules	412	TRUE	0.00920480209683797	115	7	3	0.42857142857142855	0.02608695652173913	REAC:R-HSA-9648025	REAC	EML4 and NUDC in mitotic spindle formation	10916	817		1	1	115	10801	3	4	112	10797	10916	0.10371780266984948
M1	string	0	network_modules	412	TRUE	0.00952839363743474	346	14	5	0.35714285714285715	0.014450867052023121	GO:0043254	GO:BP	regulation of protein-containing complex assembly	16175	10588		1	1	346	15829	5	9	341	15820	16175	0.06830111298424464
M1	string	0	network_modules	415	TRUE	3.1739829825388207e-22	28	9	9	1	0.32142857142857145	REAC:R-HSA-3928663	REAC	EPHA-mediated growth cone collapse	10916	820		0	0.3333333333333333	28	10888	9	0	19	10888	10916	0.5664526835317522
M1	string	0	network_modules	415	TRUE	9.441004243143704e-20	49	9	9	1	0.1836734693877551	REAC:R-HSA-3928665	REAC	EPH-ephrin mediated repulsion of cells	10916	819		0.5	0.6666666666666666	49	10867	9	0	40	10867	10916	0.42778484182310855
M1	string	0	network_modules	415	TRUE	9.300927658936755e-19	44	12	9	0.75	0.20454545454545456	GO:0048013	GO:BP	ephrin receptor signaling pathway	16175	12469		0	0.07142857142857142	44	16131	9	3	35	16128	16175	0.3909310422882752
M1	string	0	network_modules	415	TRUE	3.245498714686258e-17	90	9	9	1	0.1	REAC:R-HSA-2682334	REAC	EPH-Ephrin signaling	10916	818		1	1	90	10826	9	0	81	10826	10916	0.3150513571788229
M1	string	0	network_modules	415	TRUE	2.5719737081115183e-13	165	12	9	0.75	0.05454545454545454	GO:0097485	GO:BP	neuron projection guidance	16175	18673		0.07692307692307693	0.21428571428571427	165	16010	9	3	156	16007	16175	0.20060884173178326
M1	string	0	network_modules	415	TRUE	2.5719737081115183e-13	165	12	9	0.75	0.05454545454545454	GO:0007411	GO:BP	axon guidance	16175	2906		0.07692307692307693	0.21428571428571427	165	16010	9	3	156	16007	16175	0.20060884173178326
M1	string	0	network_modules	415	TRUE	2.0562351191203353e-12	181	8	8	1	0.04419889502762431	KEGG:04360	KEGG	Axon guidance	8484	305		0	0.2	181	8303	8	0	173	8303	8484	0.20807875994795252
M1	string	0	network_modules	415	TRUE	5.511892033358719e-11	297	12	9	0.75	0.030303030303030304	GO:0007409	GO:BP	axonogenesis	16175	2905		0.23076923076923078	0.2857142857142857	297	15878	9	3	288	15875	16175	0.14848898979675412
M1	string	0	network_modules	415	TRUE	6.943675578481688e-11	510	12	10	0.8333333333333334	0.0196078431372549	GO:0007169	GO:BP	cell surface receptor protein tyrosine kinase signaling pathway	16175	2733		0.3076923076923077	0.35714285714285715	510	15665	10	2	500	15663	16175	0.12502343309962308
M1	string	0	network_modules	415	TRUE	1.8273940825264934e-10	339	12	9	0.75	0.02654867256637168	GO:0061564	GO:BP	axon development	16175	15561		0.38461538461538464	0.42857142857142855	339	15836	9	3	330	15833	16175	0.1386767703287497
M1	string	0	network_modules	415	TRUE	5.009285772764595e-10	379	12	9	0.75	0.023746701846965697	GO:0048667	GO:BP	cell morphogenesis involved in neuron differentiation	16175	12925		0.46153846153846156	0.5	379	15796	9	3	370	15793	16175	0.1308752398074958
M1	string	0	network_modules	415	TRUE	1.9645081125673076e-9	441	12	9	0.75	0.02040816326530612	GO:0048812	GO:BP	neuron projection morphogenesis	16175	13058		0.5384615384615384	0.5714285714285714	441	15734	9	3	432	15731	16175	0.12092457444529059
M1	string	0	network_modules	415	TRUE	2.6549507414185773e-9	456	12	9	0.75	0.019736842105263157	GO:0120039	GO:BP	plasma membrane bounded cell projection morphogenesis	16175	19473		0.6153846153846154	0.6428571428571429	456	15719	9	3	447	15716	16175	0.11882311873399258
M1	string	0	network_modules	415	TRUE	2.872088490991705e-9	460	12	9	0.75	0.01956521739130435	GO:0048858	GO:BP	cell projection morphogenesis	16175	13102		0.6923076923076923	0.7142857142857143	460	15715	9	3	451	15712	16175	0.11827988670291717
M1	string	0	network_modules	415	TRUE	5.516918558005073e-9	790	12	10	0.8333333333333334	0.012658227848101266	GO:0007167	GO:BP	enzyme-linked receptor protein signaling pathway	16175	2731		0.7692307692307693	0.7857142857142857	790	15385	10	2	780	15383	16175	0.09917459652806201
M1	string	0	network_modules	415	TRUE	6.477446680434371e-8	651	12	9	0.75	0.013824884792626729	GO:0000902	GO:BP	cell morphogenesis	16175	240		0.8461538461538461	0.8571428571428571	651	15524	9	3	642	15521	16175	0.09839854368135686
M1	string	0	network_modules	415	TRUE	1.0077796686558554e-7	684	12	9	0.75	0.013157894736842105	GO:0031175	GO:BP	neuron projection development	16175	7086		0.9230769230769231	0.9285714285714286	684	15491	9	3	675	15488	16175	0.09582151351905005
M1	string	0	network_modules	415	TRUE	2.611212792211049e-7	761	12	9	0.75	0.011826544021024968	GO:0048666	GO:BP	neuron development	16175	12924		1	1	761	15414	9	3	752	15411	16175	0.090458554706026
M1	string	0	network_modules	415	TRUE	0.0013197568690285913	210	8	4	0.5	0.01904761904761905	KEGG:04015	KEGG	Rap1 signaling pathway	8484	248		0.25	0.4	210	8274	4	4	206	8270	8484	0.09397290170823085
M1	string	0	network_modules	415	TRUE	0.0020561254670010856	235	8	4	0.5	0.01702127659574468	KEGG:04014	KEGG	Ras signaling pathway	8484	247		0.5	0.6	235	8249	4	4	231	8245	8484	0.08841669539640075
M1	string	0	network_modules	415	TRUE	0.005425495136872191	301	8	4	0.5	0.013289036544850499	KEGG:04010	KEGG	MAPK signaling pathway	8484	243		0.75	0.8	301	8183	4	4	297	8179	8484	0.07714653611032096
M1	string	0	network_modules	415	TRUE	0.006086404691387543	310	8	4	0.5	0.012903225806451613	KEGG:05206	KEGG	MicroRNAs in cancer	8484	458		1	1	310	8174	4	4	306	8170	8484	0.07588655977007787
M1	string	0	network_modules	416	TRUE	6.901111139009918e-12	9	10	5	0.5	0.5555555555555556	REAC:R-HSA-629597	REAC	Highly calcium permeable nicotinic acetylcholine receptors	10916	1124		0	0.1111111111111111	9	10907	5	5	4	10902	10916	0.5266355228033709
M1	string	0	network_modules	416	TRUE	2.5284745865738753e-11	11	10	5	0.5	0.45454545454545453	REAC:R-HSA-629594	REAC	Highly calcium permeable postsynaptic nicotinic acetylcholine receptors	10916	1125		0.125	0.2222222222222222	11	10905	5	5	6	10900	10916	0.4762285754050088
M1	string	0	network_modules	416	TRUE	4.332871931542309e-11	12	10	5	0.5	0.4166666666666667	REAC:R-HSA-622323	REAC	Presynaptic nicotinic acetylcholine receptors	10916	1792		0.25	0.3333333333333333	12	10904	5	5	7	10899	10916	0.45589134352970345
M1	string	0	network_modules	416	TRUE	1.0944169678290392e-10	14	10	5	0.5	0.35714285714285715	REAC:R-HSA-181431	REAC	Acetylcholine binding and downstream events	10916	54		0.375	0.5555555555555556	14	10902	5	5	9	10897	10916	0.421957065309699
M1	string	0	network_modules	416	TRUE	1.0944169678290392e-10	14	10	5	0.5	0.35714285714285715	REAC:R-HSA-622327	REAC	Postsynaptic nicotinic acetylcholine receptors	10916	1779		0.375	0.5555555555555556	14	10902	5	5	9	10897	10916	0.421957065309699
M1	string	0	network_modules	416	TRUE	1.368699262382385e-9	365	11	9	0.8181818181818182	0.024657534246575342	KEGG:04080	KEGG	Neuroactive ligand-receptor interaction	8484	263		0	0.5	365	8119	9	2	356	8117	8484	0.13764861919764168
M1	string	0	network_modules	416	TRUE	3.58933547584887e-9	23	12	5	0.4166666666666667	0.21739130434782608	GO:0007271	GO:BP	synaptic transmission, cholinergic	16175	2799		0	0.1111111111111111	23	16152	5	7	18	16145	16175	0.30026241482314386
M1	string	0	network_modules	416	TRUE	1.7416508806343253e-8	196	10	7	0.7	0.03571428571428571	REAC:R-HSA-112314	REAC	Neurotransmitter receptors and postsynaptic signal transmission	10916	1594		0.625	0.6666666666666666	196	10720	7	3	189	10717	10916	0.15553144024187449
M1	string	0	network_modules	416	TRUE	1.2391140406923424e-7	259	10	7	0.7	0.02702702702702703	REAC:R-HSA-112315	REAC	Transmission across Chemical Synapses	10916	2580		0.75	0.7777777777777778	259	10657	7	3	252	10654	10916	0.13455061755290904
M1	string	0	network_modules	416	TRUE	3.5505992642242624e-7	487	12	8	0.6666666666666666	0.01642710472279261	GO:0098916	GO:BP	anterograde trans-synaptic signaling	16175	18949		0.125	0.3333333333333333	487	15688	8	4	479	15684	16175	0.10149951325733676
M1	string	0	network_modules	416	TRUE	3.5505992642242624e-7	487	12	8	0.6666666666666666	0.01642710472279261	GO:0007268	GO:BP	chemical synaptic transmission	16175	2796		0.125	0.3333333333333333	487	15688	8	4	479	15684	16175	0.10149951325733676
M1	string	0	network_modules	416	TRUE	3.8508543544801894e-7	492	12	8	0.6666666666666666	0.016260162601626018	GO:0099537	GO:BP	trans-synaptic signaling	16175	19116		0.375	0.4444444444444444	492	15683	8	4	484	15679	16175	0.10094949693436223
M1	string	0	network_modules	416	TRUE	5.621352022820514e-7	516	12	8	0.6666666666666666	0.015503875968992248	GO:0099536	GO:BP	synaptic signaling	16175	19115		0.5	0.5555555555555556	516	15659	8	4	508	15655	16175	0.09841933709138953
M1	string	0	network_modules	416	TRUE	6.604264781772455e-7	18	12	4	0.3333333333333333	0.2222222222222222	GO:0035094	GO:BP	response to nicotine	16175	8806		0.625	0.6666666666666666	18	16157	4	8	14	16149	16175	0.27150869653368737
M1	string	0	network_modules	416	TRUE	2.5816941359998146e-6	400	10	7	0.7	0.0175	REAC:R-HSA-112316	REAC	Neuronal System	10916	1590		0.875	0.8888888888888888	400	10516	7	3	393	10513	10916	0.10691102951978255
M1	string	0	network_modules	416	TRUE	9.138482228404075e-4	40	11	3	0.2727272727272727	0.075	KEGG:05033	KEGG	Nicotine addiction	8484	421		1	1	40	8444	3	8	37	8436	8484	0.14097086553688878
M1	string	0	network_modules	416	TRUE	0.0018913173803027153	3	12	2	0.16666666666666666	0.6666666666666666	GO:0060084	GO:BP	synaptic transmission involved in micturition	16175	14343		0.75	0.7777777777777778	3	16172	2	10	1	16162	16175	0.33311686255037765
M1	string	0	network_modules	416	TRUE	0.003781075530133068	4	12	2	0.16666666666666666	0.5	GO:0060073	GO:BP	micturition	16175	14334		0.875	0.8888888888888888	4	16171	2	10	2	16161	16175	0.2883894502100615
M1	string	0	network_modules	416	TRUE	0.004444911644031575	7	10	2	0.2	0.2857142857142857	REAC:R-HSA-629587	REAC	Highly sodium permeable postsynaptic acetylcholine nicotinic receptors	10916	1126		1	1	7	10909	2	8	5	10901	10916	0.23846495752727878
M1	string	0	network_modules	416	TRUE	0.006299194917464988	5	12	2	0.16666666666666666	0.4	GO:0035095	GO:BP	behavioral response to nicotine	16175	8807		1	1	5	16170	2	10	3	16160	16175	0.2578555143451957
M1	string	0	network_modules	417	TRUE	1.987615430401512e-12	14	6	5	0.8333333333333334	0.35714285714285715	REAC:R-HSA-193775	REAC	Synthesis of bile acids and bile salts via 24-hydroxycholesterol	10916	2402		0	0.1111111111111111	14	10902	5	1	9	10901	10916	0.5452046096717734
M1	string	0	network_modules	417	TRUE	2.9811952812203465e-12	15	6	5	0.8333333333333334	0.3333333333333333	REAC:R-HSA-193807	REAC	Synthesis of bile acids and bile salts via 27-hydroxycholesterol	10916	2403		0.125	0.2222222222222222	15	10901	5	1	10	10900	10916	0.5266838579073497
M1	string	0	network_modules	417	TRUE	2.4552359495108817e-11	4	8	4	0.5	1	GO:0071395	GO:BP	cellular response to jasmonic acid stimulus	16175	16647		0	0.05555555555555555	4	16171	4	4	0	16167	16175	0.7070193220914467
M1	string	0	network_modules	417	TRUE	2.4552359495108817e-11	4	8	4	0.5	1	GO:0009753	GO:BP	response to jasmonic acid	16175	3650		0	0.05555555555555555	4	16171	4	4	0	16167	16175	0.7070193220914467
M1	string	0	network_modules	417	TRUE	3.338424933369703e-11	23	6	5	0.8333333333333334	0.21739130434782608	REAC:R-HSA-193368	REAC	Synthesis of bile acids and bile salts via 7alpha-hydroxycholesterol	10916	2404		0.25	0.3333333333333333	23	10893	5	1	18	10892	10916	0.42511693010083385
M1	string	0	network_modules	417	TRUE	2.3528855001224395e-10	33	6	5	0.8333333333333334	0.15151515151515152	REAC:R-HSA-192105	REAC	Synthesis of bile acids and bile salts	10916	2401		0.375	0.4444444444444444	33	10883	5	1	28	10882	10916	0.3546793390895217
M1	string	0	network_modules	417	TRUE	1.0277580230998726e-9	31	8	5	0.625	0.16129032258064516	GO:0008207	GO:BP	C21-steroid hormone metabolic process	16175	3134		0.05714285714285714	0.08333333333333333	31	16144	5	3	26	16141	16175	0.31690884942841935
M1	string	0	network_modules	417	TRUE	1.075732770982216e-9	44	6	5	0.8333333333333334	0.11363636363636363	REAC:R-HSA-194068	REAC	Bile acid and bile salt metabolism	10916	222		0.5	0.5555555555555556	44	10872	5	1	39	10871	10916	0.3069436965472318
M1	string	0	network_modules	417	TRUE	3.0905373586558114e-9	9	8	4	0.5	0.4444444444444444	GO:0030647	GO:BP	aminoglycoside antibiotic metabolic process	16175	6873		0.08571428571428572	0.1388888888888889	9	16166	4	4	5	16162	16175	0.4711275072565784
M1	string	0	network_modules	417	TRUE	3.0905373586558114e-9	9	8	4	0.5	0.4444444444444444	GO:0044597	GO:BP	daunorubicin metabolic process	16175	11097		0.08571428571428572	0.1388888888888889	9	16166	4	4	5	16162	16175	0.4711275072565784
M1	string	0	network_modules	417	TRUE	5.149876091618276e-9	10	8	4	0.5	0.4	GO:0030638	GO:BP	polyketide metabolic process	16175	6865		0.14285714285714285	0.19444444444444445	10	16165	4	4	6	16161	16175	0.44690929414353137
M1	string	0	network_modules	417	TRUE	5.149876091618276e-9	10	8	4	0.5	0.4	GO:0044598	GO:BP	doxorubicin metabolic process	16175	11098		0.14285714285714285	0.19444444444444445	10	16165	4	4	6	16161	16175	0.44690929414353137
M1	string	0	network_modules	417	TRUE	5.173003374397842e-9	62	6	5	0.8333333333333334	0.08064516129032258	KEGG:00140	KEGG	Steroid hormone biosynthesis	8484	17		0	0.3333333333333333	62	8422	5	1	57	8421	8484	0.2579999067203751
M1	string	0	network_modules	417	TRUE	1.752369162453965e-8	13	8	4	0.5	0.3076923076923077	GO:0042448	GO:BP	progesterone metabolic process	16175	10188		0.2	0.2222222222222222	13	16162	4	4	9	16158	16175	0.39185616681299235
M1	string	0	network_modules	417	TRUE	3.3441076015735456e-8	15	8	4	0.5	0.26666666666666666	GO:0016137	GO:BP	glycoside metabolic process	16175	5155		0.22857142857142856	0.25	15	16160	4	4	11	16156	16175	0.36473044815943145
M1	string	0	network_modules	417	TRUE	7.49222890175809e-8	18	8	4	0.5	0.2222222222222222	GO:0071398	GO:BP	cellular response to fatty acid	16175	16650		0.2571428571428571	0.2777777777777778	18	16157	4	4	14	16153	16175	0.3328589855281636
M1	string	0	network_modules	417	TRUE	1.7896162515705097e-7	22	8	4	0.5	0.18181818181818182	GO:1902644	GO:BP	tertiary alcohol metabolic process	16175	22413		0.2857142857142857	0.3055555555555556	22	16153	4	4	18	16149	16175	0.30097029428723465
M1	string	0	network_modules	417	TRUE	4.2893608978906845e-7	27	8	4	0.5	0.14814814814814814	GO:0070542	GO:BP	response to fatty acid	16175	16171		0.3142857142857143	0.3333333333333333	27	16148	4	4	23	16144	16175	0.2715507484927268
M1	string	0	network_modules	417	TRUE	6.215011785595648e-7	152	6	5	0.8333333333333334	0.03289473684210526	REAC:R-HSA-8957322	REAC	Metabolism of steroids	10916	1438		0.625	0.6666666666666666	152	10764	5	1	147	10763	10916	0.16399053099441582
M1	string	0	network_modules	417	TRUE	1.8001699449923609e-6	38	8	4	0.5	0.10526315789473684	GO:0006693	GO:BP	prostaglandin metabolic process	16175	2401		0.34285714285714286	0.3611111111111111	38	16137	4	4	34	16133	16175	0.22866304434369172
M1	string	0	network_modules	417	TRUE	2.0055061296995563e-6	39	8	4	0.5	0.10256410256410256	GO:0006692	GO:BP	prostanoid metabolic process	16175	2400		0.37142857142857144	0.3888888888888889	39	16136	4	4	35	16132	16175	0.22569138236574088
M1	string	0	network_modules	417	TRUE	3.3067046847940774e-6	44	8	4	0.5	0.09090909090909091	GO:0019748	GO:BP	secondary metabolic process	16175	6032		0.4	0.4166666666666667	44	16131	4	4	40	16127	16175	0.21238231807194088
M1	string	0	network_modules	417	TRUE	8.556548169606625e-6	179	8	5	0.625	0.027932960893854747	GO:0042445	GO:BP	hormone metabolic process	16175	10185		0.42857142857142855	0.4444444444444444	179	15996	5	3	174	15993	16175	0.13054604232564215
M1	string	0	network_modules	417	TRUE	1.266887495393267e-5	61	8	4	0.5	0.06557377049180328	GO:1901657	GO:BP	glycosyl compound metabolic process	16175	21624		0.45714285714285713	0.4722222222222222	61	16114	4	4	57	16110	16175	0.1800901198956117
M1	string	0	network_modules	417	TRUE	1.974307331627767e-5	68	8	4	0.5	0.058823529411764705	GO:0034308	GO:BP	primary alcohol metabolic process	16175	8562		0.4857142857142857	0.5	68	16107	4	4	64	16103	16175	0.170457368811874
M1	string	0	network_modules	417	TRUE	3.883712619906896e-5	242	8	5	0.625	0.02066115702479339	GO:0008202	GO:BP	steroid metabolic process	16175	3129		0.5142857142857142	0.5277777777777778	242	15933	5	3	237	15930	16175	0.11178291913524305
M1	string	0	network_modules	417	TRUE	5.246585508569544e-5	257	8	5	0.625	0.019455252918287938	GO:0006066	GO:BP	alcohol metabolic process	16175	1933		0.5428571428571428	0.5555555555555556	257	15918	5	3	252	15915	16175	0.10835785417112322
M1	string	0	network_modules	417	TRUE	8.705207867356306e-5	98	8	4	0.5	0.04081632653061224	GO:0033559	GO:BP	unsaturated fatty acid metabolic process	16175	8288		0.5714285714285714	0.5833333333333334	98	16077	4	4	94	16073	16175	0.14159057052206178
M1	string	0	network_modules	417	TRUE	1.28892019664772e-4	108	8	4	0.5	0.037037037037037035	GO:0006690	GO:BP	icosanoid metabolic process	16175	2398		0.6	0.6111111111111112	108	16067	4	4	104	16063	16175	0.1347493499658982
M1	string	0	network_modules	417	TRUE	2.55558378213229e-4	128	8	4	0.5	0.03125	GO:0120254	GO:BP	olefinic compound metabolic process	16175	19583		0.6285714285714286	0.6388888888888888	128	16047	4	4	124	16043	16175	0.12354186416956052
M1	string	0	network_modules	417	TRUE	2.589449248139018e-4	44	6	3	0.5	0.06818181818181818	REAC:R-HSA-975634	REAC	Retinoid metabolism and transport	10916	2093		0.75	0.7777777777777778	44	10872	3	3	41	10869	10916	0.1835694645894447
M1	string	0	network_modules	417	TRUE	2.8548058624869874e-4	361	8	5	0.625	0.013850415512465374	GO:0010817	GO:BP	regulation of hormone levels	16175	4429		0.6571428571428571	0.6666666666666666	361	15814	5	3	356	15811	16175	0.0907586512767164
M1	string	0	network_modules	417	TRUE	3.163167504454865e-4	221	6	4	0.6666666666666666	0.01809954751131222	KEGG:05208	KEGG	Chemical carcinogenesis - reactive oxygen species	8484	460		0.5	0.6666666666666666	221	8263	4	2	217	8261	8484	0.10699499290490537
M1	string	0	network_modules	417	TRUE	3.378895791564491e-4	48	6	3	0.5	0.0625	REAC:R-HSA-6806667	REAC	Metabolism of fat-soluble vitamins	10916	1424		0.875	0.8888888888888888	48	10868	3	3	45	10865	10916	0.1756568463704437
M1	string	0	network_modules	417	TRUE	4.577524866349202e-4	397	8	5	0.625	0.012594458438287154	GO:1901615	GO:BP	organic hydroxy compound metabolic process	16175	21597		0.6857142857142857	0.6944444444444444	397	15778	5	3	392	15775	16175	0.08632458267611591
M1	string	0	network_modules	417	TRUE	6.42007539213897e-4	3	8	2	0.25	0.6666666666666666	GO:0071799	GO:BP	cellular response to prostaglandin D stimulus	16175	16913		0.7142857142857143	0.75	3	16172	2	6	1	16166	16175	0.4080841830381798
M1	string	0	network_modules	417	TRUE	6.42007539213897e-4	3	8	2	0.25	0.6666666666666666	GO:0071798	GO:BP	response to prostaglandin D	16175	16912		0.7142857142857143	0.75	3	16172	2	6	1	16166	16175	0.4080841830381798
M1	string	0	network_modules	417	TRUE	7.792385689640287e-4	169	8	4	0.5	0.023668639053254437	GO:0042180	GO:BP	ketone metabolic process	16175	10008		0.7714285714285715	0.7777777777777778	169	16006	4	4	165	16002	16175	0.10709974500316076
M1	string	0	network_modules	417	TRUE	9.034380015331277e-4	42	8	3	0.375	0.07142857142857142	GO:0008206	GO:BP	bile acid metabolic process	16175	3133		0.8	0.8055555555555556	42	16133	3	5	39	16128	16175	0.16278185353654356
M1	string	0	network_modules	417	TRUE	0.0014921946805268357	504	8	5	0.625	0.00992063492063492	GO:0032787	GO:BP	monocarboxylic acid metabolic process	16175	7822		0.8285714285714286	0.8333333333333334	504	15671	5	3	499	15668	16175	0.07602929711271779
M1	string	0	network_modules	417	TRUE	0.0027658636510526496	17	6	2	0.3333333333333333	0.11764705882352941	KEGG:00120	KEGG	Primary bile acid biosynthesis	8484	14		1	1	17	8467	2	4	15	8463	8484	0.19710630839258642
M1	string	0	network_modules	417	TRUE	0.0028512702339019464	97	6	3	0.5	0.030927835051546393	REAC:R-HSA-2187338	REAC	Visual phototransduction	10916	2654		1	1	97	10819	3	3	94	10816	10916	0.12272403605665891
M1	string	0	network_modules	417	TRUE	0.004279924916971707	70	8	3	0.375	0.04285714285714286	GO:0001523	GO:BP	retinoid metabolic process	16175	329		0.8571428571428571	0.8611111111111112	70	16105	3	5	67	16100	16175	0.12561322086847246
M1	string	0	network_modules	417	TRUE	0.004660871134601651	72	8	3	0.375	0.041666666666666664	GO:0016101	GO:BP	diterpenoid metabolic process	16175	5119		0.8857142857142857	0.8888888888888888	72	16103	3	5	69	16098	16175	0.1238226792176758
M1	string	0	network_modules	417	TRUE	0.006408880426447946	80	8	3	0.375	0.0375	GO:0006721	GO:BP	terpenoid metabolic process	16175	2427		0.9142857142857143	0.9166666666666666	80	16095	3	5	77	16090	16175	0.11734086762643543
M1	string	0	network_modules	417	TRUE	0.007425706419586263	84	8	3	0.375	0.03571428571428571	GO:0007586	GO:BP	digestion	16175	3048		0.9428571428571428	0.9444444444444444	84	16091	3	5	81	16086	16175	0.11445065873399712
M1	string	0	network_modules	417	TRUE	0.009763081598088549	319	8	4	0.5	0.012539184952978056	GO:0006631	GO:BP	fatty acid metabolic process	16175	2343		0.9714285714285714	0.9722222222222222	319	15856	4	4	315	15852	16175	0.07683786414475337
M1	string	0	network_modules	417	TRUE	0.00999988476823401	742	8	5	0.625	0.006738544474393531	GO:0019752	GO:BP	carboxylic acid metabolic process	16175	6036		1	1	742	15433	5	3	737	15430	16175	0.06157735781659525
M1	string	0	network_modules	425	TRUE	2.1411050323593147e-8	32	12	5	0.4166666666666667	0.15625	GO:0007035	GO:BP	vacuolar acidification	16175	2640		0	0.043478260869565216	32	16143	5	7	27	16136	16175	0.2542896013492241
M1	string	0	network_modules	425	TRUE	7.142015951394172e-8	11	12	4	0.3333333333333333	0.36363636363636365	GO:0036295	GO:BP	cellular response to increased oxygen levels	16175	9546		0.045454545454545456	0.08695652173913043	11	16164	4	8	7	16156	16175	0.34769221069462797
M1	string	0	network_modules	425	TRUE	1.0708782991658374e-7	12	12	4	0.3333333333333333	0.3333333333333333	GO:0036296	GO:BP	response to increased oxygen levels	16175	9547		0.09090909090909091	0.13043478260869565	12	16163	4	8	8	16155	16175	0.33283837571407954
M1	string	0	network_modules	425	TRUE	1.2929324452916073e-7	45	12	5	0.4166666666666667	0.1111111111111111	GO:0051452	GO:BP	intracellular pH reduction	16175	13713		0.13636363636363635	0.17391304347826086	45	16130	5	7	40	16123	16175	0.21410644864357808
M1	string	0	network_modules	425	TRUE	1.2901826270109065e-6	21	12	4	0.3333333333333333	0.19047619047619047	GO:0007042	GO:BP	lysosomal lumen acidification	16175	2646		0.18181818181818182	0.21739130434782608	21	16154	4	8	17	16146	16175	0.2512512021651199
M1	string	0	network_modules	425	TRUE	2.5120435519418968e-6	80	12	5	0.4166666666666667	0.0625	GO:0051453	GO:BP	regulation of intracellular pH	16175	13714		0.22727272727272727	0.2608695652173913	80	16095	5	7	75	16088	16175	0.1599138982553372
M1	string	0	network_modules	425	TRUE	2.849097461481444e-6	82	12	5	0.4166666666666667	0.06097560975609756	GO:0030641	GO:BP	regulation of cellular pH	16175	6868		0.2727272727272727	0.30434782608695654	82	16093	5	7	77	16086	16175	0.15791406599359462
M1	string	0	network_modules	425	TRUE	3.4213717065515176e-6	85	12	5	0.4166666666666667	0.058823529411764705	GO:0006885	GO:BP	regulation of pH	16175	2541		0.3181818181818182	0.34782608695652173	85	16090	5	7	80	16083	16175	0.15504687580325135
M1	string	0	network_modules	425	TRUE	4.4015607276610235e-6	28	12	4	0.3333333333333333	0.14285714285714285	GO:0035751	GO:BP	regulation of lysosomal lumen pH	16175	9214		0.36363636363636365	0.391304347826087	28	16147	4	8	24	16139	16175	0.2173534201376294
M1	string	0	network_modules	425	TRUE	8.547171232690693e-5	12	12	3	0.25	0.25	GO:0061795	GO:BP	Golgi lumen acidification	16175	15668		0.4090909090909091	0.43478260869565216	12	16163	3	9	9	16154	16175	0.24944317267833946
M1	string	0	network_modules	425	TRUE	1.107264807293372e-4	61	12	4	0.3333333333333333	0.06557377049180328	GO:0006879	GO:BP	intracellular iron ion homeostasis	16175	2535		0.45454545454545453	0.4782608695652174	61	16114	4	8	57	16106	16175	0.14650234145071414
M1	string	0	network_modules	425	TRUE	3.0778201017071175e-4	422	12	6	0.5	0.014218009478672985	GO:0030003	GO:BP	intracellular monoatomic cation homeostasis	16175	6648		0.5	0.5217391304347826	422	15753	6	6	416	15747	16175	0.0810088118681235
M1	string	0	network_modules	425	TRUE	3.2539327246939437e-4	426	12	6	0.5	0.014084507042253521	GO:0006873	GO:BP	intracellular monoatomic ion homeostasis	16175	2531		0.5454545454545454	0.5652173913043478	426	15749	6	6	420	15743	16175	0.08059575192411815
M1	string	0	network_modules	425	TRUE	5.590119836280098e-4	467	12	6	0.5	0.01284796573875803	GO:0055080	GO:BP	monoatomic cation homeostasis	16175	14233		0.5909090909090909	0.6086956521739131	467	15708	6	6	461	15702	16175	0.07666448407889817
M1	string	0	network_modules	425	TRUE	6.17715066861449e-4	475	12	6	0.5	0.01263157894736842	GO:0050801	GO:BP	monoatomic ion homeostasis	16175	13267		0.6363636363636364	0.6521739130434783	475	15700	6	6	469	15694	16175	0.07595568962472235
M1	string	0	network_modules	425	TRUE	6.232924183653007e-4	30	10	3	0.3	0.1	REAC:R-HSA-77387	REAC	Insulin receptor recycling	10916	1210		0	0.25	30	10886	3	7	27	10879	10916	0.1719334565383422
M1	string	0	network_modules	425	TRUE	6.897414009165246e-4	31	10	3	0.3	0.0967741935483871	REAC:R-HSA-917977	REAC	Transferrin endocytosis and recycling	10916	2564		0.3333333333333333	0.5	31	10885	3	7	28	10878	10916	0.16909324523390037
M1	string	0	network_modules	425	TRUE	6.951258364485502e-4	96	12	4	0.3333333333333333	0.041666666666666664	GO:0007040	GO:BP	lysosome organization	16175	2644		0.6818181818181818	0.7391304347826086	96	16079	4	8	92	16071	16175	0.11614088826222284
M1	string	0	network_modules	425	TRUE	6.951258364485502e-4	96	12	4	0.3333333333333333	0.041666666666666664	GO:0080171	GO:BP	lytic vacuole organization	16175	17845		0.6818181818181818	0.7391304347826086	96	16079	4	8	92	16071	16175	0.11614088826222284
M1	string	0	network_modules	425	TRUE	8.531363639271898e-4	50	9	3	0.3333333333333333	0.06	KEGG:05110	KEGG	Vibrio cholerae infection	8484	424		0	0.3333333333333333	50	8434	3	6	47	8428	8484	0.13940612072088585
M1	string	0	network_modules	425	TRUE	9.591134489199568e-4	104	12	4	0.3333333333333333	0.038461538461538464	GO:0071453	GO:BP	cellular response to oxygen levels	16175	16687		0.7727272727272727	0.782608695652174	104	16071	4	8	100	16063	16175	0.11144371626220821
M1	string	0	network_modules	425	TRUE	0.0012275881459344815	534	12	6	0.5	0.011235955056179775	GO:0055082	GO:BP	intracellular chemical homeostasis	16175	14235		0.8181818181818182	0.8260869565217391	534	15641	6	6	528	15635	16175	0.07121557473950461
M1	string	0	network_modules	425	TRUE	0.002357446810357716	70	9	3	0.3333333333333333	0.04285714285714286	KEGG:05120	KEGG	Epithelial cell signaling in Helicobacter pylori infection	8484	426		0.5	0.6666666666666666	70	8414	3	6	67	8408	8484	0.11711037975616503
M1	string	0	network_modules	425	TRUE	0.003018908020901892	623	12	6	0.5	0.009630818619582664	GO:0019725	GO:BP	cellular homeostasis	16175	6020		0.8636363636363636	0.8695652173913043	623	15552	6	6	617	15546	16175	0.06534211863471934
M1	string	0	network_modules	425	TRUE	0.004433925551966359	57	10	3	0.3	0.05263157894736842	REAC:R-HSA-917937	REAC	Iron uptake and transport	10916	1277		0.6666666666666666	0.75	57	10859	3	7	54	10852	10916	0.12384941406604488
M1	string	0	network_modules	425	TRUE	0.004680786756296842	88	9	3	0.3333333333333333	0.03409090909090909	KEGG:05323	KEGG	Rheumatoid arthritis	8484	485		1	1	88	8396	3	6	85	8390	8484	0.10387819940166591
M1	string	0	network_modules	425	TRUE	0.006984687047670995	171	12	4	0.3333333333333333	0.023391812865497075	GO:0070482	GO:BP	response to oxygen levels	16175	16143		0.9090909090909091	0.9130434782608695	171	16004	4	8	167	15996	16175	0.08598907455061602
M1	string	0	network_modules	425	TRUE	0.008421855629021724	407	12	5	0.4166666666666667	0.012285012285012284	GO:0098771	GO:BP	inorganic ion homeostasis	16175	18886		0.9545454545454546	0.9565217391304348	407	15768	5	7	402	15761	16175	0.06811222067393137
M1	string	0	network_modules	425	TRUE	0.009352428661353414	73	10	3	0.3	0.0410958904109589	REAC:R-HSA-74752	REAC	Signaling by Insulin receptor	10916	2260		1	1	73	10843	3	7	70	10836	10916	0.10897460278089975
M1	string	0	network_modules	425	TRUE	0.009772556613686973	763	12	6	0.5	0.007863695937090432	GO:0048878	GO:BP	chemical homeostasis	16175	13119		1	1	763	15412	6	6	757	15406	16175	0.05819904399069755
M1	string	0	network_modules	426	TRUE	6.548583440058559e-15	96	8	8	1	0.08333333333333333	REAC:R-HSA-5620912	REAC	Anchoring of the basal body to the plasma membrane	10916	147		0	0.3333333333333333	96	10820	8	0	88	10820	10916	0.2875083370654945
M1	string	0	network_modules	426	TRUE	2.7210981023316694e-12	200	8	8	1	0.04	REAC:R-HSA-5617833	REAC	Cilium Assembly	10916	361		0.5	0.6666666666666666	200	10716	8	0	192	10716	10916	0.19823200950643488
M1	string	0	network_modules	426	TRUE	5.876746373867413e-11	292	8	8	1	0.0273972602739726	REAC:R-HSA-1852241	REAC	Organelle biogenesis and maintenance	10916	1646		1	1	292	10624	8	0	284	10624	10916	0.16335221741227188
M1	string	0	network_modules	426	TRUE	5.530583082445165e-8	343	13	8	0.6153846153846154	0.023323615160349854	GO:0060271	GO:BP	cilium assembly	16175	14488		0	0.25	343	15832	8	5	335	15827	16175	0.1169690060896934
M1	string	0	network_modules	426	TRUE	9.696236710265936e-8	368	13	8	0.6153846153846154	0.021739130434782608	GO:0044782	GO:BP	cilium organization	16175	11155		0.3333333333333333	0.5	368	15807	8	5	360	15802	16175	0.11272128825578272
M1	string	0	network_modules	426	TRUE	1.1610521698230308e-6	503	13	8	0.6153846153846154	0.015904572564612324	GO:0120031	GO:BP	plasma membrane bounded cell projection assembly	16175	19467		0.6666666666666666	0.75	503	15672	8	5	495	15667	16175	0.09546597545275712
M1	string	0	network_modules	426	TRUE	1.3778015938197707e-6	514	13	8	0.6153846153846154	0.01556420233463035	GO:0030031	GO:BP	cell projection assembly	16175	6655		1	1	514	15661	8	5	506	15656	16175	0.09436213034830797
M1	string	0	network_modules	435	TRUE	2.9214268505603607e-8	12	9	4	0.4444444444444444	0.3333333333333333	REAC:R-HSA-176974	REAC	Unwinding of DNA	10916	2625		0	0.2	12	10904	4	5	8	10899	10916	0.3843178298824492
M1	string	0	network_modules	435	TRUE	2.5717745903174216e-7	147	11	6	0.5454545454545454	0.04081632653061224	GO:0006261	GO:BP	DNA-templated DNA replication	16175	2078		0	0.125	147	16028	6	5	141	16023	16175	0.14744480609554703
M1	string	0	network_modules	435	TRUE	7.825871054194876e-7	21	11	4	0.36363636363636365	0.19047619047619047	GO:0006268	GO:BP	DNA unwinding involved in DNA replication	16175	2083		0.14285714285714285	0.25	21	16154	4	7	17	16147	16175	0.26250071076780146
M1	string	0	network_modules	435	TRUE	2.1067913773130954e-6	32	9	4	0.4444444444444444	0.125	REAC:R-HSA-69190	REAC	DNA strand elongation	10916	449		0.25	0.4	32	10884	4	5	28	10879	10916	0.23458829199671852
M1	string	0	network_modules	435	TRUE	3.932738393659692e-6	231	11	6	0.5454545454545454	0.025974025974025976	GO:0006260	GO:BP	DNA replication	16175	2077		0.2857142857142857	0.375	231	15944	6	5	225	15939	16175	0.11678787911616238
M1	string	0	network_modules	435	TRUE	1.760955068765882e-5	44	11	4	0.36363636363636365	0.09090909090909091	GO:0032508	GO:BP	DNA duplex unwinding	16175	7615		0.42857142857142855	0.5	44	16131	4	7	40	16124	16175	0.18076548163989045
M1	string	0	network_modules	435	TRUE	3.5020979035592085e-5	52	11	4	0.36363636363636365	0.07692307692307693	GO:0032392	GO:BP	DNA geometric change	16175	7543		0.5714285714285714	0.625	52	16123	4	7	48	16116	16175	0.16609338388648556
M1	string	0	network_modules	435	TRUE	6.29055719898737e-5	60	11	4	0.36363636363636365	0.06666666666666667	GO:0071103	GO:BP	DNA conformation change	16175	16453		0.7142857142857143	0.75	60	16115	4	7	56	16108	16175	0.15445066398105214
M1	string	0	network_modules	435	TRUE	4.8167306148843333e-4	121	9	4	0.4444444444444444	0.03305785123966942	REAC:R-HSA-69239	REAC	Synthesis of DNA	10916	2376		0.5	0.6	121	10795	4	5	117	10790	10916	0.11889859888007154
M1	string	0	network_modules	435	TRUE	0.0015439437757379013	162	9	4	0.4444444444444444	0.024691358024691357	REAC:R-HSA-69242	REAC	S Phase	10916	2111		0.75	0.8	162	10754	4	5	158	10749	10916	0.10206051606004889
M1	string	0	network_modules	435	TRUE	0.0017196925992297295	35	11	3	0.2727272727272727	0.08571428571428572	GO:0033260	GO:BP	nuclear DNA replication	16175	8103		0.8571428571428571	0.875	35	16140	3	8	32	16132	16175	0.15189711841786543
M1	string	0	network_modules	435	TRUE	0.00239769911521365	39	11	3	0.2727272727272727	0.07692307692307693	GO:0044786	GO:BP	cell cycle DNA replication	16175	11158		1	1	39	16136	3	8	36	16128	16175	0.14378313524319236
M1	string	0	network_modules	435	TRUE	0.002729576455201725	187	9	4	0.4444444444444444	0.0213903743315508	REAC:R-HSA-69306	REAC	DNA Replication	10916	445		1	1	187	10729	4	5	183	10724	10916	0.09459723493010341
M1	string	0	network_modules	437	TRUE	1.4479174498769326e-6	23	11	4	0.36363636363636365	0.17391304347826086	REAC:R-HSA-373753	REAC	Nephrin family interactions	10916	1582		0	0.3333333333333333	23	10893	4	7	19	10886	10916	0.2504107349353039
M1	string	0	network_modules	437	TRUE	4.2198514617600505e-4	91	11	4	0.36363636363636365	0.04395604395604396	REAC:R-HSA-163125	REAC	Post-translational modification: synthesis of GPI-anchored proteins	10916	1775		0.5	0.6666666666666666	91	10825	4	7	87	10818	10916	0.12411022556649268
M1	string	0	network_modules	437	TRUE	4.7780235380729123e-4	2	11	2	0.18181818181818182	1	GO:0038188	GO:BP	cholecystokinin signaling pathway	16175	9758		NA	1	2	16173	2	9	0	16164	16175	0.426282773620928
M1	string	0	network_modules	437	TRUE	0.003102844145764496	150	11	4	0.36363636363636365	0.02666666666666667	REAC:R-HSA-1500931	REAC	Cell-Cell communication	10916	328		1	1	150	10766	4	7	146	10759	10916	0.09545793523535859
M1	string	0	network_modules	439	TRUE	3.685382356419853e-7	791	12	9	0.75	0.011378002528445006	GO:0000122	GO:BP	negative regulation of transcription by RNA polymerase II	16175	48		0	0.25	791	15384	9	3	782	15381	16175	0.08857871750837477
M1	string	0	network_modules	439	TRUE	3.3036282399042376e-5	529	12	7	0.5833333333333334	0.013232514177693762	GO:0006325	GO:BP	chromatin organization	16175	2122		0.3333333333333333	0.5	529	15646	7	5	522	15641	16175	0.08435350762882639
M1	string	0	network_modules	439	TRUE	5.520422163159375e-4	798	12	7	0.5833333333333334	0.008771929824561403	GO:0006974	GO:BP	DNA damage response	16175	2601		0.6666666666666666	0.75	798	15377	7	5	791	15372	16175	0.06718560836542468
M1	string	0	network_modules	439	TRUE	0.0013831620644561174	545	12	6	0.5	0.011009174311926606	GO:0051276	GO:BP	chromosome organization	16175	13613		1	1	545	15630	6	6	539	15624	16175	0.07041532940320039
M1	string	0	network_modules	440	TRUE	2.5798948017413118e-14	53	12	8	0.6666666666666666	0.1509433962264151	REAC:R-HSA-6811436	REAC	COPI-independent Golgi-to-ER retrograde traffic	10916	278		0	0.025	53	10863	8	4	45	10859	10916	0.31585128878768326
M1	string	0	network_modules	440	TRUE	4.803523383427993e-14	57	12	8	0.6666666666666666	0.14035087719298245	REAC:R-HSA-3371497	REAC	HSP90 chaperone cycle for steroid hormone receptors (SHR) in the presence of ligand	10916	1111		0.02564102564102564	0.05	57	10859	8	4	49	10855	10916	0.3044546453276063
M1	string	0	network_modules	440	TRUE	7.32921093648233e-14	193	9	9	1	0.046632124352331605	KEGG:04814	KEGG	Motor proteins	8484	366		0	0.25	193	8291	9	0	184	8291	8484	0.21358768290727093
M1	string	0	network_modules	440	TRUE	1.1817896614704108e-13	44	9	7	0.7777777777777778	0.1590909090909091	KEGG:04962	KEGG	Vasopressin-regulated water reabsorption	8484	398		0.3333333333333333	0.5	44	8440	7	2	37	8438	8484	0.3505132587666862
M1	string	0	network_modules	440	TRUE	7.577805667350921e-13	249	9	9	1	0.03614457831325301	KEGG:05132	KEGG	Salmonella infection	8484	429		0.6666666666666666	0.75	249	8235	9	0	240	8235	8484	0.18740601653518402
M1	string	0	network_modules	440	TRUE	6.281502885642674e-12	102	12	8	0.6666666666666666	0.0784313725490196	REAC:R-HSA-6807878	REAC	COPI-mediated anterograde transport	10916	279		0.05128205128205128	0.075	102	10814	8	4	94	10810	10916	0.22664519401569913
M1	string	0	network_modules	440	TRUE	2.929684276406064e-11	123	12	8	0.6666666666666666	0.06504065040650407	REAC:R-HSA-2132295	REAC	MHC class II antigen presentation	10916	1371		0.07692307692307693	0.1	123	10793	8	4	115	10789	10916	0.20598862005302698
M1	string	0	network_modules	440	TRUE	5.555221320423238e-11	133	12	8	0.6666666666666666	0.06015037593984962	REAC:R-HSA-8856688	REAC	Golgi-to-ER retrograde transport	10916	1084		0.10256410256410256	0.125	133	10783	8	4	125	10779	10916	0.19790819950260424
M1	string	0	network_modules	440	TRUE	1.9357198751118712e-10	155	12	8	0.6666666666666666	0.05161290322580645	REAC:R-HSA-199977	REAC	ER to Golgi Anterograde Transport	10916	823		0.1282051282051282	0.15	155	10761	8	4	147	10757	10916	0.1829480699311857
M1	string	0	network_modules	440	TRUE	8.498110381891389e-10	186	12	8	0.6666666666666666	0.043010752688172046	REAC:R-HSA-948021	REAC	Transport to the Golgi and subsequent modification	10916	2604		0.15384615384615385	0.175	186	10730	8	4	178	10726	10916	0.16652109909152896
M1	string	0	network_modules	440	TRUE	1.467442809574122e-9	199	12	8	0.6666666666666666	0.04020100502512563	REAC:R-HSA-68877	REAC	Mitotic Prometaphase	10916	1484		0.1794871794871795	0.2	199	10717	8	4	191	10713	10916	0.1607924152113089
M1	string	0	network_modules	440	TRUE	1.6559495215865117e-9	202	12	8	0.6666666666666666	0.039603960396039604	REAC:R-HSA-6811442	REAC	Intra-Golgi and retrograde Golgi-to-ER traffic	10916	1262		0.20512820512820512	0.225	202	10714	8	4	194	10710	10916	0.15954863795878393
M1	string	0	network_modules	440	TRUE	4.5344421650451394e-8	305	12	8	0.6666666666666666	0.02622950819672131	REAC:R-HSA-446203	REAC	Asparagine N-linked glycosylation	10916	169		0.23076923076923078	0.25	305	10611	8	4	297	10607	10916	0.12857240462053887
M1	string	0	network_modules	440	TRUE	9.152628281040535e-8	94	12	6	0.5	0.06382978723404255	REAC:R-HSA-380320	REAC	Recruitment of NuMA to mitotic centrosomes	10916	1950		0.2564102564102564	0.275	94	10822	6	6	88	10816	10916	0.17642851520898373
M1	string	0	network_modules	440	TRUE	1.942727364611444e-7	44	12	5	0.4166666666666667	0.11363636363636363	REAC:R-HSA-9646399	REAC	Aggrephagy	10916	129		0.28205128205128205	0.3	44	10872	5	7	39	10865	10916	0.21604646443665376
M1	string	0	network_modules	440	TRUE	4.4227939298740963e-7	406	12	8	0.6666666666666666	0.019704433497536946	REAC:R-HSA-68886	REAC	M Phase	10916	1343		0.3076923076923077	0.325	406	10510	8	4	398	10506	10916	0.11035050978258647
M1	string	0	network_modules	440	TRUE	1.8408854264287377e-6	68	12	5	0.4166666666666667	0.07352941176470588	REAC:R-HSA-380259	REAC	Loss of Nlp from mitotic centrosomes	10916	1331		0.3333333333333333	0.375	68	10848	5	7	63	10841	10916	0.17305284095601015
M1	string	0	network_modules	440	TRUE	1.8408854264287377e-6	68	12	5	0.4166666666666667	0.07352941176470588	REAC:R-HSA-380284	REAC	Loss of proteins required for interphase microtubule organization from the centrosome	10916	1335		0.3333333333333333	0.375	68	10848	5	7	63	10841	10916	0.17305284095601015
M1	string	0	network_modules	440	TRUE	2.295595681429403e-6	71	12	5	0.4166666666666667	0.07042253521126761	REAC:R-HSA-8854518	REAC	AURKA Activation by TPX2	10916	41		0.38461538461538464	0.4	71	10845	5	7	66	10838	10916	0.16926734314624758
M1	string	0	network_modules	440	TRUE	4.218156449282987e-6	80	12	5	0.4166666666666667	0.0625	REAC:R-HSA-380287	REAC	Centrosome maturation	10916	341		0.41025641025641024	0.475	80	10836	5	7	75	10829	10916	0.15920759192597375
M1	string	0	network_modules	440	TRUE	4.218156449282987e-6	80	12	5	0.4166666666666667	0.0625	REAC:R-HSA-380270	REAC	Recruitment of mitotic centrosome proteins and complexes	10916	1951		0.41025641025641024	0.475	80	10836	5	7	75	10829	10916	0.15920759192597375
M1	string	0	network_modules	440	TRUE	4.218156449282987e-6	80	12	5	0.4166666666666667	0.0625	REAC:R-HSA-9663891	REAC	Selective autophagy	10916	2186		0.41025641025641024	0.475	80	10836	5	7	75	10829	10916	0.15920759192597375
M1	string	0	network_modules	440	TRUE	5.740040329059967e-6	85	12	5	0.4166666666666667	0.058823529411764705	REAC:R-HSA-2565942	REAC	Regulation of PLK1 Activity at G2/M Transition	10916	1998		0.48717948717948717	0.5	85	10831	5	7	80	10824	10916	0.15431682635611862
M1	string	0	network_modules	440	TRUE	8.573336537483838e-6	92	12	5	0.4166666666666667	0.05434782608695652	REAC:R-HSA-141444	REAC	Amplification  of signal from unattached  kinetochores via a MAD2  inhibitory signal	10916	143		0.5128205128205128	0.55	92	10824	5	7	87	10817	10916	0.14814519320805275
M1	string	0	network_modules	440	TRUE	8.573336537483838e-6	92	12	5	0.4166666666666667	0.05434782608695652	REAC:R-HSA-141424	REAC	Amplification of signal from the kinetochores	10916	144		0.5128205128205128	0.55	92	10824	5	7	87	10817	10916	0.14814519320805275
M1	string	0	network_modules	440	TRUE	1.0633218009546467e-5	96	12	5	0.4166666666666667	0.052083333333333336	REAC:R-HSA-5620912	REAC	Anchoring of the basal body to the plasma membrane	10916	147		0.5641025641025641	0.575	96	10820	5	7	91	10813	10916	0.14492260300916215
M1	string	0	network_modules	440	TRUE	2.018192632058645e-5	109	12	5	0.4166666666666667	0.045871559633027525	REAC:R-HSA-69618	REAC	Mitotic Spindle Checkpoint	10916	1486		0.5897435897435898	0.6	109	10807	5	7	104	10800	10916	0.13569055935148
M1	string	0	network_modules	440	TRUE	2.6427290482190327e-5	115	12	5	0.4166666666666667	0.043478260869565216	REAC:R-HSA-9648025	REAC	EML4 and NUDC in mitotic spindle formation	10916	817		0.6153846153846154	0.625	115	10801	5	7	110	10794	10916	0.13196148211421885
M1	string	0	network_modules	440	TRUE	3.704568529645101e-5	123	12	5	0.4166666666666667	0.04065040650406504	REAC:R-HSA-2500257	REAC	Resolution of Sister Chromatid Cohesion	10916	2079		0.6410256410256411	0.65	123	10793	5	7	118	10786	10916	0.12741484973321465
M1	string	0	network_modules	440	TRUE	5.6902247877668476e-5	134	12	5	0.4166666666666667	0.03731343283582089	REAC:R-HSA-1632852	REAC	Macroautophagy	10916	1388		0.6666666666666666	0.675	134	10782	5	7	129	10775	10916	0.12183182869411346
M1	string	0	network_modules	440	TRUE	5.764744483050689e-5	52	12	4	0.3333333333333333	0.07692307692307693	GO:0051293	GO:BP	establishment of spindle localization	16175	13625		0	0.05555555555555555	52	16123	4	8	48	16115	16175	0.15889827568842396
M1	string	0	network_modules	440	TRUE	5.9058945176596714e-5	135	12	5	0.4166666666666667	0.037037037037037035	REAC:R-HSA-9609690	REAC	HCMV Early Events	10916	1088		0.6923076923076923	0.7	135	10781	5	7	130	10774	10916	0.12135789217493521
M1	string	0	network_modules	440	TRUE	6.128005274732198e-5	136	12	5	0.4166666666666667	0.03676470588235294	REAC:R-HSA-5663220	REAC	RHO GTPases Activate Formins	10916	1848		0.717948717948718	0.725	136	10780	5	7	131	10773	10916	0.12088911024322653
M1	string	0	network_modules	440	TRUE	6.655905874097294e-5	153	12	5	0.4166666666666667	0.032679738562091505	GO:1902850	GO:BP	microtubule cytoskeleton organization involved in mitosis	16175	22560		0.058823529411764705	0.1111111111111111	153	16022	5	7	148	16015	16175	0.11462668909695281
M1	string	0	network_modules	440	TRUE	6.681652586104195e-5	586	12	7	0.5833333333333334	0.011945392491467578	GO:0000226	GO:BP	microtubule cytoskeleton organization	16175	61		0.11764705882352941	0.16666666666666666	586	15589	7	5	579	15584	16175	0.07977858772362229
M1	string	0	network_modules	440	TRUE	6.728824380412145e-5	54	12	4	0.3333333333333333	0.07407407407407407	GO:0051653	GO:BP	spindle localization	16175	13866		0.17647058823529413	0.2222222222222222	54	16121	4	8	50	16113	16175	0.1558792173495216
M1	string	0	network_modules	440	TRUE	9.6684470217912e-5	149	12	5	0.4166666666666667	0.03355704697986577	REAC:R-HSA-9612973	REAC	Autophagy	10916	193		0.7435897435897436	0.75	149	10767	5	7	144	10760	10916	0.11522430046838883
M1	string	0	network_modules	440	TRUE	9.83874381120388e-5	348	12	6	0.5	0.017241379310344827	GO:0007018	GO:BP	microtubule-based movement	16175	2626		0.23529411764705882	0.2777777777777778	348	15827	6	6	342	15821	16175	0.08985735235807195
M1	string	0	network_modules	440	TRUE	1.336399413356197e-4	159	12	5	0.4166666666666667	0.031446540880503145	REAC:R-HSA-9609646	REAC	HCMV Infection	10916	1089		0.7692307692307693	0.775	159	10757	5	7	154	10750	10916	0.11134023107028931
M1	string	0	network_modules	440	TRUE	2.596010675313927e-4	410	12	6	0.5	0.014634146341463415	GO:0051656	GO:BP	establishment of organelle localization	16175	13869		0.29411764705882354	0.3333333333333333	410	15765	6	6	404	15759	16175	0.08228308114441114
M1	string	0	network_modules	440	TRUE	3.07058281295611e-4	188	12	5	0.4166666666666667	0.026595744680851064	REAC:R-HSA-2467813	REAC	Separation of Sister Chromatids	10916	2204		0.7948717948717948	0.8	188	10728	5	7	183	10721	10916	0.10185423365022418
M1	string	0	network_modules	440	TRUE	3.67961265697616e-4	195	12	5	0.4166666666666667	0.02564102564102564	REAC:R-HSA-69275	REAC	G2/M Transition	10916	1008		0.8205128205128205	0.825	195	10721	5	7	190	10714	10916	0.09988141128727304
M1	string	0	network_modules	440	TRUE	3.8700775707160856e-4	197	12	5	0.4166666666666667	0.025380710659898477	REAC:R-HSA-453274	REAC	Mitotic G2-G2/M phases	10916	1481		0.8461538461538461	0.85	197	10719	5	7	192	10712	10916	0.09933671789251305
M1	string	0	network_modules	440	TRUE	4.1703160239187146e-4	200	12	5	0.4166666666666667	0.025	REAC:R-HSA-5617833	REAC	Cilium Assembly	10916	361		0.8717948717948718	0.875	200	10716	5	7	195	10709	10916	0.09853469577088418
M1	string	0	network_modules	440	TRUE	5.508563939196378e-4	147	9	4	0.4444444444444444	0.027210884353741496	KEGG:04145	KEGG	Phagosome	8484	281		1	1	147	8337	4	5	143	8332	8484	0.10666847205170227
M1	string	0	network_modules	440	TRUE	7.958086806875824e-4	228	12	5	0.4166666666666667	0.021929824561403508	REAC:R-HSA-68882	REAC	Mitotic Anaphase	10916	1479		0.8974358974358975	0.9	228	10688	5	7	223	10681	10916	0.09181197112880937
M1	string	0	network_modules	440	TRUE	8.131311216304857e-4	229	12	5	0.4166666666666667	0.021834061135371178	REAC:R-HSA-2555396	REAC	Mitotic Metaphase and Anaphase	10916	1482		0.9230769230769231	0.925	229	10687	5	7	224	10680	10916	0.09159436932047141
M1	string	0	network_modules	440	TRUE	0.0010389121155524933	519	12	6	0.5	0.011560693641618497	GO:0051640	GO:BP	organelle localization	16175	13853		0.35294117647058826	0.3888888888888889	519	15656	6	6	513	15650	16175	0.0723461403516733
M1	string	0	network_modules	440	TRUE	0.0019109697326672008	32	12	3	0.25	0.09375	GO:0000132	GO:BP	establishment of mitotic spindle orientation	16175	50		0.4117647058823529	0.4444444444444444	32	16143	3	9	29	16134	16175	0.152088503044477
M1	string	0	network_modules	440	TRUE	0.0019413256226203462	124	12	4	0.3333333333333333	0.03225806451612903	GO:0007052	GO:BP	mitotic spindle organization	16175	2651		0.47058823529411764	0.5	124	16051	4	8	120	16043	16175	0.1017386643923446
M1	string	0	network_modules	440	TRUE	0.0025427053342193476	289	12	5	0.4166666666666667	0.01730103806228374	REAC:R-HSA-69620	REAC	Cell Cycle Checkpoints	10916	321		0.9487179487179487	0.95	289	10627	5	7	284	10620	10916	0.08062784811420957
M1	string	0	network_modules	440	TRUE	0.0026740384087551657	292	12	5	0.4166666666666667	0.017123287671232876	REAC:R-HSA-1852241	REAC	Organelle biogenesis and maintenance	10916	1646		0.9743589743589743	0.975	292	10624	5	7	287	10617	10916	0.08016741447079913
M1	string	0	network_modules	440	TRUE	0.0029873493188661243	37	12	3	0.25	0.08108108108108109	GO:0040001	GO:BP	establishment of mitotic spindle localization	16175	9890		0.5294117647058824	0.5555555555555556	37	16138	3	9	34	16129	16175	0.1412850353319482
M1	string	0	network_modules	440	TRUE	0.003242053080048044	38	12	3	0.25	0.07894736842105263	GO:0051294	GO:BP	establishment of spindle orientation	16175	13626		0.5882352941176471	0.6111111111111112	38	16137	3	9	35	16128	16175	0.13938315158677447
M1	string	0	network_modules	440	TRUE	0.0035267809544591794	144	12	4	0.3333333333333333	0.027777777777777776	GO:0010970	GO:BP	transport along microtubule	16175	4546		0.6470588235294118	0.6666666666666666	144	16031	4	8	140	16023	16175	0.0941096859567921
M1	string	0	network_modules	440	TRUE	0.004050074270554692	318	12	5	0.4166666666666667	0.015723270440251572	REAC:R-HSA-195258	REAC	RHO GTPase Effectors	10916	1846		1	1	318	10598	5	7	313	10591	10916	0.0764445931150014
M1	string	0	network_modules	440	TRUE	0.0040754357843073765	656	12	6	0.5	0.009146341463414634	GO:1903047	GO:BP	mitotic cell cycle process	16175	22727		0.7058823529411765	0.7222222222222222	656	15519	6	6	650	15513	16175	0.0634632534426204
M1	string	0	network_modules	440	TRUE	0.0040916305351758366	41	12	3	0.25	0.07317073170731707	GO:0060236	GO:BP	regulation of mitotic spindle organization	16175	14457		0.7647058823529411	0.7777777777777778	41	16134	3	9	38	16125	16175	0.13409887921903033
M1	string	0	network_modules	440	TRUE	0.005077079919351514	44	12	3	0.25	0.06818181818181818	GO:0090224	GO:BP	regulation of spindle organization	16175	18121		0.8235294117647058	0.8333333333333334	44	16131	3	9	41	16122	16175	0.12936163613663396
M1	string	0	network_modules	440	TRUE	0.006061411083809784	165	12	4	0.3333333333333333	0.024242424242424242	GO:0099111	GO:BP	microtubule-based transport	16175	19044		0.8823529411764706	0.8888888888888888	165	16010	4	8	161	16002	16175	0.08762273445048537
M1	string	0	network_modules	440	TRUE	0.007830461198972205	176	12	4	0.3333333333333333	0.022727272727272728	GO:0007051	GO:BP	spindle organization	16175	2650		0.9411764705882353	0.9444444444444444	176	15999	4	8	172	15991	16175	0.084690892825169
M1	string	0	network_modules	440	TRUE	0.009541058009608942	185	12	4	0.3333333333333333	0.021621621621621623	GO:0030705	GO:BP	cytoskeleton-dependent intracellular transport	16175	6886		1	1	185	15990	4	8	181	15982	16175	0.0824858236428818
M1	string	0	network_modules	441	TRUE	5.370696531067734e-10	46	11	6	0.5454545454545454	0.13043478260869565	REAC:R-HSA-69231	REAC	Cyclin D associated events in G1	10916	420		0	0.10526315789473684	46	10870	6	5	40	10865	10916	0.2653650183268027
M1	string	0	network_modules	441	TRUE	5.370696531067734e-10	46	11	6	0.5454545454545454	0.13043478260869565	REAC:R-HSA-69236	REAC	G1 Phase	10916	1000		0	0.10526315789473684	46	10870	6	5	40	10865	10916	0.2653650183268027
M1	string	0	network_modules	441	TRUE	6.021050350366026e-8	214	12	7	0.5833333333333334	0.03271028037383177	GO:0044843	GO:BP	cell cycle G1/S phase transition	16175	11189		0	0.07692307692307693	214	15961	7	5	207	15956	16175	0.13595348573067226
M1	string	0	network_modules	441	TRUE	3.903650678544573e-7	17	11	4	0.36363636363636365	0.23529411764705882	REAC:R-HSA-9659787	REAC	Aberrant regulation of mitotic G1/S transition in cancer due to RB1 defects	10916	47		0.1111111111111111	0.21052631578947367	17	10899	4	7	13	10892	10916	0.2916302732299817
M1	string	0	network_modules	441	TRUE	3.903650678544573e-7	17	11	4	0.36363636363636365	0.23529411764705882	REAC:R-HSA-9661069	REAC	Defective binding of RB1 mutants to E2F1,(E2F2, E2F3)	10916	689		0.1111111111111111	0.21052631578947367	17	10899	4	7	13	10892	10916	0.2916302732299817
M1	string	0	network_modules	441	TRUE	6.962809418467127e-7	147	11	6	0.5454545454545454	0.04081632653061224	REAC:R-HSA-453279	REAC	Mitotic G1 phase and G1/S transition	10916	1480		0.2222222222222222	0.2631578947368421	147	10769	6	5	141	10764	10916	0.14658940275893897
M1	string	0	network_modules	441	TRUE	1.6761462826837535e-6	155	12	6	0.5	0.03870967741935484	KEGG:04218	KEGG	Cellular senescence	8484	295		0	0.1	155	8329	6	6	149	8323	8484	0.1353754792352991
M1	string	0	network_modules	441	TRUE	1.8102297167196575e-6	157	12	6	0.5	0.03821656050955414	KEGG:04110	KEGG	Cell cycle	8484	264		0.1111111111111111	0.2	157	8327	6	6	151	8321	8484	0.13446077243413226
M1	string	0	network_modules	441	TRUE	2.2499329966325774e-6	5	11	3	0.2727272727272727	0.6	REAC:R-HSA-9754119	REAC	Drug-mediated inhibition of CDK4/CDK6 activity	10916	804		0.2777777777777778	0.3157894736842105	5	10911	3	8	2	10903	10916	0.40413672418639796
M1	string	0	network_modules	441	TRUE	2.4025460243379873e-6	187	12	6	0.5	0.03208556149732621	GO:0000082	GO:BP	G1/S transition of mitotic cell cycle	16175	31		0.08333333333333333	0.15384615384615385	187	15988	6	6	181	15982	16175	0.12449913697087417
M1	string	0	network_modules	441	TRUE	4.981492309680688e-6	330	12	7	0.5833333333333334	0.021212121212121213	KEGG:05165	KEGG	Human papillomavirus infection	8484	446		0.2222222222222222	0.3	330	8154	7	5	323	8149	8484	0.10597496656569376
M1	string	0	network_modules	441	TRUE	7.925193509342472e-6	201	12	6	0.5	0.029850746268656716	KEGG:05203	KEGG	Viral carcinogenesis	8484	455		0.3333333333333333	0.4	201	8283	6	6	195	8277	8484	0.11786765426263186
M1	string	0	network_modules	441	TRUE	9.56764932240123e-6	36	11	4	0.36363636363636365	0.1111111111111111	REAC:R-HSA-9687139	REAC	Aberrant regulation of mitotic cell cycle due to RB1 defects	10916	48		0.3333333333333333	0.3684210526315789	36	10880	4	7	32	10873	10916	0.19961443573468937
M1	string	0	network_modules	441	TRUE	1.1977082594162264e-5	38	11	4	0.36363636363636365	0.10526315789473684	REAC:R-HSA-9675126	REAC	Diseases of mitotic cell cycle	10916	769		0.3888888888888889	0.42105263157894735	38	10878	4	7	34	10871	10916	0.19420948691862297
M1	string	0	network_modules	441	TRUE	1.3560989800859253e-5	465	12	7	0.5833333333333334	0.015053763440860216	GO:0044770	GO:BP	cell cycle phase transition	16175	11146		0.16666666666666666	0.23076923076923078	465	15710	7	5	458	15705	16175	0.09043315521270319
M1	string	0	network_modules	441	TRUE	1.0983629080748238e-4	630	12	7	0.5833333333333334	0.011111111111111112	GO:0010564	GO:BP	regulation of cell cycle process	16175	4217		0.25	0.3076923076923077	630	15545	7	5	623	15540	16175	0.07666796041877996
M1	string	0	network_modules	441	TRUE	1.4148423628235608e-4	370	12	6	0.5	0.016216216216216217	GO:0044772	GO:BP	mitotic cell cycle phase transition	16175	11148		0.3333333333333333	0.38461538461538464	370	15805	6	6	364	15799	16175	0.08695772368575207
M1	string	0	network_modules	441	TRUE	1.4491364496532723e-4	656	12	7	0.5833333333333334	0.010670731707317074	GO:1903047	GO:BP	mitotic cell cycle process	16175	22727		0.4166666666666667	0.46153846153846156	656	15519	7	5	649	15514	16175	0.07497414317365704
M1	string	0	network_modules	441	TRUE	1.4729935128340188e-4	74	12	4	0.3333333333333333	0.05405405405405406	KEGG:04115	KEGG	p53 signaling pathway	8484	269		0.4444444444444444	0.5	74	8410	4	8	70	8402	8484	0.13138558757544744
M1	string	0	network_modules	441	TRUE	1.5561983454184138e-4	376	12	6	0.5	0.015957446808510637	GO:1901987	GO:BP	regulation of cell cycle phase transition	16175	21920		0.5	0.5384615384615384	376	15799	6	6	370	15793	16175	0.08621042329056124
M1	string	0	network_modules	441	TRUE	2.2960178360838048e-4	356	12	6	0.5	0.016853932584269662	KEGG:04151	KEGG	PI3K-Akt signaling pathway	8484	285		0.5555555555555556	0.6	356	8128	6	6	350	8122	8484	0.08597725975527956
M1	string	0	network_modules	441	TRUE	4.4142174778287143e-4	20	12	3	0.25	0.15	GO:2000773	GO:BP	negative regulation of cellular senescence	16175	26033		0.5833333333333334	0.6153846153846154	20	16155	3	9	17	16146	16175	0.1928821983633001
M1	string	0	network_modules	441	TRUE	5.244156799041924e-4	792	12	7	0.5833333333333334	0.008838383838383838	GO:0000278	GO:BP	mitotic cell cycle	16175	76		0.6666666666666666	0.6923076923076923	792	15383	7	5	785	15378	16175	0.06747330368243296
M1	string	0	network_modules	441	TRUE	5.78262523696255e-4	26	11	3	0.2727272727272727	0.11538461538461539	REAC:R-HSA-1538133	REAC	G0 and Early G1	10916	999		0.4444444444444444	0.47368421052631576	26	10890	3	8	23	10882	10916	0.17614303780331245
M1	string	0	network_modules	441	TRUE	6.50187366693047e-4	27	11	3	0.2727272727272727	0.1111111111111111	REAC:R-HSA-69205	REAC	G1/S-Specific Transcription	10916	1003		0.5	0.5263157894736842	27	10889	3	8	24	10881	10916	0.17279971661140084
M1	string	0	network_modules	441	TRUE	8.189759573515327e-4	3	11	2	0.18181818181818182	0.6666666666666666	REAC:R-HSA-9675132	REAC	Diseases of cellular response to stress	10916	764		0.5555555555555556	0.8421052631578947	3	10913	2	9	1	10904	10916	0.3478521475178262
M1	string	0	network_modules	441	TRUE	8.189759573515327e-4	3	11	2	0.18181818181818182	0.6666666666666666	REAC:R-HSA-9630794	REAC	Evasion of Oncogene Induced Senescence Due to Defective p16INK4A binding to CDK4 and CDK6	10916	875		0.5555555555555556	0.8421052631578947	3	10913	2	9	1	10904	10916	0.3478521475178262
M1	string	0	network_modules	441	TRUE	8.189759573515327e-4	3	11	2	0.18181818181818182	0.6666666666666666	REAC:R-HSA-9630750	REAC	Evasion of Oncogene Induced Senescence Due to p16INK4A Defects	10916	877		0.5555555555555556	0.8421052631578947	3	10913	2	9	1	10904	10916	0.3478521475178262
M1	string	0	network_modules	441	TRUE	8.189759573515327e-4	3	11	2	0.18181818181818182	0.6666666666666666	REAC:R-HSA-9632700	REAC	Evasion of Oxidative Stress Induced Senescence Due to Defective p16INK4A binding to CDK4 and CDK6	10916	879		0.5555555555555556	0.8421052631578947	3	10913	2	9	1	10904	10916	0.3478521475178262
M1	string	0	network_modules	441	TRUE	8.189759573515327e-4	3	11	2	0.18181818181818182	0.6666666666666666	REAC:R-HSA-9630747	REAC	Diseases of Cellular Senescence	10916	756		0.5555555555555556	0.8421052631578947	3	10913	2	9	1	10904	10916	0.3478521475178262
M1	string	0	network_modules	441	TRUE	8.189759573515327e-4	3	11	2	0.18181818181818182	0.6666666666666666	REAC:R-HSA-9632693	REAC	Evasion of Oxidative Stress Induced Senescence Due to p16INK4A Defects	10916	881		0.5555555555555556	0.8421052631578947	3	10913	2	9	1	10904	10916	0.3478521475178262
M1	string	0	network_modules	441	TRUE	0.0014926220111486708	286	12	5	0.4166666666666667	0.017482517482517484	GO:1901990	GO:BP	regulation of mitotic cell cycle phase transition	16175	21923		0.75	0.7692307692307693	286	15889	5	7	281	15882	16175	0.08248961180511825
M1	string	0	network_modules	441	TRUE	0.0017576893272450488	130	11	4	0.36363636363636365	0.03076923076923077	REAC:R-HSA-69206	REAC	G1/S Transition	10916	1002		0.8888888888888888	0.8947368421052632	130	10786	4	7	126	10779	10916	0.10297958893626508
M1	string	0	network_modules	441	TRUE	0.0017636012912262988	138	12	4	0.3333333333333333	0.028985507246376812	KEGG:05162	KEGG	Measles	8484	443		0.6666666666666666	0.7	138	8346	4	8	134	8338	8484	0.0943346399252632
M1	string	0	network_modules	441	TRUE	0.0026458586479625444	153	12	4	0.3333333333333333	0.026143790849673203	KEGG:04934	KEGG	Cushing syndrome	8484	391		0.7777777777777778	0.8	153	8331	4	8	149	8323	8484	0.0891717219548805
M1	string	0	network_modules	441	TRUE	0.003242053080048044	38	12	3	0.25	0.07894736842105263	GO:2000772	GO:BP	regulation of cellular senescence	16175	26032		0.8333333333333334	0.8461538461538461	38	16137	3	9	35	16128	16175	0.13938315158677447
M1	string	0	network_modules	441	TRUE	0.004046089038521042	49	11	3	0.2727272727272727	0.061224489795918366	REAC:R-HSA-6791312	REAC	TP53 Regulates Transcription of Cell Cycle Genes	10916	2454		0.9444444444444444	0.9473684210526315	49	10867	3	8	46	10859	10916	0.12744276645433525
M1	string	0	network_modules	441	TRUE	0.004088129987132527	6	11	2	0.18181818181818182	0.3333333333333333	REAC:R-HSA-8849470	REAC	PTK6 Regulates Cell Cycle	10916	1707		1	1	6	10910	2	9	4	10901	10916	0.24563002182252458
M1	string	0	network_modules	441	TRUE	0.005282669857870253	686	12	6	0.5	0.008746355685131196	GO:0008284	GO:BP	positive regulation of cell population proliferation	16175	3151		0.9166666666666666	0.9230769230769231	686	15489	6	6	680	15483	16175	0.061869361247831184
M1	string	0	network_modules	441	TRUE	0.006208603542844988	166	12	4	0.3333333333333333	0.024096385542168676	GO:1902806	GO:BP	regulation of cell cycle G1/S phase transition	16175	22525		1	1	166	16009	4	8	162	16001	16175	0.08734442574320117
M1	string	0	network_modules	441	TRUE	0.007179951413126187	72	12	3	0.25	0.041666666666666664	KEGG:05223	KEGG	Non-small cell lung cancer	8484	474		0.8888888888888888	0.9	72	8412	3	9	69	8403	8484	0.09908860804144459
M1	string	0	network_modules	441	TRUE	0.007235391965554946	198	12	4	0.3333333333333333	0.020202020202020204	KEGG:05169	KEGG	Epstein-Barr virus infection	8484	450		1	1	198	8286	4	8	194	8278	8484	0.07727665916794736
M1	string	0	network_modules	442	TRUE	2.0506898046726747e-4	21	10	3	0.3	0.14285714285714285	REAC:R-HSA-379726	REAC	Mitochondrial tRNA aminoacylation	10916	1470		0	0.5	21	10895	3	7	18	10888	10916	0.20598464316337545
M1	string	0	network_modules	442	TRUE	2.1797879036383554e-4	44	7	3	0.42857142857142855	0.06818181818181818	KEGG:00970	KEGG	Aminoacyl-tRNA biosynthesis	8484	153		NA	1	44	8440	3	4	41	8436	8484	0.1693817809350634
M1	string	0	network_modules	442	TRUE	0.001432875283621309	3	11	2	0.18181818181818182	0.6666666666666666	GO:0006421	GO:BP	asparaginyl-tRNA aminoacylation	16175	2178		0	0.2	3	16172	2	9	1	16163	16175	0.3479507533206276
M1	string	0	network_modules	442	TRUE	0.0017522520977241894	42	10	3	0.3	0.07142857142857142	REAC:R-HSA-379724	REAC	tRNA Aminoacylation	10916	2740		1	1	42	10874	3	7	39	10867	10916	0.14485276221305743
M1	string	0	network_modules	442	TRUE	0.0022140828814896565	38	11	3	0.2727272727272727	0.07894736842105263	GO:0006418	GO:BP	tRNA aminoacylation for protein translation	16175	2175		0.25	0.4	38	16137	3	8	35	16129	16175	0.14569153312358943
M1	string	0	network_modules	442	TRUE	0.0027946704556370914	41	11	3	0.2727272727272727	0.07317073170731707	GO:0043039	GO:BP	tRNA aminoacylation	16175	10489		0.5	0.8	41	16134	3	8	38	16126	16175	0.14017692893089237
M1	string	0	network_modules	442	TRUE	0.0027946704556370914	41	11	3	0.2727272727272727	0.07317073170731707	GO:0043038	GO:BP	amino acid activation	16175	10488		0.5	0.8	41	16134	3	8	38	16126	16175	0.14017692893089237
M1	string	0	network_modules	442	TRUE	0.005960738066782385	186	11	4	0.36363636363636365	0.021505376344086023	GO:0006399	GO:BP	tRNA metabolic process	16175	2160		1	1	186	15989	4	7	182	15982	16175	0.08616103672128299
M1	string	0	network_modules	444	TRUE	8.503298267780795e-8	104	11	6	0.5454545454545454	0.057692307692307696	REAC:R-HSA-194138	REAC	Signaling by VEGF	10916	2313		0	0.2	104	10812	6	5	98	10807	10916	0.17521980118330416
M1	string	0	network_modules	444	TRUE	2.4805185983686974e-7	51	12	5	0.4166666666666667	0.09803921568627451	GO:0048010	GO:BP	vascular endothelial growth factor receptor signaling pathway	16175	12466		0	0.05	51	16124	5	7	46	16117	16175	0.20097511974710577
M1	string	0	network_modules	444	TRUE	9.004682969457464e-7	4	11	3	0.2727272727272727	0.75	REAC:R-HSA-194306	REAC	Neurophilin interactions with VEGF and VEGFR	10916	1591		0.25	0.4	4	10912	3	8	1	10904	10916	0.4519699097320086
M1	string	0	network_modules	444	TRUE	1.257885199044783e-5	8	11	3	0.2727272727272727	0.375	REAC:R-HSA-195399	REAC	VEGF binds to VEGFR leading to receptor dimerization	10916	2632		0.5	0.8	8	10908	3	8	5	10900	10916	0.31921952331311165
M1	string	0	network_modules	444	TRUE	1.257885199044783e-5	8	11	3	0.2727272727272727	0.375	REAC:R-HSA-194313	REAC	VEGF ligand-receptor interactions	10916	2633		0.5	0.8	8	10908	3	8	5	10900	10916	0.31921952331311165
M1	string	0	network_modules	444	TRUE	2.5670687100589038e-5	510	12	7	0.5833333333333334	0.013725490196078431	GO:0007169	GO:BP	cell surface receptor protein tyrosine kinase signaling pathway	16175	2733		0.05263157894736842	0.1	510	15665	7	5	503	15660	16175	0.08604147530768573
M1	string	0	network_modules	444	TRUE	4.590529417919415e-5	202	9	5	0.5555555555555556	0.024752475247524754	KEGG:04510	KEGG	Focal adhesion	8484	313		0	0.3333333333333333	202	8282	5	4	197	8278	8484	0.11366140519040868
M1	string	0	network_modules	444	TRUE	9.012820259323374e-5	58	12	4	0.3333333333333333	0.06896551724137931	GO:0035924	GO:BP	cellular response to vascular endothelial growth factor stimulus	16175	9346		0.10526315789473684	0.15	58	16117	4	8	54	16109	16175	0.1503139914737635
M1	string	0	network_modules	444	TRUE	3.551542175837927e-4	214	12	5	0.4166666666666667	0.02336448598130841	GO:0018108	GO:BP	peptidyl-tyrosine phosphorylation	16175	5327		0.15789473684210525	0.2	214	15961	5	7	209	15954	16175	0.09620818933381306
M1	string	0	network_modules	444	TRUE	3.6347792131806407e-4	215	12	5	0.4166666666666667	0.023255813953488372	GO:0018212	GO:BP	peptidyl-tyrosine modification	16175	5371		0.21052631578947367	0.25	215	15960	5	7	210	15953	16175	0.09597248619911396
M1	string	0	network_modules	444	TRUE	5.154712792533666e-4	790	12	7	0.5833333333333334	0.008860759493670886	GO:0007167	GO:BP	enzyme-linked receptor protein signaling pathway	16175	2731		0.2631578947368421	0.3	790	15385	7	5	783	15380	16175	0.06756989897421549
M1	string	0	network_modules	444	TRUE	8.348398720017675e-4	500	12	6	0.5	0.012	GO:0001934	GO:BP	positive regulation of protein phosphorylation	16175	548		0.3157894736842105	0.35	500	15675	6	6	494	15669	16175	0.07384814041394377
M1	string	0	network_modules	444	TRUE	8.54623482038317e-4	502	12	6	0.5	0.01195219123505976	GO:0071363	GO:BP	cellular response to growth factor stimulus	16175	16615		0.3684210526315789	0.4	502	15673	6	6	496	15667	16175	0.073686159849437
M1	string	0	network_modules	444	TRUE	0.0010389121155524933	519	12	6	0.5	0.011560693641618497	GO:0070848	GO:BP	response to growth factor	16175	16340		0.42105263157894735	0.45	519	15656	6	6	513	15650	16175	0.0723461403516733
M1	string	0	network_modules	444	TRUE	0.0010745967901164743	522	12	6	0.5	0.011494252873563218	GO:0042327	GO:BP	positive regulation of phosphorylation	16175	10095		0.47368421052631576	0.5	522	15653	6	6	516	15647	16175	0.07211626535112799
M1	string	0	network_modules	444	TRUE	0.00109152344647921	507	11	6	0.5454545454545454	0.011834319526627219	REAC:R-HSA-9006934	REAC	Signaling by Receptor Tyrosine Kinases	10916	2302		1	1	507	10409	6	5	501	10404	10916	0.0753090025054566
M1	string	0	network_modules	444	TRUE	0.0013863622597482628	114	12	4	0.3333333333333333	0.03508771929824561	GO:0002040	GO:BP	sprouting angiogenesis	16175	640		0.5263157894736842	0.55	114	16061	4	8	110	16053	16175	0.10627543148067121
M1	string	0	network_modules	444	TRUE	0.0014082679356248995	59	9	3	0.3333333333333333	0.05084745762711865	KEGG:04370	KEGG	VEGF signaling pathway	8484	307		0.5	0.6666666666666666	59	8425	3	6	56	8419	8484	0.12798627417139175
M1	string	0	network_modules	444	TRUE	0.0016465021604292552	119	12	4	0.3333333333333333	0.03361344537815126	GO:0001936	GO:BP	regulation of endothelial cell proliferation	16175	550		0.5789473684210527	0.6	119	16056	4	8	115	16048	16175	0.10393642927625987
M1	string	0	network_modules	444	TRUE	0.0016899710756393459	564	12	6	0.5	0.010638297872340425	GO:0010562	GO:BP	positive regulation of phosphorus metabolic process	16175	4215		0.631578947368421	0.7	564	15611	6	6	558	15605	16175	0.06908673171558274
M1	string	0	network_modules	444	TRUE	0.0016899710756393459	564	12	6	0.5	0.010638297872340425	GO:0045937	GO:BP	positive regulation of phosphate metabolic process	16175	11731		0.631578947368421	0.7	564	15611	6	6	558	15605	16175	0.06908673171558274
M1	string	0	network_modules	444	TRUE	0.0027264101317558192	135	12	4	0.3333333333333333	0.02962962962962963	GO:0001935	GO:BP	endothelial cell proliferation	16175	549		0.7368421052631579	0.75	135	16040	4	8	131	16032	16175	0.09733544280610056
M1	string	0	network_modules	444	TRUE	0.0032816546694848323	632	12	6	0.5	0.00949367088607595	GO:0031401	GO:BP	positive regulation of protein modification process	16175	7157		0.7894736842105263	0.8	632	15543	6	6	626	15537	16175	0.06481573473633012
M1	string	0	network_modules	444	TRUE	0.003503215481853689	235	9	4	0.4444444444444444	0.01702127659574468	KEGG:04014	KEGG	Ras signaling pathway	8484	247		1	1	235	8249	4	5	231	8244	8484	0.08275383564272067
M1	string	0	network_modules	444	TRUE	0.0037938276959636366	40	12	3	0.25	0.075	GO:0038084	GO:BP	vascular endothelial growth factor signaling pathway	16175	9685		0.8421052631578947	0.85	40	16135	3	9	37	16126	16175	0.1357944772851887
M1	string	0	network_modules	444	TRUE	0.0077386159086705085	400	12	5	0.4166666666666667	0.0125	GO:0001525	GO:BP	angiogenesis	16175	330		0.8947368421052632	0.9	400	15775	5	7	395	15768	16175	0.06876630227173208
M1	string	0	network_modules	444	TRUE	0.008448902629777096	744	12	6	0.5	0.008064516129032258	GO:0001932	GO:BP	regulation of protein phosphorylation	16175	546		0.9473684210526315	0.95	744	15431	6	6	738	15425	16175	0.05905398812186561
M1	string	0	network_modules	444	TRUE	0.00855989115857786	180	12	4	0.3333333333333333	0.022222222222222223	GO:0046777	GO:BP	protein autophosphorylation	16175	12365		1	1	180	15995	4	8	176	15987	16175	0.08369083340702638
M1	string	0	network_modules	446	TRUE	4.503791517531462e-14	29	6	6	1	0.20689655172413793	KEGG:04744	KEGG	Phototransduction	8484	362		NA	1	29	8455	6	0	23	8455	8484	0.45424141295583403
M1	string	0	network_modules	446	TRUE	4.2091965864982695e-13	30	7	6	0.8571428571428571	0.2	REAC:R-HSA-2514859	REAC	Inactivation, recovery and regulation of the phototransduction cascade	10916	1179		0	0.3333333333333333	30	10886	6	1	24	10885	10916	0.41341266522341547
M1	string	0	network_modules	446	TRUE	5.218992930763756e-13	31	7	6	0.8571428571428571	0.1935483870967742	REAC:R-HSA-2514856	REAC	The phototransduction cascade	10916	2501		0.5	0.6666666666666666	31	10885	6	1	25	10884	10916	0.40666513329739645
M1	string	0	network_modules	446	TRUE	2.568185874432751e-10	132	10	7	0.7	0.05303030303030303	GO:0007601	GO:BP	visual perception	16175	3060		0	0.05	132	16043	7	3	125	16040	16175	0.19126340351526716
M1	string	0	network_modules	446	TRUE	3.7137318952222603e-10	139	10	7	0.7	0.050359712230215826	GO:0050953	GO:BP	sensory perception of light stimulus	16175	13395		0.05263157894736842	0.1	139	16036	7	3	132	16033	16175	0.18630926979122836
M1	string	0	network_modules	446	TRUE	6.96808705244717e-10	97	7	6	0.8571428571428571	0.061855670103092786	REAC:R-HSA-2187338	REAC	Visual phototransduction	10916	2654		1	1	97	10819	6	1	91	10818	10916	0.2289644239768931
M1	string	0	network_modules	446	TRUE	4.510911132615392e-6	529	10	7	0.7	0.013232514177693762	GO:0007600	GO:BP	sensory perception	16175	3059		0.10526315789473684	0.15	529	15646	7	3	522	15643	16175	0.09331359951916644
M1	string	0	network_modules	446	TRUE	1.5176984635509796e-5	9	10	3	0.3	0.3333333333333333	GO:0022400	GO:BP	regulation of opsin-mediated signaling pathway	16175	6591		0.15789473684210525	0.2	9	16166	3	7	6	16159	16175	0.31582674738077904
M1	string	0	network_modules	446	TRUE	1.6381797772170974e-5	49	10	4	0.4	0.08163265306122448	GO:0009583	GO:BP	detection of light stimulus	16175	3518		0.21052631578947367	0.25	49	16126	4	6	45	16120	16175	0.17966084902388826
M1	string	0	network_modules	446	TRUE	2.167436690045496e-5	10	10	3	0.3	0.3	GO:0007168	GO:BP	receptor guanylyl cyclase signaling pathway	16175	2732		0.2631578947368421	0.3	10	16165	3	7	7	16158	16175	0.2995669656665635
M1	string	0	network_modules	446	TRUE	2.9792577744638428e-5	11	10	3	0.3	0.2727272727272727	GO:0016056	GO:BP	G protein-coupled opsin signaling pathway	16175	5088		0.3157894736842105	0.35	11	16164	3	7	8	16157	16175	0.2855757448755539
M1	string	0	network_modules	446	TRUE	8.320570432566077e-5	806	10	7	0.7	0.008684863523573201	GO:0050877	GO:BP	nervous system process	16175	13322		0.3684210526315789	0.4	806	15369	7	3	799	15366	16175	0.07431783432088902
M1	string	0	network_modules	446	TRUE	1.0095013806718868e-4	16	10	3	0.3	0.1875	GO:0007603	GO:BP	phototransduction, visible light	16175	3062		0.42105263157894735	0.45	16	16159	3	7	13	16152	16175	0.23657895320640884
M1	string	0	network_modules	446	TRUE	1.2254250159607474e-4	17	10	3	0.3	0.17647058823529413	GO:0009584	GO:BP	detection of visible light	16175	3519		0.47368421052631576	0.5	17	16158	3	7	14	16151	16175	0.22947494295328424
M1	string	0	network_modules	446	TRUE	1.7016605858337215e-4	87	10	4	0.4	0.04597701149425287	GO:0009581	GO:BP	detection of external stimulus	16175	3516		0.5263157894736842	0.55	87	16088	4	6	83	16082	16175	0.13419191013968026
M1	string	0	network_modules	446	TRUE	2.0407799384959964e-4	91	10	4	0.4	0.04395604395604396	GO:0009582	GO:BP	detection of abiotic stimulus	16175	3517		0.5789473684210527	0.6	91	16084	4	6	87	16078	16175	0.13114357525808218
M1	string	0	network_modules	446	TRUE	6.645079578251611e-4	122	10	4	0.4	0.03278688524590164	GO:0008277	GO:BP	regulation of G protein-coupled receptor signaling pathway	16175	3149		0.631578947368421	0.65	122	16053	4	6	118	16047	16175	0.11282128591587098
M1	string	0	network_modules	446	TRUE	0.001097566751522752	3	10	2	0.2	0.6666666666666666	GO:0031282	GO:BP	regulation of guanylate cyclase activity	16175	7106		0.6842105263157895	0.7	3	16172	2	8	1	16164	16175	0.3649564167636381
M1	string	0	network_modules	446	TRUE	0.0016352048640097434	39	10	3	0.3	0.07692307692307693	GO:0007602	GO:BP	phototransduction	16175	3061		0.7368421052631579	0.75	39	16136	3	7	36	16129	16175	0.15091863744597775
M1	string	0	network_modules	446	TRUE	0.0021704741892287858	164	10	4	0.4	0.024390243902439025	GO:0006164	GO:BP	purine nucleotide biosynthetic process	16175	1999		0.7894736842105263	0.8	164	16011	4	6	160	16005	16175	0.09679099606426657
M1	string	0	network_modules	446	TRUE	0.0022301013754145852	774	10	6	0.6	0.007751937984496124	GO:0007186	GO:BP	G protein-coupled receptor signaling pathway	16175	2744		0.8421052631578947	0.85	774	15401	6	4	768	15397	16175	0.06433796114906774
M1	string	0	network_modules	446	TRUE	0.0035832772786612596	186	10	4	0.4	0.021505376344086023	GO:0009165	GO:BP	nucleotide biosynthetic process	16175	3331		0.8947368421052632	0.9	186	15989	4	6	182	15983	16175	0.09063192377438783
M1	string	0	network_modules	446	TRUE	0.0069773746594155115	220	10	4	0.4	0.01818181818181818	GO:0072522	GO:BP	purine-containing compound biosynthetic process	16175	17424		0.9473684210526315	1	220	15955	4	6	216	15949	16175	0.08297216421117518
M1	string	0	network_modules	446	TRUE	0.0069773746594155115	220	10	4	0.4	0.01818181818181818	GO:0009416	GO:BP	response to light stimulus	16175	3480		0.9473684210526315	1	220	15955	4	6	216	15949	16175	0.08297216421117518
M1	string	0	network_modules	450	TRUE	0.0011563708061067882	5	8	2	0.25	0.4	REAC:R-HSA-2161517	REAC	Abacavir transmembrane transport	10916	45		0	0.5	5	10911	2	6	3	10905	10916	0.31583645181620407
M1	string	0	network_modules	450	TRUE	0.004156834737373672	9	8	2	0.25	0.2222222222222222	REAC:R-HSA-2161522	REAC	Abacavir ADME	10916	43		1	1	9	10907	2	6	7	10901	10916	0.23510800786592262
M1	string	0	network_modules	450	TRUE	0.005482406360834251	6	10	2	0.2	0.3333333333333333	GO:1990962	GO:BP	xenobiotic transport across blood-brain barrier	16175	25356		0	0.5	6	16169	2	8	4	16161	16175	0.2578475355270565
M1	string	0	network_modules	450	TRUE	0.008493772504988745	67	10	3	0.3	0.04477611940298507	GO:0098754	GO:BP	detoxification	16175	18873		1	1	67	16108	3	7	64	16101	16175	0.11457272811015347
M1	string	0	network_modules	452	TRUE	1.4093362541138105e-11	4	7	4	0.5714285714285714	1	REAC:R-HSA-112126	REAC	ALKBH3 mediated reversal of alkylation damage	10916	19		0	0.14285714285714285	4	10912	4	3	0	10909	10916	0.7558250263553192
M1	string	0	network_modules	452	TRUE	4.929422687716655e-10	7	7	4	0.5714285714285714	0.5714285714285714	REAC:R-HSA-73943	REAC	Reversal of alkylation damage by DNA dioxygenases	10916	2099		0.16666666666666666	0.2857142857142857	7	10909	4	3	3	10906	10916	0.5711535691368858
M1	string	0	network_modules	452	TRUE	9.8566765704543e-10	8	7	4	0.5714285714285714	0.5	REAC:R-HSA-73942	REAC	DNA Damage Reversal	10916	440		0.3333333333333333	0.42857142857142855	8	10908	4	3	4	10905	10916	0.5342039808204538
M1	string	0	network_modules	452	TRUE	2.5804649298554278e-8	11	10	4	0.4	0.36363636363636365	GO:0006307	GO:BP	DNA alkylation repair	16175	2112		0	0.16666666666666666	11	16164	4	6	7	16158	16175	0.3809839380669633
M1	string	0	network_modules	452	TRUE	0.002345712237647435	8	7	2	0.2857142857142857	0.25	REAC:R-HSA-75094	REAC	Formation of the Editosome	10916	964		0.5	0.7142857142857143	8	10908	2	5	6	10903	10916	0.26675898657003766
M1	string	0	network_modules	452	TRUE	0.002345712237647435	8	7	2	0.2857142857142857	0.25	REAC:R-HSA-72200	REAC	mRNA Editing: C to U Conversion	10916	2705		0.5	0.7142857142857143	8	10908	2	5	6	10903	10916	0.26675898657003766
M1	string	0	network_modules	452	TRUE	0.002365848168802705	44	10	3	0.3	0.06818181818181818	GO:0032508	GO:BP	DNA duplex unwinding	16175	7615		0.2	0.3333333333333333	44	16131	3	7	41	16124	16175	0.14195960493660323
M1	string	0	network_modules	452	TRUE	0.0037675917744648623	10	7	2	0.2857142857142857	0.2	REAC:R-HSA-75072	REAC	mRNA Editing	10916	2703		0.8333333333333334	0.8571428571428571	10	10906	2	5	8	10901	10916	0.23846495752727878
M1	string	0	network_modules	452	TRUE	0.003937590019716861	52	10	3	0.3	0.057692307692307696	GO:0032392	GO:BP	DNA geometric change	16175	7543		0.4	0.5	52	16123	3	7	49	16116	16175	0.1303989278910677
M1	string	0	network_modules	452	TRUE	0.005482406360834251	6	10	2	0.2	0.3333333333333333	GO:1990116	GO:BP	ribosome-associated ubiquitin-dependent protein catabolic process	16175	25088		0.6	0.6666666666666666	6	16169	2	8	4	16161	16175	0.2578475355270565
M1	string	0	network_modules	452	TRUE	0.006081188996608529	60	10	3	0.3	0.05	GO:0071103	GO:BP	DNA conformation change	16175	16453		0.8	0.8333333333333334	60	16115	3	7	57	16108	16175	0.1212225699591538
M1	string	0	network_modules	452	TRUE	0.0062841836189277125	329	7	4	0.5714285714285714	0.0121580547112462	REAC:R-HSA-73894	REAC	DNA Repair	10916	444		1	1	329	10587	4	3	325	10584	10916	0.08019829473102297
M1	string	0	network_modules	452	TRUE	0.007672837764395193	7	10	2	0.2	0.2857142857142857	GO:2000623	GO:BP	negative regulation of nuclear-transcribed mRNA catabolic process, nonsense-mediated decay	16175	25905		1	1	7	16168	2	8	5	16160	16175	0.23865388102180132
M1	string	0	network_modules	455	TRUE	8.753204739511672e-4	4	7	2	0.2857142857142857	0.5	GO:0043490	GO:BP	malate-aspartate shuttle	16175	10735		0	0.3333333333333333	4	16171	2	5	2	16166	16175	0.37776578586754944
M1	string	0	network_modules	455	TRUE	0.0024163037408110387	10	6	2	0.3333333333333333	0.2	REAC:R-HSA-428643	REAC	Organic anion transporters	10916	1648		NA	1	10	10906	2	4	8	10902	10916	0.2576781409088113
M1	string	0	network_modules	455	TRUE	0.004873760100211015	88	7	3	0.42857142857142855	0.03409090909090909	GO:1990542	GO:BP	mitochondrial transmembrane transport	16175	25201		0.5	0.6666666666666666	88	16087	3	4	85	16083	16175	0.11969088239184526
M1	string	0	network_modules	455	TRUE	0.009612658981152065	12	7	2	0.2857142857142857	0.16666666666666666	GO:0015810	GO:BP	aspartate transmembrane transport	16175	4923		1	1	12	16163	2	5	10	16158	16175	0.2177791757308338
M1	string	0	network_modules	456	TRUE	4.021765701236586e-7	182	10	6	0.6	0.03296703296703297	GO:0006457	GO:BP	protein folding	16175	2203		0	0.25	182	15993	6	4	176	15989	16175	0.13883062130213797
M1	string	0	network_modules	456	TRUE	8.307640402289483e-7	168	6	5	0.8333333333333334	0.02976190476190476	KEGG:04141	KEGG	Protein processing in endoplasmic reticulum	8484	278		NA	1	168	8316	5	1	163	8315	8484	0.15534310902385107
M1	string	0	network_modules	456	TRUE	5.6079307743913955e-6	107	10	5	0.5	0.04672897196261682	REAC:R-HSA-8957275	REAC	Post-translational protein phosphorylation	10916	1777		0	0.25	107	10809	5	5	102	10804	10916	0.15066679743699568
M1	string	0	network_modules	456	TRUE	1.1799546828085956e-5	124	10	5	0.5	0.04032258064516129	REAC:R-HSA-381426	REAC	Regulation of Insulin-like Growth Factor (IGF) transport and uptake by Insulin-like Growth Factor Binding Proteins (IGFBPs)	10916	1981		0.3333333333333333	0.5	124	10792	5	5	119	10787	10916	0.13962347856247706
M1	string	0	network_modules	456	TRUE	2.9792577744638428e-5	11	10	3	0.3	0.2727272727272727	GO:0034975	GO:BP	protein folding in endoplasmic reticulum	16175	8745		0.3333333333333333	0.5	11	16164	3	7	8	16157	16175	0.2855757448755539
M1	string	0	network_modules	456	TRUE	1.3871178503790937e-4	483	10	6	0.6	0.012422360248447204	GO:0051604	GO:BP	protein maturation	16175	13821		0.6666666666666666	0.75	483	15692	6	4	477	15688	16175	0.0833152589171322
M1	string	0	network_modules	456	TRUE	0.007224371951019344	67	10	3	0.3	0.04477611940298507	REAC:R-HSA-1650814	REAC	Collagen biosynthesis and modifying enzymes	10916	384		0.6666666666666666	0.75	67	10849	3	7	64	10842	10916	0.11393109735884513
M1	string	0	network_modules	456	TRUE	0.007612402875442795	9	10	2	0.2	0.2222222222222222	REAC:R-HSA-381183	REAC	ATF6 (ATF6-alpha) activates chaperone genes	10916	36		1	1	9	10907	2	8	7	10899	10916	0.21013230935567795
M1	string	0	network_modules	456	TRUE	0.008116093710388047	66	10	3	0.3	0.045454545454545456	GO:0061077	GO:BP	chaperone-mediated protein folding	16175	15193		1	1	66	16109	3	7	63	16102	16175	0.11545797873346139
M1	string	0	network_modules	457	TRUE	3.354783554434947e-17	59	11	9	0.8181818181818182	0.15254237288135594	REAC:R-HSA-6790901	REAC	rRNA modification in the nucleus and cytosol	10916	2731		0	0.25	59	10857	9	2	50	10855	10916	0.3520768468821713
M1	string	0	network_modules	457	TRUE	5.404470987021123e-17	94	10	9	0.9	0.09574468085106383	GO:0042274	GO:BP	ribosomal small subunit biogenesis	16175	10071		0	0.1	94	16081	9	1	85	16080	16175	0.29259378208249565
M1	string	0	network_modules	457	TRUE	4.156948851212594e-15	182	11	10	0.9090909090909091	0.054945054945054944	REAC:R-HSA-6791226	REAC	Major pathway of rRNA processing in the nucleolus and cytosol	10916	1389		0.3333333333333333	0.5	182	10734	10	1	172	10733	10916	0.22135989102085313
M1	string	0	network_modules	457	TRUE	7.18613632320418e-15	192	11	10	0.9090909090909091	0.052083333333333336	REAC:R-HSA-8868773	REAC	rRNA processing in the nucleus and cytosol	10916	2734		0.6666666666666666	0.75	192	10724	10	1	182	10723	10916	0.21539735357649026
M1	string	0	network_modules	457	TRUE	1.2073586541746406e-14	202	11	10	0.9090909090909091	0.04950495049504951	REAC:R-HSA-72312	REAC	rRNA processing	10916	2732		1	1	202	10714	10	1	192	10713	10916	0.2098801540052629
M1	string	0	network_modules	457	TRUE	4.746881648403743e-13	251	10	9	0.9	0.035856573705179286	GO:0042254	GO:BP	ribosome biogenesis	16175	10060		0.1111111111111111	0.2	251	15924	9	1	242	15923	16175	0.17798467074997767
M1	string	0	network_modules	457	TRUE	5.654710836524352e-12	169	10	8	0.8	0.047337278106508875	GO:0006364	GO:BP	rRNA processing	16175	2140		0.2222222222222222	0.3	169	16006	8	2	161	16004	16175	0.19313113458146194
M1	string	0	network_modules	457	TRUE	2.6189523384729892e-11	390	10	9	0.9	0.023076923076923078	GO:0022613	GO:BP	ribonucleoprotein complex biogenesis	16175	6620		0.3333333333333333	0.4	390	15785	9	1	381	15784	16175	0.14202041265836068
M1	string	0	network_modules	457	TRUE	2.7201887934418654e-11	205	10	8	0.8	0.03902439024390244	GO:0016072	GO:BP	rRNA metabolic process	16175	5099		0.4444444444444444	0.5	205	15970	8	2	197	15968	16175	0.17505789672536712
M1	string	0	network_modules	457	TRUE	5.822472082989222e-9	139	7	6	0.8571428571428571	0.04316546762589928	KEGG:03008	KEGG	Ribosome biogenesis in eukaryotes	8484	207		NA	1	139	8345	6	1	133	8344	8484	0.19031787582666082
M1	string	0	network_modules	457	TRUE	3.943369722528678e-8	46	10	5	0.5	0.10869565217391304	GO:0030490	GO:BP	maturation of SSU-rRNA	16175	6815		0.5555555555555556	0.6	46	16129	5	5	41	16124	16175	0.2322023309207873
M1	string	0	network_modules	457	TRUE	5.882606399967147e-4	28	10	3	0.3	0.10714285714285714	GO:0000462	GO:BP	maturation of SSU-rRNA from tricistronic rRNA transcript (SSU-rRNA, 5.8S rRNA, LSU-rRNA)	16175	152		0.6666666666666666	0.7	28	16147	3	7	25	16140	16175	0.1784594367560398
M1	string	0	network_modules	457	TRUE	0.00365614327046356	5	10	2	0.2	0.4	GO:0000480	GO:BP	endonucleolytic cleavage in 5'-ETS of tricistronic rRNA transcript (SSU-rRNA, 5.8S rRNA, LSU-rRNA)	16175	168		0.7777777777777778	1	5	16170	2	8	3	16162	16175	0.28253656168710733
M1	string	0	network_modules	457	TRUE	0.00365614327046356	5	10	2	0.2	0.4	GO:0000967	GO:BP	rRNA 5'-end processing	16175	275		0.7777777777777778	1	5	16170	2	8	3	16162	16175	0.28253656168710733
M1	string	0	network_modules	457	TRUE	0.00365614327046356	5	10	2	0.2	0.4	GO:0000472	GO:BP	endonucleolytic cleavage to generate mature 5'-end of SSU-rRNA from (SSU-rRNA, 5.8S rRNA, LSU-rRNA)	16175	161		0.7777777777777778	1	5	16170	2	8	3	16162	16175	0.28253656168710733
M1	string	0	network_modules	466	TRUE	3.903854967263425e-7	82	9	5	0.5555555555555556	0.06097560975609756	GO:0019646	GO:BP	aerobic electron transport chain	16175	5967		0	0.07692307692307693	82	16093	5	4	77	16089	16175	0.18288795610759725
M1	string	0	network_modules	466	TRUE	5.598123498995039e-7	88	9	5	0.5555555555555556	0.056818181818181816	GO:0042773	GO:BP	ATP synthesis coupled electron transport	16175	10358		0.08333333333333333	0.23076923076923078	88	16087	5	4	83	16083	16175	0.17645701366277633
M1	string	0	network_modules	466	TRUE	5.598123498995039e-7	88	9	5	0.5555555555555556	0.056818181818181816	GO:0042775	GO:BP	mitochondrial ATP synthesis coupled electron transport	16175	10360		0.08333333333333333	0.23076923076923078	88	16087	5	4	83	16083	16175	0.17645701366277633
M1	string	0	network_modules	466	TRUE	9.148482776748035e-7	103	8	5	0.625	0.04854368932038835	REAC:R-HSA-611105	REAC	Respiratory electron transport	10916	2081		0	0.5	103	10813	5	3	98	10810	10916	0.17243192367891894
M1	string	0	network_modules	466	TRUE	1.019724221340257e-6	99	9	5	0.5555555555555556	0.050505050505050504	GO:0022904	GO:BP	respiratory electron transport chain	16175	6631		0.25	0.3076923076923077	99	16076	5	4	94	16072	16175	0.16621644190679294
M1	string	0	network_modules	466	TRUE	1.513159838901758e-6	107	9	5	0.5555555555555556	0.04672897196261682	GO:0022900	GO:BP	electron transport chain	16175	6630		0.3333333333333333	0.38461538461538464	107	16068	5	4	102	16064	16175	0.15977788122813938
M1	string	0	network_modules	466	TRUE	2.747698650005433e-6	134	8	5	0.625	0.03731343283582089	KEGG:00190	KEGG	Oxidative phosphorylation	8484	18		0	0.08333333333333333	134	8350	5	3	129	8347	8484	0.1501130341390224
M1	string	0	network_modules	466	TRUE	3.603679868232247e-6	127	9	5	0.5555555555555556	0.03937007874015748	GO:0006119	GO:BP	oxidative phosphorylation	16175	1977		0.4166666666666667	0.46153846153846156	127	16048	5	4	122	16044	16175	0.14641912184299322
M1	string	0	network_modules	466	TRUE	5.530359679784503e-6	154	8	5	0.625	0.032467532467532464	KEGG:04932	KEGG	Non-alcoholic fatty liver disease	8484	389		0.09090909090909091	0.16666666666666666	154	8330	5	3	149	8327	8484	0.1396520693555006
M1	string	0	network_modules	466	TRUE	1.1984758709493315e-5	372	9	6	0.6666666666666666	0.016129032258064516	GO:0006091	GO:BP	generation of precursor metabolites and energy	16175	1954		0.5	0.5384615384615384	372	15803	6	3	366	15800	16175	0.1013176431629545
M1	string	0	network_modules	466	TRUE	1.2294073581855264e-5	162	9	5	0.5555555555555556	0.030864197530864196	GO:0009060	GO:BP	aerobic respiration	16175	3236		0.5833333333333334	0.6153846153846154	162	16013	5	4	157	16009	16175	0.1292697998520796
M1	string	0	network_modules	466	TRUE	1.4048759673637964e-5	177	8	5	0.625	0.02824858757062147	REAC:R-HSA-1428517	REAC	Aerobic respiration and respiratory electron transport	10916	127		1	1	177	10739	5	3	172	10736	10916	0.13053637159682632
M1	string	0	network_modules	466	TRUE	2.1501960328017333e-5	202	8	5	0.625	0.024752475247524754	KEGG:05415	KEGG	Diabetic cardiomyopathy	8484	492		0.18181818181818182	0.25	202	8282	5	3	197	8279	8484	0.12114876006452192
M1	string	0	network_modules	466	TRUE	2.5961872649001706e-5	188	9	5	0.5555555555555556	0.026595744680851064	GO:0045333	GO:BP	cellular respiration	16175	11360		0.6666666666666666	0.6923076923076923	188	15987	5	4	183	15983	16175	0.11974213511142054
M1	string	0	network_modules	466	TRUE	3.3657128862115165e-5	221	8	5	0.625	0.02262443438914027	KEGG:05208	KEGG	Chemical carcinogenesis - reactive oxygen species	8484	460		0.2727272727272727	0.3333333333333333	221	8263	5	3	216	8260	8484	0.11552512209150351
M1	string	0	network_modules	466	TRUE	3.61416189530683e-5	13	9	3	0.3333333333333333	0.23076923076923078	GO:0006122	GO:BP	mitochondrial electron transport, ubiquinol to cytochrome c	16175	1980		0.75	0.7692307692307693	13	16162	3	6	10	16156	16175	0.27686966205164043
M1	string	0	network_modules	466	TRUE	3.9103376177275326e-5	87	8	4	0.5	0.04597701149425287	KEGG:04260	KEGG	Cardiac muscle contraction	8484	296		0.36363636363636365	0.4166666666666667	87	8397	4	4	83	8393	8484	0.14934780521875576
M1	string	0	network_modules	466	TRUE	4.2860943934652345e-5	232	8	5	0.625	0.021551724137931036	KEGG:04714	KEGG	Thermogenesis	8484	349		0.45454545454545453	0.5	232	8252	5	3	227	8249	8484	0.11258400771842363
M1	string	0	network_modules	466	TRUE	8.296357820540452e-5	265	8	5	0.625	0.018867924528301886	KEGG:05012	KEGG	Parkinson disease	8484	412		0.5454545454545454	0.5833333333333334	265	8219	5	3	260	8216	8484	0.10486538398314105
M1	string	0	network_modules	466	TRUE	9.270090649240791e-5	271	8	5	0.625	0.01845018450184502	KEGG:05020	KEGG	Prion disease	8484	416		0.6363636363636364	0.6666666666666666	271	8213	5	3	266	8210	8484	0.10361232989677926
M1	string	0	network_modules	466	TRUE	1.123855881464998e-4	252	9	5	0.5555555555555556	0.01984126984126984	GO:0015980	GO:BP	energy derivation by oxidation of organic compounds	16175	5060		0.8333333333333334	0.8461538461538461	252	15923	5	4	247	15919	16175	0.10287881708946334
M1	string	0	network_modules	466	TRUE	1.663684273062279e-4	305	8	5	0.625	0.01639344262295082	KEGG:05016	KEGG	Huntington disease	8484	414		0.7272727272727273	0.75	305	8179	5	3	300	8176	8484	0.09720806505404672
M1	string	0	network_modules	466	TRUE	3.9241001442245763e-4	363	8	5	0.625	0.013774104683195593	KEGG:05014	KEGG	Amyotrophic lateral sclerosis	8484	413		0.8181818181818182	0.8333333333333334	363	8121	5	3	358	8118	8484	0.08838416055428054
M1	string	0	network_modules	466	TRUE	5.042024241145133e-4	382	8	5	0.625	0.013089005235602094	KEGG:05010	KEGG	Alzheimer disease	8484	411		0.9090909090909091	0.9166666666666666	382	8102	5	3	377	8099	8484	0.08592725827155807
M1	string	0	network_modules	466	TRUE	0.002925276442811189	5	9	2	0.2222222222222222	0.4	GO:0006121	GO:BP	mitochondrial electron transport, succinate to ubiquinone	16175	1979		0.9166666666666666	1	5	16170	2	7	3	16163	16175	0.2978565749868409
M1	string	0	network_modules	466	TRUE	0.002925276442811189	5	9	2	0.2222222222222222	0.4	GO:0006105	GO:BP	succinate metabolic process	16175	1964		0.9166666666666666	1	5	16170	2	7	3	16163	16175	0.2978565749868409
M1	string	0	network_modules	466	TRUE	0.007224006891805016	115	8	3	0.375	0.02608695652173913	KEGG:01200	KEGG	Carbon metabolism	8484	184		1	1	115	8369	3	5	112	8364	8484	0.09602996805524698
M1	string	0	network_modules	468	TRUE	7.238878866885439e-7	4	10	3	0.3	0.75	GO:0140916	GO:BP	zinc ion import into lysosome	16175	19936		0	0.16666666666666666	4	16171	3	7	1	16164	16175	0.47415584794865384
M1	string	0	network_modules	468	TRUE	3.6170897221837026e-6	6	10	3	0.3	0.5	GO:0034486	GO:BP	vacuolar transmembrane transport	16175	8657		0.2	0.3333333333333333	6	16169	3	7	3	16162	16175	0.38701086433319276
M1	string	0	network_modules	468	TRUE	2.167436690045496e-5	10	10	3	0.3	0.3	GO:0062111	GO:BP	zinc ion import into organelle	16175	15827		0.4	0.5	10	16165	3	7	7	16158	16175	0.2995669656665635
M1	string	0	network_modules	468	TRUE	1.6779674839189002e-4	5	4	2	0.5	0.4	REAC:R-HSA-435368	REAC	Zinc efflux and compartmentalization by the SLC30 family	10916	2681		0	0.25	5	10911	2	2	3	10909	10916	0.44698817556185216
M1	string	0	network_modules	468	TRUE	4.671769968099404e-4	26	10	3	0.3	0.11538461538461539	GO:0071577	GO:BP	zinc ion transmembrane transport	16175	16768		0.6	0.6666666666666666	26	16149	3	7	23	16142	16175	0.18526140987785414
M1	string	0	network_modules	468	TRUE	5.882606399967147e-4	28	10	3	0.3	0.10714285714285714	GO:0006829	GO:BP	zinc ion transport	16175	2503		0.8	0.8333333333333334	28	16147	3	7	25	16140	16175	0.1784594367560398
M1	string	0	network_modules	468	TRUE	7.285673608791165e-4	30	10	3	0.3	0.1	GO:0010043	GO:BP	response to zinc ion	16175	3852		1	1	30	16145	3	7	27	16138	16175	0.17234739749830705
M1	string	0	network_modules	468	TRUE	0.0017597137558513893	15	4	2	0.5	0.13333333333333333	REAC:R-HSA-435354	REAC	Zinc transporters	10916	2683		0.3333333333333333	0.5	15	10901	2	2	13	10899	10916	0.25771360850700775
M1	string	0	network_modules	468	TRUE	0.004620445367777783	24	4	2	0.5	0.08333333333333333	REAC:R-HSA-425410	REAC	Metal ion SLC transporters	10916	1442		0.6666666666666666	0.75	24	10892	2	2	22	10890	10916	0.20348763012649823
M1	string	0	network_modules	468	TRUE	0.007323454428993245	245	4	3	0.75	0.012244897959183673	REAC:R-HSA-425407	REAC	SLC-mediated transmembrane transport	10916	2146		1	1	245	10671	3	1	242	10670	10916	0.09404205215754793
M1	string	0	network_modules	470	TRUE	7.015009593948305e-20	80	10	10	1	0.125	REAC:R-HSA-380287	REAC	Centrosome maturation	10916	341		0	0.2857142857142857	80	10836	10	0	70	10836	10916	0.35241692545238873
M1	string	0	network_modules	470	TRUE	7.015009593948305e-20	80	10	10	1	0.125	REAC:R-HSA-380270	REAC	Recruitment of mitotic centrosome proteins and complexes	10916	1951		0	0.2857142857142857	80	10836	10	0	70	10836	10916	0.35241692545238873
M1	string	0	network_modules	470	TRUE	3.8520988407698826e-19	94	10	10	1	0.10638297872340426	REAC:R-HSA-380320	REAC	Recruitment of NuMA to mitotic centrosomes	10916	1950		0.3333333333333333	0.42857142857142855	94	10822	10	0	84	10822	10916	0.32490552108152515
M1	string	0	network_modules	470	TRUE	5.540808564955248e-16	88	8	8	1	0.09090909090909091	GO:0046785	GO:BP	microtubule polymerization	16175	12369		0	0.07692307692307693	88	16087	8	0	80	16087	16175	0.30076442736038456
M1	string	0	network_modules	470	TRUE	7.38178911337482e-16	195	10	10	1	0.05128205128205128	REAC:R-HSA-69275	REAC	G2/M Transition	10916	1008		0.5	0.5714285714285714	195	10721	10	0	185	10721	10916	0.22452649440416883
M1	string	0	network_modules	470	TRUE	8.194630591847131e-16	197	10	10	1	0.050761421319796954	REAC:R-HSA-453274	REAC	Mitotic G2-G2/M phases	10916	1481		0.6666666666666666	0.7142857142857143	197	10719	10	0	187	10719	10916	0.2233630214421836
M1	string	0	network_modules	470	TRUE	9.087156213552852e-16	199	10	10	1	0.05025125628140704	REAC:R-HSA-68877	REAC	Mitotic Prometaphase	10916	1484		0.8333333333333334	0.8571428571428571	199	10717	10	0	189	10717	10916	0.2222170257328801
M1	string	0	network_modules	470	TRUE	7.444077483071284e-15	46	8	7	0.875	0.15217391304347827	GO:0007020	GO:BP	microtubule nucleation	16175	2628		0.08333333333333333	0.15384615384615385	46	16129	7	1	39	16128	16175	0.36432263309120266
M1	string	0	network_modules	470	TRUE	9.489988107687582e-15	124	8	8	1	0.06451612903225806	GO:0031109	GO:BP	microtubule polymerization or depolymerization	16175	7034		0.16666666666666666	0.23076923076923078	124	16051	8	0	116	16051	16175	0.2530873736936036
M1	string	0	network_modules	470	TRUE	1.277761922948748e-12	406	10	10	1	0.024630541871921183	REAC:R-HSA-68886	REAC	M Phase	10916	1343		1	1	406	10510	10	0	396	10510	10916	0.1540655698235381
M1	string	0	network_modules	470	TRUE	1.9542247336701372e-12	238	8	8	1	0.03361344537815126	GO:0051258	GO:BP	protein polymerization	16175	13605		0.25	0.3076923076923077	238	15937	8	0	230	15937	16175	0.18203088566138764
M1	string	0	network_modules	470	TRUE	2.8335974460458374e-9	586	8	8	1	0.013651877133105802	GO:0000226	GO:BP	microtubule cytoskeleton organization	16175	61		0.3333333333333333	0.38461538461538464	586	15589	8	0	578	15589	16175	0.11473359317935833
M1	string	0	network_modules	470	TRUE	2.01789589372308e-8	748	8	8	1	0.0106951871657754	GO:0097435	GO:BP	supramolecular fiber organization	16175	18657		0.4166666666666667	0.46153846153846156	748	15427	8	0	740	15427	16175	0.1010229892765446
M1	string	0	network_modules	470	TRUE	3.1981700080277494e-6	361	8	6	0.75	0.01662049861495845	GO:0007059	GO:BP	chromosome segregation	16175	2658		0.5	0.5384615384615384	361	15814	6	2	355	15812	16175	0.10958257301240167
M1	string	0	network_modules	470	TRUE	5.039870227620318e-6	792	8	7	0.875	0.008838383838383838	GO:0000278	GO:BP	mitotic cell cycle	16175	76		0.5833333333333334	0.6153846153846154	792	15383	7	1	785	15382	16175	0.08515108587035672
M1	string	0	network_modules	470	TRUE	7.859216380514103e-6	176	8	5	0.625	0.028409090909090908	GO:0007051	GO:BP	spindle organization	16175	2650		0.6666666666666666	0.6923076923076923	176	15999	5	3	171	15996	16175	0.13168137486311451
M1	string	0	network_modules	470	TRUE	1.5470478190364028e-4	113	8	4	0.5	0.035398230088495575	GO:0051225	GO:BP	spindle assembly	16175	13578		0.75	0.7692307692307693	113	16062	4	4	109	16058	16175	0.13167238564308784
M1	string	0	network_modules	470	TRUE	2.2136236435954122e-4	343	8	5	0.625	0.014577259475218658	GO:0140694	GO:BP	membraneless organelle assembly	16175	19860		0.8333333333333334	0.8461538461538461	343	15832	5	3	338	15829	16175	0.09322850491961868
M1	string	0	network_modules	470	TRUE	0.0016209812453832138	203	8	4	0.5	0.019704433497536946	GO:0051321	GO:BP	meiotic cell cycle	16175	13648		0.9166666666666666	0.9230769230769231	203	15972	4	4	199	15968	16175	0.09740399329737823
M1	string	0	network_modules	470	TRUE	0.0017351622113476123	52	8	3	0.375	0.057692307692307696	GO:0031122	GO:BP	cytoplasmic microtubule organization	16175	7047		1	1	52	16123	3	5	49	16118	16175	0.14609724225560775
M1	string	0	network_modules	471	TRUE	2.1502538113072123e-6	8	7	3	0.42857142857142855	0.375	REAC:R-HSA-201688	REAC	WNT mediated activation of DVL	10916	2669		0	0.25	8	10908	3	4	5	10904	10916	0.4004814836952458
M1	string	0	network_modules	471	TRUE	5.032672340794028e-4	4	7	2	0.2857142857142857	0.5	REAC:R-HSA-5368598	REAC	Negative regulation of TCF-dependent signaling by DVL-interacting proteins	10916	1577		0.3333333333333333	0.5	4	10912	2	5	2	10907	10916	0.37767001729423827
M1	string	0	network_modules	471	TRUE	0.0010806849085888475	684	10	6	0.6	0.008771929824561403	GO:0032880	GO:BP	regulation of protein localization	16175	7877		0	0.3333333333333333	684	15491	6	4	678	15487	16175	0.06892853537672179
M1	string	0	network_modules	471	TRUE	0.002264015918186618	776	10	6	0.6	0.007731958762886598	GO:0060341	GO:BP	regulation of cellular localization	16175	14553		0.5	0.6666666666666666	776	15399	6	4	770	15395	16175	0.06424478031301445
M1	string	0	network_modules	471	TRUE	0.0029660059866008564	157	5	3	0.6	0.01910828025477707	KEGG:04390	KEGG	Hippo signaling pathway	8484	310		0	0.5	157	8327	3	2	154	8325	8484	0.10477674571799724
M1	string	0	network_modules	471	TRUE	0.004032889061718816	174	5	3	0.6	0.017241379310344827	KEGG:04310	KEGG	Wnt signaling pathway	8484	299		1	1	174	8310	3	2	171	8308	8484	0.09928525567082096
M1	string	0	network_modules	471	TRUE	0.005522425550008051	12	7	2	0.2857142857142857	0.16666666666666666	REAC:R-HSA-9664420	REAC	Killing mechanisms	10916	1291		0.6666666666666666	1	12	10904	2	5	10	10899	10916	0.21756763404988302
M1	string	0	network_modules	471	TRUE	0.005522425550008051	12	7	2	0.2857142857142857	0.16666666666666666	REAC:R-HSA-9673324	REAC	WNT5:FZD7-mediated leishmania damping	10916	2670		0.6666666666666666	1	12	10904	2	5	10	10899	10916	0.21756763404988302
M1	string	0	network_modules	471	TRUE	0.0063936536891636775	61	10	3	0.3	0.04918032786885246	GO:0035567	GO:BP	non-canonical Wnt signaling pathway	16175	9097		1	1	61	16114	3	7	58	16107	16175	0.12020347993976388
M1	string	0	network_modules	475	TRUE	2.677683406911369e-22	34	9	9	1	0.2647058823529412	GO:0051932	GO:BP	synaptic transmission, GABAergic	16175	14002		0	0.05	34	16141	9	0	25	16141	16175	0.5140977791033114
M1	string	0	network_modules	475	TRUE	2.6371574884026348e-20	22	9	8	0.8888888888888888	0.36363636363636365	GO:0007214	GO:BP	gamma-aminobutyric acid signaling pathway	16175	2768		0.05263157894736842	0.1	22	16153	8	1	14	16152	16175	0.5682098493766663
M1	string	0	network_modules	475	TRUE	6.475133830474345e-18	40	8	8	1	0.2	KEGG:05033	KEGG	Nicotine addiction	8484	421		0	0.16666666666666666	40	8444	8	0	32	8444	8484	0.44636859976065607
M1	string	0	network_modules	475	TRUE	8.565659142060589e-17	54	9	8	0.8888888888888888	0.14814814814814814	GO:1902476	GO:BP	chloride transmembrane transport	16175	22306		0.10526315789473684	0.15	54	16121	8	1	46	16120	16175	0.3622302146635232
M1	string	0	network_modules	475	TRUE	4.152749294400097e-16	65	9	8	0.8888888888888888	0.12307692307692308	GO:0098656	GO:BP	monoatomic anion transmembrane transport	16175	18812		0.15789473684210525	0.2	65	16110	8	1	57	16109	16175	0.3300193825159862
M1	string	0	network_modules	475	TRUE	5.365701848010148e-16	67	9	8	0.8888888888888888	0.11940298507462686	GO:0098661	GO:BP	inorganic anion transmembrane transport	16175	18817		0.21052631578947367	0.25	67	16108	8	1	59	16107	16175	0.32503115684223266
M1	string	0	network_modules	475	TRUE	3.955091895679024e-15	85	9	8	0.8888888888888888	0.09411764705882353	GO:0006821	GO:BP	chloride transport	16175	2498		0.2631578947368421	0.3	85	16090	8	1	77	16089	16175	0.2883693669184605
M1	string	0	network_modules	475	TRUE	5.9464252938428325e-15	89	8	8	1	0.0898876404494382	KEGG:05032	KEGG	Morphine addiction	8484	420		0.2	0.5	89	8395	8	0	81	8395	8484	0.29837667250359456
M1	string	0	network_modules	475	TRUE	5.9464252938428325e-15	89	8	8	1	0.0898876404494382	KEGG:04727	KEGG	GABAergic synapse	8484	357		0.2	0.5	89	8395	8	0	81	8395	8484	0.29837667250359456
M1	string	0	network_modules	475	TRUE	3.9019766633949473e-14	112	9	8	0.8888888888888888	0.07142857142857142	GO:0006820	GO:BP	monoatomic anion transport	16175	2497		0.3157894736842105	0.35	112	16063	8	1	104	16062	16175	0.2509533982977558
M1	string	0	network_modules	475	TRUE	4.853050473454345e-14	115	9	8	0.8888888888888888	0.06956521739130435	GO:0015698	GO:BP	inorganic anion transport	16175	4818		0.3684210526315789	0.4	115	16060	8	1	107	16059	16175	0.24762950672349893
M1	string	0	network_modules	475	TRUE	2.0718358849688475e-13	60	8	7	0.875	0.11666666666666667	REAC:R-HSA-977443	REAC	GABA receptor activation	10916	1011		0	0.16666666666666666	60	10856	7	1	53	10855	10916	0.31849068757493193
M1	string	0	network_modules	475	TRUE	3.965348142119953e-13	148	8	8	1	0.05405405405405406	KEGG:04723	KEGG	Retrograde endocannabinoid signaling	8484	353		0.6	0.6666666666666666	148	8336	8	0	140	8336	8484	0.23056719427390687
M1	string	0	network_modules	475	TRUE	2.0123736825671592e-11	487	9	9	1	0.018480492813141684	GO:0098916	GO:BP	anterograde trans-synaptic signaling	16175	18949		0.42105263157894735	0.5	487	15688	9	0	478	15688	16175	0.13391809944213723
M1	string	0	network_modules	475	TRUE	2.0123736825671592e-11	487	9	9	1	0.018480492813141684	GO:0007268	GO:BP	chemical synaptic transmission	16175	2796		0.42105263157894735	0.5	487	15688	9	0	478	15688	16175	0.13391809944213723
M1	string	0	network_modules	475	TRUE	2.2078216562178095e-11	492	9	9	1	0.018292682926829267	GO:0099537	GO:BP	trans-synaptic signaling	16175	19116		0.5263157894736842	0.55	492	15683	9	0	483	15683	16175	0.13321464977100952
M1	string	0	network_modules	475	TRUE	3.401106636599233e-11	516	9	9	1	0.01744186046511628	GO:0099536	GO:BP	synaptic signaling	16175	19115		0.5789473684210527	0.6	516	15659	9	0	507	15659	16175	0.12998017840665263
M1	string	0	network_modules	475	TRUE	1.9792844372169815e-10	61	9	6	0.6666666666666666	0.09836065573770492	GO:0060078	GO:BP	regulation of postsynaptic membrane potential	16175	14337		0.631578947368421	0.65	61	16114	6	3	55	16111	16175	0.2551776741433977
M1	string	0	network_modules	475	TRUE	6.089365600209334e-10	365	8	8	1	0.021917808219178082	KEGG:04080	KEGG	Neuroactive ligand-receptor interaction	8484	263		0.8	0.8333333333333334	365	8119	8	0	357	8119	8484	0.14489531986952797
M1	string	0	network_modules	475	TRUE	1.0496843831938261e-9	196	8	7	0.875	0.03571428571428571	REAC:R-HSA-112314	REAC	Neurotransmitter receptors and postsynaptic signal transmission	10916	1594		0.2	0.3333333333333333	196	10720	7	1	189	10719	10916	0.17478896213483616
M1	string	0	network_modules	475	TRUE	7.545251403286013e-9	259	8	7	0.875	0.02702702702702703	REAC:R-HSA-112315	REAC	Transmission across Chemical Synapses	10916	2580		0.4	0.5	259	10657	7	1	252	10656	10916	0.1514738394362331
M1	string	0	network_modules	475	TRUE	3.342492955916579e-8	54	8	5	0.625	0.09259259259259259	REAC:R-HSA-1236394	REAC	Signaling by ERBB4	10916	2237		0.6	0.6666666666666666	54	10862	5	3	49	10859	10916	0.23933878552975354
M1	string	0	network_modules	475	TRUE	4.691864307795316e-8	630	9	8	0.8888888888888888	0.012698412698412698	GO:0098660	GO:BP	inorganic ion transmembrane transport	16175	18816		0.6842105263157895	0.7	630	15545	8	1	622	15544	16175	0.10365418304124352
M1	string	0	network_modules	475	TRUE	7.772753750788553e-8	671	9	8	0.8888888888888888	0.011922503725782414	GO:0034220	GO:BP	monoatomic ion transmembrane transport	16175	8508		0.7368421052631579	0.75	671	15504	8	1	663	15503	16175	0.10027027345670349
M1	string	0	network_modules	475	TRUE	1.6089390234085956e-7	400	8	7	0.875	0.0175	REAC:R-HSA-112316	REAC	Neuronal System	10916	1590		0.8	0.8333333333333334	400	10516	7	1	393	10515	10916	0.12083964160141526
M1	string	0	network_modules	475	TRUE	1.8155558245074412e-7	19	9	4	0.4444444444444444	0.21052631578947367	GO:1904862	GO:BP	inhibitory synapse assembly	16175	24170		0.7894736842105263	0.8	19	16156	4	5	15	16151	16175	0.3053434935844076
M1	string	0	network_modules	475	TRUE	2.277886701990449e-6	282	9	6	0.6666666666666666	0.02127659574468085	GO:0042391	GO:BP	regulation of membrane potential	16175	10141		0.8421052631578947	0.85	282	15893	6	3	276	15890	16175	0.11704070138593217
M1	string	0	network_modules	475	TRUE	4.430318385098489e-6	7	9	3	0.3333333333333333	0.42857142857142855	GO:0071420	GO:BP	cellular response to histamine	16175	16671		0.8947368421052632	0.9	7	16168	3	6	4	16162	16175	0.3776605498033673
M1	string	0	network_modules	475	TRUE	2.0862545816036412e-5	11	9	3	0.3333333333333333	0.2727272727272727	GO:0034776	GO:BP	response to histamine	16175	8739		0.9473684210526315	0.95	11	16164	3	6	8	16158	16175	0.30108234664318256
M1	string	0	network_modules	475	TRUE	4.421717208908346e-4	125	9	4	0.4444444444444444	0.032	GO:0007416	GO:BP	synapse assembly	16175	2911		1	1	125	16050	4	5	121	16045	16175	0.11767150336756986
M1	string	0	network_modules	475	TRUE	0.0026020155415248597	507	8	5	0.625	0.009861932938856016	REAC:R-HSA-9006934	REAC	Signaling by Receptor Tyrosine Kinases	10916	2302		1	1	507	10409	5	3	502	10406	10916	0.07445119696981867
M1	string	0	network_modules	475	TRUE	0.002928677763019233	85	8	3	0.375	0.03529411764705882	KEGG:04742	KEGG	Taste transduction	8484	361		1	1	85	8399	3	5	82	8394	8484	0.11258935997079844
M1	string	0	network_modules	477	TRUE	0.0029768627634029956	14	5	2	0.4	0.14285714285714285	REAC:R-HSA-74259	REAC	Purine catabolism	10916	1823		NA	1	14	10902	2	3	12	10899	10916	0.23848684005241802
M1	string	0	network_modules	479	TRUE	3.632435500379014e-8	147	8	6	0.75	0.04081632653061224	REAC:R-HSA-453279	REAC	Mitotic G1 phase and G1/S transition	10916	1480		0	0.043478260869565216	147	10769	6	2	141	10767	10916	0.1730541911274455
M1	string	0	network_modules	479	TRUE	5.902840605395269e-7	157	6	5	0.8333333333333334	0.03184713375796178	KEGG:04110	KEGG	Cell cycle	8484	264		0	0.3333333333333333	157	8327	5	1	152	8326	8484	0.16084270467022246
M1	string	0	network_modules	479	TRUE	2.9727865878982063e-6	130	8	5	0.625	0.038461538461538464	REAC:R-HSA-69206	REAC	G1/S Transition	10916	1002		0.045454545454545456	0.08695652173913043	130	10786	5	3	125	10783	10916	0.1530590186858439
M1	string	0	network_modules	479	TRUE	7.661149961857396e-5	155	6	4	0.6666666666666666	0.025806451612903226	KEGG:04218	KEGG	Cellular senescence	8484	295		0.5	0.6666666666666666	155	8329	4	2	151	8327	8484	0.12879775225582407
M1	string	0	network_modules	479	TRUE	9.737007501733925e-5	22	8	3	0.375	0.13636363636363635	REAC:R-HSA-113510	REAC	E2F mediated regulation of DNA replication	10916	809		0.09090909090909091	0.13043478260869565	22	10894	3	5	19	10889	10916	0.22522772086011703
M1	string	0	network_modules	479	TRUE	1.4527282623038733e-4	25	8	3	0.375	0.12	REAC:R-HSA-69273	REAC	Cyclin A/B1/B2 associated events during G2/M transition	10916	418		0.13636363636363635	0.17391304347826086	25	10891	3	5	22	10886	10916	0.21115572744206226
M1	string	0	network_modules	479	TRUE	1.8462204605198632e-4	27	8	3	0.375	0.1111111111111111	REAC:R-HSA-69205	REAC	G1/S-Specific Transcription	10916	1003		0.18181818181818182	0.21739130434782608	27	10889	3	5	24	10884	10916	0.20310346119563677
M1	string	0	network_modules	479	TRUE	3.4716567758044436e-4	3	8	2	0.25	0.6666666666666666	REAC:R-HSA-170145	REAC	Phosphorylation of proteins involved in the G2/M transition by Cyclin A:Cdc2 complexes	10916	1752		0.22727272727272727	0.2608695652173913	3	10913	2	6	1	10907	10916	0.40800508465050417
M1	string	0	network_modules	479	TRUE	3.501865889737006e-4	656	9	6	0.6666666666666666	0.009146341463414634	GO:1903047	GO:BP	mitotic cell cycle process	16175	22727		0	0.16666666666666666	656	15519	6	3	650	15516	16175	0.07489128561274482
M1	string	0	network_modules	479	TRUE	0.0010646157528003282	792	9	6	0.6666666666666666	0.007575757575757576	GO:0000278	GO:BP	mitotic cell cycle	16175	76		0.2	0.3333333333333333	792	15383	6	3	786	15380	16175	0.06753988314898994
M1	string	0	network_modules	479	TRUE	0.0011541231779150886	49	8	3	0.375	0.061224489795918366	REAC:R-HSA-6791312	REAC	TP53 Regulates Transcription of Cell Cycle Genes	10916	2454		0.2727272727272727	0.30434782608695654	49	10867	3	5	46	10862	10916	0.1501012797687379
M1	string	0	network_modules	479	TRUE	0.0011563708061067882	5	8	2	0.25	0.4	REAC:R-HSA-69478	REAC	G2/M DNA replication checkpoint	10916	1007		0.3181818181818182	0.391304347826087	5	10911	2	6	3	10905	10916	0.31583645181620407
M1	string	0	network_modules	479	TRUE	0.0011563708061067882	5	8	2	0.25	0.4	REAC:R-HSA-68911	REAC	G2 Phase	10916	1004		0.3181818181818182	0.391304347826087	5	10911	2	6	3	10905	10916	0.31583645181620407
M1	string	0	network_modules	479	TRUE	0.0016114687407549058	102	6	3	0.5	0.029411764705882353	KEGG:04914	KEGG	Progesterone-mediated oocyte maturation	8484	371		1	1	102	8382	3	3	99	8379	8484	0.11911195314389028
M1	string	0	network_modules	479	TRUE	0.0016764051358167092	197	8	4	0.5	0.02030456852791878	REAC:R-HSA-453274	REAC	Mitotic G2-G2/M phases	10916	1481		0.4090909090909091	0.43478260869565216	197	10719	4	4	193	10715	10916	0.09804613584848108
M1	string	0	network_modules	479	TRUE	0.00173392044766401	6	8	2	0.25	0.3333333333333333	REAC:R-HSA-176417	REAC	Phosphorylation of Emi1	10916	1750		0.45454545454545453	0.4782608695652174	6	10910	2	6	4	10904	10916	0.2882252799722374
M1	string	0	network_modules	479	TRUE	0.001755672469704395	4	9	2	0.2222222222222222	0.5	GO:1905448	GO:BP	positive regulation of mitochondrial ATP synthesis coupled electron transport	16175	24642		0.4	0.5	4	16171	2	7	2	16164	16175	0.33309625079917915
M1	string	0	network_modules	479	TRUE	0.00234178476880575	465	9	5	0.5555555555555556	0.010752688172043012	GO:0044770	GO:BP	cell cycle phase transition	16175	11146		0.6	0.6666666666666666	465	15710	5	4	460	15706	16175	0.07438778494458376
M1	string	0	network_modules	479	TRUE	0.0024265988665318314	7	8	2	0.25	0.2857142857142857	REAC:R-HSA-2980767	REAC	Activation of NIMA Kinases NEK9, NEK6, NEK7	10916	88		0.5	0.5217391304347826	7	10909	2	6	5	10903	10916	0.26675898657003766
M1	string	0	network_modules	479	TRUE	0.002925276442811189	5	9	2	0.2222222222222222	0.4	GO:1905446	GO:BP	regulation of mitochondrial ATP synthesis coupled electron transport	16175	24640		0.8	0.8333333333333334	5	16170	2	7	3	16163	16175	0.2978565749868409
M1	string	0	network_modules	479	TRUE	0.004156834737373672	9	8	2	0.25	0.2222222222222222	REAC:R-HSA-113507	REAC	E2F-enabled inhibition of pre-replication complex formation	10916	810		0.5454545454545454	0.5652173913043478	9	10907	2	6	7	10901	10916	0.23510800786592262
M1	string	0	network_modules	479	TRUE	0.004362962984408936	76	8	3	0.375	0.039473684210526314	REAC:R-HSA-176409	REAC	APC/C:Cdc20 mediated degradation of mitotic proteins	10916	27		0.5909090909090909	0.6086956521739131	76	10840	3	5	73	10835	10916	0.11986899856129511
M1	string	0	network_modules	479	TRUE	0.00453827410874541	77	8	3	0.375	0.03896103896103896	REAC:R-HSA-176814	REAC	Activation of APC/C and APC/C:Cdc20 mediated degradation of mitotic proteins	10916	74		0.6363636363636364	0.6521739130434783	77	10839	3	5	74	10834	10916	0.11906393438999237
M1	string	0	network_modules	479	TRUE	0.005136107554897164	231	9	4	0.4444444444444444	0.017316017316017316	GO:0006260	GO:BP	DNA replication	16175	2077		1	1	231	15944	4	5	227	15939	16175	0.08554464411429831
M1	string	0	network_modules	479	TRUE	0.005194138758048245	10	8	2	0.25	0.2	REAC:R-HSA-2465910	REAC	MASTL Facilitates Mitotic Progression	10916	1354		0.6818181818181818	0.6956521739130435	10	10906	2	6	8	10900	10916	0.22297126089211025
M1	string	0	network_modules	479	TRUE	0.005286009297945432	81	8	3	0.375	0.037037037037037035	REAC:R-HSA-176408	REAC	Regulation of APC/C activators between G1/S and early anaphase	10916	1963		0.7272727272727273	0.7391304347826086	81	10835	3	5	78	10830	10916	0.11599265973482267
M1	string	0	network_modules	479	TRUE	0.006346064693349163	11	8	2	0.25	0.18181818181818182	REAC:R-HSA-2514853	REAC	Condensation of Prometaphase Chromosomes	10916	394		0.7727272727272727	0.782608695652174	11	10905	2	6	9	10899	10916	0.21252631092836188
M1	string	0	network_modules	479	TRUE	0.006782301729635938	88	8	3	0.375	0.03409090909090909	REAC:R-HSA-453276	REAC	Regulation of mitotic cell cycle	10916	2044		0.8181818181818182	0.8695652173913043	88	10828	3	5	85	10823	10916	0.11112549417999892
M1	string	0	network_modules	479	TRUE	0.006782301729635938	88	8	3	0.375	0.03409090909090909	REAC:R-HSA-174143	REAC	APC/C-mediated degradation of cell cycle proteins	10916	24		0.8181818181818182	0.8695652173913043	88	10828	3	5	85	10823	10916	0.11112549417999892
M1	string	0	network_modules	479	TRUE	0.00899327640400849	13	8	2	0.25	0.15384615384615385	REAC:R-HSA-162658	REAC	Golgi Cisternae Pericentriolar Stack Reorganization	10916	1083		0.9090909090909091	1	13	10903	2	6	11	10897	10916	0.1953698361491887
M1	string	0	network_modules	479	TRUE	0.00899327640400849	13	8	2	0.25	0.15384615384615385	REAC:R-HSA-4419969	REAC	Depolymerization of the Nuclear Lamina	10916	729		0.9090909090909091	1	13	10903	2	6	11	10897	10916	0.1953698361491887
M1	string	0	network_modules	479	TRUE	0.00899327640400849	13	8	2	0.25	0.15384615384615385	REAC:R-HSA-75035	REAC	Chk1/Chk2(Cds1) mediated inactivation of Cyclin B:Cdk1 complex	10916	347		0.9090909090909091	1	13	10903	2	6	11	10897	10916	0.1953698361491887
M1	string	0	network_modules	480	TRUE	2.2784420411467967e-12	26	9	6	0.6666666666666666	0.23076923076923078	REAC:R-HSA-179409	REAC	APC-Cdc20 mediated degradation of Nek2A	10916	23		0	0.02702702702702703	26	10890	6	3	20	10887	10916	0.3914586136949905
M1	string	0	network_modules	480	TRUE	1.7132470331280605e-11	88	9	7	0.7777777777777778	0.07954545454545454	REAC:R-HSA-174143	REAC	APC/C-mediated degradation of cell cycle proteins	10916	24		0.027777777777777776	0.08108108108108109	88	10828	7	2	81	10826	10916	0.2472562635858409
M1	string	0	network_modules	480	TRUE	1.7132470331280605e-11	88	9	7	0.7777777777777778	0.07954545454545454	REAC:R-HSA-453276	REAC	Regulation of mitotic cell cycle	10916	2044		0.027777777777777776	0.08108108108108109	88	10828	7	2	81	10826	10916	0.2472562635858409
M1	string	0	network_modules	480	TRUE	2.995284056239331e-10	656	9	9	1	0.013719512195121951	GO:1903047	GO:BP	mitotic cell cycle process	16175	22727		0	0.017857142857142856	656	15519	9	0	647	15519	16175	0.11476247726524128
M1	string	0	network_modules	480	TRUE	4.185832786103093e-10	20	9	5	0.5555555555555556	0.25	REAC:R-HSA-9687136	REAC	Aberrant regulation of mitotic exit in cancer due to RB1 defects	10916	49		0.08333333333333333	0.13513513513513514	20	10896	5	4	15	10892	10916	0.3719430459333364
M1	string	0	network_modules	480	TRUE	4.185832786103093e-10	20	9	5	0.5555555555555556	0.25	REAC:R-HSA-176407	REAC	Conversion from APC/C:Cdc20 to APC/C:Cdh1 in late anaphase	10916	409		0.08333333333333333	0.13513513513513514	20	10896	5	4	15	10892	10916	0.3719430459333364
M1	string	0	network_modules	480	TRUE	5.492225372621584e-10	21	9	5	0.5555555555555556	0.23809523809523808	REAC:R-HSA-141430	REAC	Inactivation of APC/C via direct inhibition of the APC/C complex	10916	1176		0.1388888888888889	0.1891891891891892	21	10895	5	4	16	10891	10916	0.3629358488729434
M1	string	0	network_modules	480	TRUE	5.492225372621584e-10	21	9	5	0.5555555555555556	0.23809523809523808	REAC:R-HSA-141405	REAC	Inhibition of the proteolytic activity of APC/C required for the onset of anaphase by mitotic spindle checkpoint components	10916	1199		0.1388888888888889	0.1891891891891892	21	10895	5	4	16	10891	10916	0.3629358488729434
M1	string	0	network_modules	480	TRUE	6.154586923318139e-10	24	9	5	0.5555555555555556	0.20833333333333334	GO:0031145	GO:BP	anaphase-promoting complex-dependent catabolic process	16175	7063		0.01818181818181818	0.03571428571428571	24	16151	5	4	19	16147	16175	0.33964479383996143
M1	string	0	network_modules	480	TRUE	1.647992675326019e-9	792	9	9	1	0.011363636363636364	GO:0000278	GO:BP	mitotic cell cycle	16175	76		0.03636363636363636	0.05357142857142857	792	15383	9	0	783	15383	16175	0.10398672407562344
M1	string	0	network_modules	480	TRUE	1.812617127172811e-9	74	9	6	0.6666666666666666	0.08108108108108109	REAC:R-HSA-179419	REAC	APC:Cdc20 mediated degradation of cell cycle proteins prior to satisfation of the cell cycle checkpoint	10916	29		0.19444444444444445	0.21621621621621623	74	10842	6	3	68	10839	10916	0.2310104089754702
M1	string	0	network_modules	480	TRUE	2.1380999188816857e-9	76	9	6	0.6666666666666666	0.07894736842105263	REAC:R-HSA-176409	REAC	APC/C:Cdc20 mediated degradation of mitotic proteins	10916	27		0.2222222222222222	0.24324324324324326	76	10840	6	3	70	10837	10916	0.2279082649066528
M1	string	0	network_modules	480	TRUE	2.31823499922103e-9	77	9	6	0.6666666666666666	0.07792207792207792	REAC:R-HSA-176814	REAC	Activation of APC/C and APC/C:Cdc20 mediated degradation of mitotic proteins	10916	74		0.25	0.2702702702702703	77	10839	6	3	71	10836	10916	0.22640250597908024
M1	string	0	network_modules	480	TRUE	2.4567626462339022e-9	31	9	5	0.5555555555555556	0.16129032258064516	GO:0070979	GO:BP	protein K11-linked ubiquitination	16175	16411		0.05454545454545454	0.07142857142857142	31	16144	5	4	26	16140	16175	0.298678887398768
M1	string	0	network_modules	480	TRUE	3.170254148576165e-9	81	9	6	0.6666666666666666	0.07407407407407407	REAC:R-HSA-176408	REAC	Regulation of APC/C activators between G1/S and early anaphase	10916	1963		0.2777777777777778	0.2972972972972973	81	10835	6	3	75	10832	10916	0.22065963857259144
M1	string	0	network_modules	480	TRUE	5.9165861523719674e-9	9	9	4	0.4444444444444444	0.4444444444444444	GO:1904668	GO:BP	positive regulation of ubiquitin protein ligase activity	16175	24008		0.07272727272727272	0.08928571428571429	9	16166	4	5	5	16161	16175	0.44413515333965653
M1	string	0	network_modules	480	TRUE	1.0128467497388384e-8	36	9	5	0.5555555555555556	0.1388888888888889	REAC:R-HSA-9687139	REAC	Aberrant regulation of mitotic cell cycle due to RB1 defects	10916	48		0.3055555555555556	0.32432432432432434	36	10880	5	4	31	10876	10916	0.27669936538628215
M1	string	0	network_modules	480	TRUE	1.3477184072191658e-8	38	9	5	0.5555555555555556	0.13157894736842105	REAC:R-HSA-9675126	REAC	Diseases of mitotic cell cycle	10916	769		0.3333333333333333	0.35135135135135137	38	10878	5	4	33	10874	10916	0.26925478494797583
M1	string	0	network_modules	480	TRUE	1.4901055036345633e-8	277	9	7	0.7777777777777778	0.02527075812274368	GO:0098813	GO:BP	nuclear chromosome segregation	16175	18900		0.09090909090909091	0.10714285714285714	277	15898	7	2	270	15896	16175	0.13833735611490441
M1	string	0	network_modules	480	TRUE	1.5454389207829485e-8	39	9	5	0.5555555555555556	0.1282051282051282	REAC:R-HSA-8853884	REAC	Transcriptional Regulation by VENTX	10916	2547		0.3611111111111111	0.3783783783783784	39	10877	5	4	34	10873	10916	0.2657484969762152
M1	string	0	network_modules	480	TRUE	4.691864307795316e-8	630	9	8	0.8888888888888888	0.012698412698412698	GO:0010564	GO:BP	regulation of cell cycle process	16175	4217		0.10909090909090909	0.125	630	15545	8	1	622	15544	16175	0.10365418304124352
M1	string	0	network_modules	480	TRUE	9.59759392290549e-8	361	9	7	0.7777777777777778	0.019390581717451522	GO:0007059	GO:BP	chromosome segregation	16175	2658		0.12727272727272726	0.14285714285714285	361	15814	7	2	354	15812	16175	0.12067044367435908
M1	string	0	network_modules	480	TRUE	1.1408134204407995e-7	370	9	7	0.7777777777777778	0.01891891891891892	GO:0044772	GO:BP	mitotic cell cycle phase transition	16175	11148		0.14545454545454545	0.16071428571428573	370	15805	7	2	363	15803	16175	0.11913991317961255
M1	string	0	network_modules	480	TRUE	1.3503231084001284e-7	379	9	7	0.7777777777777778	0.018469656992084433	GO:0000280	GO:BP	nuclear division	16175	78		0.16363636363636364	0.17857142857142858	379	15796	7	2	372	15794	16175	0.11766356473661538
M1	string	0	network_modules	480	TRUE	1.8155558245074412e-7	19	9	4	0.4444444444444444	0.21052631578947367	GO:1904666	GO:BP	regulation of ubiquitin protein ligase activity	16175	24006		0.18181818181818182	0.19642857142857142	19	16156	4	5	15	16151	16175	0.3053434935844076
M1	string	0	network_modules	480	TRUE	2.0309373650154308e-7	64	9	5	0.5555555555555556	0.078125	REAC:R-HSA-174084	REAC	Autodegradation of Cdh1 by Cdh1:APC/C	10916	190		0.3888888888888889	0.40540540540540543	64	10852	5	4	59	10848	10916	0.20682695483254027
M1	string	0	network_modules	480	TRUE	2.802044179603995e-7	21	9	4	0.4444444444444444	0.19047619047619047	GO:0051443	GO:BP	positive regulation of ubiquitin-protein transferase activity	16175	13706		0.2	0.21428571428571427	21	16154	4	5	17	16149	16175	0.29037655295651454
M1	string	0	network_modules	480	TRUE	2.8510765573272157e-7	20	9	4	0.4444444444444444	0.2	REAC:R-HSA-176412	REAC	Phosphorylation of the APC/C	10916	1753		0.4166666666666667	0.43243243243243246	20	10896	4	5	16	10891	10916	0.29730829796627206
M1	string	0	network_modules	480	TRUE	2.9644585528043025e-7	424	9	7	0.7777777777777778	0.01650943396226415	GO:0048285	GO:BP	organelle fission	16175	12627		0.21818181818181817	0.23214285714285715	424	15751	7	2	417	15749	16175	0.11099246908137986
M1	string	0	network_modules	480	TRUE	3.1144972507306105e-7	427	9	7	0.7777777777777778	0.01639344262295082	GO:0007346	GO:BP	regulation of mitotic cell cycle	16175	2855		0.23636363636363636	0.25	427	15748	7	2	420	15746	16175	0.11058511590556214
M1	string	0	network_modules	480	TRUE	3.9899229554060604e-7	73	9	5	0.5555555555555556	0.0684931506849315	REAC:R-HSA-174184	REAC	Cdc20:Phospho-APC/C mediated degradation of Cyclin A	10916	319		0.4444444444444444	0.4864864864864865	73	10843	5	4	68	10839	10916	0.1934478805566764
M1	string	0	network_modules	480	TRUE	3.9899229554060604e-7	73	9	5	0.5555555555555556	0.0684931506849315	REAC:R-HSA-69017	REAC	CDK-mediated phosphorylation and removal of Cdc6	10916	272		0.4444444444444444	0.4864864864864865	73	10843	5	4	68	10839	10916	0.1934478805566764
M1	string	0	network_modules	480	TRUE	4.277734316575222e-7	74	9	5	0.5555555555555556	0.06756756756756757	REAC:R-HSA-174178	REAC	APC/C:Cdh1 mediated degradation of Cdc20 and other APC/C:Cdh1 targeted proteins in late mitosis/early G1	10916	28		0.5	0.5135135135135135	74	10842	5	4	69	10838	10916	0.1921131449869428
M1	string	0	network_modules	480	TRUE	5.655839014009307e-7	465	9	7	0.7777777777777778	0.015053763440860216	GO:0044770	GO:BP	cell cycle phase transition	16175	11146		0.2545454545454545	0.26785714285714285	465	15710	7	2	458	15708	16175	0.10576664585157664
M1	string	0	network_modules	480	TRUE	6.243776024225215e-7	24	9	4	0.4444444444444444	0.16666666666666666	REAC:R-HSA-174048	REAC	APC/C:Cdc20 mediated degradation of Cyclin B	10916	25		0.5277777777777778	0.5405405405405406	24	10892	4	5	20	10887	10916	0.27122919894403336
M1	string	0	network_modules	480	TRUE	1.1312072418351209e-6	140	7	5	0.7142857142857143	0.03571428571428571	KEGG:04120	KEGG	Ubiquitin mediated proteolysis	8484	270		0	0.25	140	8344	5	2	135	8342	8484	0.15739773179662034
M1	string	0	network_modules	480	TRUE	1.1581161457339733e-6	252	9	6	0.6666666666666666	0.023809523809523808	GO:0140014	GO:BP	mitotic nuclear division	16175	19633		0.2727272727272727	0.2857142857142857	252	15923	6	3	246	15920	16175	0.12404824050496156
M1	string	0	network_modules	480	TRUE	1.2987130224836145e-6	92	9	5	0.5555555555555556	0.05434782608695652	REAC:R-HSA-69052	REAC	Switching of origins to a post-replicative state	10916	2365		0.5555555555555556	0.5675675675675675	92	10824	5	4	87	10820	10916	0.17192257661281016
M1	string	0	network_modules	480	TRUE	3.0692132288633124e-6	109	9	5	0.5555555555555556	0.045871559633027525	REAC:R-HSA-69618	REAC	Mitotic Spindle Checkpoint	10916	1486		0.5833333333333334	0.5945945945945946	109	10807	5	4	104	10803	10916	0.15762204258345733
M1	string	0	network_modules	480	TRUE	3.3649623986008616e-6	111	9	5	0.5555555555555556	0.04504504504504504	REAC:R-HSA-2559582	REAC	Senescence-Associated Secretory Phenotype (SASP)	10916	2194		0.6111111111111112	0.6216216216216216	111	10805	5	4	106	10801	10916	0.15615756504157785
M1	string	0	network_modules	480	TRUE	3.8336819279939385e-6	39	9	4	0.4444444444444444	0.10256410256410256	GO:0051438	GO:BP	regulation of ubiquitin-protein transferase activity	16175	13705		0.2909090909090909	0.30357142857142855	39	16136	4	5	35	16131	16175	0.21266156921336687
M1	string	0	network_modules	480	TRUE	5.203249808358001e-6	121	9	5	0.5555555555555556	0.04132231404958678	REAC:R-HSA-69239	REAC	Synthesis of DNA	10916	2376		0.6388888888888888	0.6486486486486487	121	10795	5	4	116	10791	10916	0.14938355731518277
M1	string	0	network_modules	480	TRUE	1.1652288777257964e-5	142	9	5	0.5555555555555556	0.035211267605633804	REAC:R-HSA-68867	REAC	Assembly of the pre-replicative complex	10916	181		0.6666666666666666	0.6756756756756757	142	10774	5	4	137	10770	10916	0.1375425069560649
M1	string	0	network_modules	480	TRUE	2.0559526391461247e-5	159	9	5	0.5555555555555556	0.031446540880503145	REAC:R-HSA-69002	REAC	DNA Replication Pre-Initiation	10916	446		0.6944444444444444	0.7027027027027027	159	10757	5	4	154	10753	10916	0.12971106940999633
M1	string	0	network_modules	480	TRUE	2.2579565784225838e-5	162	9	5	0.5555555555555556	0.030864197530864196	REAC:R-HSA-69242	REAC	S Phase	10916	2111		0.7222222222222222	0.7297297297297297	162	10754	5	4	157	10750	10916	0.12845706141643173
M1	string	0	network_modules	480	TRUE	4.630615080087608e-5	187	9	5	0.5555555555555556	0.026737967914438502	REAC:R-HSA-69306	REAC	DNA Replication	10916	445		0.75	0.7567567567567568	187	10729	5	4	182	10725	10916	0.1191946341463443
M1	string	0	network_modules	480	TRUE	4.708509383656631e-5	68	9	4	0.4444444444444444	0.058823529411764705	REAC:R-HSA-174154	REAC	APC/C:Cdc20 mediated degradation of Securin	10916	26		0.7777777777777778	0.7837837837837838	68	10848	4	5	64	10843	10916	0.15998900066959645
M1	string	0	network_modules	480	TRUE	4.755662628992484e-5	188	9	5	0.5555555555555556	0.026595744680851064	REAC:R-HSA-2467813	REAC	Separation of Sister Chromatids	10916	2204		0.8055555555555556	0.8108108108108109	188	10728	5	4	183	10724	10916	0.1188625179009049
M1	string	0	network_modules	480	TRUE	5.3254773468324445e-5	217	9	5	0.5555555555555556	0.02304147465437788	GO:0000819	GO:BP	sister chromatid segregation	16175	237		0.3090909090909091	0.32142857142857145	217	15958	5	4	212	15954	16175	0.11118762230306863
M1	string	0	network_modules	480	TRUE	5.415694289792343e-5	406	9	6	0.6666666666666666	0.014778325123152709	REAC:R-HSA-68886	REAC	M Phase	10916	1343		0.8333333333333334	0.8378378378378378	406	10510	6	3	400	10507	10916	0.09555320099694864
M1	string	0	network_modules	480	TRUE	5.563520622534612e-5	194	9	5	0.5555555555555556	0.02577319587628866	REAC:R-HSA-2559583	REAC	Cellular Senescence	10916	331		0.8611111111111112	0.8648648648648649	194	10722	5	4	189	10718	10916	0.11692323267568039
M1	string	0	network_modules	480	TRUE	6.969711813751842e-5	229	9	5	0.5555555555555556	0.021834061135371178	GO:0033044	GO:BP	regulation of chromosome organization	16175	7999		0.32727272727272727	0.3392857142857143	229	15946	5	4	224	15942	16175	0.1081277601039117
M1	string	0	network_modules	480	TRUE	1.0376413920374222e-4	248	9	5	0.5555555555555556	0.020161290322580645	GO:0000209	GO:BP	protein polyubiquitination	16175	59		0.34545454545454546	0.35714285714285715	248	15927	5	4	243	15923	16175	0.10373963122091401
M1	string	0	network_modules	480	TRUE	1.1671474973959775e-4	545	9	6	0.6666666666666666	0.011009174311926606	GO:0051276	GO:BP	chromosome organization	16175	13613		0.36363636363636365	0.375	545	15630	6	3	539	15627	16175	0.08276972118944169
M1	string	0	network_modules	480	TRUE	1.175994076917455e-4	90	9	4	0.4444444444444444	0.044444444444444446	GO:0007091	GO:BP	metaphase/anaphase transition of mitotic cell cycle	16175	2675		0.38181818181818183	0.39285714285714285	90	16085	4	5	86	16080	16175	0.13921260455455817
M1	string	0	network_modules	480	TRUE	1.1928137953369729e-4	547	9	6	0.6666666666666666	0.010968921389396709	GO:0006511	GO:BP	ubiquitin-dependent protein catabolic process	16175	2235		0.4	0.4107142857142857	547	15628	6	3	541	15625	16175	0.0826074132061521
M1	string	0	network_modules	480	TRUE	1.2440127878941763e-4	228	9	5	0.5555555555555556	0.021929824561403508	REAC:R-HSA-68882	REAC	Mitotic Anaphase	10916	1479		0.8888888888888888	0.8918918918918919	228	10688	5	4	223	10684	10916	0.10739926470461636
M1	string	0	network_modules	480	TRUE	1.2713862663755248e-4	229	9	5	0.5555555555555556	0.021834061135371178	REAC:R-HSA-2555396	REAC	Mitotic Metaphase and Anaphase	10916	1482		0.9166666666666666	0.918918918918919	229	10687	5	4	224	10683	10916	0.10715116346891732
M1	string	0	network_modules	480	TRUE	1.2853363316840414e-4	92	9	4	0.4444444444444444	0.043478260869565216	GO:0044784	GO:BP	metaphase/anaphase transition of cell cycle	16175	11156		0.41818181818181815	0.42857142857142855	92	16083	4	5	88	16078	16175	0.13766087594654178
M1	string	0	network_modules	480	TRUE	1.3002028908444362e-4	555	9	6	0.6666666666666666	0.010810810810810811	GO:0019941	GO:BP	modification-dependent protein catabolic process	16175	6072		0.43636363636363634	0.44642857142857145	555	15620	6	3	549	15617	16175	0.08196677236556676
M1	string	0	network_modules	480	TRUE	1.356826735909136e-4	559	9	6	0.6666666666666666	0.01073345259391771	GO:0043632	GO:BP	modification-dependent macromolecule catabolic process	16175	10812		0.45454545454545453	0.4642857142857143	559	15616	6	3	553	15613	16175	0.08165149921344338
M1	string	0	network_modules	480	TRUE	1.402101346026469e-4	94	9	4	0.4444444444444444	0.0425531914893617	GO:0031398	GO:BP	positive regulation of protein ubiquitination	16175	7154		0.4727272727272727	0.48214285714285715	94	16081	4	5	90	16076	16175	0.1361586112577331
M1	string	0	network_modules	480	TRUE	1.7286393127760076e-4	99	9	4	0.4444444444444444	0.04040404040404041	GO:0033045	GO:BP	regulation of sister chromatid segregation	16175	8000		0.4909090909090909	0.5	99	16076	4	5	95	16071	16175	0.13260283233684927
M1	string	0	network_modules	480	TRUE	1.8367456209683025e-4	157	7	4	0.5714285714285714	0.025477707006369428	KEGG:04110	KEGG	Cell cycle	8484	264		0.3333333333333333	0.5	157	8327	4	3	153	8324	8484	0.11789604949640874
M1	string	0	network_modules	480	TRUE	1.8688612840407618e-4	590	9	6	0.6666666666666666	0.010169491525423728	GO:0016567	GO:BP	protein ubiquitination	16175	5254		0.509090909090909	0.5178571428571429	590	15585	6	3	584	15582	16175	0.07931526593628639
M1	string	0	network_modules	480	TRUE	2.1111916832647253e-4	286	9	5	0.5555555555555556	0.017482517482517484	GO:1901990	GO:BP	regulation of mitotic cell cycle phase transition	16175	21923		0.5272727272727272	0.5357142857142857	286	15889	5	4	281	15885	16175	0.09629715743913644
M1	string	0	network_modules	480	TRUE	2.2772502488135974e-4	106	9	4	0.4444444444444444	0.03773584905660377	GO:0007088	GO:BP	regulation of mitotic nuclear division	16175	2673		0.5454545454545454	0.5535714285714286	106	16069	4	5	102	16064	16175	0.1280510188849405
M1	string	0	network_modules	480	TRUE	2.722281664738328e-4	301	9	5	0.5555555555555556	0.016611295681063124	GO:0051347	GO:BP	positive regulation of transferase activity	16175	13674		0.5636363636363636	0.5714285714285714	301	15874	5	4	296	15870	16175	0.09374948929790104
M1	string	0	network_modules	480	TRUE	3.1620810752836133e-4	115	9	4	0.4444444444444444	0.034782608695652174	GO:1903322	GO:BP	positive regulation of protein modification by small protein conjugation or removal	16175	22906		0.5818181818181818	0.5892857142857143	115	16060	4	5	111	16055	16175	0.12281644175243686
M1	string	0	network_modules	480	TRUE	3.274198729396695e-4	116	9	4	0.4444444444444444	0.034482758620689655	GO:1901875	GO:BP	positive regulation of post-translational protein modification	16175	21819		0.6	0.6071428571428571	116	16059	4	5	112	16054	16175	0.12227243454030894
M1	string	0	network_modules	480	TRUE	3.6283979127594277e-4	119	9	4	0.4444444444444444	0.03361344537815126	GO:0051783	GO:BP	regulation of nuclear division	16175	13933		0.6181818181818182	0.625	119	16056	4	5	115	16051	16175	0.12068141550366032
M1	string	0	network_modules	480	TRUE	3.863760953836058e-4	667	9	6	0.6666666666666666	0.008995502248875561	GO:0032446	GO:BP	protein modification by small protein conjugation	16175	7568		0.6363636363636364	0.6428571428571429	667	15508	6	3	661	15505	16175	0.07421681030559948
M1	string	0	network_modules	480	TRUE	4.0315165910308047e-4	289	9	5	0.5555555555555556	0.01730103806228374	REAC:R-HSA-69620	REAC	Cell Cycle Checkpoints	10916	321		0.9444444444444444	0.9459459459459459	289	10627	5	4	284	10623	10916	0.09466724687626941
M1	string	0	network_modules	480	TRUE	4.073843239242887e-4	673	9	6	0.6666666666666666	0.008915304606240713	GO:0051603	GO:BP	proteolysis involved in protein catabolic process	16175	13820		0.6545454545454545	0.6607142857142857	673	15502	6	3	667	15499	16175	0.0738557042030134
M1	string	0	network_modules	480	TRUE	4.2812865169272485e-4	124	9	4	0.4444444444444444	0.03225806451612903	GO:0051983	GO:BP	regulation of chromosome segregation	16175	14045		0.6727272727272727	0.6785714285714286	124	16051	4	5	120	16046	16175	0.11815807678871545
M1	string	0	network_modules	480	TRUE	5.521988394120251e-4	308	9	5	0.5555555555555556	0.016233766233766232	REAC:R-HSA-983168	REAC	Antigen processing: Ubiquitination & Proteasome degradation	10916	154		0.9722222222222222	0.972972972972973	308	10608	5	4	303	10604	10916	0.09148097865578912
M1	string	0	network_modules	480	TRUE	6.782059930782722e-4	218	7	4	0.5714285714285714	0.01834862385321101	KEGG:05166	KEGG	Human T-cell leukemia virus 1 infection	8484	447		0.6666666666666666	0.75	218	8266	4	3	214	8263	8484	0.09911353640074388
M1	string	0	network_modules	480	TRUE	6.894185389577263e-4	363	9	5	0.5555555555555556	0.013774104683195593	GO:0043161	GO:BP	proteasome-mediated ubiquitin-dependent protein catabolic process	16175	10561		0.6909090909090909	0.6964285714285714	363	15812	5	4	358	15808	16175	0.0849253282715036
M1	string	0	network_modules	480	TRUE	7.662104433793159e-4	749	9	6	0.6666666666666666	0.00801068090787717	GO:0070647	GO:BP	protein modification by small protein conjugation or removal	16175	16231		0.7090909090909091	0.7142857142857143	749	15426	6	3	743	15423	16175	0.0696531752172598
M1	string	0	network_modules	480	TRUE	8.205817691308359e-4	376	9	5	0.5555555555555556	0.013297872340425532	GO:1901987	GO:BP	regulation of cell cycle phase transition	16175	21920		0.7272727272727273	0.7321428571428571	376	15799	5	4	371	15795	16175	0.08335276317370233
M1	string	0	network_modules	480	TRUE	0.0011129856918783644	798	9	6	0.6666666666666666	0.007518796992481203	GO:0043687	GO:BP	post-translational protein modification	16175	10838		0.7454545454545455	0.75	798	15377	6	3	792	15374	16175	0.06725820642904572
M1	string	0	network_modules	480	TRUE	0.0014453235927366927	168	9	4	0.4444444444444444	0.023809523809523808	GO:0031396	GO:BP	regulation of protein ubiquitination	16175	7152		0.7636363636363637	0.7678571428571429	168	16007	4	5	164	16002	16175	0.10101885790880767
M1	string	0	network_modules	480	TRUE	0.0015529965976854372	380	9	5	0.5555555555555556	0.013157894736842105	REAC:R-HSA-983169	REAC	Class I MHC mediated antigen processing & presentation	10916	368		1	1	380	10536	5	4	375	10532	10916	0.0816069121391877
M1	string	0	network_modules	480	TRUE	0.0018205784896406219	178	9	4	0.4444444444444444	0.02247191011235955	GO:0000070	GO:BP	mitotic sister chromatid segregation	16175	24		0.7818181818181819	0.7857142857142857	178	15997	4	5	174	15992	16175	0.09803107796660503
M1	string	0	network_modules	480	TRUE	0.002451443220108132	50	9	3	0.3333333333333333	0.06	GO:0051445	GO:BP	regulation of meiotic cell cycle	16175	13708		0.8	0.8035714285714286	50	16125	3	6	47	16119	16175	0.140365988076645
M1	string	0	network_modules	480	TRUE	0.002468390632814507	470	9	5	0.5555555555555556	0.010638297872340425	GO:0010498	GO:BP	proteasomal protein catabolic process	16175	4177		0.8181818181818182	0.8214285714285714	470	15705	5	4	465	15701	16175	0.0739594013635256
M1	string	0	network_modules	480	TRUE	0.002768277736780933	102	7	3	0.42857142857142855	0.029411764705882353	KEGG:04914	KEGG	Progesterone-mediated oocyte maturation	8484	371		1	1	102	8382	3	4	99	8378	8484	0.10982989274011107
M1	string	0	network_modules	480	TRUE	0.003073492900968457	203	9	4	0.4444444444444444	0.019704433497536946	GO:0051321	GO:BP	meiotic cell cycle	16175	13648		0.8363636363636363	0.8392857142857143	203	15972	4	5	199	15967	16175	0.09154064573277686
M1	string	0	network_modules	480	TRUE	0.0032582248569193845	206	9	4	0.4444444444444444	0.019417475728155338	GO:1903320	GO:BP	regulation of protein modification by small protein conjugation or removal	16175	22904		0.8545454545454545	0.8571428571428571	206	15969	4	5	202	15964	16175	0.09084115104199901
M1	string	0	network_modules	480	TRUE	0.0034510871318226507	209	9	4	0.4444444444444444	0.019138755980861243	GO:1901873	GO:BP	regulation of post-translational protein modification	16175	21817		0.8727272727272727	0.875	209	15966	4	5	205	15961	16175	0.09015654728243233
M1	string	0	network_modules	480	TRUE	0.0034612479043194264	56	9	3	0.3333333333333333	0.05357142857142857	GO:0010965	GO:BP	regulation of mitotic sister chromatid separation	16175	4541		0.8909090909090909	0.8928571428571429	56	16119	3	6	53	16113	16175	0.13250906713809857
M1	string	0	network_modules	480	TRUE	0.0037600081997200157	512	9	5	0.5555555555555556	0.009765625	GO:0051338	GO:BP	regulation of transferase activity	16175	13665		0.9090909090909091	0.9107142857142857	512	15663	5	4	507	15659	16175	0.07060600955466852
M1	string	0	network_modules	480	TRUE	0.0038506760167845953	58	9	3	0.3333333333333333	0.05172413793103448	GO:0051306	GO:BP	mitotic sister chromatid separation	16175	13637		0.9272727272727272	0.9285714285714286	58	16117	3	6	55	16111	16175	0.13016365594100812
M1	string	0	network_modules	480	TRUE	0.006756284723541064	577	9	5	0.5555555555555556	0.008665511265164644	GO:0043085	GO:BP	positive regulation of catalytic activity	16175	10518		0.9454545454545454	0.9464285714285714	577	15598	5	4	572	15594	16175	0.06613748771003279
M1	string	0	network_modules	480	TRUE	0.006808462970229872	70	9	3	0.3333333333333333	0.04285714285714286	GO:1905818	GO:BP	regulation of chromosome separation	16175	24928		0.9636363636363636	0.9642857142857143	70	16105	3	6	67	16099	16175	0.11826010249410746
M1	string	0	network_modules	480	TRUE	0.008460087025460623	262	9	4	0.4444444444444444	0.015267175572519083	GO:0010948	GO:BP	negative regulation of cell cycle process	16175	4526		0.9818181818181818	0.9821428571428571	262	15913	4	5	258	15908	16175	0.08004450288914673
M1	string	0	network_modules	480	TRUE	0.0087291684934094	76	9	3	0.3333333333333333	0.039473684210526314	GO:0051304	GO:BP	chromosome separation	16175	13635		1	1	76	16099	3	6	73	16093	16175	0.11338913980803081
M1	string	0	network_modules	481	TRUE	9.83036994847994e-5	97	8	4	0.5	0.041237113402061855	REAC:R-HSA-5607764	REAC	CLEC7A (Dectin-1) signaling	10916	275		0	0.09090909090909091	97	10819	4	4	93	10815	10916	0.1417225012488543
M1	string	0	network_modules	481	TRUE	1.9499940793882807e-4	102	9	4	0.4444444444444444	0.0392156862745098	GO:0038061	GO:BP	non-canonical NF-kappaB signal transduction	16175	9680		0	0.5	102	16073	4	5	98	16068	16175	0.13059514533076733
M1	string	0	network_modules	481	TRUE	3.823850656985968e-4	136	8	4	0.5	0.029411764705882353	REAC:R-HSA-5621481	REAC	C-type lectin receptors (CLRs)	10916	261		0.1	0.18181818181818182	136	10780	4	4	132	10776	10916	0.11903329742635485
M1	string	0	network_modules	481	TRUE	4.5376428812647434e-4	140	9	4	0.4444444444444444	0.02857142857142857	KEGG:04120	KEGG	Ubiquitin mediated proteolysis	8484	270		0	0.5	140	8344	4	5	136	8339	8484	0.10946785636741112
M1	string	0	network_modules	481	TRUE	7.586152955972954e-4	143	9	4	0.4444444444444444	0.027972027972027972	GO:0043433	GO:BP	negative regulation of DNA-binding transcription factor activity	16175	10690		1	1	143	16032	4	5	139	16027	16175	0.10979786284549624
M1	string	0	network_modules	481	TRUE	0.0024265988665318314	7	8	2	0.25	0.2857142857142857	REAC:R-HSA-5603029	REAC	IkBA variant leads to EDA-ID	10916	1167		0.2	0.2727272727272727	7	10909	2	6	5	10903	10916	0.26675898657003766
M1	string	0	network_modules	481	TRUE	0.002982325231395592	67	8	3	0.375	0.04477611940298507	REAC:R-HSA-1169091	REAC	Activation of NF-kappaB in B cells	10916	87		0.3	0.36363636363636365	67	10849	3	5	64	10844	10916	0.1278992142338518
M1	string	0	network_modules	481	TRUE	0.005091987713643295	80	8	3	0.375	0.0375	REAC:R-HSA-1168372	REAC	Downstream signaling events of B Cell Receptor (BCR)	10916	791		0.4	0.45454545454545453	80	10836	3	5	77	10831	10916	0.11673906336323314
M1	string	0	network_modules	481	TRUE	0.007612486045548108	12	8	2	0.25	0.16666666666666666	REAC:R-HSA-4755510	REAC	SUMOylation of immune response proteins	10916	2174		0.5	0.5454545454545454	12	10904	2	6	10	10898	10916	0.20341291469682457
M1	string	0	network_modules	481	TRUE	0.007701604223847101	104	9	3	0.3333333333333333	0.028846153846153848	KEGG:04625	KEGG	C-type lectin receptor signaling pathway	8484	330		1	1	104	8380	3	6	101	8374	8484	0.09508671098271247
M1	string	0	network_modules	481	TRUE	0.0085341775517774	95	8	3	0.375	0.031578947368421054	REAC:R-HSA-168142	REAC	Toll Like Receptor 10 (TLR10) Cascade	10916	2513		0.6	0.8181818181818182	95	10821	3	5	92	10816	10916	0.10680068250748154
M1	string	0	network_modules	481	TRUE	0.0085341775517774	95	8	3	0.375	0.031578947368421054	REAC:R-HSA-975871	REAC	MyD88 cascade initiated on plasma membrane	10916	1497		0.6	0.8181818181818182	95	10821	3	5	92	10816	10916	0.10680068250748154
M1	string	0	network_modules	481	TRUE	0.0085341775517774	95	8	3	0.375	0.031578947368421054	REAC:R-HSA-168176	REAC	Toll Like Receptor 5 (TLR5) Cascade	10916	2517		0.6	0.8181818181818182	95	10821	3	5	92	10816	10916	0.10680068250748154
M1	string	0	network_modules	481	TRUE	0.009367990167315597	98	8	3	0.375	0.030612244897959183	REAC:R-HSA-202424	REAC	Downstream TCR signaling	10916	789		0.9	0.9090909090909091	98	10818	3	5	95	10813	10916	0.1050889462915353
M1	string	0	network_modules	481	TRUE	0.009798598474769852	308	8	4	0.5	0.012987012987012988	REAC:R-HSA-983168	REAC	Antigen processing: Ubiquitination & Proteasome degradation	10916	154		1	1	308	10608	4	4	304	10604	10916	0.0771591694357087
M1	string	0	network_modules	482	TRUE	7.48141571231875e-7	99	8	5	0.625	0.050505050505050504	REAC:R-HSA-6811434	REAC	COPI-dependent Golgi-to-ER retrograde traffic	10916	277		0	0.14285714285714285	99	10817	5	3	94	10814	10916	0.17595306075661316
M1	string	0	network_modules	482	TRUE	8.706390560869435e-7	102	8	5	0.625	0.049019607843137254	REAC:R-HSA-6807878	REAC	COPI-mediated anterograde transport	10916	279		0.16666666666666666	0.2857142857142857	102	10814	5	3	97	10811	10916	0.1732928905160806
M1	string	0	network_modules	482	TRUE	2.1642432989139283e-6	34	9	4	0.4444444444444444	0.11764705882352941	GO:0006891	GO:BP	intra-Golgi vesicle-mediated transport	16175	2546		0	0.3333333333333333	34	16141	4	5	30	16136	16175	0.2278862826038497
M1	string	0	network_modules	482	TRUE	3.335608512924187e-6	133	8	5	0.625	0.03759398496240601	REAC:R-HSA-8856688	REAC	Golgi-to-ER retrograde transport	10916	1084		0.3333333333333333	0.42857142857142855	133	10783	5	3	128	10780	10916	0.15127615025298494
M1	string	0	network_modules	482	TRUE	3.4625205721621454e-6	126	9	5	0.5555555555555556	0.03968253968253968	GO:0006888	GO:BP	endoplasmic reticulum to Golgi vesicle-mediated transport	16175	2544		0.5	0.6666666666666666	126	16049	5	4	121	16045	16175	0.14701101451496995
M1	string	0	network_modules	482	TRUE	7.2127030186412905e-6	155	8	5	0.625	0.03225806451612903	REAC:R-HSA-199977	REAC	ER to Golgi Anterograde Transport	10916	823		0.5	0.5714285714285714	155	10761	5	3	150	10758	10916	0.13981162660596888
M1	string	0	network_modules	482	TRUE	1.801509085747821e-5	186	8	5	0.625	0.026881720430107527	REAC:R-HSA-948021	REAC	Transport to the Golgi and subsequent modification	10916	2604		0.6666666666666666	0.7142857142857143	186	10730	5	3	181	10727	10916	0.12721994236756454
M1	string	0	network_modules	482	TRUE	2.7232841911407946e-5	202	8	5	0.625	0.024752475247524754	REAC:R-HSA-6811442	REAC	Intra-Golgi and retrograde Golgi-to-ER traffic	10916	1262		0.8333333333333334	0.8571428571428571	202	10714	5	3	197	10711	10916	0.12187418178031648
M1	string	0	network_modules	482	TRUE	2.0387434659980378e-4	284	9	5	0.5555555555555556	0.017605633802816902	GO:0048193	GO:BP	Golgi vesicle transport	16175	12570		1	1	284	15891	5	4	279	15887	16175	0.09665176912852642
M1	string	0	network_modules	482	TRUE	2.122022734955644e-4	305	8	5	0.625	0.01639344262295082	REAC:R-HSA-446203	REAC	Asparagine N-linked glycosylation	10916	169		1	1	305	10611	5	3	300	10608	10916	0.09811273713364069
M1	string	0	network_modules	486	TRUE	5.330106017367935e-15	44	8	7	0.875	0.1590909090909091	GO:0048013	GO:BP	ephrin receptor signaling pathway	16175	12469		0	0.023809523809523808	44	16131	7	1	37	16130	16175	0.3725403957812859
M1	string	0	network_modules	486	TRUE	3.998389569379891e-12	90	8	7	0.875	0.07777777777777778	REAC:R-HSA-2682334	REAC	EPH-Ephrin signaling	10916	818		0	0.25	90	10826	7	1	83	10825	10916	0.25958354344179674
M1	string	0	network_modules	486	TRUE	1.7581055486115506e-11	181	9	8	0.8888888888888888	0.04419889502762431	KEGG:04360	KEGG	Axon guidance	8484	305		NA	1	181	8303	8	1	173	8302	8484	0.19565550775376303
M1	string	0	network_modules	486	TRUE	4.08193968405533e-11	49	8	6	0.75	0.12244897959183673	REAC:R-HSA-3928665	REAC	EPH-ephrin mediated repulsion of cells	10916	819		0.3333333333333333	0.5	49	10867	6	2	43	10865	10916	0.30202106929360595
M1	string	0	network_modules	486	TRUE	6.595976573953255e-11	17	8	5	0.625	0.29411764705882354	REAC:R-HSA-3928664	REAC	Ephrin signaling	10916	849		0.6666666666666666	0.75	17	10899	5	3	12	10896	10916	0.42816846722126106
M1	string	0	network_modules	486	TRUE	5.811754976846728e-9	43	8	5	0.625	0.11627906976744186	GO:0060997	GO:BP	dendritic spine morphogenesis	16175	15121		0.024390243902439025	0.047619047619047616	43	16132	5	3	38	16129	16175	0.2688592884406126
M1	string	0	network_modules	486	TRUE	6.97697585497543e-9	40	8	5	0.625	0.125	REAC:R-HSA-3928662	REAC	EPHB-mediated forward signaling	10916	821		1	1	40	10876	5	3	35	10873	10916	0.2784823250214225
M1	string	0	network_modules	486	TRUE	2.8321718084881648e-8	165	8	6	0.75	0.03636363636363636	GO:0097485	GO:BP	neuron projection guidance	16175	18673		0.04878048780487805	0.09523809523809523	165	16010	6	2	159	16008	16175	0.16377616906585893
M1	string	0	network_modules	486	TRUE	2.8321718084881648e-8	165	8	6	0.75	0.03636363636363636	GO:0007411	GO:BP	axon guidance	16175	2906		0.04878048780487805	0.09523809523809523	165	16010	6	2	159	16008	16175	0.16377616906585893
M1	string	0	network_modules	486	TRUE	2.878612477769467e-8	379	8	7	0.875	0.018469656992084433	GO:0048667	GO:BP	cell morphogenesis involved in neuron differentiation	16175	12925		0.0975609756097561	0.11904761904761904	379	15796	7	1	372	15795	16175	0.12522790834251277
M1	string	0	network_modules	486	TRUE	3.581835192998007e-8	61	8	5	0.625	0.08196721311475409	GO:0097061	GO:BP	dendritic spine organization	16175	18469		0.12195121951219512	0.14285714285714285	61	16114	5	3	56	16111	16175	0.22545481324438638
M1	string	0	network_modules	486	TRUE	4.58839651298127e-8	64	8	5	0.625	0.078125	GO:0060996	GO:BP	dendritic spine development	16175	15120		0.14634146341463414	0.16666666666666666	64	16111	5	3	59	16108	16175	0.22006206928063687
M1	string	0	network_modules	486	TRUE	7.826820348739049e-8	71	8	5	0.625	0.07042253521126761	GO:0106027	GO:BP	neuron projection organization	16175	19219		0.17073170731707318	0.19047619047619047	71	16104	5	3	66	16101	16175	0.20883228211686503
M1	string	0	network_modules	486	TRUE	8.350426459472997e-8	441	8	7	0.875	0.015873015873015872	GO:0048812	GO:BP	neuron projection morphogenesis	16175	13058		0.1951219512195122	0.21428571428571427	441	15734	7	1	434	15733	16175	0.11579669663360688
M1	string	0	network_modules	486	TRUE	1.0561319352249731e-7	456	8	7	0.875	0.015350877192982455	GO:0120039	GO:BP	plasma membrane bounded cell projection morphogenesis	16175	19473		0.21951219512195122	0.23809523809523808	456	15719	7	1	449	15718	16175	0.11380590984285752
M1	string	0	network_modules	486	TRUE	1.122918691508143e-7	460	8	7	0.875	0.015217391304347827	GO:0048858	GO:BP	cell projection morphogenesis	16175	13102		0.24390243902439024	0.2619047619047619	460	15715	7	1	453	15714	16175	0.11329134649601039
M1	string	0	network_modules	486	TRUE	2.3162727154452952e-7	510	8	7	0.875	0.013725490196078431	GO:0007169	GO:BP	cell surface receptor protein tyrosine kinase signaling pathway	16175	2733		0.2682926829268293	0.2857142857142857	510	15665	7	1	503	15664	16175	0.10737269279300034
M1	string	0	network_modules	486	TRUE	3.1135657247182976e-7	93	8	5	0.625	0.053763440860215055	GO:0048813	GO:BP	dendrite morphogenesis	16175	13059		0.2926829268292683	0.30952380952380953	93	16082	5	3	88	16079	16175	0.18219201822962067
M1	string	0	network_modules	486	TRUE	4.065337719501487e-7	98	8	5	0.625	0.05102040816326531	GO:0099173	GO:BP	postsynapse organization	16175	19081		0.3170731707317073	0.3333333333333333	98	16077	5	3	93	16074	16175	0.1774224041504858
M1	string	0	network_modules	486	TRUE	9.896037699980115e-7	297	8	6	0.75	0.020202020202020204	GO:0007409	GO:BP	axonogenesis	16175	2905		0.34146341463414637	0.35714285714285715	297	15878	6	2	291	15876	16175	0.1212257529998931
M1	string	0	network_modules	486	TRUE	1.2804068822298924e-6	651	8	7	0.875	0.010752688172043012	GO:0000902	GO:BP	cell morphogenesis	16175	240		0.36585365853658536	0.38095238095238093	651	15524	7	1	644	15523	16175	0.0944800440966743
M1	string	0	network_modules	486	TRUE	1.3423769009193824e-6	124	8	5	0.625	0.04032258064516129	GO:0050807	GO:BP	regulation of synapse organization	16175	13273		0.3902439024390244	0.40476190476190477	124	16051	5	3	119	16048	16175	0.15744641044768345
M1	string	0	network_modules	486	TRUE	1.6397115257319264e-6	129	8	5	0.625	0.03875968992248062	GO:0050803	GO:BP	regulation of synapse structure or activity	16175	13269		0.4146341463414634	0.42857142857142855	129	16046	5	3	124	16043	16175	0.1543117103584314
M1	string	0	network_modules	486	TRUE	1.8094631224833397e-6	684	8	7	0.875	0.01023391812865497	GO:0031175	GO:BP	neuron projection development	16175	7086		0.43902439024390244	0.4523809523809524	684	15491	7	1	677	15490	16175	0.09204535560588732
M1	string	0	network_modules	486	TRUE	2.1923224790310553e-6	339	8	6	0.75	0.017699115044247787	GO:0061564	GO:BP	axon development	16175	15561		0.4634146341463415	0.47619047619047616	339	15836	6	2	333	15834	16175	0.11321510052500469
M1	string	0	network_modules	486	TRUE	3.5129626284956943e-6	150	8	5	0.625	0.03333333333333333	GO:0016358	GO:BP	dendrite development	16175	5220		0.4878048780487805	0.5	150	16025	5	3	145	16022	16175	0.14289522311126351
M1	string	0	network_modules	486	TRUE	3.8135042236261883e-6	761	8	7	0.875	0.009198423127463863	GO:0048666	GO:BP	neuron development	16175	12924		0.5121951219512195	0.5238095238095238	761	15414	7	1	754	15413	16175	0.0869820748342152
M1	string	0	network_modules	486	TRUE	4.951679174888635e-6	790	8	7	0.875	0.008860759493670886	GO:0007167	GO:BP	enzyme-linked receptor protein signaling pathway	16175	2731		0.5365853658536586	0.5476190476190477	790	15385	7	1	783	15384	16175	0.08526602344807756
M1	string	0	network_modules	486	TRUE	2.2659257410248798e-5	13	8	3	0.375	0.23076923076923078	GO:0106030	GO:BP	neuron projection fasciculation	16175	19221		0.5609756097560976	0.5952380952380952	13	16162	3	5	10	16157	16175	0.2937344023353134
M1	string	0	network_modules	486	TRUE	2.2659257410248798e-5	13	8	3	0.375	0.23076923076923078	GO:0007413	GO:BP	axonal fasciculation	16175	2908		0.5609756097560976	0.5952380952380952	13	16162	3	5	10	16157	16175	0.2937344023353134
M1	string	0	network_modules	486	TRUE	8.490724105292365e-5	283	8	5	0.625	0.0176678445229682	GO:0050808	GO:BP	synapse organization	16175	13274		0.6097560975609756	0.6190476190476191	283	15892	5	3	278	15889	16175	0.10307209710814663
M1	string	0	network_modules	486	TRUE	4.302672870493158e-4	33	8	3	0.375	0.09090909090909091	GO:0008038	GO:BP	neuron recognition	16175	3100		0.6341463414634146	0.6666666666666666	33	16142	3	5	30	16137	16175	0.18386580285820447
M1	string	0	network_modules	486	TRUE	4.302672870493158e-4	33	8	3	0.375	0.09090909090909091	GO:0051965	GO:BP	positive regulation of synapse assembly	16175	14034		0.6341463414634146	0.6666666666666666	33	16142	3	5	30	16137	16175	0.18386580285820447
M1	string	0	network_modules	486	TRUE	4.7517702738727416e-4	400	8	5	0.625	0.0125	GO:0001525	GO:BP	angiogenesis	16175	330		0.6829268292682927	0.6904761904761905	400	15775	5	3	395	15772	16175	0.08598186671276974
M1	string	0	network_modules	486	TRUE	8.241788721061234e-4	447	8	5	0.625	0.011185682326621925	GO:0048514	GO:BP	blood vessel morphogenesis	16175	12799		0.7073170731707317	0.7142857142857143	447	15728	5	3	442	15725	16175	0.08106318272306255
M1	string	0	network_modules	486	TRUE	0.00117245465294107	480	8	5	0.625	0.010416666666666666	GO:0001568	GO:BP	blood vessel development	16175	353		0.7317073170731707	0.7380952380952381	480	15695	5	3	475	15692	16175	0.07804176727587496
M1	string	0	network_modules	486	TRUE	0.0014921946805268357	504	8	5	0.625	0.00992063492063492	GO:0001944	GO:BP	vasculature development	16175	555		0.7560975609756098	0.7619047619047619	504	15671	5	3	499	15668	16175	0.07602929711271779
M1	string	0	network_modules	486	TRUE	0.0019669049621778745	533	8	5	0.625	0.009380863039399626	GO:0034330	GO:BP	cell junction organization	16175	8572		0.7804878048780488	0.7857142857142857	533	15642	5	3	528	15639	16175	0.0737771158162321
M1	string	0	network_modules	486	TRUE	0.002337839922726532	552	8	5	0.625	0.009057971014492754	GO:0035239	GO:BP	tube morphogenesis	16175	8921		0.8048780487804879	0.8095238095238095	552	15623	5	3	547	15620	16175	0.0723964291416793
M1	string	0	network_modules	486	TRUE	0.0024192573723068296	58	8	3	0.375	0.05172413793103448	GO:0051963	GO:BP	regulation of synapse assembly	16175	14032		0.8292682926829268	0.8333333333333334	58	16117	3	5	55	16112	16175	0.13822194201041574
M1	string	0	network_modules	486	TRUE	0.0031061066511492447	239	8	4	0.5	0.016736401673640166	GO:0070372	GO:BP	regulation of ERK1 and ERK2 cascade	16175	16083		0.8536585365853658	0.8571428571428571	239	15936	4	4	235	15932	16175	0.08945988301805337
M1	string	0	network_modules	486	TRUE	0.003920212781831468	68	8	3	0.375	0.04411764705882353	GO:1901890	GO:BP	positive regulation of cell junction assembly	16175	21834		0.8780487804878049	0.8809523809523809	68	16107	3	5	65	16102	16175	0.1274816854692083
M1	string	0	network_modules	486	TRUE	0.004018707320674348	255	8	4	0.5	0.01568627450980392	GO:0070371	GO:BP	ERK1 and ERK2 cascade	16175	16082		0.9024390243902439	0.9047619047619048	255	15920	4	4	251	15916	16175	0.0864746983969959
M1	string	0	network_modules	486	TRUE	0.004343222368303634	626	8	5	0.625	0.007987220447284345	GO:0035295	GO:BP	tube development	16175	8953		0.926829268292683	0.9285714285714286	626	15549	5	3	621	15546	16175	0.06761682902176556
M1	string	0	network_modules	486	TRUE	0.005984663719820224	8	8	2	0.25	0.25	GO:0022038	GO:BP	corpus callosum development	16175	6590		0.9512195121951219	0.9523809523809523	8	16167	2	6	6	16161	16175	0.24962887363147154
M1	string	0	network_modules	486	TRUE	0.007163621857197198	295	8	4	0.5	0.013559322033898305	GO:0010975	GO:BP	regulation of neuron projection development	16175	4551		0.975609756097561	0.9761904761904762	295	15880	4	4	291	15876	16175	0.0800886232852902
M1	string	0	network_modules	486	TRUE	0.008254678822659695	87	8	3	0.375	0.034482758620689655	GO:0010977	GO:BP	negative regulation of neuron projection development	16175	4553		1	1	87	16088	3	5	84	16083	16175	0.11241413759481705
M1	string	0	network_modules	488	TRUE	1.1160163406867666e-11	4	7	4	0.5714285714285714	1	GO:0006003	GO:BP	fructose 2,6-bisphosphate metabolic process	16175	1878		0	0.05555555555555555	4	16171	4	3	0	16168	16175	0.7558588238235925
M1	string	0	network_modules	488	TRUE	6.963946155177692e-9	12	7	4	0.5714285714285714	0.3333333333333333	REAC:R-HSA-9634600	REAC	Regulation of glycolysis by fructose 2,6-bisphosphate metabolism	10916	2038		0	0.25	12	10904	4	3	8	10901	10916	0.435975606579635
M1	string	0	network_modules	488	TRUE	4.000202178095333e-8	68	7	5	0.7142857142857143	0.07352941176470588	REAC:R-HSA-70171	REAC	Glycolysis	10916	1074		0.3333333333333333	0.5	68	10848	5	2	63	10846	10916	0.22795996882999123
M1	string	0	network_modules	488	TRUE	1.3327509717572108e-7	86	7	5	0.7142857142857143	0.05813953488372093	REAC:R-HSA-70326	REAC	Glucose metabolism	10916	1053		0.6666666666666666	0.75	86	10830	5	2	81	10828	10916	0.2024006226327591
M1	string	0	network_modules	488	TRUE	1.571840343354132e-7	34	6	4	0.6666666666666666	0.11764705882352941	KEGG:00051	KEGG	Fructose and mannose metabolism	8484	6		0	0.5	34	8450	4	2	30	8448	8484	0.2790306734955726
M1	string	0	network_modules	488	TRUE	2.7390865055170918e-5	120	6	4	0.6666666666666666	0.03333333333333333	KEGG:04152	KEGG	AMPK signaling pathway	8484	286		1	1	120	8364	4	2	116	8362	8484	0.14700339522373226
M1	string	0	network_modules	488	TRUE	5.913974059649606e-5	288	7	5	0.7142857142857143	0.017361111111111112	REAC:R-HSA-71387	REAC	Metabolism of carbohydrates	10916	1422		1	1	288	10628	5	2	283	10626	10916	0.10872386909492282
M1	string	0	network_modules	488	TRUE	0.002656718060147737	72	7	3	0.42857142857142855	0.041666666666666664	GO:0046032	GO:BP	ADP catabolic process	16175	11809		0.058823529411764705	0.16666666666666666	72	16103	3	4	69	16099	16175	0.13256668145646744
M1	string	0	network_modules	488	TRUE	0.002656718060147737	72	7	3	0.42857142857142855	0.041666666666666664	GO:0006096	GO:BP	glycolytic process	16175	1956		0.058823529411764705	0.16666666666666666	72	16103	3	4	69	16099	16175	0.13256668145646744
M1	string	0	network_modules	488	TRUE	0.002886570040669879	74	7	3	0.42857142857142855	0.04054054054054054	GO:0009137	GO:BP	purine nucleoside diphosphate catabolic process	16175	3304		0.17647058823529413	0.3333333333333333	74	16101	3	4	71	16097	16175	0.1307329653698209
M1	string	0	network_modules	488	TRUE	0.002886570040669879	74	7	3	0.42857142857142855	0.04054054054054054	GO:0046031	GO:BP	ADP metabolic process	16175	11808		0.17647058823529413	0.3333333333333333	74	16101	3	4	71	16097	16175	0.1307329653698209
M1	string	0	network_modules	488	TRUE	0.002886570040669879	74	7	3	0.42857142857142855	0.04054054054054054	GO:0009181	GO:BP	purine ribonucleoside diphosphate catabolic process	16175	3347		0.17647058823529413	0.3333333333333333	74	16101	3	4	71	16097	16175	0.1307329653698209
M1	string	0	network_modules	488	TRUE	0.003129248318921616	76	7	3	0.42857142857142855	0.039473684210526314	GO:0009179	GO:BP	purine ribonucleoside diphosphate metabolic process	16175	3345		0.35294117647058826	0.4444444444444444	76	16099	3	4	73	16095	16175	0.1289717169753835
M1	string	0	network_modules	488	TRUE	0.003129248318921616	76	7	3	0.42857142857142855	0.039473684210526314	GO:0019364	GO:BP	pyridine nucleotide catabolic process	16175	5726		0.35294117647058826	0.4444444444444444	76	16099	3	4	73	16095	16175	0.1289717169753835
M1	string	0	network_modules	488	TRUE	0.0032555040717178667	77	7	3	0.42857142857142855	0.03896103896103896	GO:0009135	GO:BP	purine nucleoside diphosphate metabolic process	16175	3302		0.47058823529411764	0.5555555555555556	77	16098	3	4	74	16094	16175	0.12811679192798228
M1	string	0	network_modules	488	TRUE	0.0032555040717178667	77	7	3	0.42857142857142855	0.03896103896103896	GO:0009191	GO:BP	ribonucleoside diphosphate catabolic process	16175	3357		0.47058823529411764	0.5555555555555556	77	16098	3	4	74	16094	16175	0.12811679192798228
M1	string	0	network_modules	488	TRUE	0.0035180620236807338	79	7	3	0.42857142857142855	0.0379746835443038	GO:0072526	GO:BP	pyridine-containing compound catabolic process	16175	17428		0.5882352941176471	0.6111111111111112	79	16096	3	4	76	16092	16175	0.12645561772485178
M1	string	0	network_modules	488	TRUE	0.003937653748182873	82	7	3	0.42857142857142855	0.036585365853658534	GO:0009134	GO:BP	nucleoside diphosphate catabolic process	16175	3301		0.6470588235294118	0.6666666666666666	82	16093	3	4	79	16089	16175	0.12407808057846476
M1	string	0	network_modules	488	TRUE	0.0043891713613958975	85	7	3	0.42857142857142855	0.03529411764705882	GO:0009185	GO:BP	ribonucleoside diphosphate metabolic process	16175	3351		0.7058823529411765	0.7222222222222222	85	16090	3	4	82	16086	16175	0.12182678232478586
M1	string	0	network_modules	488	TRUE	0.005215756465839129	90	7	3	0.42857142857142855	0.03333333333333333	GO:0009154	GO:BP	purine ribonucleotide catabolic process	16175	3321		0.7647058823529411	0.7777777777777778	90	16085	3	4	87	16081	16175	0.11832628240569532
M1	string	0	network_modules	488	TRUE	0.005573296891132017	92	7	3	0.42857142857142855	0.03260869565217391	GO:0009261	GO:BP	ribonucleotide catabolic process	16175	3426		0.8235294117647058	0.8333333333333334	92	16083	3	4	89	16079	16175	0.117006125150534
M1	string	0	network_modules	488	TRUE	0.005758001578749265	93	7	3	0.42857142857142855	0.03225806451612903	GO:0009132	GO:BP	nucleoside diphosphate metabolic process	16175	3299		0.8823529411764706	0.8888888888888888	93	16082	3	4	90	16078	16175	0.11636196378838377
M1	string	0	network_modules	488	TRUE	0.006336358936943704	96	7	3	0.42857142857142855	0.03125	GO:0006090	GO:BP	pyruvate metabolic process	16175	1953		0.9411764705882353	0.9444444444444444	96	16079	3	4	93	16075	16175	0.11448981809974512
M1	string	0	network_modules	488	TRUE	0.006951964151748747	99	7	3	0.42857142857142855	0.030303030303030304	GO:0006195	GO:BP	purine nucleotide catabolic process	16175	2024		1	1	99	16076	3	4	96	16072	16175	0.11270281771282976
M1	string	0	network_modules	491	TRUE	6.30659130425118e-4	18	3	2	0.6666666666666666	0.1111111111111111	KEGG:00511	KEGG	Other glycan degradation	8484	64		NA	1	18	8466	2	1	16	8465	8484	0.2716356597912063
M1	string	0	network_modules	496	TRUE	0.00769266439847492	9	8	2	0.25	0.2222222222222222	GO:0000492	GO:BP	box C/D snoRNP assembly	16175	179		NA	1	9	16166	2	6	7	16160	16175	0.2353013195399492
M1	string	0	network_modules	497	TRUE	5.99348749857138e-11	20	7	5	0.7142857142857143	0.25	REAC:R-HSA-190840	REAC	Microtubule-dependent trafficking of connexons from Golgi to the plasma membrane	10916	1451		0	0.014084507042253521	20	10896	5	2	15	10894	10916	0.4220151873837171
M1	string	0	network_modules	497	TRUE	7.865249394356016e-11	21	7	5	0.7142857142857143	0.23809523809523808	REAC:R-HSA-190872	REAC	Transport of connexons to the plasma membrane	10916	2592		0.014285714285714285	0.028169014084507043	21	10895	5	2	16	10893	10916	0.411810594137591
M1	string	0	network_modules	497	TRUE	1.6421013029843167e-10	24	7	5	0.7142857142857143	0.20833333333333334	REAC:R-HSA-389977	REAC	Post-chaperonin tubulin folding pathway	10916	1773		0.02857142857142857	0.04225352112676056	24	10892	5	2	19	10890	10916	0.38511795012852656
M1	string	0	network_modules	497	TRUE	2.540569802369777e-10	26	7	5	0.7142857142857143	0.19230769230769232	REAC:R-HSA-389960	REAC	Formation of tubulin folding intermediates by CCT/TriC	10916	975		0.04285714285714286	0.056338028169014086	26	10890	5	2	21	10888	10916	0.3699481227941553
M1	string	0	network_modules	497	TRUE	3.794630650566759e-10	28	7	5	0.7142857142857143	0.17857142857142858	REAC:R-HSA-389957	REAC	Prefoldin mediated transfer of substrate  to CCT/TriC	10916	1788		0.05714285714285714	0.08450704225352113	28	10888	5	2	23	10886	10916	0.3564319155312321
M1	string	0	network_modules	497	TRUE	3.794630650566759e-10	28	7	5	0.7142857142857143	0.17857142857142858	REAC:R-HSA-9619483	REAC	Activation of AMPK downstream of NMDARs	10916	73		0.05714285714285714	0.08450704225352113	28	10888	5	2	23	10886	10916	0.3564319155312321
M1	string	0	network_modules	497	TRUE	5.742803934196233e-10	94	7	6	0.8571428571428571	0.06382978723404255	REAC:R-HSA-380320	REAC	Recruitment of NuMA to mitotic centrosomes	10916	1950		0.08571428571428572	0.09859154929577464	94	10822	6	1	88	10821	10916	0.23263252127711767
M1	string	0	network_modules	497	TRUE	7.770450770415756e-10	32	7	5	0.7142857142857143	0.15625	REAC:R-HSA-5626467	REAC	RHO GTPases activate IQGAPs	10916	1854		0.1	0.1267605633802817	32	10884	5	2	27	10882	10916	0.3333010972356932
M1	string	0	network_modules	497	TRUE	7.770450770415756e-10	32	7	5	0.7142857142857143	0.15625	REAC:R-HSA-9668328	REAC	Sealing of the nuclear envelope (NE) by ESCRT-III	10916	2185		0.1	0.1267605633802817	32	10884	5	2	27	10882	10916	0.3333010972356932
M1	string	0	network_modules	497	TRUE	9.156629558567912e-10	33	7	5	0.7142857142857143	0.15151515151515152	REAC:R-HSA-389958	REAC	Cooperation of Prefoldin and TriC/CCT  in actin and tubulin folding	10916	411		0.12857142857142856	0.14084507042253522	33	10883	5	2	28	10881	10916	0.32818504148848504
M1	string	0	network_modules	497	TRUE	1.9350540616724196e-9	38	7	5	0.7142857142857143	0.13157894736842105	REAC:R-HSA-190861	REAC	Gap junction assembly	10916	1033		0.14285714285714285	0.15492957746478872	38	10878	5	2	33	10876	10916	0.30570600629431727
M1	string	0	network_modules	497	TRUE	3.7081042670235203e-9	43	7	5	0.7142857142857143	0.11627906976744186	REAC:R-HSA-9609736	REAC	Assembly and cell surface presentation of NMDA receptors	10916	173		0.15714285714285714	0.16901408450704225	43	10873	5	2	38	10871	10916	0.2872641466548804
M1	string	0	network_modules	497	TRUE	4.182861409064158e-9	44	7	5	0.7142857142857143	0.11363636363636363	REAC:R-HSA-9646399	REAC	Aggrephagy	10916	129		0.17142857142857143	0.18309859154929578	44	10872	5	2	39	10870	10916	0.28395745509412307
M1	string	0	network_modules	497	TRUE	4.704998195982829e-9	45	7	5	0.7142857142857143	0.1111111111111111	REAC:R-HSA-8955332	REAC	Carboxyterminal post-translational modifications of tubulin	10916	305		0.18571428571428572	0.19718309859154928	45	10871	5	2	40	10869	10916	0.2807613433517496
M1	string	0	network_modules	497	TRUE	6.59105819574968e-9	48	7	5	0.7142857142857143	0.10416666666666667	REAC:R-HSA-437239	REAC	Recycling pathway of L1	10916	1954		0.2	0.2112676056338028	48	10868	5	2	43	10866	10916	0.2717783031860092
M1	string	0	network_modules	497	TRUE	7.338917294513266e-9	49	7	5	0.7142857142857143	0.10204081632653061	REAC:R-HSA-190828	REAC	Gap junction trafficking	10916	1035		0.21428571428571427	0.22535211267605634	49	10867	5	2	44	10865	10916	0.26896842201143256
M1	string	0	network_modules	497	TRUE	8.1531028845161e-9	50	7	5	0.7142857142857143	0.1	REAC:R-HSA-157858	REAC	Gap junction trafficking and regulation	10916	1036		0.22857142857142856	0.23943661971830985	50	10866	5	2	45	10864	10916	0.266243038504783
M1	string	0	network_modules	497	TRUE	1.1037625928968096e-8	53	7	5	0.7142857142857143	0.09433962264150944	REAC:R-HSA-6811436	REAC	COPI-independent Golgi-to-ER retrograde traffic	10916	278		0.24285714285714285	0.2535211267605634	53	10863	5	2	48	10861	10916	0.25853365165669856
M1	string	0	network_modules	497	TRUE	1.2162049598590947e-8	54	7	5	0.7142857142857143	0.09259259259259259	REAC:R-HSA-5620924	REAC	Intraflagellar transport	10916	1267		0.2571428571428571	0.2676056338028169	54	10862	5	2	49	10860	10916	0.2561073496598099
M1	string	0	network_modules	497	TRUE	1.6094928259798723e-8	57	7	5	0.7142857142857143	0.08771929824561403	REAC:R-HSA-3371497	REAC	HSP90 chaperone cycle for steroid hormone receptors (SHR) in the presence of ligand	10916	1111		0.2714285714285714	0.28169014084507044	57	10859	5	2	52	10857	10916	0.2492144276474244
M1	string	0	network_modules	497	TRUE	2.0983994522290513e-8	60	7	5	0.7142857142857143	0.08333333333333333	REAC:R-HSA-983189	REAC	Kinesins	10916	1292		0.2857142857142857	0.29577464788732394	60	10856	5	2	55	10854	10916	0.2428435775722175
M1	string	0	network_modules	497	TRUE	4.643040009783016e-8	70	7	5	0.7142857142857143	0.07142857142857142	REAC:R-HSA-2995410	REAC	Nuclear Envelope (NE) Reassembly	10916	1612		0.3	0.30985915492957744	70	10846	5	2	65	10844	10916	0.22464236905659724
M1	string	0	network_modules	497	TRUE	4.943667110973887e-8	195	7	6	0.8571428571428571	0.03076923076923077	REAC:R-HSA-69275	REAC	G2/M Transition	10916	1008		0.3142857142857143	0.323943661971831	195	10721	6	1	189	10720	10916	0.16050610926354847
M1	string	0	network_modules	497	TRUE	5.259146561358977e-8	197	7	6	0.8571428571428571	0.030456852791878174	REAC:R-HSA-453274	REAC	Mitotic G2-G2/M phases	10916	1481		0.32857142857142857	0.3380281690140845	197	10719	6	1	191	10718	10916	0.15966931213422922
M1	string	0	network_modules	497	TRUE	5.365882977248217e-8	72	7	5	0.7142857142857143	0.06944444444444445	REAC:R-HSA-1445148	REAC	Translocation of SLC2A4 (GLUT4) to the plasma membrane	10916	2578		0.34285714285714286	0.352112676056338	72	10844	5	2	67	10842	10916	0.22146345237850507
M1	string	0	network_modules	497	TRUE	5.5912088783706626e-8	199	7	6	0.8571428571428571	0.03015075376884422	REAC:R-HSA-68877	REAC	Mitotic Prometaphase	10916	1484		0.35714285714285715	0.36619718309859156	199	10717	6	1	193	10716	10916	0.15884505903282117
M1	string	0	network_modules	497	TRUE	5.763673033458999e-8	200	7	6	0.8571428571428571	0.03	REAC:R-HSA-5617833	REAC	Cilium Assembly	10916	361		0.37142857142857144	0.38028169014084506	200	10716	6	1	194	10715	10916	0.15843753845744027
M1	string	0	network_modules	497	TRUE	6.616083164625181e-8	75	7	5	0.7142857142857143	0.06666666666666667	REAC:R-HSA-9833482	REAC	PKR-mediated signaling	10916	1692		0.38571428571428573	0.39436619718309857	75	10841	5	2	70	10839	10916	0.21693472563912475
M1	string	0	network_modules	497	TRUE	7.080917084049891e-8	76	7	5	0.7142857142857143	0.06578947368421052	REAC:R-HSA-438064	REAC	Post NMDA receptor activation events	10916	1772		0.4	0.4084507042253521	76	10840	5	2	71	10838	10916	0.2154848291356259
M1	string	0	network_modules	497	TRUE	8.634053809889563e-8	79	7	5	0.7142857142857143	0.06329113924050633	REAC:R-HSA-8852276	REAC	The role of GTSE1 in G2/M progression after G2 checkpoint	10916	2503		0.4142857142857143	0.4225352112676056	79	10837	5	2	74	10835	10916	0.21130086726712996
M1	string	0	network_modules	497	TRUE	9.208242847559048e-8	80	7	5	0.7142857142857143	0.0625	REAC:R-HSA-9663891	REAC	Selective autophagy	10916	2186		0.42857142857142855	0.43661971830985913	80	10836	5	2	75	10834	10916	0.20995856570067392
M1	string	0	network_modules	497	TRUE	1.0738542443548107e-7	88	7	5	0.7142857142857143	0.056818181818181816	KEGG:04540	KEGG	Gap junction	8484	318		0	0.1	88	8396	5	2	83	8394	8484	0.19965039623498237
M1	string	0	network_modules	497	TRUE	1.5877037052456187e-7	89	7	5	0.7142857142857143	0.056179775280898875	REAC:R-HSA-442755	REAC	Activation of NMDA receptors and postsynaptic events	10916	89		0.44285714285714284	0.4507042253521127	89	10827	5	2	84	10825	10916	0.19891028166768462
M1	string	0	network_modules	497	TRUE	1.7782894750965127e-7	91	7	5	0.7142857142857143	0.054945054945054944	REAC:R-HSA-390466	REAC	Chaperonin-mediated protein folding	10916	345		0.45714285714285713	0.4647887323943662	91	10825	5	2	86	10823	10916	0.19667943688980696
M1	string	0	network_modules	497	TRUE	2.594057701998492e-7	98	7	5	0.7142857142857143	0.05102040816326531	REAC:R-HSA-391251	REAC	Protein folding	10916	1812		0.4714285714285714	0.4788732394366197	98	10818	5	2	93	10816	10916	0.18941414185153077
M1	string	0	network_modules	497	TRUE	2.7316192739255625e-7	99	7	5	0.7142857142857143	0.050505050505050504	REAC:R-HSA-6811434	REAC	COPI-dependent Golgi-to-ER retrograde traffic	10916	277		0.4857142857142857	0.49295774647887325	99	10817	5	2	94	10815	10916	0.188439309060381
M1	string	0	network_modules	497	TRUE	3.179616168581857e-7	102	7	5	0.7142857142857143	0.049019607843137254	REAC:R-HSA-6807878	REAC	COPI-mediated anterograde transport	10916	279		0.5	0.5070422535211268	102	10814	5	2	97	10812	10916	0.18560085279260818
M1	string	0	network_modules	497	TRUE	5.349277905569231e-7	113	7	5	0.7142857142857143	0.04424778761061947	REAC:R-HSA-5610787	REAC	Hedgehog 'off' state	10916	1112		0.5142857142857142	0.5211267605633803	113	10803	5	2	108	10801	10916	0.17617349480355612
M1	string	0	network_modules	497	TRUE	5.675979552051454e-7	292	7	6	0.8571428571428571	0.02054794520547945	REAC:R-HSA-1852241	REAC	Organelle biogenesis and maintenance	10916	1646		0.5285714285714286	0.5352112676056338	292	10624	6	1	286	10623	10916	0.13036720900594845
M1	string	0	network_modules	497	TRUE	5.847159017408873e-7	115	7	5	0.7142857142857143	0.043478260869565216	REAC:R-HSA-9648025	REAC	EML4 and NUDC in mitotic spindle formation	10916	817		0.5428571428571428	0.5492957746478874	115	10801	5	2	110	10799	10916	0.1746055423276197
M1	string	0	network_modules	497	TRUE	6.953858337760728e-7	119	7	5	0.7142857142857143	0.04201680672268908	REAC:R-HSA-373760	REAC	L1CAM interactions	10916	1294		0.5571428571428572	0.5633802816901409	119	10797	5	2	114	10795	10916	0.17158831360589524
M1	string	0	network_modules	497	TRUE	8.22178336975547e-7	123	7	5	0.7142857142857143	0.04065040650406504	REAC:R-HSA-2500257	REAC	Resolution of Sister Chromatid Cohesion	10916	2079		0.5714285714285714	0.5915492957746479	123	10793	5	2	118	10791	10916	0.16871853059172012
M1	string	0	network_modules	497	TRUE	8.22178336975547e-7	123	7	5	0.7142857142857143	0.04065040650406504	REAC:R-HSA-2132295	REAC	MHC class II antigen presentation	10916	1371		0.5714285714285714	0.5915492957746479	123	10793	5	2	118	10791	10916	0.16871853059172012
M1	string	0	network_modules	497	TRUE	1.2210906798520902e-6	133	7	5	0.7142857142857143	0.03759398496240601	REAC:R-HSA-8856688	REAC	Golgi-to-ER retrograde transport	10916	1084		0.6	0.6056338028169014	133	10783	5	2	128	10781	10916	0.1621154914892351
M1	string	0	network_modules	497	TRUE	1.2682241664529492e-6	134	7	5	0.7142857142857143	0.03731343283582089	REAC:R-HSA-1632852	REAC	Macroautophagy	10916	1388		0.6142857142857143	0.6197183098591549	134	10782	5	2	129	10780	10916	0.16149586538159186
M1	string	0	network_modules	497	TRUE	1.3167989021696453e-6	135	7	5	0.7142857142857143	0.037037037037037035	REAC:R-HSA-9609690	REAC	HCMV Early Events	10916	1088		0.6285714285714286	0.6338028169014085	135	10781	5	2	130	10779	10916	0.16088308550430766
M1	string	0	network_modules	497	TRUE	1.3668475495987127e-6	136	7	5	0.7142857142857143	0.03676470588235294	REAC:R-HSA-5663220	REAC	RHO GTPases Activate Formins	10916	1848		0.6428571428571429	0.647887323943662	136	10780	5	2	131	10778	10916	0.1602770259535896
M1	string	0	network_modules	497	TRUE	1.4467446975502583e-6	147	7	5	0.7142857142857143	0.034013605442176874	KEGG:04145	KEGG	Phagosome	8484	281		0.1111111111111111	0.2	147	8337	5	2	142	8335	8484	0.15348722678406898
M1	string	0	network_modules	497	TRUE	2.024494179603279e-6	147	7	5	0.7142857142857143	0.034013605442176874	REAC:R-HSA-1169410	REAC	Antiviral mechanism by IFN-stimulated genes	10916	157		0.6571428571428571	0.6619718309859155	147	10769	5	2	142	10767	10916	0.15402092894802402
M1	string	0	network_modules	497	TRUE	2.167364129057317e-6	149	7	5	0.7142857142857143	0.03355704697986577	REAC:R-HSA-9612973	REAC	Autophagy	10916	193		0.6714285714285714	0.6901408450704225	149	10767	5	2	144	10765	10916	0.15295794837714838
M1	string	0	network_modules	497	TRUE	2.167364129057317e-6	149	7	5	0.7142857142857143	0.03355704697986577	REAC:R-HSA-5358351	REAC	Signaling by Hedgehog	10916	2258		0.6714285714285714	0.6901408450704225	149	10767	5	2	144	10765	10916	0.15295794837714838
M1	string	0	network_modules	497	TRUE	2.6448902325132215e-6	155	7	5	0.7142857142857143	0.03225806451612903	REAC:R-HSA-199977	REAC	ER to Golgi Anterograde Transport	10916	823		0.7	0.704225352112676	155	10761	5	2	150	10759	10916	0.1498923733659557
M1	string	0	network_modules	497	TRUE	3.0073573477350922e-06	159	7	5	0.7142857142857143	0.031446540880503145	REAC:R-HSA-9609646	REAC	HCMV Infection	10916	1089		0.7142857142857143	0.7183098591549296	159	10757	5	2	154	10755	10916	0.14794496159294887
M1	string	0	network_modules	497	TRUE	4.088914535901288e-6	169	7	5	0.7142857142857143	0.029585798816568046	REAC:R-HSA-983231	REAC	Factors involved in megakaryocyte development and platelet production	10916	931		0.7285714285714285	0.7323943661971831	169	10747	5	2	164	10745	10916	0.14337993862529008
M1	string	0	network_modules	497	TRUE	4.123207457340602e-6	406	7	6	0.8571428571428571	0.014778325123152709	REAC:R-HSA-68886	REAC	M Phase	10916	1343		0.7428571428571429	0.7464788732394366	406	10510	6	1	400	10509	10916	0.10975970650166025
M1	string	0	network_modules	497	TRUE	5.685551403053565e-6	193	7	5	0.7142857142857143	0.025906735751295335	KEGG:04814	KEGG	Motor proteins	8484	366		0.2222222222222222	0.3	193	8291	5	2	188	8289	8484	0.13327905494184195
M1	string	0	network_modules	497	TRUE	6.301347620236833e-6	197	7	5	0.7142857142857143	0.025380710659898477	KEGG:05130	KEGG	Pathogenic Escherichia coli infection	8484	427		0.3333333333333333	0.4	197	8287	5	2	192	8285	8484	0.13186090135731401
M1	string	0	network_modules	497	TRUE	6.621953014554512e-6	186	7	5	0.7142857142857143	0.026881720430107527	REAC:R-HSA-948021	REAC	Transport to the Golgi and subsequent modification	10916	2604		0.7571428571428571	0.7605633802816901	186	10730	5	2	181	10728	10916	0.13647405304297325
M1	string	0	network_modules	497	TRUE	6.987608661727787e-6	188	7	5	0.7142857142857143	0.026595744680851064	REAC:R-HSA-2467813	REAC	Separation of Sister Chromatids	10916	2204		0.7714285714285715	0.7746478873239436	188	10728	5	2	183	10726	10916	0.13572316538814405
M1	string	0	network_modules	497	TRUE	8.614684509007828e-6	196	7	5	0.7142857142857143	0.025510204081632654	REAC:R-HSA-112314	REAC	Neurotransmitter receptors and postsynaptic signal transmission	10916	1594		0.7857142857142857	0.7887323943661971	196	10720	5	2	191	10718	10916	0.1328342339636607
M1	string	0	network_modules	497	TRUE	1.0022596726727288e-5	202	7	5	0.7142857142857143	0.024752475247524754	REAC:R-HSA-6811442	REAC	Intra-Golgi and retrograde Golgi-to-ER traffic	10916	1262		0.8	0.8028169014084507	202	10714	5	2	197	10712	10916	0.13077989679850527
M1	string	0	network_modules	497	TRUE	1.8392132167565513e-5	228	7	5	0.7142857142857143	0.021929824561403508	REAC:R-HSA-68882	REAC	Mitotic Anaphase	10916	1479		0.8142857142857143	0.8169014084507042	228	10688	5	2	223	10686	10916	0.1228252353820889
M1	string	0	network_modules	497	TRUE	1.879975041181001e-5	229	7	5	0.7142857142857143	0.021834061135371178	REAC:R-HSA-2555396	REAC	Mitotic Metaphase and Anaphase	10916	1482		0.8285714285714286	0.8309859154929577	229	10687	5	2	224	10685	10916	0.12254630599709654
M1	string	0	network_modules	497	TRUE	2.0334479594480878e-5	249	7	5	0.7142857142857143	0.020080321285140562	KEGG:05132	KEGG	Salmonella infection	8484	429		0.4444444444444444	0.5	249	8235	5	2	244	8233	8484	0.11661309676079394
M1	string	0	network_modules	497	TRUE	2.774160941808005e-5	265	7	5	0.7142857142857143	0.018867924528301886	KEGG:05012	KEGG	Parkinson disease	8484	412		0.5555555555555556	0.6	265	8219	5	2	260	8217	8484	0.11283632720559544
M1	string	0	network_modules	497	TRUE	3.1016321283568003e-5	271	7	5	0.7142857142857143	0.01845018450184502	KEGG:05020	KEGG	Prion disease	8484	416		0.6666666666666666	0.7	271	8213	5	2	266	8211	8484	0.11150540543632553
M1	string	0	network_modules	497	TRUE	3.480739509168145e-5	259	7	5	0.7142857142857143	0.019305019305019305	REAC:R-HSA-112315	REAC	Transmission across Chemical Synapses	10916	2580		0.8428571428571429	0.8450704225352113	259	10657	5	2	254	10655	10916	0.11493533018797308
M1	string	0	network_modules	497	TRUE	3.7578456854029235e-5	263	7	5	0.7142857142857143	0.019011406844106463	REAC:R-HSA-913531	REAC	Interferon Signaling	10916	1227		0.8571428571428571	0.8591549295774648	263	10653	5	2	258	10651	10916	0.11401882525169094
M1	string	0	network_modules	497	TRUE	5.585540879145002e-5	305	7	5	0.7142857142857143	0.01639344262295082	KEGG:05016	KEGG	Huntington disease	8484	414		0.7777777777777778	0.8	305	8179	5	2	300	8177	8484	0.10470640111538099
M1	string	0	network_modules	497	TRUE	5.802458690417943e-5	586	8	6	0.75	0.010238907849829351	GO:0000226	GO:BP	microtubule cytoskeleton organization	16175	61		NA	1	586	15589	6	2	580	15587	16175	0.08497196848123592
M1	string	0	network_modules	497	TRUE	7.87249815406194e-5	305	7	5	0.7142857142857143	0.01639344262295082	REAC:R-HSA-446203	REAC	Asparagine N-linked glycosylation	10916	169		0.8714285714285714	0.8732394366197183	305	10611	5	2	300	10609	10916	0.10549564261237664
M1	string	0	network_modules	497	TRUE	9.692911554835354e-5	318	7	5	0.7142857142857143	0.015723270440251572	REAC:R-HSA-195258	REAC	RHO GTPase Effectors	10916	1846		0.8857142857142857	0.8873239436619719	318	10598	5	2	313	10596	10916	0.10320075159372254
M1	string	0	network_modules	497	TRUE	1.325205246920019e-4	363	7	5	0.7142857142857143	0.013774104683195593	KEGG:05014	KEGG	Amyotrophic lateral sclerosis	8484	413		0.8888888888888888	0.9	363	8121	5	2	358	8119	8484	0.09534898627907995
M1	string	0	network_modules	497	TRUE	1.7060265320674648e-4	382	7	5	0.7142857142857143	0.013089005235602094	KEGG:05010	KEGG	Alzheimer disease	8484	411		1	1	382	8102	5	2	377	8100	8484	0.09274606994729515
M1	string	0	network_modules	497	TRUE	3.032882613300509e-4	400	7	5	0.7142857142857143	0.0125	REAC:R-HSA-112316	REAC	Neuronal System	10916	1590		0.9	0.9014084507042254	400	10516	5	2	395	10514	10916	0.09136193114922107
M1	string	0	network_modules	497	TRUE	0.0018927803357118367	68	7	3	0.42857142857142855	0.04411764705882353	REAC:R-HSA-380259	REAC	Loss of Nlp from mitotic centrosomes	10916	1331		0.9142857142857143	0.9295774647887324	68	10848	3	4	65	10844	10916	0.13597375635963102
M1	string	0	network_modules	497	TRUE	0.0018927803357118367	68	7	3	0.42857142857142855	0.04411764705882353	REAC:R-HSA-380284	REAC	Loss of proteins required for interphase microtubule organization from the centrosome	10916	1335		0.9142857142857143	0.9295774647887324	68	10848	3	4	65	10844	10916	0.13597375635963102
M1	string	0	network_modules	497	TRUE	0.002156842971704246	71	7	3	0.42857142857142855	0.04225352112676056	REAC:R-HSA-8854518	REAC	AURKA Activation by TPX2	10916	41		0.9428571428571428	0.9436619718309859	71	10845	3	4	68	10841	10916	0.1330018683675745
M1	string	0	network_modules	497	TRUE	0.0030927571820933662	80	7	3	0.42857142857142855	0.0375	REAC:R-HSA-380270	REAC	Recruitment of mitotic centrosome proteins and complexes	10916	1951		0.9571428571428572	0.971830985915493	80	10836	3	4	77	10832	10916	0.12510452263556632
M1	string	0	network_modules	497	TRUE	0.0030927571820933662	80	7	3	0.42857142857142855	0.0375	REAC:R-HSA-380287	REAC	Centrosome maturation	10916	341		0.9571428571428572	0.971830985915493	80	10836	3	4	77	10832	10916	0.12510452263556632
M1	string	0	network_modules	497	TRUE	0.003712879245278181	85	7	3	0.42857142857142855	0.03529411764705882	REAC:R-HSA-2565942	REAC	Regulation of PLK1 Activity at G2/M Transition	10916	1998		0.9857142857142858	0.9859154929577465	85	10831	3	4	82	10827	10916	0.1212652227513992
M1	string	0	network_modules	497	TRUE	0.005354728583105831	96	7	3	0.42857142857142855	0.03125	REAC:R-HSA-5620912	REAC	Anchoring of the basal body to the plasma membrane	10916	147		1	1	96	10820	3	4	93	10816	10916	0.11389101594457168
M1	string	0	network_modules	498	TRUE	4.804756795171202e-12	12	8	5	0.625	0.4166666666666667	GO:0009304	GO:BP	tRNA transcription	16175	3451		0	0.125	12	16163	5	3	7	16160	16175	0.5100199336187351
M1	string	0	network_modules	498	TRUE	8.007031273869939e-11	27	6	5	0.8333333333333334	0.18518518518518517	REAC:R-HSA-76066	REAC	RNA Polymerase III Transcription Initiation From Type 2 Promoter	10916	1901		0	0.2	27	10889	5	1	22	10888	10916	0.39226421878427153
M1	string	0	network_modules	498	TRUE	9.746944508473254e-11	28	6	5	0.8333333333333334	0.17857142857142858	REAC:R-HSA-76061	REAC	RNA Polymerase III Transcription Initiation From Type 1 Promoter	10916	1900		0.25	0.4	28	10888	5	1	23	10887	10916	0.38517103194249763
M1	string	0	network_modules	498	TRUE	3.6813964730853324e-10	6	8	4	0.5	0.6666666666666666	GO:0042791	GO:BP	5S class rRNA transcription by RNA polymerase III	16175	10369		0.14285714285714285	0.25	6	16169	4	4	2	16165	16175	0.5771717230802277
M1	string	0	network_modules	498	TRUE	3.7365394852732917e-10	36	6	5	0.8333333333333334	0.1388888888888889	REAC:R-HSA-76046	REAC	RNA Polymerase III Transcription Initiation	10916	1899		0.5	0.6	36	10880	5	1	31	10879	10916	0.3395140140337575
M1	string	0	network_modules	498	TRUE	7.424781859614782e-10	41	6	5	0.8333333333333334	0.12195121951219512	REAC:R-HSA-749476	REAC	RNA Polymerase III Abortive And Retractive Initiation	10916	1896		0.75	1	41	10875	5	1	36	10874	10916	0.3180366108485994
M1	string	0	network_modules	498	TRUE	7.424781859614782e-10	41	6	5	0.8333333333333334	0.12195121951219512	REAC:R-HSA-74158	REAC	RNA Polymerase III Transcription	10916	1898		0.75	1	41	10875	5	1	36	10874	10916	0.3180366108485994
M1	string	0	network_modules	498	TRUE	8.62124052784984e-10	30	8	5	0.625	0.16666666666666666	GO:0009303	GO:BP	rRNA transcription	16175	3450		0.2857142857142857	0.375	30	16145	5	3	25	16142	16175	0.3221693534990593
M1	string	0	network_modules	498	TRUE	8.091060596360151e-9	11	8	4	0.5	0.36363636363636365	GO:0042797	GO:BP	tRNA transcription by RNA polymerase III	16175	10374		0.42857142857142855	0.5	11	16164	4	4	7	16160	16175	0.4260717189221374
M1	string	0	network_modules	498	TRUE	2.301600592935825e-8	56	8	5	0.625	0.08928571428571429	GO:0006383	GO:BP	transcription by RNA polymerase III	16175	2148		0.5714285714285714	0.625	56	16119	5	3	51	16116	16175	0.2353851690046681
M1	string	0	network_modules	498	TRUE	1.056189110377854e-7	205	8	6	0.75	0.02926829268292683	GO:0016072	GO:BP	rRNA metabolic process	16175	5099		0.7142857142857143	0.75	205	15970	6	2	199	15968	16175	0.14662390932518699
M1	string	0	network_modules	498	TRUE	1.0376536771140945e-5	186	8	5	0.625	0.026881720430107527	GO:0006399	GO:BP	tRNA metabolic process	16175	2160		0.8571428571428571	0.875	186	15989	5	3	181	15986	16175	0.12800370917926204
M1	string	0	network_modules	498	TRUE	0.0032076564362333833	6	8	2	0.25	0.3333333333333333	GO:0006384	GO:BP	transcription initiation at RNA polymerase III promoter	16175	2149		1	1	6	16169	2	6	4	16163	16175	0.28837160488364655
M1	string	0	network_modules	499	TRUE	1.4051373211456592e-9	9	7	4	0.5714285714285714	0.4444444444444444	GO:1900264	GO:BP	positive regulation of DNA-directed DNA polymerase activity	16175	20525		0	0.18181818181818182	9	16166	4	3	5	16163	16175	0.5037110510841536
M1	string	0	network_modules	499	TRUE	1.4051373211456592e-9	9	7	4	0.5714285714285714	0.4444444444444444	GO:1900262	GO:BP	regulation of DNA-directed DNA polymerase activity	16175	20524		0	0.18181818181818182	9	16166	4	3	5	16163	16175	0.5037110510841536
M1	string	0	network_modules	499	TRUE	1.004303636156697e-8	23	5	4	0.8	0.17391304347826086	KEGG:03430	KEGG	Mismatch repair	8484	239		0	0.25	23	8461	4	1	19	8460	8484	0.3723525728907259
M1	string	0	network_modules	499	TRUE	1.4076449098496597e-8	14	7	4	0.5714285714285714	0.2857142857142857	REAC:R-HSA-69109	REAC	Leading Strand Synthesis	10916	1308		0	0.0392156862745098	14	10902	4	3	10	10899	10916	0.40354232288688935
M1	string	0	network_modules	499	TRUE	1.4076449098496597e-8	14	7	4	0.5714285714285714	0.2857142857142857	REAC:R-HSA-69091	REAC	Polymerase switching	10916	1769		0	0.0392156862745098	14	10902	4	3	10	10899	10916	0.40354232288688935
M1	string	0	network_modules	499	TRUE	2.5582278949318204e-8	16	7	4	0.5714285714285714	0.25	REAC:R-HSA-110312	REAC	Translesion synthesis by REV1	10916	2576		0.04	0.058823529411764705	16	10900	4	3	12	10897	10916	0.37739259319908736
M1	string	0	network_modules	499	TRUE	3.344638559479254e-8	17	7	4	0.5714285714285714	0.23529411764705882	REAC:R-HSA-5655862	REAC	Translesion synthesis by POLK	10916	2575		0.06	0.09803921568627451	17	10899	4	3	13	10896	10916	0.3660825408083997
M1	string	0	network_modules	499	TRUE	3.344638559479254e-8	17	7	4	0.5714285714285714	0.23529411764705882	REAC:R-HSA-5656121	REAC	Translesion synthesis by POLI	10916	2574		0.06	0.09803921568627451	17	10899	4	3	13	10896	10916	0.3660825408083997
M1	string	0	network_modules	499	TRUE	5.4445848518902615e-8	19	7	4	0.5714285714285714	0.21052631578947367	REAC:R-HSA-110320	REAC	Translesion Synthesis by POLH	10916	2573		0.1	0.11764705882352941	19	10897	4	3	15	10894	10916	0.34619985140643494
M1	string	0	network_modules	499	TRUE	6.672594299529116e-8	36	5	4	0.8	0.1111111111111111	KEGG:03030	KEGG	DNA replication	8484	214		0.3333333333333333	0.5	36	8448	4	1	32	8447	8484	0.2972798378529468
M1	string	0	network_modules	499	TRUE	6.804232692988181e-8	20	7	4	0.5714285714285714	0.2	REAC:R-HSA-69186	REAC	Lagging Strand Synthesis	10916	1302		0.12	0.13725490196078433	20	10896	4	3	16	10893	10916	0.33739509580618854
M1	string	0	network_modules	499	TRUE	8.403377973833757e-8	21	7	4	0.5714285714285714	0.19047619047619047	REAC:R-HSA-5651801	REAC	PCNA-Dependent Long Patch Base Excision Repair	10916	1658		0.14	0.1568627450980392	21	10895	4	3	17	10892	10916	0.32922605083470596
M1	string	0	network_modules	499	TRUE	1.53658542994189e-7	44	5	4	0.8	0.09090909090909091	KEGG:03410	KEGG	Base excision repair	8484	237		0.6666666666666666	0.75	44	8440	4	1	40	8439	8484	0.26870835101807583
M1	string	0	network_modules	499	TRUE	1.7745885452761547e-7	25	7	4	0.5714285714285714	0.16	REAC:R-HSA-5696397	REAC	Gap-filling DNA repair synthesis and ligation in GG-NER	10916	1037		0.16	0.19607843137254902	25	10891	4	3	21	10888	10916	0.30160188201565996
M1	string	0	network_modules	499	TRUE	1.7745885452761547e-7	25	7	4	0.5714285714285714	0.16	REAC:R-HSA-110373	REAC	Resolution of AP sites via the multiple-nucleotide patch replacement pathway	10916	2073		0.16	0.19607843137254902	25	10891	4	3	21	10888	10916	0.30160188201565996
M1	string	0	network_modules	499	TRUE	2.09677908627139e-7	26	7	4	0.5714285714285714	0.15384615384615385	REAC:R-HSA-174411	REAC	Polymerase switching on the C-strand of the telomere	10916	1770		0.2	0.21568627450980393	26	10890	4	3	22	10887	10916	0.29571095031683997
M1	string	0	network_modules	499	TRUE	3.840241763133778e-7	30	7	4	0.5714285714285714	0.13333333333333333	REAC:R-HSA-110314	REAC	Recognition of DNA damage by PCNA-containing replication complex	10916	1948		0.22	0.23529411764705882	30	10886	4	3	26	10883	10916	0.27516518020124214
M1	string	0	network_modules	499	TRUE	5.036827094186356e-7	32	7	4	0.5714285714285714	0.125	REAC:R-HSA-5656169	REAC	Termination of translesion DNA synthesis	10916	2492		0.24	0.27450980392156865	32	10884	4	3	28	10881	10916	0.26636617234378013
M1	string	0	network_modules	499	TRUE	5.036827094186356e-7	32	7	4	0.5714285714285714	0.125	REAC:R-HSA-69190	REAC	DNA strand elongation	10916	449		0.24	0.27450980392156865	32	10884	4	3	28	10881	10916	0.26636617234378013
M1	string	0	network_modules	499	TRUE	5.897443795090574e-7	61	5	4	0.8	0.06557377049180328	KEGG:03420	KEGG	Nucleotide excision repair	8484	238		1	1	61	8423	4	1	57	8422	8484	0.22786842123376383
M1	string	0	network_modules	499	TRUE	6.492907571326722e-7	34	7	4	0.5714285714285714	0.11764705882352941	REAC:R-HSA-174417	REAC	Telomere C-strand (Lagging Strand) Synthesis	10916	2486		0.28	0.29411764705882354	34	10882	4	3	30	10879	10916	0.25835360016982345
M1	string	0	network_modules	499	TRUE	7.329086515864683e-7	35	7	4	0.5714285714285714	0.11428571428571428	REAC:R-HSA-9709570	REAC	Impaired BRCA2 binding to RAD51	10916	1173		0.3	0.3137254901960784	35	10881	4	3	31	10878	10916	0.25460674141804085
M1	string	0	network_modules	499	TRUE	8.243405080202546e-7	36	7	4	0.5714285714285714	0.1111111111111111	REAC:R-HSA-73933	REAC	Resolution of Abasic Sites (AP sites)	10916	2075		0.32	0.3333333333333333	36	10880	4	3	32	10877	10916	0.2510166939769647
M1	string	0	network_modules	499	TRUE	9.240568485045766e-7	37	7	4	0.5714285714285714	0.10810810810810811	REAC:R-HSA-176187	REAC	Activation of ATR in response to replication stress	10916	75		0.34	0.37254901960784315	37	10879	4	3	33	10876	10916	0.24757279474578114
M1	string	0	network_modules	499	TRUE	9.240568485045766e-7	37	7	4	0.5714285714285714	0.10810810810810811	REAC:R-HSA-5685938	REAC	HDR through Single Strand Annealing (SSA)	10916	1100		0.34	0.37254901960784315	37	10879	4	3	33	10876	10916	0.24757279474578114
M1	string	0	network_modules	499	TRUE	1.1502929065885908e-6	39	7	4	0.5714285714285714	0.10256410256410256	REAC:R-HSA-110313	REAC	Translesion synthesis by Y family DNA polymerases bypasses lesions on DNA template	10916	2577		0.38	0.39215686274509803	39	10877	4	3	35	10874	10916	0.24108561644369594
M1	string	0	network_modules	499	TRUE	1.2778214592445637e-6	40	7	4	0.5714285714285714	0.1	REAC:R-HSA-5693616	REAC	Presynaptic phase of homologous DNA pairing and strand exchange	10916	1793		0.4	0.4117647058823529	40	10876	4	3	36	10873	10916	0.23802551058121396
M1	string	0	network_modules	499	TRUE	1.3693195036711867e-6	43	7	4	0.5714285714285714	0.09302325581395349	GO:0090329	GO:BP	regulation of DNA-templated DNA replication	16175	18209		0.2	0.2727272727272727	43	16132	4	3	39	16129	16175	0.22983894467364843
M1	string	0	network_modules	499	TRUE	1.4156521355691642e-6	41	7	4	0.5714285714285714	0.0975609756097561	REAC:R-HSA-9701190	REAC	Defective homologous recombination repair (HRR) due to BRCA2 loss of function	10916	698		0.42	0.47058823529411764	41	10875	4	3	37	10872	10916	0.23507771486349488
M1	string	0	network_modules	499	TRUE	1.4156521355691642e-6	41	7	4	0.5714285714285714	0.0975609756097561	REAC:R-HSA-9675136	REAC	Diseases of DNA Double-Strand Break Repair	10916	757		0.42	0.47058823529411764	41	10875	4	3	37	10872	10916	0.23507771486349488
M1	string	0	network_modules	499	TRUE	1.4156521355691642e-6	41	7	4	0.5714285714285714	0.0975609756097561	REAC:R-HSA-5696400	REAC	Dual Incision in GG-NER	10916	807		0.42	0.47058823529411764	41	10875	4	3	37	10872	10916	0.23507771486349488
M1	string	0	network_modules	499	TRUE	1.7243862394029566e-6	43	7	4	0.5714285714285714	0.09302325581395349	REAC:R-HSA-5693579	REAC	Homologous DNA Pairing and Strand Exchange	10916	1129		0.48	0.49019607843137253	43	10873	4	3	39	10870	10916	0.22949271709861235
M1	string	0	network_modules	499	TRUE	2.7158352866499307e-6	48	7	4	0.5714285714285714	0.08333333333333333	REAC:R-HSA-73893	REAC	DNA Damage Bypass	10916	438		0.5	0.5098039215686274	48	10868	4	3	44	10865	10916	0.21708595089675184
M1	string	0	network_modules	499	TRUE	2.9998637495050798e-6	52	7	4	0.5714285714285714	0.07692307692307693	GO:2000573	GO:BP	positive regulation of DNA biosynthetic process	16175	25874		0.3	0.36363636363636365	52	16123	4	3	48	16120	16175	0.2088585635130249
M1	string	0	network_modules	499	TRUE	3.2129763817943074e-6	50	7	4	0.5714285714285714	0.08	REAC:R-HSA-9675135	REAC	Diseases of DNA repair	10916	758		0.52	0.5294117647058824	50	10866	4	3	46	10863	10916	0.21265076470212374
M1	string	0	network_modules	499	TRUE	3.4856519951954414e-6	51	7	4	0.5714285714285714	0.0784313725490196	REAC:R-HSA-180786	REAC	Extension of Telomeres	10916	887		0.54	0.5490196078431373	51	10865	4	3	47	10862	10916	0.21053129200716747
M1	string	0	network_modules	499	TRUE	8.286467596877893e-6	63	7	4	0.5714285714285714	0.06349206349206349	REAC:R-HSA-6782210	REAC	Gap-filling DNA repair synthesis and ligation in TC-NER	10916	1038		0.56	0.5686274509803921	63	10853	4	3	59	10850	10916	0.18915953588179718
M1	string	0	network_modules	499	TRUE	8.836946995806277e-6	64	7	4	0.5714285714285714	0.0625	REAC:R-HSA-6782135	REAC	Dual incision in TC-NER	10916	808		0.58	0.5882352941176471	64	10852	4	3	60	10849	10916	0.1876541599722136
M1	string	0	network_modules	499	TRUE	1.0612928460417518e-5	231	7	5	0.7142857142857143	0.021645021645021644	GO:0006260	GO:BP	DNA replication	16175	2077		0.4	0.45454545454545453	231	15944	5	2	226	15942	16175	0.12276125117273946
M1	string	0	network_modules	499	TRUE	1.1316640123509064e-5	68	7	4	0.5714285714285714	0.058823529411764705	REAC:R-HSA-5685942	REAC	HDR through Homologous Recombination (HRR)	10916	1097		0.6	0.6078431372549019	68	10848	4	3	64	10845	10916	0.18196686259481112
M1	string	0	network_modules	499	TRUE	1.8767658168342233e-5	77	7	4	0.5714285714285714	0.05194805194805195	REAC:R-HSA-6781827	REAC	Transcription-Coupled Nucleotide Excision Repair (TC-NER)	10916	2541		0.62	0.6274509803921569	77	10839	4	3	73	10836	10916	0.17082351203321755
M1	string	0	network_modules	499	TRUE	2.232640040973583e-5	85	7	4	0.5714285714285714	0.047058823529411764	GO:2000278	GO:BP	regulation of DNA biosynthetic process	16175	25603		0.5	0.5454545454545454	85	16090	4	3	81	16087	16175	0.1629398264329313
M1	string	0	network_modules	499	TRUE	2.6717566186881404e-5	84	7	4	0.5714285714285714	0.047619047619047616	REAC:R-HSA-5696399	REAC	Global Genome Nucleotide Excision Repair (GG-NER)	10916	1047		0.64	0.6470588235294118	84	10832	4	3	80	10829	10916	0.16341800663953118
M1	string	0	network_modules	499	TRUE	3.2260843878847016e-5	88	7	4	0.5714285714285714	0.045454545454545456	REAC:R-HSA-73884	REAC	Base Excision Repair	10916	205		0.66	0.6666666666666666	88	10828	4	3	84	10825	10916	0.15958645535516458
M1	string	0	network_modules	499	TRUE	3.862191745023879e-5	92	7	4	0.5714285714285714	0.043478260869565216	REAC:R-HSA-6804756	REAC	Regulation of TP53 Activity through Phosphorylation	10916	2016		0.68	0.6862745098039216	92	10824	4	3	88	10821	10916	0.15600593104210558
M1	string	0	network_modules	499	TRUE	4.213276056342186e-5	94	7	4	0.5714285714285714	0.0425531914893617	REAC:R-HSA-69473	REAC	G2/M DNA damage checkpoint	10916	1006		0.7	0.7058823529411765	94	10822	4	3	90	10819	10916	0.15430140056824274
M1	string	0	network_modules	499	TRUE	4.783942685865319e-5	97	7	4	0.5714285714285714	0.041237113402061855	REAC:R-HSA-5693607	REAC	Processing of DNA double-strand break ends	10916	1798		0.72	0.7254901960784313	97	10819	4	3	93	10816	10916	0.1518434325045397
M1	string	0	network_modules	499	TRUE	6.820887198183841e-5	112	7	4	0.5714285714285714	0.03571428571428571	GO:0006275	GO:BP	regulation of DNA replication	16175	2090		0.6	0.6363636363636364	112	16063	4	3	108	16060	16175	0.14164787929851963
M1	string	0	network_modules	499	TRUE	7.660858606065568e-5	109	7	4	0.5714285714285714	0.03669724770642202	REAC:R-HSA-5696398	REAC	Nucleotide Excision Repair	10916	1622		0.74	0.7450980392156863	109	10807	4	3	105	10804	10916	0.14304085582975976
M1	string	0	network_modules	499	TRUE	8.243488661375682e-5	111	7	4	0.5714285714285714	0.036036036036036036	REAC:R-HSA-157579	REAC	Telomere Maintenance	10916	2489		0.76	0.7647058823529411	111	10805	4	3	107	10802	10916	0.1417131990518212
M1	string	0	network_modules	499	TRUE	1.1667510705853413e-4	121	7	4	0.5714285714285714	0.03305785123966942	REAC:R-HSA-69239	REAC	Synthesis of DNA	10916	2376		0.78	0.7843137254901961	121	10795	4	3	117	10792	10916	0.13557222868900004
M1	string	0	network_modules	499	TRUE	1.6553941097108407e-4	132	7	4	0.5714285714285714	0.030303030303030304	REAC:R-HSA-5693567	REAC	HDR through Homologous Recombination (HRR) or Single Strand Annealing (SSA)	10916	1098		0.8	0.803921568627451	132	10784	4	3	128	10781	10916	0.12963316418345236
M1	string	0	network_modules	499	TRUE	1.6765182909427004e-4	140	7	4	0.5714285714285714	0.02857142857142857	GO:0071897	GO:BP	DNA biosynthetic process	16175	16970		0.7	0.7272727272727273	140	16035	4	3	136	16032	16175	0.12641543309985376
M1	string	0	network_modules	499	TRUE	1.9788697115089325e-4	138	7	4	0.5714285714285714	0.028985507246376812	REAC:R-HSA-5693538	REAC	Homology Directed Repair	10916	1130		0.82	0.8431372549019608	138	10778	4	3	134	10775	10916	0.12669439709708702
M1	string	0	network_modules	499	TRUE	1.9788697115089325e-4	138	7	4	0.5714285714285714	0.028985507246376812	REAC:R-HSA-73886	REAC	Chromosome Maintenance	10916	357		0.82	0.8431372549019608	138	10778	4	3	134	10775	10916	0.12669439709708702
M1	string	0	network_modules	499	TRUE	2.0399165923924855e-4	147	7	4	0.5714285714285714	0.027210884353741496	GO:0006261	GO:BP	DNA-templated DNA replication	16175	2078		0.8	0.8181818181818182	147	16028	4	3	143	16025	16175	0.12330087720207844
M1	string	0	network_modules	499	TRUE	3.5801108542024465e-4	160	7	4	0.5714285714285714	0.025	REAC:R-HSA-5633007	REAC	Regulation of TP53 Activity	10916	2012		0.86	0.8627450980392157	160	10756	4	3	156	10753	10916	0.11735765986403762
M1	string	0	network_modules	499	TRUE	3.7625955498734974e-4	162	7	4	0.5714285714285714	0.024691358024691357	REAC:R-HSA-69242	REAC	S Phase	10916	2111		0.88	0.8823529411764706	162	10754	4	3	158	10751	10916	0.11660344146316087
M1	string	0	network_modules	499	TRUE	4.24912059349289e-4	167	7	4	0.5714285714285714	0.023952095808383235	REAC:R-HSA-69481	REAC	G2/M Checkpoints	10916	1005		0.9	0.9019607843137255	167	10749	4	3	163	10746	10916	0.11477679030404006
M1	string	0	network_modules	499	TRUE	4.351789741053272e-4	168	7	4	0.5714285714285714	0.023809523809523808	REAC:R-HSA-5693532	REAC	DNA Double-Strand Break Repair	10916	443		0.92	0.9215686274509803	168	10748	4	3	164	10745	10916	0.11442115511556414
M1	string	0	network_modules	499	TRUE	6.676638035612302e-4	187	7	4	0.5714285714285714	0.0213903743315508	REAC:R-HSA-69306	REAC	DNA Replication	10916	445		0.94	0.9411764705882353	187	10729	4	3	183	10726	10916	0.10820884694116294
M1	string	0	network_modules	499	TRUE	0.0016027709528679715	246	7	4	0.5714285714285714	0.016260162601626018	GO:0051054	GO:BP	positive regulation of DNA metabolic process	16175	13464		0.9	0.9090909090909091	246	15929	4	3	242	15926	16175	0.09456923689973876
M1	string	0	network_modules	499	TRUE	0.0035789888736209034	301	7	4	0.5714285714285714	0.013289036544850499	GO:0051347	GO:BP	positive regulation of transferase activity	16175	13674		1	1	301	15874	4	3	297	15871	16175	0.0851181471168608
M1	string	0	network_modules	499	TRUE	0.0037657619199703363	289	7	4	0.5714285714285714	0.01384083044982699	REAC:R-HSA-69620	REAC	Cell Cycle Checkpoints	10916	321		0.96	0.9607843137254902	289	10627	4	3	285	10624	10916	0.08598553502503399
M1	string	0	network_modules	499	TRUE	0.0062841836189277125	329	7	4	0.5714285714285714	0.0121580547112462	REAC:R-HSA-73894	REAC	DNA Repair	10916	444		0.98	0.9803921568627451	329	10587	4	3	325	10584	10916	0.08019829473102297
M1	string	0	network_modules	499	TRUE	0.00886292015646532	359	7	4	0.5714285714285714	0.011142061281337047	REAC:R-HSA-3700989	REAC	Transcriptional Regulation by TP53	10916	2546		1	1	359	10557	4	3	355	10554	10916	0.07649295128814829
M1	string	0	network_modules	500	TRUE	3.39940504783872e-13	8	8	5	0.625	0.625	GO:1905821	GO:BP	positive regulation of chromosome condensation	16175	24931		0	0.041666666666666664	8	16167	5	3	3	16164	16175	0.6248144368157358
M1	string	0	network_modules	500	TRUE	1.5292592121052751e-12	10	8	5	0.625	0.5	GO:0060623	GO:BP	regulation of chromosome condensation	16175	14800		0.043478260869565216	0.08333333333333333	10	16165	5	3	5	16162	16175	0.5587749368667071
M1	string	0	network_modules	500	TRUE	1.788444053712415e-12	11	7	5	0.7142857142857143	0.45454545454545453	REAC:R-HSA-2514853	REAC	Condensation of Prometaphase Chromosomes	10916	394		0	0.3333333333333333	11	10905	5	2	6	10903	10916	0.5694685434310286
M1	string	0	network_modules	500	TRUE	5.193051123726955e-11	18	8	5	0.625	0.2777777777777778	GO:0007076	GO:BP	mitotic chromosome condensation	16175	2665		0.08695652173913043	0.125	18	16157	5	3	13	16154	16175	0.4162593525105982
M1	string	0	network_modules	500	TRUE	5.947524143599047e-10	28	8	5	0.625	0.17857142857142858	GO:0051984	GO:BP	positive regulation of chromosome segregation	16175	14046		0.13043478260869565	0.16666666666666666	28	16147	5	3	23	16144	16175	0.3335224755523794
M1	string	0	network_modules	500	TRUE	7.185479330991122e-10	29	8	5	0.625	0.1724137931034483	GO:1905820	GO:BP	positive regulation of chromosome separation	16175	24930		0.17391304347826086	0.20833333333333334	29	16146	5	3	24	16143	16175	0.32769928206254667
M1	string	0	network_modules	500	TRUE	1.1744975566378761e-9	98	8	6	0.75	0.061224489795918366	GO:2001252	GO:BP	positive regulation of chromosome organization	16175	26441		0.21739130434782608	0.25	98	16077	6	2	92	16075	16175	0.21325423777890984
M1	string	0	network_modules	500	TRUE	1.9624190300901937e-9	35	8	5	0.625	0.14285714285714285	GO:0030261	GO:BP	chromosome condensation	16175	6749		0.2608695652173913	0.2916666666666667	35	16140	5	3	30	16137	16175	0.2981690760822525
M1	string	0	network_modules	500	TRUE	7.276764421679634e-8	70	8	5	0.625	0.07142857142857142	GO:1905818	GO:BP	regulation of chromosome separation	16175	24928		0.30434782608695654	0.3333333333333333	70	16105	5	3	65	16102	16175	0.21033307274161087
M1	string	0	network_modules	500	TRUE	1.109739994913626e-7	76	8	5	0.625	0.06578947368421052	GO:0051304	GO:BP	chromosome separation	16175	13635		0.34782608695652173	0.375	76	16099	5	3	71	16096	16175	0.20177672668295896
M1	string	0	network_modules	500	TRUE	2.0630132103995416e-7	229	8	6	0.75	0.026200873362445413	GO:0033044	GO:BP	regulation of chromosome organization	16175	7999		0.391304347826087	0.4166666666666667	229	15946	6	2	223	15944	16175	0.13855293227015042
M1	string	0	network_modules	500	TRUE	1.3423769009193824e-6	124	8	5	0.625	0.04032258064516129	GO:0051983	GO:BP	regulation of chromosome segregation	16175	14045		0.43478260869565216	0.4583333333333333	124	16051	5	3	119	16048	16175	0.15744641044768345
M1	string	0	network_modules	500	TRUE	7.927590125152568e-6	420	8	6	0.75	0.014285714285714285	GO:0010638	GO:BP	positive regulation of organelle organization	16175	4284		0.4782608695652174	0.5	420	15755	6	2	414	15753	16175	0.10127439963988305
M1	string	0	network_modules	500	TRUE	8.318835492983443e-6	178	8	5	0.625	0.028089887640449437	GO:0000070	GO:BP	mitotic sister chromatid segregation	16175	24		0.5217391304347826	0.5416666666666666	178	15997	5	3	173	15994	16175	0.13092132186135566
M1	string	0	network_modules	500	TRUE	9.297403839193224e-6	199	7	5	0.7142857142857143	0.02512562814070352	REAC:R-HSA-68877	REAC	Mitotic Prometaphase	10916	1484		0.5	0.6666666666666666	199	10717	5	2	194	10715	10916	0.13179558140459355
M1	string	0	network_modules	500	TRUE	1.8632430595611444e-5	209	8	5	0.625	0.023923444976076555	GO:0090068	GO:BP	positive regulation of cell cycle process	16175	17994		0.5652173913043478	0.5833333333333334	209	15966	5	3	204	15963	16175	0.12056207489293817
M1	string	0	network_modules	500	TRUE	2.2494229200167033e-5	217	8	5	0.625	0.02304147465437788	GO:0000819	GO:BP	sister chromatid segregation	16175	237		0.6086956521739131	0.625	217	15958	5	3	212	15955	16175	0.11825288590155947
M1	string	0	network_modules	500	TRUE	3.764505493550919e-5	545	8	6	0.75	0.011009174311926606	GO:0051276	GO:BP	chromosome organization	16175	13613		0.6521739130434783	0.6666666666666666	545	15630	6	2	539	15628	16175	0.08830706066745274
M1	string	0	network_modules	500	TRUE	4.755699525730988e-5	252	8	5	0.625	0.01984126984126984	GO:0140014	GO:BP	mitotic nuclear division	16175	19633		0.6956521739130435	0.7083333333333334	252	15923	5	3	247	15920	16175	0.10946589568454525
M1	string	0	network_modules	500	TRUE	6.0007858228254695e-5	264	8	5	0.625	0.01893939393939394	GO:0045787	GO:BP	positive regulation of cell cycle	16175	11619		0.7391304347826086	0.75	264	15911	5	3	259	15908	16175	0.10685917960832066
M1	string	0	network_modules	500	TRUE	7.629283069297935e-5	277	8	5	0.625	0.018050541516245487	GO:0098813	GO:BP	nuclear chromosome segregation	16175	18900		0.782608695652174	0.7916666666666666	277	15898	5	3	272	15895	16175	0.10422636159153384
M1	string	0	network_modules	500	TRUE	8.932220525671921e-5	630	8	6	0.75	0.009523809523809525	GO:0010564	GO:BP	regulation of cell cycle process	16175	4217		0.8260869565217391	0.8333333333333334	630	15545	6	2	624	15543	16175	0.08175412601854568
M1	string	0	network_modules	500	TRUE	2.8548058624869874e-4	361	8	5	0.625	0.013850415512465374	GO:0007059	GO:BP	chromosome segregation	16175	2658		0.8695652173913043	0.875	361	15814	5	3	356	15811	16175	0.0907586512767164
M1	string	0	network_modules	500	TRUE	3.2654070151159496e-4	406	7	5	0.7142857142857143	0.012315270935960592	REAC:R-HSA-68886	REAC	M Phase	10916	1343		1	1	406	10510	5	2	401	10508	10916	0.09063663445243557
M1	string	0	network_modules	500	TRUE	3.6356510106829245e-4	379	8	5	0.625	0.013192612137203167	GO:0000280	GO:BP	nuclear division	16175	78		0.9130434782608695	0.9166666666666666	379	15796	5	3	374	15793	16175	0.08846402284270526
M1	string	0	network_modules	500	TRUE	6.343950893944259e-4	424	8	5	0.625	0.01179245283018868	GO:0048285	GO:BP	organelle fission	16175	12627		0.9565217391304348	0.9583333333333334	424	15751	5	3	419	15748	16175	0.08336998450093355
M1	string	0	network_modules	500	TRUE	0.0054663799517303225	656	8	5	0.625	0.007621951219512195	GO:1903047	GO:BP	mitotic cell cycle process	16175	22727		1	1	656	15519	5	3	651	15516	16175	0.06590727779086905
M1	string	0	network_modules	501	TRUE	0.006537366020356855	97	7	3	0.42857142857142855	0.030927835051546393	GO:0033108	GO:BP	mitochondrial respiratory chain complex assembly	16175	8042		0	0.25	97	16078	3	4	94	16074	16175	0.11388501579878973
M1	string	0	network_modules	501	TRUE	0.009287521322117232	109	7	3	0.42857142857142855	0.027522935779816515	GO:0097250	GO:BP	mitochondrial respirasome assembly	16175	18559		0.3333333333333333	0.5	109	16066	3	4	106	16062	16175	0.10728480192749004
M1	string	0	network_modules	501	TRUE	0.009612658981152065	12	7	2	0.2857142857142857	0.16666666666666666	GO:0034551	GO:BP	mitochondrial respiratory chain complex III assembly	16175	8677		0.6666666666666666	1	12	16163	2	5	10	16158	16175	0.2177791757308338
M1	string	0	network_modules	501	TRUE	0.009612658981152065	12	7	2	0.2857142857142857	0.16666666666666666	GO:0017062	GO:BP	respiratory chain complex III assembly	16175	5279		0.6666666666666666	1	12	16163	2	5	10	16158	16175	0.2177791757308338
M1	string	0	network_modules	506	TRUE	0.006291151474416468	31	5	2	0.4	0.06451612903225806	KEGG:03060	KEGG	Protein export	8484	217		NA	1	31	8453	2	3	29	8450	8484	0.15951503068985615
M1	string	0	network_modules	506	TRUE	0.009161773496589474	19	6	2	0.3333333333333333	0.10526315789473684	REAC:R-HSA-9609523	REAC	Insertion of tail-anchored proteins into the endoplasmic reticulum membrane	10916	1207		NA	1	19	10897	2	4	17	10893	10916	0.18655270573943536
M1	string	0	network_modules	508	TRUE	0.002066278881203097	70	7	3	0.42857142857142855	0.04285714285714286	REAC:R-HSA-9013026	REAC	RHOB GTPase cycle	10916	1860		0	0.5	70	10846	3	4	67	10842	10916	0.1339714095216808
M1	string	0	network_modules	508	TRUE	0.002444221436922124	74	7	3	0.42857142857142855	0.04054054054054054	REAC:R-HSA-9013106	REAC	RHOC GTPase cycle	10916	1865		1	1	74	10842	3	4	71	10838	10916	0.13021117361565246
M1	string	0	network_modules	509	TRUE	1.2303223631162788e-8	4	4	3	0.75	0.75	REAC:R-HSA-111957	REAC	Cam-PDE 1 activation	10916	303		0	0.1	4	10912	3	1	1	10911	10916	0.749908357771261
M1	string	0	network_modules	509	TRUE	2.0088257574598276e-5	35	4	3	0.75	0.08571428571428572	REAC:R-HSA-111997	REAC	CaM pathway	10916	297		0.1111111111111111	0.3	35	10881	3	1	32	10880	10916	0.25291440205520815
M1	string	0	network_modules	509	TRUE	2.0088257574598276e-5	35	4	3	0.75	0.08571428571428572	REAC:R-HSA-111933	REAC	Calmodulin induced events	10916	301		0.1111111111111111	0.3	35	10881	3	1	32	10880	10916	0.25291440205520815
M1	string	0	network_modules	509	TRUE	2.384480671719599e-5	37	4	3	0.75	0.08108108108108109	REAC:R-HSA-111996	REAC	Ca-dependent events	10916	294		0.3333333333333333	0.4	37	10879	3	1	34	10878	10916	0.24594617648151854
M1	string	0	network_modules	509	TRUE	3.2704710416246626e-5	41	4	3	0.75	0.07317073170731707	REAC:R-HSA-1489509	REAC	DAG and IP3 signaling	10916	431		0.4444444444444444	0.5	41	10875	3	1	38	10874	10916	0.23356924751547856
M1	string	0	network_modules	509	TRUE	5.649338016990162e-5	49	4	3	0.75	0.061224489795918366	REAC:R-HSA-112043	REAC	PLC beta mediated events	10916	1693		0.5555555555555556	0.6	49	10867	3	1	46	10866	10916	0.21352200013215092
M1	string	0	network_modules	509	TRUE	7.60301109134878e-5	54	4	3	0.75	0.05555555555555555	REAC:R-HSA-112040	REAC	G-protein mediated events	10916	998		0.6666666666666666	0.7	54	10862	3	1	51	10861	10916	0.20331845935036733
M1	string	0	network_modules	509	TRUE	2.495000079959669e-4	69	5	3	0.6	0.043478260869565216	KEGG:04924	KEGG	Renin secretion	8484	381		0	0.25	69	8415	3	2	66	8413	8484	0.16002428567798577
M1	string	0	network_modules	509	TRUE	3.4726018636722504e-4	89	4	3	0.75	0.033707865168539325	REAC:R-HSA-111885	REAC	Opioid Signalling	10916	1642		0.7777777777777778	0.8	89	10827	3	1	86	10826	10916	0.15794523113865327
M1	string	0	network_modules	509	TRUE	4.6900499075772296e-4	85	5	3	0.6	0.03529411764705882	KEGG:04742	KEGG	Taste transduction	8484	361		0.3333333333333333	0.5	85	8399	3	2	82	8397	8484	0.14385607949953708
M1	string	0	network_modules	509	TRUE	5.388696018601498e-4	89	5	3	0.6	0.033707865168539325	KEGG:05032	KEGG	Morphine addiction	8484	420		0.6666666666666666	0.75	89	8395	3	2	86	8393	8484	0.14050731045787554
M1	string	0	network_modules	509	TRUE	0.0015343594431677125	126	5	3	0.6	0.023809523809523808	KEGG:00230	KEGG	Purine metabolism	8484	22		1	1	126	8358	3	2	123	8356	8484	0.11747433507388132
M1	string	0	network_modules	509	TRUE	0.0017597137558513893	15	4	2	0.5	0.13333333333333333	REAC:R-HSA-418457	REAC	cGMP effects	10916	2691		0.8888888888888888	0.9	15	10901	2	2	13	10899	10916	0.25771360850700775
M1	string	0	network_modules	509	TRUE	0.0035168464095975726	21	4	2	0.5	0.09523809523809523	REAC:R-HSA-392154	REAC	Nitric oxide stimulates guanylate cyclase	10916	1601		1	1	21	10895	2	2	19	10893	10916	0.21762755623977673
M1	string	0	network_modules	513	TRUE	8.822045940629566e-5	16	2	2	1	0.125	KEGG:00430	KEGG	Taurine and hypotaurine metabolism	8484	56		NA	1	16	8468	2	0	14	8468	8484	0.3532614905925574
M1	string	0	network_modules	515	TRUE	1.0290130656105292e-4	42	5	3	0.6	0.07142857142857142	REAC:R-HSA-9035034	REAC	RHOF GTPase cycle	10916	1867		NA	1	42	10874	3	2	39	10872	10916	0.206136199721145
M1	string	0	network_modules	516	TRUE	1.5430149323840482e-6	182	6	5	0.8333333333333334	0.027472527472527472	REAC:R-HSA-6791226	REAC	Major pathway of rRNA processing in the nucleolus and cytosol	10916	1389		0	0.3333333333333333	182	10734	5	1	177	10733	10916	0.14957254017432592
M1	string	0	network_modules	516	TRUE	2.0204406965143273e-6	192	6	5	0.8333333333333334	0.026041666666666668	REAC:R-HSA-8868773	REAC	rRNA processing in the nucleus and cytosol	10916	2734		0.5	0.6666666666666666	192	10724	5	1	187	10723	10916	0.14552978904488523
M1	string	0	network_modules	516	TRUE	2.609139594691586e-6	202	6	5	0.8333333333333334	0.024752475247524754	REAC:R-HSA-72312	REAC	rRNA processing	10916	2732		1	1	202	10714	5	1	197	10713	10916	0.1417886349479296
M1	string	0	network_modules	518	TRUE	8.065234896082145e-5	157	6	4	0.6666666666666666	0.025477707006369428	KEGG:04390	KEGG	Hippo signaling pathway	8484	310		0	0.25	157	8327	4	2	153	8325	8484	0.12794358932179276
M1	string	0	network_modules	518	TRUE	2.93016005002299e-4	58	6	3	0.5	0.05172413793103448	KEGG:05213	KEGG	Endometrial cancer	8484	464		0.3333333333333333	0.5	58	8426	3	3	55	8423	8484	0.15921935885125083
M1	string	0	network_modules	518	TRUE	0.0019081129309480153	257	7	4	0.5714285714285714	0.01556420233463035	GO:0060070	GO:BP	canonical Wnt signaling pathway	16175	14332		0	0.3333333333333333	257	15918	4	3	253	15915	16175	0.09244204998967975
M1	string	0	network_modules	518	TRUE	0.004881527570650452	14	6	2	0.3333333333333333	0.14285714285714285	REAC:R-HSA-5467337	REAC	APC truncation mutants have impaired AXIN binding	10916	22		0	0.46153846153846156	14	10902	2	4	12	10898	10916	0.2175776176442625
M1	string	0	network_modules	518	TRUE	0.004881527570650452	14	6	2	0.3333333333333333	0.14285714285714285	REAC:R-HSA-4839744	REAC	Signaling by APC mutants	10916	2221		0	0.46153846153846156	14	10902	2	4	12	10898	10916	0.2175776176442625
M1	string	0	network_modules	518	TRUE	0.004881527570650452	14	6	2	0.3333333333333333	0.14285714285714285	REAC:R-HSA-5467348	REAC	Truncations of AMER1 destabilize the destruction complex	10916	2609		0	0.46153846153846156	14	10902	2	4	12	10898	10916	0.2175776176442625
M1	string	0	network_modules	518	TRUE	0.004881527570650452	14	6	2	0.3333333333333333	0.14285714285714285	REAC:R-HSA-4839735	REAC	Signaling by AXIN mutants	10916	2222		0	0.46153846153846156	14	10902	2	4	12	10898	10916	0.2175776176442625
M1	string	0	network_modules	518	TRUE	0.004881527570650452	14	6	2	0.3333333333333333	0.14285714285714285	REAC:R-HSA-4839748	REAC	Signaling by AMER1 mutants	10916	2220		0	0.46153846153846156	14	10902	2	4	12	10898	10916	0.2175776176442625
M1	string	0	network_modules	518	TRUE	0.004881527570650452	14	6	2	0.3333333333333333	0.14285714285714285	REAC:R-HSA-5467340	REAC	AXIN missense mutants destabilize the destruction complex	10916	42		0	0.46153846153846156	14	10902	2	4	12	10898	10916	0.2175776176442625
M1	string	0	network_modules	518	TRUE	0.004907742810305817	148	6	3	0.5	0.02027027027027027	KEGG:05226	KEGG	Gastric cancer	8484	477		0.6666666666666666	0.75	148	8336	3	3	145	8333	8484	0.09805439100676794
M1	string	0	network_modules	518	TRUE	0.005631154960289099	15	6	2	0.3333333333333333	0.13333333333333333	REAC:R-HSA-5339716	REAC	Signaling by GSK3beta mutants	10916	2257		0.5	0.9230769230769231	15	10901	2	4	13	10897	10916	0.21015159549681772
M1	string	0	network_modules	518	TRUE	0.005631154960289099	15	6	2	0.3333333333333333	0.13333333333333333	REAC:R-HSA-4839743	REAC	Signaling by CTNNB1 phospho-site mutants	10916	2228		0.5	0.9230769230769231	15	10901	2	4	13	10897	10916	0.21015159549681772
M1	string	0	network_modules	518	TRUE	0.005631154960289099	15	6	2	0.3333333333333333	0.13333333333333333	REAC:R-HSA-5358752	REAC	CTNNB1 T41 mutants aren't phosphorylated	10916	292		0.5	0.9230769230769231	15	10901	2	4	13	10897	10916	0.21015159549681772
M1	string	0	network_modules	518	TRUE	0.005631154960289099	15	6	2	0.3333333333333333	0.13333333333333333	REAC:R-HSA-5358751	REAC	CTNNB1 S45 mutants aren't phosphorylated	10916	291		0.5	0.9230769230769231	15	10901	2	4	13	10897	10916	0.21015159549681772
M1	string	0	network_modules	518	TRUE	0.005631154960289099	15	6	2	0.3333333333333333	0.13333333333333333	REAC:R-HSA-5358749	REAC	CTNNB1 S37 mutants aren't phosphorylated	10916	290		0.5	0.9230769230769231	15	10901	2	4	13	10897	10916	0.21015159549681772
M1	string	0	network_modules	518	TRUE	0.005631154960289099	15	6	2	0.3333333333333333	0.13333333333333333	REAC:R-HSA-5358747	REAC	CTNNB1 S33 mutants aren't phosphorylated	10916	289		0.5	0.9230769230769231	15	10901	2	4	13	10897	10916	0.21015159549681772
M1	string	0	network_modules	518	TRUE	0.00615184196316859	345	7	4	0.5714285714285714	0.011594202898550725	GO:0016055	GO:BP	Wnt signaling pathway	16175	5087		0.5	0.6666666666666666	345	15830	4	3	341	15827	16175	0.07922391380914652
M1	string	0	network_modules	518	TRUE	0.007290120826219926	17	6	2	0.3333333333333333	0.11764705882352941	REAC:R-HSA-196299	REAC	Beta-catenin phosphorylation cascade	10916	217		1	1	17	10899	2	4	15	10895	10916	0.19731219996961333
M1	string	0	network_modules	518	TRUE	0.007525812129294249	363	7	4	0.5714285714285714	0.011019283746556474	GO:0043161	GO:BP	proteasome-mediated ubiquitin-dependent protein catabolic process	16175	10561		1	1	363	15812	4	3	359	15809	16175	0.07712232849353681
M1	string	0	network_modules	518	TRUE	0.007944034410447748	174	6	3	0.5	0.017241379310344827	KEGG:04310	KEGG	Wnt signaling pathway	8484	299		1	1	174	8310	3	3	171	8307	8484	0.08999838729959335
M1	string	0	network_modules	519	TRUE	3.095840099275202e-5	253	7	5	0.7142857142857143	0.019762845849802372	REAC:R-HSA-1257604	REAC	PIP3 activates AKT signaling	10916	1679		0	0.14285714285714285	253	10663	5	2	248	10661	10916	0.11635002678941996
M1	string	0	network_modules	519	TRUE	5.179976954836386e-5	317	7	5	0.7142857142857143	0.015772870662460567	GO:0001558	GO:BP	regulation of cell growth	16175	348		0	0.07692307692307693	317	15858	5	2	312	15856	16175	0.10427995827949338
M1	string	0	network_modules	519	TRUE	6.444306942801418e-5	293	7	5	0.7142857142857143	0.017064846416382253	REAC:R-HSA-9006925	REAC	Intracellular signaling by second messengers	10916	1266		0.16666666666666666	0.2857142857142857	293	10623	5	2	288	10621	10916	0.10774577302876612
M1	string	0	network_modules	519	TRUE	9.509625149712587e-5	358	7	5	0.7142857142857143	0.013966480446927373	GO:0016049	GO:BP	cell growth	16175	5081		0.08333333333333333	0.15384615384615385	358	15817	5	2	353	15815	16175	0.09789568830238343
M1	string	0	network_modules	519	TRUE	9.934000281644561e-5	26	7	3	0.42857142857142855	0.11538461538461539	REAC:R-HSA-5674400	REAC	Constitutive Signaling by AKT1 E17K in Cancer	10916	400		0.3333333333333333	0.42857142857142855	26	10890	3	4	23	10886	10916	0.22147377783952463
M1	string	0	network_modules	519	TRUE	1.7450541259678558e-4	155	7	4	0.5714285714285714	0.025806451612903226	KEGG:04150	KEGG	mTOR signaling pathway	8484	284		NA	1	155	8329	4	3	151	8326	8484	0.1186905664498872
M1	string	0	network_modules	519	TRUE	1.82501382576633e-4	408	7	5	0.7142857142857143	0.012254901960784314	GO:0040008	GO:BP	regulation of growth	16175	9896		0.16666666666666666	0.23076923076923078	408	15767	5	2	403	15765	16175	0.09143628947277889
M1	string	0	network_modules	519	TRUE	2.720527866253793e-4	36	7	3	0.42857142857142855	0.08333333333333333	REAC:R-HSA-6804757	REAC	Regulation of TP53 Degradation	10916	2017		0.5	0.5714285714285714	36	10880	3	4	33	10876	10916	0.18789824213294584
M1	string	0	network_modules	519	TRUE	2.7259062352594205e-4	158	7	4	0.5714285714285714	0.02531645569620253	GO:0031929	GO:BP	TOR signaling	16175	7288		0.25	0.3076923076923077	158	16017	4	3	154	16014	16175	0.11882828823866949
M1	string	0	network_modules	519	TRUE	2.9597590984098567e-4	37	7	3	0.42857142857142855	0.08108108108108109	REAC:R-HSA-6806003	REAC	Regulation of TP53 Expression and Degradation	10916	2019		0.6666666666666666	0.7142857142857143	37	10879	3	4	34	10875	10916	0.18531027597041086
M1	string	0	network_modules	519	TRUE	4.377504613166454e-4	3	7	2	0.2857142857142857	0.6666666666666666	GO:1905857	GO:BP	positive regulation of pentose-phosphate shunt	16175	24967		0.3333333333333333	0.38461538461538464	3	16172	2	5	1	16167	16175	0.4362873362648091
M1	string	0	network_modules	519	TRUE	5.645829110897443e-4	512	7	5	0.7142857142857143	0.009765625	GO:0040007	GO:BP	growth	16175	9895		0.4166666666666667	0.46153846153846156	512	15663	5	2	507	15661	16175	0.08112959380325101
M1	string	0	network_modules	519	TRUE	7.25676846817398e-4	47	7	3	0.42857142857142855	0.06382978723404255	GO:0043470	GO:BP	regulation of carbohydrate catabolic process	16175	10718		0.5	0.5384615384615384	47	16128	3	4	44	16124	16175	0.1645487695451152
M1	string	0	network_modules	519	TRUE	0.0013780914522210912	58	7	3	0.42857142857142855	0.05172413793103448	GO:0034248	GO:BP	regulation of amide metabolic process	16175	8522		0.5833333333333334	0.6153846153846154	58	16117	3	4	55	16113	16175	0.1479392195758419
M1	string	0	network_modules	519	TRUE	0.0030617276505831527	7	7	2	0.2857142857142857	0.2857142857142857	GO:0043456	GO:BP	regulation of pentose-phosphate shunt	16175	10707		0.6666666666666666	0.6923076923076923	7	16168	2	5	5	16163	16175	0.2854050328691595
M1	string	0	network_modules	519	TRUE	0.004711579257946325	92	7	3	0.42857142857142855	0.03260869565217391	REAC:R-HSA-2219528	REAC	PI3K/AKT Signaling in Cancer	10916	1674		0.8333333333333334	0.8571428571428571	92	10824	3	4	89	10820	10916	0.11642060460659594
M1	string	0	network_modules	519	TRUE	0.005246512395443979	9	7	2	0.2857142857142857	0.2222222222222222	GO:1902031	GO:BP	regulation of NADP metabolic process	16175	21955		0.75	0.7692307692307693	9	16166	2	5	7	16161	16175	0.25161004852258095
M1	string	0	network_modules	519	TRUE	0.00886292015646532	359	7	4	0.5714285714285714	0.011142061281337047	REAC:R-HSA-3700989	REAC	Transcriptional Regulation by TP53	10916	2546		1	1	359	10557	4	3	355	10554	10916	0.07649295128814829
M1	string	0	network_modules	519	TRUE	0.009287521322117232	109	7	3	0.42857142857142855	0.027522935779816515	GO:0043467	GO:BP	regulation of generation of precursor metabolites and energy	16175	10715		0.8333333333333334	0.8461538461538461	109	16066	3	4	106	16062	16175	0.10728480192749004
M1	string	0	network_modules	519	TRUE	0.009612658981152065	12	7	2	0.2857142857142857	0.16666666666666666	GO:0071233	GO:BP	cellular response to L-leucine	16175	16495		0.9166666666666666	1	12	16163	2	5	10	16158	16175	0.2177791757308338
M1	string	0	network_modules	519	TRUE	0.009612658981152065	12	7	2	0.2857142857142857	0.16666666666666666	GO:0043201	GO:BP	response to L-leucine	16175	10575		0.9166666666666666	1	12	16163	2	5	10	16158	16175	0.2177791757308338
M1	string	0	network_modules	521	TRUE	0.0011084493568089505	57	7	3	0.42857142857142855	0.05263157894736842	REAC:R-HSA-75955	REAC	RNA Polymerase II Transcription Elongation	10916	1891		0	0.6666666666666666	57	10859	3	4	54	10855	10916	0.14879455011842774
M1	string	0	network_modules	521	TRUE	0.0011084493568089505	57	7	3	0.42857142857142855	0.05263157894736842	REAC:R-HSA-112382	REAC	Formation of RNA Pol II elongation complex 	10916	949		0	0.6666666666666666	57	10859	3	4	54	10855	10916	0.14879455011842774
M1	string	0	network_modules	521	TRUE	0.0030927571820933662	80	7	3	0.42857142857142855	0.0375	REAC:R-HSA-674695	REAC	RNA Polymerase II Pre-transcription Events	10916	1888		1	1	80	10836	3	4	77	10832	10916	0.12510452263556632
M1	string	0	network_modules	521	TRUE	0.007832670098017738	103	7	3	0.42857142857142855	0.02912621359223301	GO:0006368	GO:BP	transcription elongation by RNA polymerase II	16175	2143		NA	1	103	16072	3	4	100	16068	16175	0.11044180432551852
M1	string	0	network_modules	522	TRUE	2.3415478867410783e-9	10	7	4	0.5714285714285714	0.4	GO:0006086	GO:BP	acetyl-CoA biosynthetic process from pyruvate	16175	1951		0	0.04	10	16165	4	3	6	16162	16175	0.4778252890470576
M1	string	0	network_modules	522	TRUE	2.5582278949318204e-8	16	7	4	0.5714285714285714	0.25	REAC:R-HSA-9861718	REAC	Regulation of pyruvate metabolism	10916	2048		0	0.3333333333333333	16	10900	4	3	12	10897	10916	0.37739259319908736
M1	string	0	network_modules	522	TRUE	2.5582278949318204e-8	16	7	4	0.5714285714285714	0.25	REAC:R-HSA-204174	REAC	Regulation of pyruvate dehydrogenase (PDH) complex	10916	2047		0	0.3333333333333333	16	10900	4	3	12	10897	10916	0.37739259319908736
M1	string	0	network_modules	522	TRUE	2.650997397447179e-8	17	7	4	0.5714285714285714	0.23529411764705882	GO:0006085	GO:BP	acetyl-CoA biosynthetic process	16175	1950		0.041666666666666664	0.08	17	16158	4	3	13	16155	16175	0.3662767337082104
M1	string	0	network_modules	522	TRUE	8.041722307612325e-8	88	7	5	0.7142857142857143	0.056818181818181816	GO:0035383	GO:BP	thioester metabolic process	16175	9012		0.08333333333333333	0.16	88	16087	5	2	83	16085	16175	0.20051077104274997
M1	string	0	network_modules	522	TRUE	8.041722307612325e-8	88	7	5	0.7142857142857143	0.056818181818181816	GO:0006637	GO:BP	acyl-CoA metabolic process	16175	2348		0.08333333333333333	0.16	88	16087	5	2	83	16085	16175	0.20051077104274997
M1	string	0	network_modules	522	TRUE	2.276913932269135e-7	28	7	4	0.5714285714285714	0.14285714285714285	GO:0006084	GO:BP	acetyl-CoA metabolic process	16175	1949		0.16666666666666666	0.2	28	16147	4	3	24	16144	16175	0.28515732906130303
M1	string	0	network_modules	522	TRUE	3.840241763133778e-7	30	7	4	0.5714285714285714	0.13333333333333333	REAC:R-HSA-70268	REAC	Pyruvate metabolism	10916	1832		0.4	0.5	30	10886	4	3	26	10883	10916	0.27516518020124214
M1	string	0	network_modules	522	TRUE	9.476785864961046e-7	143	7	5	0.7142857142857143	0.03496503496503497	GO:0043604	GO:BP	amide biosynthetic process	16175	10796		0.20833333333333334	0.24	143	16032	5	2	138	16030	16175	0.15680734185580966
M1	string	0	network_modules	522	TRUE	1.1614634852597558e-6	389	7	6	0.8571428571428571	0.015424164524421594	GO:0043603	GO:BP	amide metabolic process	16175	10795		0.25	0.28	389	15786	6	1	383	15785	16175	0.11314829187605757
M1	string	0	network_modules	522	TRUE	1.2421256119578708e-6	42	7	4	0.5714285714285714	0.09523809523809523	GO:0071616	GO:BP	acyl-CoA biosynthetic process	16175	16800		0.2916666666666667	0.36	42	16133	4	3	38	16130	16175	0.2325770969609692
M1	string	0	network_modules	522	TRUE	1.2421256119578708e-6	42	7	4	0.5714285714285714	0.09523809523809523	GO:0035384	GO:BP	thioester biosynthetic process	16175	9013		0.2916666666666667	0.36	42	16133	4	3	38	16130	16175	0.2325770969609692
M1	string	0	network_modules	522	TRUE	1.7243862394029566e-6	43	7	4	0.5714285714285714	0.09302325581395349	REAC:R-HSA-5362517	REAC	Signaling by Retinoic Acid	10916	2303		0.6	0.6666666666666666	43	10873	4	3	39	10870	10916	0.22949271709861235
M1	string	0	network_modules	522	TRUE	3.261763332030542e-5	289	7	5	0.7142857142857143	0.01730103806228374	GO:0006790	GO:BP	sulfur compound metabolic process	16175	2476		0.375	0.4	289	15886	5	2	284	15884	16175	0.10939043327431967
M1	string	0	network_modules	522	TRUE	3.656978080488333e-5	96	7	4	0.5714285714285714	0.041666666666666664	GO:0006090	GO:BP	pyruvate metabolic process	16175	1953		0.4166666666666667	0.44	96	16079	4	3	92	16076	16175	0.15318901789418596
M1	string	0	network_modules	522	TRUE	2.7259062352594205e-4	158	7	4	0.5714285714285714	0.02531645569620253	GO:0044272	GO:BP	sulfur compound biosynthetic process	16175	10944		0.4583333333333333	0.48	158	16017	4	3	154	16014	16175	0.11882828823866949
M1	string	0	network_modules	522	TRUE	3.651173194911082e-4	469	7	5	0.7142857142857143	0.010660980810234541	GO:0072521	GO:BP	purine-containing compound metabolic process	16175	17423		0.5	0.52	469	15706	5	2	464	15704	16175	0.08498074970612263
M1	string	0	network_modules	522	TRUE	5.221106185921126e-4	504	7	5	0.7142857142857143	0.00992063492063492	GO:0032787	GO:BP	monocarboxylic acid metabolic process	16175	7822		0.5416666666666666	0.56	504	15671	5	2	499	15669	16175	0.0818093006170101
M1	string	0	network_modules	522	TRUE	5.361098375604535e-4	177	7	4	0.5714285714285714	0.022598870056497175	REAC:R-HSA-1428517	REAC	Aerobic respiration and respiratory electron transport	10916	127		0.8	0.8333333333333334	177	10739	4	3	173	10736	10916	0.11135553421455505
M1	string	0	network_modules	522	TRUE	6.15602626477451e-4	521	7	5	0.7142857142857143	0.009596928982725527	GO:0006753	GO:BP	nucleoside phosphate metabolic process	16175	2450		0.5833333333333334	0.6	521	15654	5	2	516	15652	16175	0.08038334808870135
M1	string	0	network_modules	522	TRUE	8.652405810432896e-4	558	7	5	0.7142857142857143	0.008960573476702509	GO:0055086	GO:BP	nucleobase-containing small molecule metabolic process	16175	14237		0.625	0.64	558	15617	5	2	553	15615	16175	0.07750375946025144
M1	string	0	network_modules	522	TRUE	8.753204739511672e-4	4	7	2	0.2857142857142857	0.5	GO:0050812	GO:BP	regulation of acyl-CoA biosynthetic process	16175	13276		0.6666666666666666	0.72	4	16171	2	5	2	16166	16175	0.37776578586754944
M1	string	0	network_modules	522	TRUE	8.753204739511672e-4	4	7	2	0.2857142857142857	0.5	GO:0010510	GO:BP	regulation of acetyl-CoA biosynthetic process from pyruvate	16175	4185		0.6666666666666666	0.72	4	16171	2	5	2	16166	16175	0.37776578586754944
M1	string	0	network_modules	522	TRUE	0.001026244126421133	220	7	4	0.5714285714285714	0.01818181818181818	GO:0072522	GO:BP	purine-containing compound biosynthetic process	16175	17424		0.75	0.76	220	15955	4	3	216	15952	16175	0.10020864884558581
M1	string	0	network_modules	522	TRUE	0.0013780914522210912	58	7	3	0.42857142857142855	0.05172413793103448	GO:0034248	GO:BP	regulation of amide metabolic process	16175	8522		0.7916666666666666	0.8	58	16117	3	4	55	16113	16175	0.1479392195758419
M1	string	0	network_modules	522	TRUE	0.0019984229093990675	260	7	4	0.5714285714285714	0.015384615384615385	GO:1901293	GO:BP	nucleoside phosphate biosynthetic process	16175	21368		0.8333333333333334	0.84	260	15915	4	3	256	15912	16175	0.09188515818040181
M1	string	0	network_modules	522	TRUE	0.003543343706806819	742	7	5	0.7142857142857143	0.006738544474393531	GO:0019752	GO:BP	carboxylic acid metabolic process	16175	6036		0.875	0.88	742	15433	5	2	737	15431	16175	0.06647870654450104
M1	string	0	network_modules	522	TRUE	0.0038175737282087237	290	7	4	0.5714285714285714	0.013793103448275862	REAC:R-HSA-9006931	REAC	Signaling by Nuclear Receptors	10916	2289		1	1	290	10626	4	3	286	10623	10916	0.08582676478987863
M1	string	0	network_modules	522	TRUE	0.004014026652267577	761	7	5	0.7142857142857143	0.006570302233902759	GO:0043436	GO:BP	oxoacid metabolic process	16175	10693		0.9166666666666666	0.92	761	15414	5	2	756	15412	16175	0.0655685826117856
M1	string	0	network_modules	522	TRUE	0.004172529577893091	767	7	5	0.7142857142857143	0.00651890482398957	GO:0006082	GO:BP	organic acid metabolic process	16175	1947		0.9583333333333334	0.96	767	15408	5	2	762	15406	16175	0.06528801680000376
M1	string	0	network_modules	522	TRUE	0.0065567886350286295	10	7	2	0.2857142857142857	0.2	GO:0042762	GO:BP	regulation of sulfur metabolic process	16175	10354		1	1	10	16165	2	5	8	16160	16175	0.23865388102180132
M1	string	0	network_modules	526	TRUE	5.537161593796388e-4	510	7	5	0.7142857142857143	0.00980392156862745	GO:0007169	GO:BP	cell surface receptor protein tyrosine kinase signaling pathway	16175	2733		0	0.5	510	15665	5	2	505	15663	16175	0.08129804958301036
M1	string	0	network_modules	526	TRUE	0.00482672483859787	790	7	5	0.7142857142857143	0.006329113924050633	GO:0007167	GO:BP	enzyme-linked receptor protein signaling pathway	16175	2731		1	1	790	15385	5	2	785	15383	16175	0.06424139617636149
M1	string	0	network_modules	528	TRUE	1.6094928259798723e-8	57	7	5	0.7142857142857143	0.08771929824561403	REAC:R-HSA-112382	REAC	Formation of RNA Pol II elongation complex 	10916	949		0	0.4	57	10859	5	2	52	10857	10916	0.2492144276474244
M1	string	0	network_modules	528	TRUE	1.6094928259798723e-8	57	7	5	0.7142857142857143	0.08771929824561403	REAC:R-HSA-75955	REAC	RNA Polymerase II Transcription Elongation	10916	1891		0	0.4	57	10859	5	2	52	10857	10916	0.2492144276474244
M1	string	0	network_modules	528	TRUE	9.208242847559048e-8	80	7	5	0.7142857142857143	0.0625	REAC:R-HSA-674695	REAC	RNA Polymerase II Pre-transcription Events	10916	1888		0.5	0.6	80	10836	5	2	75	10834	10916	0.20995856570067392
M1	string	0	network_modules	528	TRUE	1.7941961679220685e-7	103	7	5	0.7142857142857143	0.04854368932038835	GO:0006368	GO:BP	transcription elongation by RNA polymerase II	16175	2143		0	0.1	103	16072	5	2	98	16070	16175	0.18518016031937937
M1	string	0	network_modules	528	TRUE	3.5803829169544326e-7	118	7	5	0.7142857142857143	0.0423728813559322	GO:0006354	GO:BP	DNA-templated transcription elongation	16175	2131		0.1111111111111111	0.2	118	16057	5	2	113	16055	16175	0.1728643881474255
M1	string	0	network_modules	528	TRUE	5.90866177410357e-6	58	7	4	0.5714285714285714	0.06896551724137931	REAC:R-HSA-8866654	REAC	E3 ubiquitin ligases ubiquitinate target proteins	10916	811		0.75	0.8	58	10858	4	3	54	10855	10916	0.1972586379198841
M1	string	0	network_modules	528	TRUE	9.909955937403335e-6	12	7	3	0.42857142857142855	0.25	GO:0001711	GO:BP	endodermal cell fate commitment	16175	403		0.2222222222222222	0.3	12	16163	3	4	9	16159	16175	0.3269522423472795
M1	string	0	network_modules	528	TRUE	1.9777753833110216e-5	78	7	4	0.5714285714285714	0.05128205128205128	REAC:R-HSA-8852135	REAC	Protein ubiquitination	10916	1818		1	1	78	10838	4	3	74	10835	10916	0.16970523622952793
M1	string	0	network_modules	528	TRUE	5.1275395868352116e-5	20	7	3	0.42857142857142855	0.15	GO:0060795	GO:BP	cell fate commitment involved in formation of primary germ layer	16175	14961		0.3333333333333333	0.4	20	16155	3	4	17	16151	16175	0.2530259686439337
M1	string	0	network_modules	528	TRUE	5.527127071042539e-4	43	7	3	0.42857142857142855	0.06976744186046512	GO:0035987	GO:BP	endodermal cell differentiation	16175	9378		0.4444444444444444	0.5	43	16132	3	4	40	16128	16175	0.17211064252460476
M1	string	0	network_modules	528	TRUE	8.766783193757848e-4	50	7	3	0.42857142857142855	0.06	GO:0001706	GO:BP	endoderm formation	16175	398		0.5555555555555556	0.6	50	16125	3	4	47	16121	16175	0.15948127140133395
M1	string	0	network_modules	528	TRUE	0.0013070538122150978	57	7	3	0.42857142857142855	0.05263157894736842	GO:0007492	GO:BP	endoderm development	16175	2978		0.6666666666666666	0.7	57	16118	3	4	54	16114	16175	0.14924836868783609
M1	string	0	network_modules	528	TRUE	0.003654449412798811	80	7	3	0.42857142857142855	0.0375	GO:0001704	GO:BP	formation of primary germ layer	16175	396		0.7777777777777778	0.8	80	16095	3	4	77	16091	16175	0.12564835135362312
M1	string	0	network_modules	528	TRUE	0.006951964151748747	99	7	3	0.42857142857142855	0.030303030303030304	GO:0019827	GO:BP	stem cell population maintenance	16175	6046		0.8888888888888888	0.9	99	16076	3	4	96	16072	16175	0.11270281771282976
M1	string	0	network_modules	528	TRUE	0.007165639092817354	100	7	3	0.42857142857142855	0.03	GO:0098727	GO:BP	maintenance of cell number	16175	18856		1	1	100	16075	3	4	97	16071	16175	0.11212496426524005
M1	string	0	network_modules	529	TRUE	0.008295286235839682	32	4	2	0.5	0.0625	REAC:R-HSA-5576892	REAC	Phase 0 - rapid depolarisation	10916	1732		NA	1	32	10884	2	2	30	10882	10916	0.17603067354664229
M1	string	0	network_modules	530	TRUE	2.5965372710991172e-5	43	4	3	0.75	0.06976744186046512	KEGG:04975	KEGG	Fat digestion and absorption	8484	406		0	0.3333333333333333	43	8441	3	1	40	8440	8484	0.22783370355265659
M1	string	0	network_modules	530	TRUE	8.34033512605362e-5	63	4	3	0.75	0.047619047619047616	KEGG:00561	KEGG	Glycerolipid metabolism	8484	85		0.5	0.6666666666666666	63	8421	3	1	60	8420	8484	0.18785402750922708
M1	string	0	network_modules	530	TRUE	2.516643687567665e-4	6	4	2	0.5	0.3333333333333333	REAC:R-HSA-192456	REAC	Digestion of dietary lipid	10916	744		0	0.3333333333333333	6	10910	2	2	4	10908	10916	0.40798637869251825
M1	string	0	network_modules	530	TRUE	0.002462960227079048	24	4	2	0.5	0.08333333333333333	KEGG:04977	KEGG	Vitamin digestion and absorption	8484	408		1	1	24	8460	2	2	22	8458	8484	0.2033048983853568
M1	string	0	network_modules	530	TRUE	0.0038680579624495374	22	4	2	0.5	0.09090909090909091	REAC:R-HSA-8935690	REAC	Digestion	10916	741		0.5	0.6666666666666666	22	10894	2	2	20	10892	10916	0.21259460496347032
M1	string	0	network_modules	530	TRUE	0.005439410948319916	26	4	2	0.5	0.07692307692307693	REAC:R-HSA-8963743	REAC	Digestion and absorption	10916	742		1	1	26	10890	2	2	24	10888	10916	0.1954505803946764
M1	string	0	network_modules	537	TRUE	6.042910825552532e-7	56	5	4	0.8	0.07142857142857142	REAC:R-HSA-72187	REAC	mRNA 3'-end processing	10916	2701		0	0.08333333333333333	56	10860	4	1	52	10859	10916	0.2381789548701313
M1	string	0	network_modules	537	TRUE	1.1131755510359937e-6	65	5	4	0.8	0.06153846153846154	REAC:R-HSA-73856	REAC	RNA Polymerase II Transcription Termination	10916	1895		0.09090909090909091	0.16666666666666666	65	10851	4	1	61	10850	10916	0.22093781064708182
M1	string	0	network_modules	537	TRUE	1.5968368367598539e-6	71	5	4	0.8	0.056338028169014086	REAC:R-HSA-159236	REAC	Transport of Mature mRNA derived from an Intron-Containing Transcript	10916	2586		0.18181818181818182	0.25	71	10845	4	1	67	10844	10916	0.21130847874122619
M1	string	0	network_modules	537	TRUE	1.947754425612707e-6	276	5	5	1	0.018115942028985508	REAC:R-HSA-72203	REAC	Processing of Capped Intron-Containing Pre-mRNA	10916	1796		0.2727272727272727	0.3333333333333333	276	10640	5	0	271	10640	10916	0.13291347026262176
M1	string	0	network_modules	537	TRUE	2.597529500490791e-6	80	5	4	0.8	0.05	REAC:R-HSA-72202	REAC	Transport of Mature Transcript to Cytoplasm	10916	2584		0.36363636363636365	0.4166666666666667	80	10836	4	1	76	10835	10916	0.19894356596709661
M1	string	0	network_modules	537	TRUE	3.7042021140971147e-6	69	6	4	0.6666666666666666	0.057971014492753624	GO:0006406	GO:BP	mRNA export from nucleus	16175	2167		0	0.047619047619047616	69	16106	4	2	65	16104	16175	0.19578562666380656
M1	string	0	network_modules	537	TRUE	5.493455236444944e-6	76	6	4	0.6666666666666666	0.05263157894736842	GO:0051028	GO:BP	mRNA transport	16175	13445		0.05	0.09523809523809523	76	16099	4	2	72	16097	16175	0.18647006464555674
M1	string	0	network_modules	537	TRUE	1.092563620707678e-5	90	6	4	0.6666666666666666	0.044444444444444446	GO:0006405	GO:BP	RNA export from nucleus	16175	2166		0.1	0.14285714285714285	90	16085	4	2	86	16083	16175	0.1712045735542589
M1	string	0	network_modules	537	TRUE	1.8930086332446427e-5	18	6	3	0.5	0.16666666666666666	GO:0031053	GO:BP	primary miRNA processing	16175	7015		0.15	0.19047619047619047	18	16157	3	3	15	16154	16175	0.2882465085833545
M1	string	0	network_modules	537	TRUE	2.8464297275770593e-5	114	6	4	0.6666666666666666	0.03508771929824561	GO:0050658	GO:BP	RNA transport	16175	13198		0.2	0.2857142857142857	114	16061	4	2	110	16059	16175	0.15189119943701937
M1	string	0	network_modules	537	TRUE	2.8464297275770593e-5	114	6	4	0.6666666666666666	0.03508771929824561	GO:0050657	GO:BP	nucleic acid transport	16175	13197		0.2	0.2857142857142857	114	16061	4	2	110	16059	16175	0.15189119943701937
M1	string	0	network_modules	537	TRUE	3.161499474640472e-5	117	6	4	0.6666666666666666	0.03418803418803419	GO:0051236	GO:BP	establishment of RNA localization	16175	13586		0.3	0.3333333333333333	117	16058	4	2	113	16056	16175	0.1499030739516669
M1	string	0	network_modules	537	TRUE	8.382647504587276e-5	149	6	4	0.6666666666666666	0.026845637583892617	GO:0006403	GO:BP	RNA localization	16175	2164		0.35	0.38095238095238093	149	16026	4	2	145	16024	16175	0.13256797134240092
M1	string	0	network_modules	537	TRUE	9.083041056793457e-5	152	6	4	0.6666666666666666	0.02631578947368421	GO:0051168	GO:BP	nuclear export	16175	13551		0.4	0.42857142857142855	152	16023	4	2	148	16021	16175	0.13122847124906037
M1	string	0	network_modules	537	TRUE	9.933759332209239e-5	108	3	3	1	0.027777777777777776	KEGG:03013	KEGG	Nucleocytoplasmic transport	8484	209		0	0.5	108	8376	3	0	105	8376	8484	0.16563173546107776
M1	string	0	network_modules	537	TRUE	1.3584959171314683e-4	168	6	4	0.6666666666666666	0.023809523809523808	GO:0015931	GO:BP	nucleobase-containing compound transport	16175	5016		0.45	0.47619047619047616	168	16007	4	2	164	16005	16175	0.12469759210534762
M1	string	0	network_modules	537	TRUE	2.2850126871258968e-4	40	6	3	0.5	0.075	GO:0035196	GO:BP	miRNA processing	16175	8885		0.5	0.5238095238095238	40	16135	3	3	37	16132	16175	0.19296589117038332
M1	string	0	network_modules	537	TRUE	4.1987888369615883e-4	174	3	3	1	0.017241379310344827	KEGG:03040	KEGG	Spliceosome	8484	215		1	1	174	8310	3	0	171	8310	8484	0.12997594494547624
M1	string	0	network_modules	537	TRUE	5.551168117512626e-4	73	5	3	0.6	0.0410958904109589	REAC:R-HSA-6807505	REAC	RNA polymerase II transcribes snRNA genes	10916	1904		0.45454545454545453	0.5	73	10843	3	2	70	10841	10916	0.15583451039218937
M1	string	0	network_modules	537	TRUE	5.637774700037587e-4	4	6	2	0.3333333333333333	0.5	GO:0031442	GO:BP	positive regulation of mRNA 3'-end processing	16175	7168		0.55	0.6190476190476191	4	16171	2	4	2	16167	16175	0.4080715603825347
M1	string	0	network_modules	537	TRUE	5.637774700037587e-4	4	6	2	0.3333333333333333	0.5	GO:0006408	GO:BP	snRNA export from nucleus	16175	2168		0.55	0.6190476190476191	4	16171	2	4	2	16167	16175	0.4080715603825347
M1	string	0	network_modules	537	TRUE	7.942135159647462e-4	261	6	4	0.6666666666666666	0.01532567049808429	GO:0006913	GO:BP	nucleocytoplasmic transport	16175	2562		0.65	0.7142857142857143	261	15914	4	2	257	15912	16175	0.09945718654056294
M1	string	0	network_modules	537	TRUE	7.942135159647462e-4	261	6	4	0.6666666666666666	0.01532567049808429	GO:0051169	GO:BP	nuclear transport	16175	13552		0.65	0.7142857142857143	261	15914	4	2	257	15912	16175	0.09945718654056294
M1	string	0	network_modules	537	TRUE	9.394741790157856e-4	5	6	2	0.3333333333333333	0.4	GO:0051030	GO:BP	snRNA transport	16175	13447		0.75	0.7619047619047619	5	16170	2	4	3	16166	16175	0.36493383771979027
M1	string	0	network_modules	537	TRUE	0.0010067013198139395	65	6	3	0.5	0.046153846153846156	GO:0070918	GO:BP	regulatory ncRNA processing	16175	16370		0.8	0.8095238095238095	65	16110	3	3	62	16107	16175	0.1510216886096173
M1	string	0	network_modules	537	TRUE	0.0014731549935844454	10	5	2	0.4	0.2	REAC:R-HSA-111367	REAC	SLBP independent Processing of Histone Pre-mRNAs	10916	2144		0.5454545454545454	0.5833333333333334	10	10906	2	3	8	10903	10916	0.2823889684611204
M1	string	0	network_modules	537	TRUE	0.0018001927016410263	11	5	2	0.4	0.18181818181818182	REAC:R-HSA-77588	REAC	SLBP Dependent Processing of Replication-Dependent Histone Pre-mRNAs	10916	2143		0.6363636363636364	0.6666666666666666	11	10905	2	3	9	10902	10916	0.2691978540546046
M1	string	0	network_modules	537	TRUE	0.00197224517358476	7	6	2	0.3333333333333333	0.2857142857142857	GO:0002191	GO:BP	cap-dependent translational initiation	16175	735		0.85	0.8571428571428571	7	16168	2	4	5	16164	16175	0.3083299398805696
M1	string	0	network_modules	537	TRUE	0.003379876718209125	9	6	2	0.3333333333333333	0.2222222222222222	GO:0031440	GO:BP	regulation of mRNA 3'-end processing	16175	7166		0.9	0.9047619047619048	9	16166	2	4	7	16162	16175	0.2718372629362925
M1	string	0	network_modules	537	TRUE	0.005001384993362142	18	5	2	0.4	0.1111111111111111	REAC:R-HSA-8851708	REAC	Signaling by FGFR2 IIIa TM	10916	2245		0.7272727272727273	0.75	18	10898	2	3	16	10895	10916	0.21017088694923294
M1	string	0	network_modules	537	TRUE	0.005218559398169767	112	6	3	0.5	0.026785714285714284	GO:0031047	GO:BP	regulatory ncRNA-mediated gene silencing	16175	7011		0.95	0.9523809523809523	112	16063	3	3	109	16060	16175	0.1145432820700676
M1	string	0	network_modules	537	TRUE	0.005588758144257042	19	5	2	0.4	0.10526315789473684	REAC:R-HSA-77595	REAC	Processing of Intronless Pre-mRNAs	10916	1799		0.8181818181818182	0.8333333333333334	19	10897	2	3	17	10894	10916	0.2045276598933455
M1	string	0	network_modules	537	TRUE	0.006022621068109906	434	6	4	0.6666666666666666	0.009216589861751152	GO:0010608	GO:BP	post-transcriptional regulation of gene expression	16175	4255		1	1	434	15741	4	2	430	15739	16175	0.076275558356137
M1	string	0	network_modules	537	TRUE	0.007545572771065852	22	5	2	0.4	0.09090909090909091	REAC:R-HSA-167242	REAC	Abortive elongation of HIV-1 transcript in the absence of Tat	10916	51		0.9090909090909091	0.9166666666666666	22	10894	2	3	20	10891	10916	0.18996671092011097
M1	string	0	network_modules	537	TRUE	0.009794053691391271	25	5	2	0.4	0.08	REAC:R-HSA-6803529	REAC	FGFR2 alternative splicing	10916	905		1	1	25	10891	2	3	23	10888	10916	0.17810603801751362
M1	string	0	network_modules	538	TRUE	2.2510916143016495e-7	35	6	4	0.6666666666666666	0.11428571428571428	GO:0000184	GO:BP	nuclear-transcribed mRNA catabolic process, nonsense-mediated decay	16175	57		0	0.125	35	16140	4	2	31	16138	16175	0.2754795620338285
M1	string	0	network_modules	538	TRUE	8.270475998998244e-7	96	4	4	1	0.041666666666666664	KEGG:03015	KEGG	mRNA surveillance pathway	8484	210		0	0.5	96	8388	4	0	92	8388	8484	0.20301384839835296
M1	string	0	network_modules	538	TRUE	1.3342203570738828e-6	108	4	4	1	0.037037037037037035	KEGG:03013	KEGG	Nucleocytoplasmic transport	8484	209		1	1	108	8376	4	0	104	8376	8484	0.19126633060818274
M1	string	0	network_modules	538	TRUE	2.7468281898756635e-5	113	6	4	0.6666666666666666	0.035398230088495575	GO:0000956	GO:BP	nuclear-transcribed mRNA catabolic process	16175	264		0.14285714285714285	0.25	113	16062	4	2	109	16060	16175	0.152571353441662
M1	string	0	network_modules	538	TRUE	2.1263109462100197e-4	116	3	3	1	0.02586206896551724	REAC:R-HSA-975957	REAC	Nonsense Mediated Decay (NMD) enhanced by the Exon Junction Complex (EJC)	10916	1606		0	0.5	116	10800	3	0	113	10800	10916	0.15998211460432948
M1	string	0	network_modules	538	TRUE	2.1263109462100197e-4	116	3	3	1	0.02586206896551724	REAC:R-HSA-927802	REAC	Nonsense-Mediated Decay (NMD)	10916	1608		0	0.5	116	10800	3	0	113	10800	10916	0.15998211460432948
M1	string	0	network_modules	538	TRUE	3.0298708813964646e-4	590	6	5	0.8333333333333334	0.00847457627118644	GO:0016071	GO:BP	mRNA metabolic process	16175	5098		0.2857142857142857	0.375	590	15585	5	1	585	15584	16175	0.08188030939454304
M1	string	0	network_modules	538	TRUE	4.4644611438169604e-4	226	6	4	0.6666666666666666	0.017699115044247787	GO:0006402	GO:BP	mRNA catabolic process	16175	2163		0.42857142857142855	0.5	226	15949	4	2	222	15947	16175	0.10711920235142287
M1	string	0	network_modules	538	TRUE	6.869068232902602e-4	171	3	3	1	0.017543859649122806	REAC:R-HSA-9010553	REAC	Regulation of expression of SLITs and ROBOs	10916	2031		0.6666666666666666	0.75	171	10745	3	0	168	10745	10916	0.131429756861652
M1	string	0	network_modules	538	TRUE	0.0010367127549954706	279	6	4	0.6666666666666666	0.014336917562724014	GO:0006401	GO:BP	RNA catabolic process	16175	2162		0.5714285714285714	0.625	279	15896	4	2	275	15894	16175	0.09608520271430347
M1	string	0	network_modules	538	TRUE	0.0013667371962638281	299	6	4	0.6666666666666666	0.013377926421404682	GO:0141188	GO:BP	nucleic acid catabolic process	16175	20075		0.7142857142857143	0.75	299	15876	4	2	295	15874	16175	0.09269765026331801
M1	string	0	network_modules	538	TRUE	0.001409022859242255	217	3	3	1	0.013824884792626729	REAC:R-HSA-376176	REAC	Signaling by ROBO receptors	10916	2301		1	1	217	10699	3	0	214	10699	10916	0.11642071886255495
M1	string	0	network_modules	538	TRUE	0.0061063066227532116	118	6	3	0.5	0.025423728813559324	GO:0045727	GO:BP	positive regulation of translation	16175	11569		0.8571428571428571	0.875	118	16057	3	3	115	16054	16175	0.11153005395501997
M1	string	0	network_modules	538	TRUE	0.006831451505866046	448	6	4	0.6666666666666666	0.008928571428571428	GO:0034655	GO:BP	nucleobase-containing compound catabolic process	16175	8711		1	1	448	15727	4	2	444	15725	16175	0.0750060996001674
M1	string	0	network_modules	539	TRUE	6.0249300019979846e-5	26	6	3	0.5	0.11538461538461539	GO:0048026	GO:BP	positive regulation of mRNA splicing, via spliceosome	16175	12477		0	0.08333333333333333	26	16149	3	3	23	16146	16175	0.23965716178343868
M1	string	0	network_modules	539	TRUE	8.463806846219475e-5	29	6	3	0.5	0.10344827586206896	GO:0050685	GO:BP	positive regulation of mRNA processing	16175	13216		0.09090909090909091	0.16666666666666666	29	16146	3	3	26	16143	16175	0.22685940145051087
M1	string	0	network_modules	539	TRUE	1.9515930799716397e-4	38	6	3	0.5	0.07894736842105263	GO:0033120	GO:BP	positive regulation of RNA splicing	16175	8044		0.18181818181818182	0.25	38	16137	3	3	35	16134	16175	0.1980157575422673
M1	string	0	network_modules	539	TRUE	2.1139312715169704e-4	39	6	3	0.5	0.07692307692307693	GO:0000387	GO:BP	spliceosomal snRNP assembly	16175	114		0.2727272727272727	0.3333333333333333	39	16136	3	3	36	16133	16175	0.19544238194756897
M1	string	0	network_modules	539	TRUE	4.065788120227219e-4	51	6	3	0.5	0.058823529411764705	REAC:R-HSA-194441	REAC	Metabolism of non-coding RNA	10916	1431		0	1	51	10865	3	3	48	10862	10916	0.17034118576543844
M1	string	0	network_modules	539	TRUE	4.065788120227219e-4	51	6	3	0.5	0.058823529411764705	REAC:R-HSA-191859	REAC	snRNP Assembly	10916	2736		0	1	51	10865	3	3	48	10862	10916	0.17034118576543844
M1	string	0	network_modules	539	TRUE	0.001160602083009287	287	6	4	0.6666666666666666	0.013937282229965157	GO:0000398	GO:BP	mRNA splicing, via spliceosome	16175	121		0.36363636363636365	0.5	287	15888	4	2	283	15886	16175	0.09468825104623364
M1	string	0	network_modules	539	TRUE	0.001160602083009287	287	6	4	0.6666666666666666	0.013937282229965157	GO:0000377	GO:BP	RNA splicing, via transesterification reactions with bulged adenosine as nucleophile	16175	109		0.36363636363636365	0.5	287	15888	4	2	283	15886	16175	0.09468825104623364
M1	string	0	network_modules	539	TRUE	0.0012265331629529904	291	6	4	0.6666666666666666	0.013745704467353952	GO:0000375	GO:BP	RNA splicing, via transesterification reactions	16175	107		0.5454545454545454	0.5833333333333334	291	15884	4	2	287	15882	16175	0.09401122036528924
M1	string	0	network_modules	539	TRUE	0.002619268054737768	352	6	4	0.6666666666666666	0.011363636363636364	GO:0006397	GO:BP	mRNA processing	16175	2158		0.6363636363636364	0.6666666666666666	352	15823	4	2	348	15821	16175	0.08514479857126787
M1	string	0	network_modules	539	TRUE	0.0034892768748634112	98	6	3	0.5	0.030612244897959183	GO:0048024	GO:BP	regulation of mRNA splicing, via spliceosome	16175	12475		0.7272727272727273	0.75	98	16077	3	3	95	16074	16175	0.1226134470624237
M1	string	0	network_modules	539	TRUE	0.00422714797511519	397	6	4	0.6666666666666666	0.010075566750629723	GO:0008380	GO:BP	RNA splicing	16175	3186		0.8181818181818182	0.8333333333333334	397	15778	4	2	393	15776	16175	0.07994201152733926
M1	string	0	network_modules	539	TRUE	0.006263352764920577	119	6	3	0.5	0.025210084033613446	GO:0050684	GO:BP	regulation of mRNA processing	16175	13215		0.9090909090909091	0.9166666666666666	119	16056	3	3	116	16053	16175	0.1110499740022716
M1	string	0	network_modules	539	TRUE	0.00726213895816145	125	6	3	0.5	0.024	GO:1903313	GO:BP	positive regulation of mRNA metabolic process	16175	22897		1	1	125	16050	3	3	122	16047	16175	0.10829065115364309
M1	string	0	network_modules	540	TRUE	9.833642832243957e-5	3	5	2	0.4	0.6666666666666666	REAC:R-HSA-175567	REAC	Integration of viral DNA into host genomic DNA	10916	1215		0	0.2857142857142857	3	10913	2	3	1	10910	10916	0.5162321482100574
M1	string	0	network_modules	540	TRUE	9.833642832243957e-5	3	5	2	0.4	0.6666666666666666	REAC:R-HSA-177539	REAC	Autointegration results in viral DNA circles	10916	192		0	0.2857142857142857	3	10913	2	3	1	10910	10916	0.5162321482100574
M1	string	0	network_modules	540	TRUE	1.966368145217464e-4	4	5	2	0.4	0.5	REAC:R-HSA-180689	REAC	APOBEC3G mediated resistance to HIV-1 infection	10916	31		0.3333333333333333	0.42857142857142855	4	10912	2	3	2	10909	10916	0.44698817556185216
M1	string	0	network_modules	540	TRUE	6.878505125691542e-4	7	5	2	0.4	0.2857142857142857	REAC:R-HSA-164843	REAC	2-LTR circle formation	10916	1		0.5	0.5714285714285714	7	10909	2	3	5	10906	10916	0.33770535962789805
M1	string	0	network_modules	540	TRUE	0.0011787400692830035	9	5	2	0.4	0.2222222222222222	REAC:R-HSA-162592	REAC	Integration of provirus	10916	1214		0.6666666666666666	0.7142857142857143	9	10907	2	3	7	10904	10916	0.2977187878175293
M1	string	0	network_modules	540	TRUE	0.0029768627634029956	14	5	2	0.4	0.14285714285714285	REAC:R-HSA-162594	REAC	Early Phase of HIV Life Cycle	10916	831		0.8333333333333334	0.8571428571428571	14	10902	2	3	12	10899	10916	0.23848684005241802
M1	string	0	network_modules	540	TRUE	0.003924093907567078	16	5	2	0.4	0.125	REAC:R-HSA-2995383	REAC	Initiation of Nuclear Envelope (NE) Reformation	10916	1201		1	1	16	10900	2	3	14	10897	10916	0.22300195695873815
M1	string	0	network_modules	541	TRUE	3.5347814276778205e-7	39	6	4	0.6666666666666666	0.10256410256410256	GO:0000387	GO:BP	spliceosomal snRNP assembly	16175	114		0	0.1111111111111111	39	16136	4	2	35	16134	16175	0.26090552265705785
M1	string	0	network_modules	541	TRUE	3.8307085532423894e-5	390	6	5	0.8333333333333334	0.01282051282051282	GO:0022613	GO:BP	ribonucleoprotein complex biogenesis	16175	6620		0.125	0.2222222222222222	390	15785	5	1	385	15784	16175	0.10162286760969942
M1	string	0	network_modules	541	TRUE	1.7137653388990962e-4	178	6	4	0.6666666666666666	0.02247191011235955	GO:0022618	GO:BP	protein-RNA complex assembly	16175	6625		0.25	0.3333333333333333	178	15997	4	2	174	15995	16175	0.12106792369868356
M1	string	0	network_modules	541	TRUE	2.1343129947212707e-4	188	6	4	0.6666666666666666	0.02127659574468085	GO:0071826	GO:BP	protein-RNA complex organization	16175	16929		0.375	0.4444444444444444	188	15987	4	2	184	15985	16175	0.11772975951639882
M1	string	0	network_modules	541	TRUE	4.065788120227219e-4	51	6	3	0.5	0.058823529411764705	REAC:R-HSA-9754678	REAC	SARS-CoV-2 modulates host translation machinery	10916	2125		0	1	51	10865	3	3	48	10862	10916	0.17034118576543844
M1	string	0	network_modules	541	TRUE	4.065788120227219e-4	51	6	3	0.5	0.058823529411764705	REAC:R-HSA-194441	REAC	Metabolism of non-coding RNA	10916	1431		0	1	51	10865	3	3	48	10862	10916	0.17034118576543844
M1	string	0	network_modules	541	TRUE	4.065788120227219e-4	51	6	3	0.5	0.058823529411764705	REAC:R-HSA-191859	REAC	snRNP Assembly	10916	2736		0	1	51	10865	3	3	48	10862	10916	0.17034118576543844
M1	string	0	network_modules	541	TRUE	0.001160602083009287	287	6	4	0.6666666666666666	0.013937282229965157	GO:0000377	GO:BP	RNA splicing, via transesterification reactions with bulged adenosine as nucleophile	16175	109		0.5	0.6666666666666666	287	15888	4	2	283	15886	16175	0.09468825104623364
M1	string	0	network_modules	541	TRUE	0.001160602083009287	287	6	4	0.6666666666666666	0.013937282229965157	GO:0000398	GO:BP	mRNA splicing, via spliceosome	16175	121		0.5	0.6666666666666666	287	15888	4	2	283	15886	16175	0.09468825104623364
M1	string	0	network_modules	541	TRUE	0.0012265331629529904	291	6	4	0.6666666666666666	0.013745704467353952	GO:0000375	GO:BP	RNA splicing, via transesterification reactions	16175	107		0.75	0.7777777777777778	291	15884	4	2	287	15882	16175	0.09401122036528924
M1	string	0	network_modules	541	TRUE	0.002619268054737768	352	6	4	0.6666666666666666	0.011363636363636364	GO:0006397	GO:BP	mRNA processing	16175	2158		0.875	0.8888888888888888	352	15823	4	2	348	15821	16175	0.08514479857126787
M1	string	0	network_modules	541	TRUE	0.00422714797511519	397	6	4	0.6666666666666666	0.010075566750629723	GO:0008380	GO:BP	RNA splicing	16175	3186		1	1	397	15778	4	2	393	15776	16175	0.07994201152733926
M1	string	0	network_modules	545	TRUE	5.3304880545889984e-5	25	6	3	0.5	0.12	GO:0006783	GO:BP	heme biosynthetic process	16175	2469		0	0.125	25	16150	3	3	22	16147	16175	0.2444260585285185
M1	string	0	network_modules	545	TRUE	7.589297576628946e-5	28	6	3	0.5	0.10714285714285714	GO:0033014	GO:BP	tetrapyrrole biosynthetic process	16175	7979		0.14285714285714285	0.375	28	16147	3	3	25	16144	16175	0.23089642354241308
M1	string	0	network_modules	545	TRUE	7.589297576628946e-5	28	6	3	0.5	0.10714285714285714	GO:0006779	GO:BP	porphyrin-containing compound biosynthetic process	16175	2465		0.14285714285714285	0.375	28	16147	3	3	25	16144	16175	0.23089642354241308
M1	string	0	network_modules	545	TRUE	2.2850126871258968e-4	40	6	3	0.5	0.075	GO:0042168	GO:BP	heme metabolic process	16175	10001		0.42857142857142855	0.5	40	16135	3	3	37	16132	16175	0.19296589117038332
M1	string	0	network_modules	545	TRUE	2.8529914117340026e-4	43	6	3	0.5	0.06976744186046512	GO:0006778	GO:BP	porphyrin-containing compound metabolic process	16175	2464		0.5714285714285714	0.625	43	16132	3	3	40	16129	16175	0.1860607495690633
M1	string	0	network_modules	545	TRUE	3.0613202163219395e-4	44	6	3	0.5	0.06818181818181818	GO:0046148	GO:BP	pigment biosynthetic process	16175	11918		0.7142857142857143	0.75	44	16131	3	3	41	16128	16175	0.18391710703539552
M1	string	0	network_modules	545	TRUE	5.102671106323547e-4	52	6	3	0.5	0.057692307692307696	GO:0033013	GO:BP	tetrapyrrole metabolic process	16175	7978		0.8571428571428571	0.875	52	16123	3	3	49	16120	16175	0.16905279336959259
M1	string	0	network_modules	545	TRUE	0.0010067013198139395	65	6	3	0.5	0.046153846153846156	GO:0042440	GO:BP	pigment metabolic process	16175	10180		1	1	65	16110	3	3	62	16107	16175	0.1510216886096173
M1	string	0	network_modules	546	TRUE	9.394741790157856e-4	5	6	2	0.3333333333333333	0.4	GO:0006561	GO:BP	proline biosynthetic process	16175	2280		0	0.3333333333333333	5	16170	2	4	3	16166	16175	0.36493383771979027
M1	string	0	network_modules	546	TRUE	0.0042241491632657386	10	6	2	0.3333333333333333	0.2	GO:0006560	GO:BP	proline metabolic process	16175	2279		0.5	0.6666666666666666	10	16165	2	4	8	16161	16175	0.2578475355270565
M1	string	0	network_modules	546	TRUE	0.008536534460640288	14	6	2	0.3333333333333333	0.14285714285714285	GO:0009084	GO:BP	glutamine family amino acid biosynthetic process	16175	3257		1	1	14	16161	2	4	12	16157	16175	0.21778591592692415
M1	string	0	network_modules	555	TRUE	5.539737435446853e-5	2	5	2	0.4	1	GO:1903210	GO:BP	podocyte apoptotic process	16175	22828		0	0.375	2	16173	2	3	0	16170	16175	0.6323968708517073
M1	string	0	network_modules	555	TRUE	5.539737435446853e-5	2	5	2	0.4	1	GO:1904633	GO:BP	regulation of podocyte apoptotic process	16175	23973		0	0.375	2	16173	2	3	0	16170	16175	0.6323968708517073
M1	string	0	network_modules	555	TRUE	5.539737435446853e-5	2	5	2	0.4	1	GO:1904635	GO:BP	positive regulation of podocyte apoptotic process	16175	23975		0	0.375	2	16173	2	3	0	16170	16175	0.6323968708517073
M1	string	0	network_modules	555	TRUE	0.0015499758480338754	8	5	2	0.4	0.25	GO:0032429	GO:BP	regulation of phospholipase A2 activity	16175	7560		0.42857142857142855	0.5	8	16167	2	3	6	16164	16175	0.31596373083382445
M1	string	0	network_modules	555	TRUE	0.004446490933020022	17	5	2	0.4	0.11764705882352941	REAC:R-HSA-1482922	REAC	Acyl chain remodelling of PI	10916	115		0	0.3333333333333333	17	10899	2	3	15	10896	10916	0.21630386887908817
M1	string	0	network_modules	555	TRUE	0.005001384993362142	18	5	2	0.4	0.1111111111111111	REAC:R-HSA-1482925	REAC	Acyl chain remodelling of PG	10916	114		0.5	0.6666666666666666	18	10898	2	3	16	10895	10916	0.21017088694923294
M1	string	0	network_modules	555	TRUE	0.005033684027061729	14	5	2	0.4	0.14285714285714285	GO:0050482	GO:BP	arachidonate secretion	16175	13190		0.5714285714285714	0.875	14	16161	2	3	12	16158	16175	0.2386686524028136
M1	string	0	network_modules	555	TRUE	0.005033684027061729	14	5	2	0.4	0.14285714285714285	GO:1904037	GO:BP	positive regulation of epithelial cell apoptotic process	16175	23478		0.5714285714285714	0.875	14	16161	2	3	12	16158	16175	0.2386686524028136
M1	string	0	network_modules	555	TRUE	0.005033684027061729	14	5	2	0.4	0.14285714285714285	GO:1903963	GO:BP	arachidonate transport	16175	23420		0.5714285714285714	0.875	14	16161	2	3	12	16158	16175	0.2386686524028136
M1	string	0	network_modules	555	TRUE	0.007545572771065852	22	5	2	0.4	0.09090909090909091	REAC:R-HSA-1482801	REAC	Acyl chain remodelling of PS	10916	116		1	1	22	10894	2	3	20	10891	10916	0.18996671092011097
M1	string	0	network_modules	555	TRUE	0.009453051094839434	19	5	2	0.4	0.10526315789473684	GO:0010517	GO:BP	regulation of phospholipase activity	16175	4192		1	1	19	16156	2	3	17	16153	16175	0.20474500309377794
M1	string	0	network_modules	556	TRUE	7.473950283407794e-8	36	5	4	0.8	0.1111111111111111	GO:0006749	GO:BP	glutathione metabolic process	16175	2447		0	0.14285714285714285	36	16139	4	1	32	16138	16175	0.2976903696950193
M1	string	0	network_modules	556	TRUE	7.642456151116716e-8	34	5	4	0.8	0.11764705882352941	REAC:R-HSA-156590	REAC	Glutathione conjugation	10916	1058		0	0.3333333333333333	34	10882	4	1	30	10881	10916	0.3061387120631246
M1	string	0	network_modules	556	TRUE	4.1526849173820686e-7	56	5	4	0.8	0.07142857142857142	KEGG:00480	KEGG	Glutathione metabolism	8484	61		0	0.1	56	8428	4	1	52	8427	8484	0.2379298343509289
M1	string	0	network_modules	556	TRUE	8.657002887752952e-7	67	5	4	0.8	0.05970149253731343	KEGG:05204	KEGG	Chemical carcinogenesis - DNA adducts	8484	456		0.1111111111111111	0.2	67	8417	4	1	63	8416	8484	0.21730955270984226
M1	string	0	network_modules	556	TRUE	9.197192638032726e-7	68	5	4	0.8	0.058823529411764705	KEGG:00982	KEGG	Drug metabolism - cytochrome P450	8484	156		0.2222222222222222	0.3	68	8416	4	1	64	8415	8484	0.2156864850683743
M1	string	0	network_modules	556	TRUE	1.1614147567329924e-6	72	5	4	0.8	0.05555555555555555	KEGG:01524	KEGG	Platinum drug resistance	8484	198		0.3333333333333333	0.4	72	8412	4	1	68	8411	8484	0.20953460426410028
M1	string	0	network_modules	556	TRUE	1.2987103739864965e-6	74	5	4	0.8	0.05405405405405406	KEGG:00980	KEGG	Metabolism of xenobiotics by cytochrome P450	8484	154		0.4444444444444444	0.5	74	8410	4	1	70	8409	8484	0.20664667067583384
M1	string	0	network_modules	556	TRUE	1.6950660648556064e-6	79	5	4	0.8	0.05063291139240506	KEGG:00983	KEGG	Drug metabolism - other enzymes	8484	157		0.5555555555555556	0.6	79	8405	4	1	75	8404	8484	0.19991081159014754
M1	string	0	network_modules	556	TRUE	8.1431144627558e-6	106	5	4	0.8	0.03773584905660377	REAC:R-HSA-156580	REAC	Phase II - Conjugation of compounds	10916	1738		0.5	0.6666666666666666	106	10810	4	1	102	10809	10916	0.17251889760023242
M1	string	0	network_modules	556	TRUE	9.049008004344135e-6	116	5	4	0.8	0.034482758620689655	GO:0006805	GO:BP	xenobiotic metabolic process	16175	2487		0.16666666666666666	0.2857142857142857	116	16059	4	1	112	16058	16175	0.16522100437290702
M1	string	0	network_modules	556	TRUE	1.622525661733425e-5	138	5	4	0.8	0.028985507246376812	KEGG:05418	KEGG	Fluid shear stress and atherosclerosis	8484	495		0.6666666666666666	0.7	138	8346	4	1	134	8345	8484	0.15045386450503442
M1	string	0	network_modules	556	TRUE	2.1680159761235514e-5	144	5	4	0.8	0.027777777777777776	GO:0006575	GO:BP	modified amino acid metabolic process	16175	2294		0.3333333333333333	0.5714285714285714	144	16031	4	1	140	16030	16175	0.14809577559311887
M1	string	0	network_modules	556	TRUE	2.1680159761235514e-5	144	5	4	0.8	0.027777777777777776	GO:0071466	GO:BP	cellular response to xenobiotic stimulus	16175	16699		0.3333333333333333	0.5714285714285714	144	16031	4	1	140	16030	16175	0.14809577559311887
M1	string	0	network_modules	556	TRUE	3.413337960778085e-5	166	5	4	0.8	0.024096385542168676	KEGG:05225	KEGG	Hepatocellular carcinoma	8484	476		0.7777777777777778	0.8	166	8318	4	1	162	8317	8484	0.13683143729884634
M1	string	0	network_modules	556	TRUE	6.764646062927558e-5	191	5	4	0.8	0.020942408376963352	GO:0009410	GO:BP	response to xenobiotic stimulus	16175	3475		0.6666666666666666	0.7142857142857143	191	15984	4	1	187	15983	16175	0.12830591976547415
M1	string	0	network_modules	556	TRUE	8.941097110896547e-5	211	5	4	0.8	0.018957345971563982	KEGG:05207	KEGG	Chemical carcinogenesis - receptor activation	8484	459		0.8888888888888888	0.9	211	8273	4	1	207	8272	8484	0.12086900793230514
M1	string	0	network_modules	556	TRUE	1.076408033700575e-4	221	5	4	0.8	0.01809954751131222	KEGG:05208	KEGG	Chemical carcinogenesis - reactive oxygen species	8484	460		1	1	221	8263	4	1	217	8262	8484	0.11799450374876168
M1	string	0	network_modules	556	TRUE	1.4076078261635215e-4	215	5	4	0.8	0.018604651162790697	REAC:R-HSA-211859	REAC	Biological oxidations	10916	227		1	1	215	10701	4	1	211	10700	10916	0.1202122569032999
M1	string	0	network_modules	556	TRUE	3.5665334369477616e-4	289	5	4	0.8	0.01384083044982699	GO:0006790	GO:BP	sulfur compound metabolic process	16175	2476		0.8333333333333334	0.8571428571428571	289	15886	4	1	285	15885	16175	0.10382421292213626
M1	string	0	network_modules	556	TRUE	0.0011711240895696297	389	5	4	0.8	0.010282776349614395	GO:0043603	GO:BP	amide metabolic process	16175	10795		1	1	389	15786	4	1	385	15785	16175	0.08906303118526897
M1	string	0	network_modules	558	TRUE	3.0412949316680416e-7	191	5	5	1	0.02617801047120419	REAC:R-HSA-202733	REAC	Cell surface interactions at the vascular wall	10916	327		NA	1	191	10725	5	0	186	10725	10916	0.1604112012536602
M1	string	0	network_modules	558	TRUE	0.0047390123205378575	142	5	3	0.6	0.02112676056338028	GO:0016064	GO:BP	immunoglobulin mediated immune response	16175	5095		0	0.5	142	16033	3	2	139	16031	16175	0.11144807706232666
M1	string	0	network_modules	558	TRUE	0.0052588148648583695	147	5	3	0.6	0.02040816326530612	GO:0019724	GO:BP	B cell mediated immunity	16175	6019		1	1	147	16028	3	2	144	16026	16175	0.10949610838744646
M1	string	0	network_modules	559	TRUE	9.717871869283767e-4	84	5	3	0.6	0.03571428571428571	GO:2000781	GO:BP	positive regulation of double-strand break repair	16175	26037		0	0.3333333333333333	84	16091	3	2	81	16089	16175	0.145518780462203
M1	string	0	network_modules	559	TRUE	0.003386447348217797	127	5	3	0.6	0.023622047244094488	GO:0045739	GO:BP	positive regulation of DNA repair	16175	11579		0.5	0.6666666666666666	127	16048	3	2	124	16046	16175	0.11797568471397027
M1	string	0	network_modules	559	TRUE	0.0034673987084122824	128	5	3	0.6	0.0234375	GO:2000779	GO:BP	regulation of double-strand break repair	16175	26035		1	1	128	16047	3	2	125	16045	16175	0.11750533054266445
M1	string	0	network_modules	559	TRUE	0.004903587201999922	116	2	2	1	0.017241379310344827	KEGG:03082	KEGG	ATP-dependent chromatin remodeling	8484	219		NA	1	116	8368	2	0	114	8368	8484	0.13042105378207053
M1	string	0	network_modules	560	TRUE	0.003011516771019604	24	3	2	0.6666666666666666	0.08333333333333333	GO:0016973	GO:BP	poly(A)+ mRNA export from nucleus	16175	5260		NA	1	24	16151	2	1	22	16150	16175	0.23537416597204877
M1	string	0	network_modules	560	TRUE	0.0033523774574392333	96	2	2	1	0.020833333333333332	KEGG:03015	KEGG	mRNA surveillance pathway	8484	210		0	0.3333333333333333	96	8388	2	0	94	8388	8484	0.14353554351388856
M1	string	0	network_modules	560	TRUE	0.004247815120413137	108	2	2	1	0.018518518518518517	KEGG:03013	KEGG	Nucleocytoplasmic transport	8484	209		0.5	0.6666666666666666	108	8376	2	0	106	8376	8484	0.13522977341862624
M1	string	0	network_modules	560	TRUE	0.007051020218048176	139	2	2	1	0.014388489208633094	KEGG:03008	KEGG	Ribosome biogenesis in eukaryotes	8484	207		1	1	139	8345	2	0	137	8345	8484	0.11897936155119038
M1	string	0	network_modules	562	TRUE	8.626952474973194e-7	9	5	3	0.6	0.3333333333333333	GO:0030388	GO:BP	fructose 1,6-bisphosphate metabolic process	16175	6785		0	0.022222222222222223	9	16166	3	2	6	16164	16175	0.4469923155970298
M1	string	0	network_modules	562	TRUE	1.2987103739864965e-6	74	5	4	0.8	0.05405405405405406	KEGG:01230	KEGG	Biosynthesis of amino acids	8484	188		0	0.08333333333333333	74	8410	4	1	70	8409	8484	0.20664667067583384
M1	string	0	network_modules	562	TRUE	1.6942655221322317e-6	11	5	3	0.6	0.2727272727272727	GO:0006002	GO:BP	fructose 6-phosphate metabolic process	16175	1877		0.022727272727272728	0.044444444444444446	11	16164	3	2	8	16162	16175	0.4042613706465461
M1	string	0	network_modules	562	TRUE	5.747567084887296e-6	16	5	3	0.6	0.1875	GO:0061621	GO:BP	canonical glycolysis	16175	15590		0.045454545454545456	0.1111111111111111	16	16159	3	2	13	16157	16175	0.33507476086645344
M1	string	0	network_modules	562	TRUE	5.747567084887296e-6	16	5	3	0.6	0.1875	GO:0061718	GO:BP	glucose catabolic process to pyruvate	16175	15628		0.045454545454545456	0.1111111111111111	16	16159	3	2	13	16157	16175	0.33507476086645344
M1	string	0	network_modules	562	TRUE	5.747567084887296e-6	16	5	3	0.6	0.1875	GO:0006735	GO:BP	NADH regeneration	16175	2436		0.045454545454545456	0.1111111111111111	16	16159	3	2	13	16157	16175	0.33507476086645344
M1	string	0	network_modules	562	TRUE	6.978540898610422e-6	17	5	3	0.6	0.17647058823529413	GO:0061615	GO:BP	glycolytic process through fructose-6-phosphate	16175	15586		0.11363636363636363	0.15555555555555556	17	16158	3	2	14	16156	16175	0.3250467737153748
M1	string	0	network_modules	562	TRUE	6.978540898610422e-6	17	5	3	0.6	0.17647058823529413	GO:0061620	GO:BP	glycolytic process through glucose-6-phosphate	16175	15589		0.11363636363636363	0.15555555555555556	17	16158	3	2	14	16156	16175	0.3250467737153748
M1	string	0	network_modules	562	TRUE	7.772697333203904e-6	115	5	4	0.8	0.034782608695652174	KEGG:01200	KEGG	Carbon metabolism	8484	184		0.09090909090909091	0.16666666666666666	115	8369	4	1	111	8368	8484	0.16515663901824396
M1	string	0	network_modules	562	TRUE	9.942574959859881e-6	19	5	3	0.6	0.15789473684210525	GO:0006007	GO:BP	glucose catabolic process	16175	1882		0.1590909090909091	0.2	19	16156	3	2	16	16154	16175	0.3074190203017103
M1	string	0	network_modules	562	TRUE	9.942574959859881e-6	19	5	3	0.6	0.15789473684210525	GO:0019677	GO:BP	NAD catabolic process	16175	5995		0.1590909090909091	0.2	19	16156	3	2	16	16154	16175	0.3074190203017103
M1	string	0	network_modules	562	TRUE	2.1550088622821083e-5	31	5	3	0.6	0.0967741935483871	KEGG:00030	KEGG	Pentose phosphate pathway	8484	4		0.18181818181818182	0.25	31	8453	3	2	28	8451	8484	0.24000783508959087
M1	string	0	network_modules	562	TRUE	2.3775192628189677e-5	32	5	3	0.6	0.09375	KEGG:00052	KEGG	Galactose metabolism	8484	7		0.2727272727272727	0.3333333333333333	32	8452	3	2	29	8450	8484	0.23619522851542293
M1	string	0	network_modules	562	TRUE	2.8673449325303657e-5	34	5	3	0.6	0.08823529411764706	KEGG:00051	KEGG	Fructose and mannose metabolism	8484	6		0.36363636363636365	0.4166666666666667	34	8450	3	2	31	8448	8484	0.22907953569178954
M1	string	0	network_modules	562	TRUE	2.9990135192608108e-5	27	5	3	0.6	0.1111111111111111	GO:0006734	GO:BP	NADH metabolic process	16175	2435		0.20454545454545456	0.2222222222222222	27	16148	3	2	24	16146	16175	0.25773556882201987
M1	string	0	network_modules	562	TRUE	6.131430648965469e-5	34	5	3	0.6	0.08823529411764706	GO:0019320	GO:BP	hexose catabolic process	16175	5683		0.22727272727272727	0.24444444444444444	34	16141	3	2	31	16139	16175	0.22956025485666445
M1	string	0	network_modules	562	TRUE	7.959214974391446e-5	37	5	3	0.6	0.08108108108108109	GO:0046365	GO:BP	monosaccharide catabolic process	16175	12096		0.25	0.26666666666666666	37	16138	3	2	34	16136	16175	0.22000923774276243
M1	string	0	network_modules	562	TRUE	2.2820455669400283e-4	67	5	3	0.6	0.04477611940298507	KEGG:00010	KEGG	Glycolysis / Gluconeogenesis	8484	2		0.45454545454545453	0.5	67	8417	3	2	64	8415	8484	0.16244052365742412
M1	string	0	network_modules	562	TRUE	2.6062529380652095e-4	70	5	3	0.6	0.04285714285714286	KEGG:05230	KEGG	Central carbon metabolism in cancer	8484	478		0.5454545454545454	0.5833333333333334	70	8414	3	2	67	8412	8484	0.15885494245922877
M1	string	0	network_modules	562	TRUE	2.6828959967256514e-4	55	5	3	0.6	0.05454545454545454	GO:0019674	GO:BP	NAD metabolic process	16175	5993		0.2727272727272727	0.28888888888888886	55	16120	3	2	52	16118	16175	0.18021603985196236
M1	string	0	network_modules	562	TRUE	3.759044748410647e-4	79	5	3	0.6	0.0379746835443038	KEGG:03018	KEGG	RNA degradation	8484	211		0.6363636363636364	0.6666666666666666	79	8405	3	2	76	8403	8484	0.14934453969811057
M1	string	0	network_modules	562	TRUE	4.4760827294973925e-4	68	5	3	0.6	0.04411764705882353	REAC:R-HSA-70171	REAC	Glycolysis	10916	1074		0	0.5	68	10848	3	2	65	10846	10916	0.16154951387600847
M1	string	0	network_modules	562	TRUE	6.089390057081452e-4	72	5	3	0.6	0.041666666666666664	GO:0046032	GO:BP	ADP catabolic process	16175	11809		0.29545454545454547	0.3333333333333333	72	16103	3	2	69	16101	16175	0.1573156423106073
M1	string	0	network_modules	562	TRUE	6.089390057081452e-4	72	5	3	0.6	0.041666666666666664	GO:0006096	GO:BP	glycolytic process	16175	1956		0.29545454545454547	0.3333333333333333	72	16103	3	2	69	16101	16175	0.1573156423106073
M1	string	0	network_modules	562	TRUE	6.617457700809325e-4	74	5	3	0.6	0.04054054054054054	GO:0009181	GO:BP	purine ribonucleoside diphosphate catabolic process	16175	3347		0.3409090909090909	0.4	74	16101	3	2	71	16099	16175	0.1551526115929706
M1	string	0	network_modules	562	TRUE	6.617457700809325e-4	74	5	3	0.6	0.04054054054054054	GO:0046031	GO:BP	ADP metabolic process	16175	11808		0.3409090909090909	0.4	74	16101	3	2	71	16099	16175	0.1551526115929706
M1	string	0	network_modules	562	TRUE	6.617457700809325e-4	74	5	3	0.6	0.04054054054054054	GO:0009137	GO:BP	purine nucleoside diphosphate catabolic process	16175	3304		0.3409090909090909	0.4	74	16101	3	2	71	16099	16175	0.1551526115929706
M1	string	0	network_modules	562	TRUE	7.175131338733943e-4	76	5	3	0.6	0.039473684210526314	GO:0019364	GO:BP	pyridine nucleotide catabolic process	16175	5726		0.4090909090909091	0.4444444444444444	76	16099	3	2	73	16097	16175	0.15307523420884236
M1	string	0	network_modules	562	TRUE	7.175131338733943e-4	76	5	3	0.6	0.039473684210526314	GO:0009179	GO:BP	purine ribonucleoside diphosphate metabolic process	16175	3345		0.4090909090909091	0.4444444444444444	76	16099	3	2	73	16097	16175	0.15307523420884236
M1	string	0	network_modules	562	TRUE	7.465320352603341e-4	77	5	3	0.6	0.03896103896103896	GO:0009191	GO:BP	ribonucleoside diphosphate catabolic process	16175	3357		0.45454545454545453	0.4888888888888889	77	16098	3	2	74	16096	16175	0.15206691999180494
M1	string	0	network_modules	562	TRUE	7.465320352603341e-4	77	5	3	0.6	0.03896103896103896	GO:0009135	GO:BP	purine nucleoside diphosphate metabolic process	16175	3302		0.45454545454545453	0.4888888888888889	77	16098	3	2	74	16096	16175	0.15206691999180494
M1	string	0	network_modules	562	TRUE	7.589423194509473e-4	349	5	4	0.8	0.011461318051575931	GO:0006163	GO:BP	purine nucleotide metabolic process	16175	1998		0.5	0.5111111111111111	349	15826	4	1	345	15825	16175	0.09420889762405163
M1	string	0	network_modules	562	TRUE	8.068902333767612e-4	79	5	3	0.6	0.0379746835443038	GO:0072526	GO:BP	pyridine-containing compound catabolic process	16175	17428		0.5227272727272727	0.5333333333333333	79	16096	3	2	76	16094	16175	0.15010782153262459
M1	string	0	network_modules	562	TRUE	9.033782746862632e-4	82	5	3	0.6	0.036585365853658534	GO:0009134	GO:BP	nucleoside diphosphate catabolic process	16175	3301		0.5454545454545454	0.5555555555555556	82	16093	3	2	79	16091	16175	0.14730417163337642
M1	string	0	network_modules	562	TRUE	9.117745395114358e-4	86	5	3	0.6	0.03488372093023256	REAC:R-HSA-70326	REAC	Glucose metabolism	10916	1053		1	1	86	10830	3	2	83	10828	10916	0.14337180161125318
M1	string	0	network_modules	562	TRUE	9.388086789140868e-4	107	5	3	0.6	0.028037383177570093	KEGG:04922	KEGG	Glucagon signaling pathway	8484	379		0.7272727272727273	0.75	107	8377	3	2	104	8375	8484	0.12782102205342644
M1	string	0	network_modules	562	TRUE	9.92606721537306e-4	109	5	3	0.6	0.027522935779816515	KEGG:04066	KEGG	HIF-1 signaling pathway	8484	257		0.8181818181818182	0.8333333333333334	109	8375	3	2	106	8373	8484	0.12660721164327293
M1	string	0	network_modules	562	TRUE	0.0010072466143102928	85	5	3	0.6	0.03529411764705882	GO:0009185	GO:BP	ribonucleoside diphosphate metabolic process	16175	3351		0.5681818181818182	0.5777777777777777	85	16090	3	2	82	16088	16175	0.14464971401462592
M1	string	0	network_modules	562	TRUE	0.001159140137080592	388	5	4	0.8	0.010309278350515464	GO:0009117	GO:BP	nucleotide metabolic process	16175	3286		0.5909090909090909	0.6	388	15787	4	1	384	15786	16175	0.08918200983214493
M1	string	0	network_modules	562	TRUE	0.001197491793377393	90	5	3	0.6	0.03333333333333333	GO:0009154	GO:BP	purine ribonucleotide catabolic process	16175	3321		0.6136363636363636	0.6222222222222222	90	16085	3	2	87	16083	16175	0.1405230260657453
M1	string	0	network_modules	562	TRUE	0.0012798179957464774	92	5	3	0.6	0.03260869565217391	GO:0009261	GO:BP	ribonucleotide catabolic process	16175	3426		0.6363636363636364	0.6444444444444445	92	16083	3	2	89	16081	16175	0.13896693848412628
M1	string	0	network_modules	562	TRUE	0.0013223554576608535	93	5	3	0.6	0.03225806451612903	GO:0009132	GO:BP	nucleoside diphosphate metabolic process	16175	3299		0.6590909090909091	0.6666666666666666	93	16082	3	2	90	16080	16175	0.13820770366315543
M1	string	0	network_modules	562	TRUE	0.001325258449919296	120	5	3	0.6	0.025	KEGG:04152	KEGG	AMPK signaling pathway	8484	286		0.9090909090909091	0.9166666666666666	120	8364	3	2	117	8362	8484	0.1204776229024251
M1	string	0	network_modules	562	TRUE	0.001358708767418211	121	5	3	0.6	0.024793388429752067	KEGG:04919	KEGG	Thyroid hormone signaling pathway	8484	376		1	1	121	8363	3	2	118	8361	8484	0.11996178149529135
M1	string	0	network_modules	562	TRUE	0.0014555844457546608	96	5	3	0.6	0.03125	GO:0006090	GO:BP	pyruvate metabolic process	16175	1953		0.6818181818181818	0.6888888888888889	96	16079	3	2	93	16077	16175	0.13600129742561218
M1	string	0	network_modules	562	TRUE	0.0015974466882895247	99	5	3	0.6	0.030303030303030304	GO:0006195	GO:BP	purine nucleotide catabolic process	16175	2024		0.7045454545454546	0.7111111111111111	99	16076	3	2	96	16074	16175	0.13389549910607026
M1	string	0	network_modules	562	TRUE	0.0024710929725578006	469	5	4	0.8	0.008528784648187633	GO:0072521	GO:BP	purine-containing compound metabolic process	16175	17423		0.7272727272727273	0.7333333333333333	469	15706	4	1	465	15705	16175	0.08080012888553689
M1	string	0	network_modules	562	TRUE	0.0025773068433924957	116	5	3	0.6	0.02586206896551724	GO:0072523	GO:BP	purine-containing compound catabolic process	16175	17425		0.75	0.7555555555555555	116	16059	3	2	113	16057	16175	0.12354212499468227
M1	string	0	network_modules	562	TRUE	0.002644884158724493	117	5	3	0.6	0.02564102564102564	GO:0009166	GO:BP	nucleotide catabolic process	16175	3332		0.7727272727272727	0.7777777777777778	117	16058	3	2	114	16056	16175	0.12300403549008437
M1	string	0	network_modules	562	TRUE	0.002783548710067511	119	5	3	0.6	0.025210084033613446	GO:0006006	GO:BP	glucose metabolic process	16175	1881		0.7954545454545454	0.8	119	16056	3	2	116	16054	16175	0.12194816127339676
M1	string	0	network_modules	562	TRUE	0.003075192794275993	123	5	3	0.6	0.024390243902439025	GO:0016052	GO:BP	carbohydrate catabolic process	16175	5084		0.8181818181818182	0.8222222222222222	123	16052	3	2	120	16050	16175	0.11991376182585109
M1	string	0	network_modules	562	TRUE	0.003758034283231852	521	5	4	0.8	0.007677543186180422	GO:0006753	GO:BP	nucleoside phosphate metabolic process	16175	2450		0.8409090909090909	0.8444444444444444	521	15654	4	1	517	15653	16175	0.07646894401367106
M1	string	0	network_modules	562	TRUE	0.004348635431381604	138	5	3	0.6	0.021739130434782608	GO:0046496	GO:BP	nicotinamide nucleotide metabolic process	16175	12199		0.8636363636363636	0.8888888888888888	138	16037	3	2	135	16035	16175	0.11308491042845988
M1	string	0	network_modules	562	TRUE	0.004348635431381604	138	5	3	0.6	0.021739130434782608	GO:0019362	GO:BP	pyridine nucleotide metabolic process	16175	5724		0.8636363636363636	0.8888888888888888	138	16037	3	2	135	16035	16175	0.11308491042845988
M1	string	0	network_modules	562	TRUE	0.004444146545109636	139	5	3	0.6	0.02158273381294964	GO:1901292	GO:BP	nucleoside phosphate catabolic process	16175	21367		0.9090909090909091	0.9111111111111111	139	16036	3	2	136	16034	16175	0.11266913103949505
M1	string	0	network_modules	562	TRUE	0.00484011089205381	143	5	3	0.6	0.02097902097902098	GO:0072524	GO:BP	pyridine-containing compound metabolic process	16175	17426		0.9318181818181818	0.9333333333333333	143	16032	3	2	140	16030	16175	0.11104956476114135
M1	string	0	network_modules	562	TRUE	0.004939274243732769	558	5	4	0.8	0.007168458781362007	GO:0055086	GO:BP	nucleobase-containing small molecule metabolic process	16175	14237		0.9545454545454546	0.9555555555555556	558	15617	4	1	554	15616	16175	0.07375727910352227
M1	string	0	network_modules	562	TRUE	0.005476888921020923	149	5	3	0.6	0.020134228187919462	GO:0019318	GO:BP	hexose metabolic process	16175	5681		0.9772727272727273	0.9777777777777777	149	16026	3	2	146	16024	16175	0.10874277959301328
M1	string	0	network_modules	562	TRUE	0.007173471687620153	163	5	3	0.6	0.018404907975460124	GO:0005996	GO:BP	monosaccharide metabolic process	16175	1871		1	1	163	16012	3	2	160	16010	16175	0.10386107455294598
M1	string	0	network_modules	563	TRUE	4.6362993211574645e-5	84	3	3	1	0.03571428571428571	KEGG:03083	KEGG	Polycomb repressive complex	8484	220		NA	1	84	8400	3	0	81	8400	8484	0.1880776093110498
M1	string	0	network_modules	563	TRUE	5.369690206076665e-5	34	5	3	0.6	0.08823529411764706	REAC:R-HSA-8953750	REAC	Transcriptional Regulation by E2F6	10916	2543		0	0.3333333333333333	34	10882	3	2	31	10880	10916	0.22930489174581487
M1	string	0	network_modules	563	TRUE	0.003924093907567078	16	5	2	0.4	0.125	REAC:R-HSA-2559584	REAC	Formation of Senescence-Associated Heterochromatin Foci (SAHF)	10916	950		0.5	0.6666666666666666	16	10900	2	3	14	10897	10916	0.22300195695873815
M1	string	0	network_modules	563	TRUE	0.005001384993362142	18	5	2	0.4	0.1111111111111111	REAC:R-HSA-1362277	REAC	Transcription of E2F targets under negative control by DREAM complex	10916	2536		1	1	18	10898	2	3	16	10895	10916	0.21017088694923294
M1	string	0	network_modules	564	TRUE	1.1140549408243956e-5	177	4	4	1	0.022598870056497175	REAC:R-HSA-2990846	REAC	SUMOylation	10916	2167		0	0.14285714285714285	177	10739	4	0	173	10739	10916	0.14913277703046035
M1	string	0	network_modules	564	TRUE	3.2704710416246626e-5	41	4	3	0.75	0.07317073170731707	REAC:R-HSA-3899300	REAC	SUMOylation of transcription cofactors	10916	2177		0.16666666666666666	0.2857142857142857	41	10875	3	1	38	10874	10916	0.23356924751547856
M1	string	0	network_modules	564	TRUE	1.6779674839189002e-4	5	4	2	0.5	0.4	REAC:R-HSA-3065676	REAC	SUMO is conjugated to E1 (UBA2:SAE1)	10916	2164		0.3333333333333333	0.42857142857142855	5	10911	2	2	3	10909	10916	0.44698817556185216
M1	string	0	network_modules	564	TRUE	3.4978475925774973e-4	60	5	3	0.6	0.05	GO:0016925	GO:BP	protein sumoylation	16175	5258		0	0.5	60	16115	3	2	57	16113	16175	0.17248107253519926
M1	string	0	network_modules	564	TRUE	3.5228706385558213e-4	7	4	2	0.5	0.2857142857142857	REAC:R-HSA-3065678	REAC	SUMO is transferred from E1 to E2 (UBE2I, UBC9)	10916	2166		0.5	0.5714285714285714	7	10909	2	2	5	10907	10916	0.37767001729423827
M1	string	0	network_modules	564	TRUE	7.546241237176022e-4	10	4	2	0.5	0.2	REAC:R-HSA-3215018	REAC	Processing and activation of SUMO	10916	1795		0.6666666666666666	0.7142857142857143	10	10906	2	2	8	10904	10916	0.31585093673197046
M1	string	0	network_modules	564	TRUE	0.0024895782684612377	171	4	3	0.75	0.017543859649122806	REAC:R-HSA-3108232	REAC	SUMO E3 ligases SUMOylate target proteins	10916	2163		0.8333333333333334	0.8571428571428571	171	10745	3	1	168	10744	10916	0.11322289636620655
M1	string	0	network_modules	564	TRUE	0.0034673987084122824	128	5	3	0.6	0.0234375	GO:0018205	GO:BP	peptidyl-lysine modification	16175	5364		1	1	128	16047	3	2	125	16045	16175	0.11750533054266445
M1	string	0	network_modules	564	TRUE	0.008295286235839682	32	4	2	0.5	0.0625	REAC:R-HSA-4085377	REAC	SUMOylation of SUMOylation proteins	10916	2172		1	1	32	10884	2	2	30	10882	10916	0.17603067354664229
M1	string	0	network_modules	567	TRUE	0.001586337996458355	167	4	3	0.75	0.017964071856287425	KEGG:05164	KEGG	Influenza A	8484	445		NA	1	167	8317	3	1	164	8316	8484	0.11418311647225332
M1	string	0	network_modules	568	TRUE	2.830721104848348e-4	5	4	2	0.5	0.4	GO:0051664	GO:BP	nuclear pore localization	16175	13876		0	0.2	5	16170	2	2	3	16168	16175	0.4470614869492386
M1	string	0	network_modules	568	TRUE	0.001458742331844635	137	4	3	0.75	0.021897810218978103	GO:0031503	GO:BP	protein-containing complex localization	16175	7188		0.25	0.4	137	16038	3	1	134	16037	16175	0.12726215282693354
M1	string	0	network_modules	568	TRUE	0.0015561264922747044	11	4	2	0.5	0.18181818181818182	GO:0090435	GO:BP	protein localization to nuclear envelope	16175	18286		0.5	0.6	11	16164	2	2	9	16162	16175	0.30124093787466694
M1	string	0	network_modules	568	TRUE	0.003845972661947621	17	4	2	0.5	0.11764705882352941	GO:0007097	GO:BP	nuclear migration	16175	2680		0.75	0.8	17	16158	2	2	15	16156	16175	0.2421830455760906
M1	string	0	network_modules	568	TRUE	0.0066496171277495375	135	2	2	1	0.014814814814814815	KEGG:04210	KEGG	Apoptosis	8484	287		NA	1	135	8349	2	0	133	8349	8484	0.1207580829845106
M1	string	0	network_modules	568	TRUE	0.00715109976083305	23	4	2	0.5	0.08695652173913043	GO:0051647	GO:BP	nucleus localization	16175	13860		1	1	23	16152	2	2	21	16150	16175	0.2080951375401522
M1	string	0	network_modules	569	TRUE	0.002552064558095169	13	5	2	0.4	0.15384615384615385	REAC:R-HSA-162658	REAC	Golgi Cisternae Pericentriolar Stack Reorganization	10916	1083		NA	1	13	10903	2	3	11	10900	10916	0.24753500040008916
M1	string	0	network_modules	573	TRUE	0.0015561264922747044	11	4	2	0.5	0.18181818181818182	GO:0036152	GO:BP	phosphatidylethanolamine acyl-chain remodeling	16175	9465		NA	1	11	16164	2	2	9	16162	16175	0.30124093787466694
M1	string	0	network_modules	573	TRUE	0.0035663120714995024	99	2	2	1	0.020202020202020204	KEGG:00564	KEGG	Glycerophospholipid metabolism	8484	88		NA	1	99	8385	2	0	97	8385	8484	0.14131875410226413
M1	string	0	network_modules	580	TRUE	3.5331364940117604e-8	46	4	4	1	0.08695652173913043	GO:0006120	GO:BP	mitochondrial electron transport, NADH to ubiquinone	16175	1978		0	0.025	46	16129	4	0	42	16129	16175	0.2945007209002209
M1	string	0	network_modules	580	TRUE	1.465866796522793e-7	65	4	4	1	0.06153846153846154	GO:0042776	GO:BP	proton motive force-driven mitochondrial ATP synthesis	16175	10361		0.02564102564102564	0.05	65	16110	4	0	61	16110	16175	0.2476011451725456
M1	string	0	network_modules	580	TRUE	2.227444614195157e-7	72	4	4	1	0.05555555555555555	GO:0015986	GO:BP	proton motive force-driven ATP synthesis	16175	5062		0.05128205128205128	0.075	72	16103	4	0	68	16103	16175	0.23520616743166406
M1	string	0	network_modules	580	TRUE	3.7869091621265334e-7	82	4	4	1	0.04878048780487805	GO:0019646	GO:BP	aerobic electron transport chain	16175	5967		0.07692307692307693	0.1	82	16093	4	0	78	16093	16175	0.22032974740372713
M1	string	0	network_modules	580	TRUE	5.048800845066063e-7	88	4	4	1	0.045454545454545456	GO:0042775	GO:BP	mitochondrial ATP synthesis coupled electron transport	16175	10360		0.10256410256410256	0.15	88	16087	4	0	84	16087	16175	0.2126462615415612
M1	string	0	network_modules	580	TRUE	5.048800845066063e-7	88	4	4	1	0.045454545454545456	GO:0042773	GO:BP	ATP synthesis coupled electron transport	16175	10358		0.10256410256410256	0.15	88	16087	4	0	84	16087	16175	0.2126462615415612
M1	string	0	network_modules	580	TRUE	5.532270146235209e-7	90	4	4	1	0.044444444444444446	GO:0006754	GO:BP	ATP biosynthetic process	16175	2451		0.15384615384615385	0.175	90	16085	4	0	86	16085	16175	0.21025717985974474
M1	string	0	network_modules	580	TRUE	6.049655912262428e-7	92	4	4	1	0.043478260869565216	GO:0009206	GO:BP	purine ribonucleoside triphosphate biosynthetic process	16175	3372		0.1794871794871795	0.225	92	16083	4	0	88	16083	16175	0.20794628901719692
M1	string	0	network_modules	580	TRUE	6.049655912262428e-7	92	4	4	1	0.043478260869565216	GO:0009145	GO:BP	purine nucleoside triphosphate biosynthetic process	16175	3312		0.1794871794871795	0.225	92	16083	4	0	88	16083	16175	0.20794628901719692
M1	string	0	network_modules	580	TRUE	7.501763427957058e-7	97	4	4	1	0.041237113402061855	GO:0009201	GO:BP	ribonucleoside triphosphate biosynthetic process	16175	3367		0.23076923076923078	0.25	97	16078	4	0	93	16078	16175	0.2024844618394175
M1	string	0	network_modules	580	TRUE	8.150292136398578e-7	99	4	4	1	0.04040404040404041	GO:0022904	GO:BP	respiratory electron transport chain	16175	6631		0.2564102564102564	0.275	99	16076	4	0	95	16076	16175	0.20041626237024054
M1	string	0	network_modules	580	TRUE	9.57255143092924e-7	103	4	4	1	0.038834951456310676	GO:0009142	GO:BP	nucleoside triphosphate biosynthetic process	16175	3309		0.28205128205128205	0.3	103	16072	4	0	99	16072	16175	0.19646170403049903
M1	string	0	network_modules	580	TRUE	1.1173293821345113e-6	107	4	4	1	0.037383177570093455	GO:0022900	GO:BP	electron transport chain	16175	6630		0.3076923076923077	0.325	107	16068	4	0	103	16068	16175	0.19273055844577158
M1	string	0	network_modules	580	TRUE	2.2375610956537828e-6	127	4	4	1	0.031496062992125984	GO:0006119	GO:BP	oxidative phosphorylation	16175	1977		0.3333333333333333	0.35	127	16048	4	0	123	16048	16175	0.1767950716663462
M1	string	0	network_modules	580	TRUE	2.3097404858361624e-6	128	4	4	1	0.03125	GO:0009152	GO:BP	purine ribonucleotide biosynthetic process	16175	3319		0.358974358974359	0.375	128	16047	4	0	124	16047	16175	0.17609762493609005
M1	string	0	network_modules	580	TRUE	3.04065383547244e-6	137	4	4	1	0.029197080291970802	GO:0009260	GO:BP	ribonucleotide biosynthetic process	16175	3425		0.38461538461538464	0.4	137	16038	4	0	133	16038	16175	0.17016740580181006
M1	string	0	network_modules	580	TRUE	3.1968814481394312e-6	134	4	4	1	0.029850746268656716	KEGG:00190	KEGG	Oxidative phosphorylation	8484	18		0	0.1	134	8350	4	0	130	8350	8484	0.17144424369497488
M1	string	0	network_modules	580	TRUE	3.616100302416815e-6	143	4	4	1	0.027972027972027972	GO:0046390	GO:BP	ribose phosphate biosynthetic process	16175	12117		0.41025641025641024	0.425	143	16032	4	0	139	16032	16175	0.16652804764624332
M1	string	0	network_modules	580	TRUE	4.777764875517932e-6	148	4	4	1	0.02702702702702703	KEGG:04723	KEGG	Retrograde endocannabinoid signaling	8484	353		0.1111111111111111	0.2	148	8336	4	0	144	8336	8484	0.16299717025603158
M1	string	0	network_modules	580	TRUE	5.9858652449075385e-6	162	4	4	1	0.024691358024691357	GO:0009060	GO:BP	aerobic respiration	16175	3236		0.4358974358974359	0.45	162	16013	4	0	158	16013	16175	0.156365306928663
M1	string	0	network_modules	580	TRUE	6.289864376056149e-6	164	4	4	1	0.024390243902439025	GO:0006164	GO:BP	purine nucleotide biosynthetic process	16175	1999		0.46153846153846156	0.475	164	16011	4	0	160	16011	16175	0.15539922974758852
M1	string	0	network_modules	580	TRUE	1.0006629352402873e-5	184	4	4	1	0.021739130434782608	GO:0046034	GO:BP	ATP metabolic process	16175	11811		0.48717948717948717	0.5	184	15991	4	0	180	15991	16175	0.14661906891213192
M1	string	0	network_modules	580	TRUE	1.0452556493721814e-5	186	4	4	1	0.021505376344086023	GO:0009165	GO:BP	nucleotide biosynthetic process	16175	3331		0.5128205128205128	0.525	186	15989	4	0	182	15989	16175	0.14581954415440518
M1	string	0	network_modules	580	TRUE	1.0913223927693176e-5	188	4	4	1	0.02127659574468085	GO:0045333	GO:BP	cellular respiration	16175	11360		0.5384615384615384	0.55	188	15987	4	0	184	15987	16175	0.14503276273881277
M1	string	0	network_modules	580	TRUE	1.3449032320436088e-5	198	4	4	1	0.020202020202020204	GO:0009205	GO:BP	purine ribonucleoside triphosphate metabolic process	16175	3371		0.5641025641025641	0.575	198	15977	4	0	194	15977	16175	0.14127866407167516
M1	string	0	network_modules	580	TRUE	1.4289375796155374e-5	201	4	4	1	0.01990049751243781	GO:0009144	GO:BP	purine nucleoside triphosphate metabolic process	16175	3311		0.5897435897435898	0.6	201	15974	4	0	197	15974	16175	0.14020721682115458
M1	string	0	network_modules	580	TRUE	1.5168497710143874e-5	204	4	4	1	0.0196078431372549	GO:0009199	GO:BP	ribonucleoside triphosphate metabolic process	16175	3365		0.6153846153846154	0.625	204	15971	4	0	200	15971	16175	0.1391593938030232
M1	string	0	network_modules	580	TRUE	1.6763139691566174e-5	202	4	4	1	0.019801980198019802	KEGG:05415	KEGG	Diabetic cardiomyopathy	8484	492		0.2222222222222222	0.3	202	8282	4	0	198	8282	8484	0.13906697178521374
M1	string	0	network_modules	580	TRUE	1.8742893426684957e-5	215	4	4	1	0.018604651162790697	GO:0009141	GO:BP	nucleoside triphosphate metabolic process	16175	3308		0.6410256410256411	0.65	215	15960	4	0	211	15960	16175	0.13550607648082333
M1	string	0	network_modules	580	TRUE	2.056136588129013e-5	220	4	4	1	0.01818181818181818	GO:0072522	GO:BP	purine-containing compound biosynthetic process	16175	17424		0.6666666666666666	0.675	220	15955	4	0	216	15955	16175	0.13393639980161948
M1	string	0	network_modules	580	TRUE	2.4079109856969165e-5	221	4	4	1	0.01809954751131222	KEGG:05208	KEGG	Chemical carcinogenesis - reactive oxygen species	8484	460		0.3333333333333333	0.4	221	8263	4	0	217	8263	8484	0.13280205917272392
M1	string	0	network_modules	580	TRUE	2.4546618119665805e-5	57	3	3	1	0.05263157894736842	REAC:R-HSA-6799198	REAC	Complex I biogenesis	10916	391		0	0.3333333333333333	57	10859	3	0	54	10859	10916	0.22884742942275274
M1	string	0	network_modules	580	TRUE	2.928115127655185e-5	232	4	4	1	0.017241379310344827	KEGG:04714	KEGG	Thermogenesis	8484	349		0.4444444444444444	0.5	232	8252	4	0	228	8252	8484	0.1295292010445022
M1	string	0	network_modules	580	TRUE	3.55207850945558e-5	252	4	4	1	0.015873015873015872	GO:0015980	GO:BP	energy derivation by oxidation of organic compounds	16175	5060		0.6923076923076923	0.7	252	15923	4	0	248	15923	16175	0.12501834179846852
M1	string	0	network_modules	580	TRUE	4.0280502475122166e-5	260	4	4	1	0.015384615384615385	GO:1901293	GO:BP	nucleoside phosphate biosynthetic process	16175	21368		0.717948717948718	0.725	260	15915	4	0	256	15915	16175	0.12304903286357859
M1	string	0	network_modules	580	TRUE	4.415258385894161e-5	266	4	4	1	0.015037593984962405	GO:0009150	GO:BP	purine ribonucleotide metabolic process	16175	3317		0.7435897435897436	0.75	266	15909	4	0	262	15909	16175	0.12163041252520815
M1	string	0	network_modules	580	TRUE	5.0007104147251205e-5	265	4	4	1	0.01509433962264151	KEGG:05012	KEGG	Parkinson disease	8484	412		0.5555555555555556	0.6	265	8219	4	0	261	8219	8484	0.12095355092329481
M1	string	0	network_modules	580	TRUE	5.121815426842401e-5	276	4	4	1	0.014492753623188406	GO:0009259	GO:BP	ribonucleotide metabolic process	16175	3424		0.7692307692307693	0.775	276	15899	4	0	272	15899	16175	0.1193691003549053
M1	string	0	network_modules	580	TRUE	5.471986209950413e-5	271	4	4	1	0.014760147601476014	KEGG:05020	KEGG	Prion disease	8484	416		0.6666666666666666	0.7	271	8213	4	0	267	8213	8484	0.11956342175616567
M1	string	0	network_modules	580	TRUE	5.6645945897585604e-5	283	4	4	1	0.014134275618374558	GO:0019693	GO:BP	ribose phosphate metabolic process	16175	6010		0.7948717948717948	0.8	283	15892	4	0	279	15892	16175	0.117857606639981
M1	string	0	network_modules	580	TRUE	8.801320975868316e-5	305	4	4	1	0.013114754098360656	KEGG:05016	KEGG	Huntington disease	8484	414		0.7777777777777778	0.8	305	8179	4	0	301	8179	8484	0.11246884986482474
M1	string	0	network_modules	580	TRUE	1.315464652058531e-4	349	4	4	1	0.011461318051575931	GO:0006163	GO:BP	purine nucleotide metabolic process	16175	1998		0.8205128205128205	0.825	349	15826	4	0	345	15826	16175	0.10590937967433153
M1	string	0	network_modules	580	TRUE	1.483627464484293e-4	103	3	3	1	0.02912621359223301	REAC:R-HSA-611105	REAC	Respiratory electron transport	10916	2081		0.5	0.6666666666666666	103	10813	3	0	100	10813	10916	0.16988030768226756
M1	string	0	network_modules	580	TRUE	1.6998628313542668e-4	372	4	4	1	0.010752688172043012	GO:0006091	GO:BP	generation of precursor metabolites and energy	16175	1954		0.8461538461538461	0.85	372	15803	4	0	368	15803	16175	0.1025084949618711
M1	string	0	network_modules	580	TRUE	1.7715351075294226e-4	363	4	4	1	0.011019283746556474	KEGG:05014	KEGG	Amyotrophic lateral sclerosis	8484	413		0.8888888888888888	0.9	363	8121	4	0	359	8121	8484	0.1027267414488607
M1	string	0	network_modules	580	TRUE	2.0130736440467816e-4	388	4	4	1	0.010309278350515464	GO:0009117	GO:BP	nucleotide metabolic process	16175	3286		0.8717948717948718	0.875	388	15787	4	0	384	15787	16175	0.1003218422756115
M1	string	0	network_modules	580	TRUE	2.1743828317495595e-4	382	4	4	1	0.010471204188481676	KEGG:05010	KEGG	Alzheimer disease	8484	411		1	1	382	8102	4	0	378	8102	8484	0.10002222414310154
M1	string	0	network_modules	580	TRUE	4.3091382837748325e-4	469	4	4	1	0.008528784648187633	GO:0072521	GO:BP	purine-containing compound metabolic process	16175	17423		0.8974358974358975	0.9	469	15706	4	0	465	15706	16175	0.09101394354037368
M1	string	0	network_modules	580	TRUE	6.126998269596408e-4	512	4	4	1	0.0078125	GO:0090407	GO:BP	organophosphate biosynthetic process	16175	18274		0.9230769230769231	0.925	512	15663	4	0	508	15663	16175	0.08698894236054373
M1	string	0	network_modules	580	TRUE	6.223580098323203e-4	514	4	4	1	0.007782101167315175	GO:1901137	GO:BP	carbohydrate derivative biosynthetic process	16175	21245		0.9487179487179487	0.95	514	15661	4	0	510	15661	16175	0.0868139950755407
M1	string	0	network_modules	580	TRUE	6.570631670600254e-4	521	4	4	1	0.007677543186180422	GO:0006753	GO:BP	nucleoside phosphate metabolic process	16175	2450		0.9743589743589743	0.975	521	15654	4	0	517	15654	16175	0.08620954643632962
M1	string	0	network_modules	580	TRUE	7.622370889790995e-4	177	3	3	1	0.01694915254237288	REAC:R-HSA-1428517	REAC	Aerobic respiration and respiratory electron transport	10916	127		1	1	177	10739	3	0	174	10739	10916	0.12914685592801367
M1	string	0	network_modules	580	TRUE	8.652191176907593e-4	558	4	4	1	0.007168458781362007	GO:0055086	GO:BP	nucleobase-containing small molecule metabolic process	16175	14237		1	1	558	15617	4	0	554	15617	16175	0.08320381942353625
M1	string	0	network_modules	585	TRUE	1.2771824473590472e-4	8	2	2	1	0.25	REAC:R-HSA-72731	REAC	Recycling of eIF2:GDP	10916	1953		0	0.14285714285714285	8	10908	2	0	6	10908	10916	0.4998625429527289
M1	string	0	network_modules	585	TRUE	4.789434177596428e-4	15	2	2	1	0.13333333333333333	REAC:R-HSA-9648895	REAC	Response of EIF2AK1 (HRI) to heme deficiency	10916	2086		0.16666666666666666	0.2857142857142857	15	10901	2	0	13	10901	10916	0.36493083716272035
M1	string	0	network_modules	585	TRUE	7.727768903886162e-4	111	4	3	0.75	0.02702702702702703	GO:0006413	GO:BP	translational initiation	16175	2171		NA	1	111	16064	3	1	108	16063	16175	0.14157504889904243
M1	string	0	network_modules	585	TRUE	0.002262437478178884	32	2	2	1	0.0625	REAC:R-HSA-381042	REAC	PERK regulates gene expression	10916	1664		0.3333333333333333	0.42857142857142855	32	10884	2	0	30	10884	10916	0.2496561681772773
M1	string	0	network_modules	585	TRUE	0.006048371161421775	52	2	2	1	0.038461538461538464	REAC:R-HSA-72695	REAC	Formation of the ternary complex, and subsequently, the 43S complex	10916	973		0.5	0.5714285714285714	52	10864	2	0	50	10864	10916	0.19566638878841308
M1	string	0	network_modules	585	TRUE	0.007804497026540451	59	2	2	1	0.03389830508474576	REAC:R-HSA-72649	REAC	Translation initiation complex formation	10916	2566		0.6666666666666666	0.8571428571428571	59	10857	2	0	57	10857	10916	0.18363351030848754
M1	string	0	network_modules	585	TRUE	0.007804497026540451	59	2	2	1	0.03389830508474576	REAC:R-HSA-72702	REAC	Ribosomal scanning and start codon recognition	10916	2106		0.6666666666666666	0.8571428571428571	59	10857	2	0	57	10857	10916	0.18363351030848754
M1	string	0	network_modules	585	TRUE	0.008073617613662553	60	2	2	1	0.03333333333333333	REAC:R-HSA-72662	REAC	Activation of the mRNA upon binding of the cap-binding complex and eIFs, and subsequent binding to 43S	10916	105		1	1	60	10856	2	0	58	10856	10916	0.1820884148572878
M1	string	0	network_modules	591	TRUE	2.2882768737886497e-5	35	4	3	0.75	0.08571428571428572	GO:0030261	GO:BP	chromosome condensation	16175	6749		0	0.25	35	16140	3	1	32	16139	16175	0.25312003612333916
M1	string	0	network_modules	591	TRUE	4.0123571977349106e-5	42	4	3	0.75	0.07142857142857142	GO:0045910	GO:BP	negative regulation of DNA recombination	16175	11704		0.3333333333333333	0.5	42	16133	3	1	39	16132	16175	0.23098230115815804
M1	string	0	network_modules	591	TRUE	7.136807575790226e-4	13	3	2	0.6666666666666666	0.15384615384615385	REAC:R-HSA-140342	REAC	Apoptosis induced DNA fragmentation	10916	159		0	0.5	13	10903	2	1	11	10902	10916	0.3199187039314686
M1	string	0	network_modules	591	TRUE	8.156257389786119e-4	113	4	3	0.75	0.02654867256637168	GO:0000018	GO:BP	regulation of DNA recombination	16175	6		0.6666666666666666	0.75	113	16062	3	1	110	16061	16175	0.1403019665598749
M1	string	0	network_modules	591	TRUE	9.780024866020546e-4	120	4	3	0.75	0.025	GO:0051053	GO:BP	negative regulation of DNA metabolic process	16175	13463		1	1	120	16055	3	1	117	16054	16175	0.13609870270565624
M1	string	0	network_modules	591	TRUE	0.0010977690569606976	16	3	2	0.6666666666666666	0.125	REAC:R-HSA-2559584	REAC	Formation of Senescence-Associated Heterochromatin Foci (SAHF)	10916	950		1	1	16	10900	2	1	14	10899	10916	0.2882913972771879
M1	string	0	network_modules	592	TRUE	2.0550662979499116e-4	390	4	4	1	0.010256410256410256	GO:0022613	GO:BP	ribonucleoprotein complex biogenesis	16175	6620		0	0.2	390	15785	4	0	386	15785	16175	0.10005793754723888
M1	string	0	network_modules	592	TRUE	0.002745672736168823	169	4	3	0.75	0.01775147928994083	GO:0006364	GO:BP	rRNA processing	16175	2140		0.25	0.4	169	16006	3	1	166	16005	16175	0.11439042486718189
M1	string	0	network_modules	592	TRUE	0.004907779725225224	205	4	3	0.75	0.014634146341463415	GO:0016072	GO:BP	rRNA metabolic process	16175	5099		0.5	0.6	205	15970	3	1	202	15969	16175	0.10366593697349143
M1	string	0	network_modules	592	TRUE	0.009013258262247118	251	4	3	0.75	0.01195219123505976	GO:0042254	GO:BP	ribosome biogenesis	16175	10060		0.75	0.8	251	15924	3	1	248	15923	16175	0.0934596589016322
M1	string	0	network_modules	592	TRUE	0.009917817065442654	27	4	2	0.5	0.07407407407407407	GO:0000470	GO:BP	maturation of LSU-rRNA	16175	159		1	1	27	16148	2	2	25	16146	16175	0.19199162611275264
M1	string	0	network_modules	595	TRUE	2.830721104848348e-4	5	4	2	0.5	0.4	GO:0016076	GO:BP	snRNA catabolic process	16175	5103		NA	1	5	16170	2	2	3	16168	16175	0.4470614869492386
M1	string	0	network_modules	596	TRUE	0.00410614606372029	202	4	3	0.75	0.01485148514851485	REAC:R-HSA-72163	REAC	mRNA Splicing - Major Pathway	10916	2707		0	0.5	202	10714	3	1	199	10713	10916	0.10392050098562043
M1	string	0	network_modules	596	TRUE	0.0045480482137003585	209	4	3	0.75	0.014354066985645933	REAC:R-HSA-72172	REAC	mRNA Splicing	10916	2706		1	1	209	10707	3	1	206	10706	10916	0.10210918377031558
M1	string	0	network_modules	598	TRUE	9.15422750928893e-5	5	3	2	0.6666666666666666	0.4	REAC:R-HSA-426048	REAC	Arachidonate production from DAG	10916	166		0	0.5	5	10911	2	1	3	10910	10916	0.5162321482100574
M1	string	0	network_modules	598	TRUE	0.0032088151274596577	27	3	2	0.6666666666666666	0.07407407407407407	REAC:R-HSA-114508	REAC	Effects of PIP2 hydrolysis	10916	833		1	1	27	10889	2	1	25	10888	10916	0.22170252656645592
M1	string	0	network_modules	598	TRUE	0.00799718464518069	148	2	2	1	0.013513513513513514	KEGG:04723	KEGG	Retrograde endocannabinoid signaling	8484	353		NA	1	148	8336	2	0	146	8336	8484	0.11524281524882975
M1	string	0	network_modules	604	TRUE	5.473639060110199e-4	16	2	2	1	0.125	REAC:R-HSA-210993	REAC	Tie2 Signaling	10916	2509		NA	1	16	10900	2	0	14	10900	10916	0.35332655644370065
M1	string	0	network_modules	604	TRUE	0.004327213533878798	109	2	2	1	0.01834862385321101	KEGG:04066	KEGG	HIF-1 signaling pathway	8484	257		NA	1	109	8375	2	0	107	8375	8484	0.13459998846024124
M1	string	0	network_modules	604	TRUE	0.0061187096533699865	34	3	2	0.6666666666666666	0.058823529411764705	GO:0043537	GO:BP	negative regulation of blood vessel endothelial cell migration	16175	10758		0	0.3333333333333333	34	16141	2	1	32	16140	16175	0.19763124847567545
M1	string	0	network_modules	604	TRUE	0.007148984405101332	400	3	3	1	0.0075	GO:0001525	GO:BP	angiogenesis	16175	330		0.5	0.6666666666666666	400	15775	3	0	397	15775	16175	0.08553294968068392
M1	string	0	network_modules	604	TRUE	0.009984602585162103	447	3	3	1	0.006711409395973154	GO:0048514	GO:BP	blood vessel morphogenesis	16175	12799		1	1	447	15728	3	0	444	15728	16175	0.0807907704438497
M1	string	0	network_modules	610	TRUE	0.006259976765371717	131	2	2	1	0.015267175572519083	KEGG:04142	KEGG	Lysosome	8484	279		NA	1	131	8353	2	0	129	8353	8484	0.12261721750023377
M1	string	0	network_modules	611	TRUE	1.2771824473590472e-4	8	2	2	1	0.25	REAC:R-HSA-444821	REAC	Relaxin receptors	10916	2053		NA	1	8	10908	2	0	6	10908	10916	0.4998625429527289
M1	string	0	network_modules	611	TRUE	1.700605723879998e-4	129	3	3	1	0.023255813953488372	KEGG:04926	KEGG	Relaxin signaling pathway	8484	383		0	0.5	129	8355	3	0	126	8355	8484	0.15136151560034602
M1	string	0	network_modules	611	TRUE	0.0039111197087069605	365	3	3	1	0.00821917808219178	KEGG:04080	KEGG	Neuroactive ligand-receptor interaction	8484	263		1	1	365	8119	3	0	362	8119	8484	0.08870374059865381
M1	string	0	network_modules	614	TRUE	0.003976006841408507	30	3	2	0.6666666666666666	0.06666666666666667	REAC:R-HSA-9680350	REAC	Signaling by CSF1 (M-CSF) in myeloid cells	10916	2226		NA	1	30	10886	2	1	28	10885	10916	0.21026742396583623
M1	string	0	network_modules	625	TRUE	0.007464186036267645	143	2	2	1	0.013986013986013986	KEGG:04550	KEGG	Signaling pathways regulating pluripotency of stem cells	8484	319		NA	1	143	8341	2	0	141	8341	8484	0.1172753953371743
M1	string	0	network_modules	630	TRUE	0.0076662080381286885	38	3	2	0.6666666666666666	0.05263157894736842	GO:0050832	GO:BP	defense response to fungus	16175	13290		0	0.5	38	16137	2	1	36	16136	16175	0.18689404152052572
M1	string	0	network_modules	630	TRUE	0.008940984431095342	41	3	2	0.6666666666666666	0.04878048780487805	GO:0009620	GO:BP	response to fungus	16175	3544		1	1	41	16134	2	1	39	16133	16175	0.17989306889367992
M1	string	0	network_modules	632	TRUE	0.0021511088685235097	77	2	2	1	0.025974025974025976	KEGG:05100	KEGG	Bacterial invasion of epithelial cells	8484	423		NA	1	77	8407	2	0	75	8407	8484	0.16045048156408623
M1	string	0	network_modules	634	TRUE	0.007024930029910556	370	3	3	1	0.008108108108108109	REAC:R-HSA-71291	REAC	Metabolism of amino acids and derivatives	10916	1421		NA	1	370	10546	3	0	367	10546	10916	0.08851799560262366
